date,geography,geography code,Tenure of household: Total: All households,Tenure of household: Owned,Tenure of household: Owned: Owns outright,Tenure of household: Owned: Owns with a mortgage or loan,Tenure of household: Shared ownership,Tenure of household: Shared ownership: Shared ownership,Tenure of household: Social rented,Tenure of household: Social rented: Rents from council or Local Authority,Tenure of household: Social rented: Other social rented,Tenure of household: Private rented,Tenure of household: Private rented: Private landlord or letting agency,Tenure of household: Private rented: Other private rented,Tenure of household: Lives rent free
2021,City of London 001A,E01000001,837,481,337,144,4,4,22,18,4,329,280,49,1
2021,City of London 001B,E01000002,826,433,284,149,2,2,27,23,4,364,326,38,0
2021,City of London 001C,E01000003,1015,378,231,147,0,0,302,250,52,333,292,41,2
2021,City of London 001E,E01000005,478,40,19,21,1,1,333,148,185,104,91,13,0
2021,Barking and Dagenham 016A,E01000006,553,270,111,159,4,4,22,13,9,257,228,29,0
2021,Barking and Dagenham 015A,E01000007,1190,201,34,167,116,116,452,261,191,417,398,19,4
2021,Barking and Dagenham 015B,E01000008,548,82,32,50,6,6,310,296,14,147,135,12,3
2021,Barking and Dagenham 016B,E01000009,598,200,109,91,0,0,116,102,14,280,271,9,2
2021,Barking and Dagenham 016C,E01000011,473,197,101,96,1,1,28,17,11,247,229,18,0
2021,Barking and Dagenham 015D,E01000012,782,196,70,126,29,29,223,71,152,332,312,20,2
2021,Barking and Dagenham 013A,E01000013,619,254,86,168,2,2,189,167,22,173,151,22,1
2021,Barking and Dagenham 013B,E01000014,634,285,111,174,4,4,214,180,34,129,118,11,2
2021,Barking and Dagenham 009A,E01000015,834,320,93,227,33,33,259,212,47,220,201,19,2
2021,Barking and Dagenham 009B,E01000016,628,313,110,203,3,3,201,175,26,111,100,11,0
2021,Barking and Dagenham 009C,E01000017,597,275,90,185,5,5,212,180,32,104,88,16,1
2021,Barking and Dagenham 009D,E01000018,645,270,104,166,5,5,247,182,65,123,117,6,0
2021,Barking and Dagenham 023A,E01000019,501,231,79,152,1,1,124,109,15,144,138,6,1
2021,Barking and Dagenham 023B,E01000020,664,296,82,214,7,7,209,182,27,149,133,16,3
2021,Barking and Dagenham 008A,E01000021,591,211,70,141,4,4,159,125,34,217,193,24,0
2021,Barking and Dagenham 008B,E01000022,479,234,78,156,19,19,119,104,15,106,87,19,1
2021,Barking and Dagenham 008D,E01000024,459,226,72,154,1,1,145,129,16,86,81,5,1
2021,Barking and Dagenham 008E,E01000025,696,271,93,178,13,13,284,222,62,128,111,17,0
2021,Barking and Dagenham 001A,E01000027,663,265,86,179,4,4,302,143,159,92,84,8,0
2021,Barking and Dagenham 001B,E01000028,621,193,61,132,0,0,316,259,57,106,96,10,6
2021,Barking and Dagenham 001C,E01000029,682,515,284,231,3,3,50,40,10,114,104,10,0
2021,Barking and Dagenham 001D,E01000030,905,264,76,188,2,2,530,479,51,105,96,9,4
2021,Barking and Dagenham 002A,E01000031,595,415,186,229,2,2,38,30,8,140,127,13,0
2021,Barking and Dagenham 002B,E01000032,723,375,170,205,1,1,105,83,22,242,225,17,0
2021,Barking and Dagenham 006A,E01000033,554,211,82,129,3,3,271,253,18,67,62,5,2
2021,Barking and Dagenham 003A,E01000034,511,228,72,156,9,9,198,154,44,76,70,6,0
2021,Barking and Dagenham 010A,E01000035,595,295,125,170,4,4,122,86,36,174,158,16,0
2021,Barking and Dagenham 010B,E01000036,471,313,130,183,1,1,22,18,4,135,117,18,0
2021,Barking and Dagenham 003B,E01000037,589,468,213,255,3,3,19,12,7,99,91,8,0
2021,Barking and Dagenham 003C,E01000038,566,413,190,223,3,3,70,63,7,80,69,11,0
2021,Barking and Dagenham 003D,E01000039,642,434,174,260,1,1,85,32,53,121,107,14,1
2021,Barking and Dagenham 019A,E01000040,656,216,75,141,2,2,270,250,20,166,161,5,2
2021,Barking and Dagenham 017A,E01000041,605,286,97,189,2,2,187,164,23,129,118,11,1
2021,Barking and Dagenham 017B,E01000042,652,225,69,156,2,2,285,207,78,140,132,8,0
2021,Barking and Dagenham 019B,E01000043,470,226,84,142,15,15,140,134,6,89,77,12,0
2021,Barking and Dagenham 016D,E01000044,661,292,111,181,4,4,122,38,84,243,229,14,0
2021,Barking and Dagenham 017C,E01000045,578,248,87,161,3,3,198,182,16,129,112,17,0
2021,Barking and Dagenham 017D,E01000046,662,281,90,191,9,9,242,189,53,128,111,17,2
2021,Barking and Dagenham 021C,E01000049,575,108,43,65,19,19,353,349,4,91,83,8,4
2021,Barking and Dagenham 019C,E01000050,631,229,107,122,61,61,147,130,17,179,150,29,15
2021,Barking and Dagenham 021D,E01000051,432,34,8,26,141,141,193,146,47,64,57,7,0
2021,Barking and Dagenham 019D,E01000052,797,330,127,203,3,3,172,155,17,287,268,19,5
2021,Barking and Dagenham 020A,E01000053,651,207,73,134,13,13,230,145,85,199,186,13,2
2021,Barking and Dagenham 018A,E01000054,640,293,103,190,0,0,225,208,17,121,108,13,1
2021,Barking and Dagenham 018B,E01000055,568,253,89,164,2,2,206,178,28,107,96,11,0
2021,Barking and Dagenham 018C,E01000056,563,202,61,141,15,15,254,133,121,92,79,13,0
2021,Barking and Dagenham 012A,E01000057,530,195,68,127,12,12,212,169,43,107,98,9,4
2021,Barking and Dagenham 018D,E01000058,698,263,79,184,27,27,215,176,39,192,183,9,1
2021,Barking and Dagenham 013C,E01000059,570,273,99,174,1,1,198,168,30,97,92,5,1
2021,Barking and Dagenham 006B,E01000060,810,318,116,202,3,3,350,315,35,139,130,9,0
2021,Barking and Dagenham 006C,E01000061,750,162,22,140,36,36,505,490,15,44,38,6,3
2021,Barking and Dagenham 006D,E01000062,769,399,152,247,6,6,216,197,19,146,137,9,2
2021,Barking and Dagenham 004A,E01000063,625,314,105,209,0,0,199,183,16,109,101,8,3
2021,Barking and Dagenham 006E,E01000064,794,362,101,261,14,14,210,166,44,207,189,18,1
2021,Barking and Dagenham 007A,E01000065,781,276,106,170,3,3,357,321,36,143,128,15,2
2021,Barking and Dagenham 011A,E01000066,705,432,160,272,2,2,156,149,7,115,107,8,0
2021,Barking and Dagenham 011B,E01000067,661,424,176,248,4,4,101,98,3,132,117,15,0
2021,Barking and Dagenham 016E,E01000068,476,324,147,177,2,2,6,4,2,144,136,8,0
2021,Barking and Dagenham 011C,E01000069,536,447,174,273,1,1,13,11,2,75,67,8,0
2021,Barking and Dagenham 011D,E01000070,578,423,183,240,0,0,30,25,5,125,113,12,0
2021,Barking and Dagenham 011E,E01000071,806,488,169,319,3,3,102,41,61,213,190,23,0
2021,Barking and Dagenham 017E,E01000072,741,238,76,162,5,5,308,241,67,184,170,14,6
2021,Barking and Dagenham 012B,E01000073,665,285,90,195,2,2,227,207,20,148,136,12,3
2021,Barking and Dagenham 012C,E01000074,626,249,79,170,1,1,252,235,17,122,105,17,2
2021,Barking and Dagenham 012D,E01000075,640,320,144,176,1,1,190,178,12,129,112,17,0
2021,Barking and Dagenham 012E,E01000076,793,279,92,187,5,5,323,287,36,184,172,12,2
2021,Barking and Dagenham 008F,E01000077,592,223,71,152,2,2,232,163,69,133,114,19,2
2021,Barking and Dagenham 007B,E01000078,623,274,86,188,4,4,203,178,25,139,124,15,3
2021,Barking and Dagenham 009E,E01000079,622,265,87,178,3,3,200,155,45,153,141,12,1
2021,Barking and Dagenham 007C,E01000080,608,284,97,187,1,1,221,194,27,102,97,5,0
2021,Barking and Dagenham 007D,E01000081,652,347,109,238,4,4,189,167,22,112,104,8,0
2021,Barking and Dagenham 007E,E01000082,697,283,79,204,30,30,233,197,36,149,140,9,2
2021,Barking and Dagenham 007F,E01000083,633,305,110,195,3,3,199,172,27,126,118,8,0
2021,Barking and Dagenham 013D,E01000084,498,200,65,135,2,2,189,170,19,107,95,12,0
2021,Barking and Dagenham 013E,E01000085,576,186,67,119,4,4,243,185,58,142,135,7,1
2021,Barking and Dagenham 013F,E01000086,488,208,73,135,5,5,174,142,32,101,92,9,0
2021,Barking and Dagenham 020B,E01000087,519,226,94,132,12,12,169,141,28,109,97,12,3
2021,Barking and Dagenham 020C,E01000088,608,313,118,195,7,7,74,46,28,213,205,8,1
2021,Barking and Dagenham 020D,E01000089,604,340,136,204,1,1,67,44,23,196,173,23,0
2021,Barking and Dagenham 020E,E01000090,558,304,130,174,1,1,72,63,9,180,171,9,1
2021,Barking and Dagenham 022A,E01000091,672,199,68,131,2,2,367,345,22,103,92,11,1
2021,Barking and Dagenham 022B,E01000093,665,192,57,135,21,21,344,328,16,106,86,20,2
2021,Barking and Dagenham 022C,E01000094,844,234,24,210,17,17,351,205,146,240,230,10,2
2021,Barking and Dagenham 018E,E01000095,737,325,73,252,29,29,241,228,13,141,134,7,1
2021,Barking and Dagenham 022D,E01000096,483,174,46,128,8,8,220,208,12,80,73,7,1
2021,Barking and Dagenham 023C,E01000097,685,254,88,166,3,3,265,194,71,162,148,14,1
2021,Barking and Dagenham 023D,E01000098,622,280,100,180,6,6,193,172,21,142,134,8,1
2021,Barking and Dagenham 023E,E01000099,933,405,117,288,49,49,257,162,95,221,207,14,1
2021,Barking and Dagenham 004B,E01000100,656,264,82,182,1,1,246,216,30,144,132,12,1
2021,Barking and Dagenham 004C,E01000101,583,245,89,156,3,3,206,171,35,127,114,13,2
2021,Barking and Dagenham 007G,E01000102,629,255,96,159,0,0,239,213,26,132,126,6,3
2021,Barking and Dagenham 014A,E01000103,533,233,88,145,29,29,166,58,108,104,94,10,1
2021,Barking and Dagenham 014B,E01000104,693,215,85,130,14,14,364,302,62,99,86,13,1
2021,Barking and Dagenham 014C,E01000105,935,235,88,147,17,17,532,383,149,151,135,16,0
2021,Barking and Dagenham 014D,E01000106,870,253,114,139,6,6,369,322,47,239,222,17,3
2021,Barking and Dagenham 010C,E01000107,604,369,180,189,5,5,83,70,13,147,131,16,0
2021,Barking and Dagenham 010D,E01000108,686,332,149,183,4,4,126,67,59,224,202,22,0
2021,Barking and Dagenham 002C,E01000110,522,388,176,212,5,5,10,7,3,119,102,17,0
2021,Barking and Dagenham 002D,E01000111,748,332,124,208,2,2,253,211,42,160,149,11,1
2021,Barking and Dagenham 002E,E01000112,700,360,145,215,10,10,75,53,22,255,237,18,0
2021,Barking and Dagenham 002F,E01000113,642,316,141,175,4,4,41,25,16,281,270,11,0
2021,Barking and Dagenham 004E,E01000114,755,452,149,303,10,10,72,49,23,221,210,11,0
2021,Barnet 009A,E01000115,481,435,245,190,2,2,1,0,1,43,37,6,0
2021,Barnet 009B,E01000116,620,476,225,251,2,2,46,5,41,96,85,11,0
2021,Barnet 010A,E01000117,694,558,306,252,2,2,9,4,5,125,102,23,0
2021,Barnet 010B,E01000118,749,581,295,286,24,24,18,10,8,126,119,7,0
2021,Barnet 009C,E01000119,628,479,263,216,3,3,39,5,34,107,95,12,0
2021,Barnet 009D,E01000120,499,426,219,207,3,3,3,1,2,67,64,3,0
2021,Barnet 010C,E01000121,525,205,88,117,18,18,246,34,212,56,52,4,0
2021,Barnet 009E,E01000122,518,435,204,231,2,2,5,3,2,76,69,7,0
2021,Barnet 010D,E01000123,731,473,217,256,21,21,27,13,14,210,197,13,0
2021,Barnet 010E,E01000124,794,372,182,190,2,2,169,113,56,251,238,13,0
2021,Barnet 026A,E01000126,768,195,58,137,42,42,340,21,319,191,170,21,0
2021,Barnet 024B,E01000127,517,190,85,105,2,2,197,171,26,127,110,17,1
2021,Barnet 024C,E01000128,635,302,138,164,7,7,184,170,14,140,127,13,2
2021,Barnet 024D,E01000129,573,140,69,71,3,3,229,203,26,199,188,11,2
2021,Barnet 021A,E01000130,655,223,87,136,36,36,223,114,109,172,161,11,1
2021,Barnet 024E,E01000131,713,331,190,141,22,22,100,50,50,257,234,23,3
2021,Barnet 021B,E01000132,505,198,75,123,2,2,203,169,34,101,84,17,1
2021,Barnet 021C,E01000133,581,223,87,136,3,3,233,198,35,122,110,12,0
2021,Barnet 024F,E01000134,635,248,102,146,3,3,181,160,21,202,196,6,1
2021,Barnet 038A,E01000135,626,366,216,150,4,4,14,3,11,242,225,17,0
2021,Barnet 038B,E01000136,563,375,232,143,6,6,1,0,1,181,168,13,0
2021,Barnet 041A,E01000137,673,202,107,95,6,6,306,270,36,156,146,10,3
2021,Barnet 040A,E01000138,654,295,169,126,4,4,40,31,9,315,298,17,0
2021,Barnet 041B,E01000139,546,316,171,145,4,4,22,19,3,204,187,17,0
2021,Barnet 041C,E01000140,868,365,172,193,6,6,107,51,56,390,361,29,0
2021,Barnet 039A,E01000141,792,224,124,100,3,3,126,32,94,439,425,14,0
2021,Barnet 040B,E01000142,892,321,164,157,11,11,90,14,76,469,444,25,1
2021,Barnet 041D,E01000143,677,230,76,154,12,12,251,167,84,181,174,7,3
2021,Barnet 038C,E01000144,743,214,121,93,2,2,32,19,13,494,476,18,1
2021,Barnet 037A,E01000145,488,269,135,134,0,0,7,2,5,212,194,18,0
2021,Barnet 038D,E01000146,868,264,154,110,1,1,75,41,34,525,505,20,3
2021,Barnet 043F,E01000147,558,368,215,153,2,2,3,3,0,185,163,22,0
2021,Barnet 036A,E01000150,776,414,213,201,9,9,118,43,75,235,220,15,0
2021,Barnet 026B,E01000151,655,64,27,37,4,4,477,365,112,105,86,19,5
2021,Barnet 026C,E01000152,927,422,55,367,22,22,338,250,88,140,129,11,5
2021,Barnet 026D,E01000153,740,170,76,94,35,35,422,101,321,112,96,16,1
2021,Barnet 026E,E01000154,707,167,60,107,41,41,346,180,166,150,135,15,3
2021,Barnet 022A,E01000156,748,426,185,241,1,1,38,16,22,283,263,20,0
2021,Barnet 022B,E01000157,668,373,157,216,3,3,77,42,35,212,198,14,3
2021,Barnet 015A,E01000158,545,306,139,167,3,3,78,57,21,157,139,18,1
2021,Barnet 015B,E01000159,647,439,224,215,2,2,78,67,11,128,119,9,0
2021,Barnet 015C,E01000160,804,440,169,271,1,1,35,19,16,327,299,28,1
2021,Barnet 015D,E01000161,808,410,199,211,0,0,106,59,47,290,263,27,2
2021,Barnet 015E,E01000162,548,348,179,169,4,4,46,9,37,150,137,13,0
2021,Barnet 022C,E01000163,798,240,78,162,13,13,274,202,72,270,253,17,1
2021,Barnet 022D,E01000164,647,268,123,145,2,2,194,152,42,182,165,17,1
2021,Barnet 022E,E01000165,706,440,254,186,6,6,44,27,17,216,195,21,0
2021,Barnet 003A,E01000166,653,422,230,192,2,2,78,65,13,151,136,15,0
2021,Barnet 002A,E01000167,522,280,126,154,4,4,161,142,19,76,65,11,1
2021,Barnet 003B,E01000168,558,507,289,218,0,0,6,5,1,45,40,5,0
2021,Barnet 003C,E01000169,691,400,200,200,18,18,36,13,23,237,226,11,0
2021,Barnet 006A,E01000170,698,392,159,233,2,2,118,105,13,184,165,19,2
2021,Barnet 006B,E01000171,998,342,131,211,4,4,84,57,27,567,539,28,1
2021,Barnet 003D,E01000172,607,466,241,225,1,1,25,5,20,115,90,25,0
2021,Barnet 006C,E01000173,607,479,223,256,2,2,48,8,40,78,69,9,0
2021,Barnet 006D,E01000174,762,370,180,190,2,2,81,29,52,309,292,17,0
2021,Barnet 006E,E01000175,642,514,237,277,3,3,11,5,6,114,97,17,0
2021,Barnet 027A,E01000176,721,239,127,112,13,13,376,62,314,91,83,8,2
2021,Barnet 029A,E01000177,690,444,237,207,1,1,22,4,18,223,210,13,0
2021,Barnet 027B,E01000178,676,406,215,191,2,2,97,69,28,171,159,12,0
2021,Barnet 029B,E01000179,772,452,170,282,3,3,28,11,17,288,271,17,1
2021,Barnet 029C,E01000180,667,264,128,136,1,1,212,130,82,188,172,16,2
2021,Barnet 029D,E01000181,686,395,216,179,2,2,15,7,8,274,261,13,0
2021,Barnet 029E,E01000182,731,435,265,170,4,4,31,8,23,261,249,12,0
2021,Barnet 033A,E01000183,600,339,180,159,1,1,82,25,57,178,164,14,0
2021,Barnet 027C,E01000184,712,216,84,132,15,15,343,138,205,134,121,13,4
2021,Barnet 029F,E01000185,642,137,53,84,1,1,365,256,109,136,127,9,3
2021,Barnet 014A,E01000186,510,419,201,218,1,1,4,3,1,85,79,6,1
2021,Barnet 014B,E01000187,593,350,171,179,1,1,117,18,99,124,102,22,1
2021,Barnet 014C,E01000188,509,427,220,207,1,1,10,8,2,71,57,14,0
2021,Barnet 014D,E01000189,982,302,62,240,102,102,320,26,294,258,238,20,0
2021,Barnet 014E,E01000190,569,420,216,204,3,3,53,18,35,92,79,13,1
2021,Barnet 014F,E01000191,554,419,264,155,1,1,7,2,5,127,109,18,0
2021,Barnet 018A,E01000192,710,386,234,152,4,4,26,5,21,294,269,25,0
2021,Barnet 018B,E01000193,711,357,203,154,3,3,27,5,22,324,300,24,0
2021,Barnet 018C,E01000194,706,291,168,123,9,9,69,25,44,336,318,18,1
2021,Barnet 013A,E01000195,716,229,85,144,24,24,195,116,79,268,247,21,0
2021,Barnet 028A,E01000196,1092,357,239,118,2,2,37,20,17,696,658,38,0
2021,Barnet 023A,E01000197,731,362,178,184,5,5,8,1,7,356,341,15,0
2021,Barnet 025A,E01000198,777,519,216,303,5,5,32,6,26,221,196,25,0
2021,Barnet 025B,E01000199,657,491,296,195,2,2,9,5,4,155,144,11,0
2021,Barnet 028B,E01000200,875,543,350,193,0,0,36,22,14,296,272,24,0
2021,Barnet 028C,E01000201,527,422,247,175,0,0,4,2,2,101,86,15,0
2021,Barnet 028D,E01000202,616,414,220,194,2,2,16,10,6,184,174,10,0
2021,Barnet 028E,E01000203,683,348,177,171,4,4,111,86,25,219,202,17,1
2021,Barnet 025C,E01000204,695,441,240,201,1,1,62,36,26,191,170,21,0
2021,Barnet 035A,E01000205,605,475,235,240,0,0,10,3,7,119,108,11,1
2021,Barnet 033B,E01000206,521,383,245,138,3,3,12,3,9,123,89,34,0
2021,Barnet 033C,E01000207,643,439,272,167,0,0,30,3,27,174,151,23,0
2021,Barnet 033D,E01000208,630,433,237,196,0,0,11,4,7,186,166,20,0
2021,Barnet 035B,E01000209,741,505,337,168,3,3,107,12,95,126,110,16,0
2021,Barnet 033E,E01000210,584,407,175,232,3,3,16,9,7,158,147,11,0
2021,Barnet 035C,E01000211,925,315,171,144,2,2,60,40,20,548,522,26,0
2021,Barnet 035D,E01000212,554,339,220,119,0,0,6,5,1,209,196,13,0
2021,Barnet 033F,E01000213,452,343,180,163,2,2,55,5,50,52,46,6,0
2021,Barnet 038E,E01000214,774,366,184,182,2,2,10,4,6,396,350,46,0
2021,Barnet 037B,E01000215,707,315,176,139,4,4,66,14,52,322,302,20,0
2021,Barnet 035E,E01000216,724,384,233,151,5,5,45,20,25,288,265,23,2
2021,Barnet 035F,E01000217,551,284,154,130,1,1,12,5,7,254,244,10,0
2021,Barnet 037C,E01000218,583,271,162,109,2,2,16,9,7,294,274,20,0
2021,Barnet 037D,E01000219,660,262,142,120,2,2,28,8,20,368,349,19,0
2021,Barnet 037E,E01000220,681,222,136,86,2,2,93,9,84,363,348,15,1
2021,Barnet 039B,E01000221,528,76,46,30,9,9,297,149,148,145,139,6,1
2021,Barnet 040C,E01000222,730,348,178,170,7,7,84,52,32,290,264,26,1
2021,Barnet 039C,E01000223,744,215,92,123,18,18,202,127,75,305,286,19,4
2021,Barnet 040D,E01000224,557,293,189,104,1,1,8,3,5,255,235,20,0
2021,Barnet 037F,E01000225,578,329,162,167,7,7,100,13,87,142,110,32,0
2021,Barnet 018D,E01000226,602,250,93,157,3,3,236,191,45,113,104,9,0
2021,Barnet 018E,E01000227,596,464,234,230,3,3,7,2,5,122,113,9,0
2021,Barnet 007A,E01000228,459,323,145,178,1,1,61,58,3,74,62,12,0
2021,Barnet 013B,E01000229,584,323,143,180,4,4,130,82,48,126,115,11,1
2021,Barnet 013C,E01000230,659,479,274,205,1,1,36,8,28,143,127,16,0
2021,Barnet 013D,E01000231,617,409,176,233,2,2,32,26,6,174,160,14,0
2021,Barnet 013E,E01000232,705,465,230,235,4,4,87,5,82,149,136,13,0
2021,Barnet 013F,E01000233,658,470,220,250,2,2,16,4,12,170,158,12,0
2021,Barnet 021D,E01000234,673,431,195,236,4,4,7,3,4,231,223,8,0
2021,Barnet 021E,E01000235,655,269,130,139,3,3,179,104,75,203,181,22,1
2021,Barnet 034A,E01000236,696,291,152,139,1,1,53,33,20,351,307,44,0
2021,Barnet 032A,E01000237,727,297,152,145,3,3,13,6,7,414,394,20,0
2021,Barnet 034B,E01000238,645,311,151,160,3,3,47,10,37,284,267,17,0
2021,Barnet 031A,E01000239,934,278,138,140,5,5,87,7,80,564,530,34,0
2021,Barnet 031B,E01000240,626,375,173,202,4,4,17,5,12,230,213,17,0
2021,Barnet 031C,E01000241,701,383,188,195,2,2,39,6,33,277,264,13,0
2021,Barnet 032B,E01000242,595,361,195,166,1,1,64,9,55,168,149,19,1
2021,Barnet 032C,E01000243,902,305,165,140,1,1,40,17,23,554,524,30,2
2021,Barnet 032D,E01000244,626,253,136,117,6,6,79,38,41,288,260,28,0
2021,Barnet 032E,E01000245,876,182,93,89,2,2,334,293,41,358,328,30,0
2021,Barnet 002B,E01000246,643,518,288,230,5,5,14,8,6,106,98,8,0
2021,Barnet 002C,E01000247,728,462,226,236,7,7,32,12,20,227,216,11,0
2021,Barnet 001A,E01000248,716,493,254,239,0,0,54,8,46,169,151,18,0
2021,Barnet 001B,E01000249,619,511,278,233,14,14,25,6,19,69,57,12,0
2021,Barnet 001C,E01000250,1145,554,283,271,21,21,153,65,88,416,394,22,1
2021,Barnet 002D,E01000251,1058,453,225,228,7,7,183,46,137,414,385,29,1
2021,Barnet 002E,E01000252,789,425,194,231,11,11,150,38,112,203,192,11,0
2021,Barnet 007B,E01000253,709,615,314,301,0,0,11,6,5,83,68,15,0
2021,Barnet 001D,E01000254,633,499,281,218,0,0,21,8,13,113,99,14,0
2021,Barnet 017A,E01000255,631,372,173,199,28,28,147,89,58,82,66,16,2
2021,Barnet 016A,E01000256,677,469,202,267,2,2,50,48,2,156,138,18,0
2021,Barnet 017B,E01000257,912,418,151,267,14,14,265,105,160,215,191,24,0
2021,Barnet 016B,E01000258,780,514,292,222,0,0,22,6,16,244,224,20,0
2021,Barnet 025D,E01000259,981,618,303,315,0,0,67,7,60,296,268,28,0
2021,Barnet 025E,E01000260,839,459,187,272,2,2,37,4,33,341,321,20,0
2021,Barnet 017C,E01000261,679,483,281,202,2,2,71,4,67,123,99,24,0
2021,Barnet 016C,E01000263,504,465,211,254,0,0,2,2,0,37,35,2,0
2021,Barnet 016D,E01000264,714,353,145,208,2,2,40,25,15,319,304,15,0
2021,Barnet 011A,E01000265,767,413,182,231,0,0,83,39,44,271,246,25,0
2021,Barnet 011B,E01000266,507,454,234,220,0,0,1,1,0,52,39,13,0
2021,Barnet 005A,E01000267,579,436,212,224,1,1,15,9,6,126,123,3,1
2021,Barnet 005B,E01000268,932,408,191,217,7,7,78,39,39,435,406,29,4
2021,Barnet 005C,E01000269,544,444,241,203,1,1,19,13,6,80,70,10,0
2021,Barnet 005D,E01000270,635,435,227,208,0,0,31,6,25,169,155,14,0
2021,Barnet 008A,E01000271,614,458,254,204,5,5,9,1,8,142,135,7,0
2021,Barnet 008B,E01000272,500,413,223,190,10,10,8,5,3,68,55,13,1
2021,Barnet 008C,E01000273,741,368,203,165,6,6,105,49,56,262,240,22,0
2021,Barnet 011C,E01000274,699,430,184,246,3,3,139,103,36,127,122,5,0
2021,Barnet 012A,E01000275,665,381,207,174,4,4,39,25,14,241,222,19,0
2021,Barnet 020A,E01000276,495,411,194,217,0,0,5,3,2,79,76,3,0
2021,Barnet 012B,E01000277,747,271,167,104,4,4,157,31,126,314,297,17,1
2021,Barnet 020B,E01000278,503,393,213,180,0,0,3,1,2,107,98,9,0
2021,Barnet 007C,E01000279,508,435,258,177,1,1,7,1,6,65,45,20,0
2021,Barnet 007D,E01000280,507,441,265,176,2,2,6,1,5,58,52,6,0
2021,Barnet 008D,E01000281,781,469,147,322,73,73,59,9,50,180,168,12,0
2021,Barnet 008E,E01000282,694,500,253,247,10,10,16,5,11,168,154,14,0
2021,Barnet 012C,E01000283,476,420,241,179,2,2,6,4,2,48,45,3,0
2021,Barnet 012D,E01000284,813,359,186,173,4,4,112,93,19,337,312,25,1
2021,Barnet 004A,E01000285,612,397,192,205,7,7,103,34,69,105,101,4,0
2021,Barnet 007E,E01000286,668,342,146,196,3,3,201,164,37,122,106,16,0
2021,Barnet 004B,E01000287,611,316,145,171,11,11,207,131,76,76,70,6,1
2021,Barnet 004C,E01000288,566,414,202,212,8,8,70,47,23,74,66,8,0
2021,Barnet 004D,E01000289,550,180,71,109,11,11,287,233,54,72,69,3,0
2021,Barnet 007F,E01000290,665,478,288,190,2,2,108,98,10,77,59,18,0
2021,Barnet 004E,E01000291,618,248,100,148,38,38,277,167,110,52,45,7,3
2021,Barnet 001E,E01000292,655,456,270,186,1,1,61,18,43,137,121,16,0
2021,Barnet 001F,E01000293,707,510,274,236,1,1,23,2,21,173,153,20,0
2021,Barnet 004F,E01000294,731,415,198,217,0,0,123,51,72,193,182,11,0
2021,Barnet 023B,E01000295,648,364,203,161,3,3,23,10,13,258,245,13,0
2021,Barnet 023C,E01000296,767,290,151,139,6,6,30,3,27,441,418,23,0
2021,Barnet 027D,E01000297,540,303,157,146,1,1,37,16,21,199,193,6,0
2021,Barnet 023D,E01000298,732,312,153,159,3,3,46,8,38,371,356,15,0
2021,Barnet 019A,E01000299,906,368,201,167,1,1,55,15,40,482,457,25,0
2021,Barnet 019B,E01000300,681,421,209,212,2,2,43,32,11,213,199,14,2
2021,Barnet 020C,E01000301,530,387,218,169,1,1,1,1,0,140,134,6,1
2021,Barnet 019C,E01000302,839,291,154,137,5,5,90,53,37,452,427,25,1
2021,Barnet 020D,E01000303,534,364,204,160,3,3,20,3,17,147,140,7,0
2021,Barnet 020E,E01000304,603,312,156,156,5,5,30,21,9,256,247,9,0
2021,Barnet 036B,E01000305,653,313,131,182,4,4,70,19,51,266,249,17,0
2021,Barnet 036C,E01000306,619,281,187,94,9,9,22,4,18,307,284,23,0
2021,Barnet 039D,E01000307,553,282,156,126,2,2,89,80,9,179,159,20,1
2021,Barnet 036D,E01000308,959,391,93,298,14,14,258,139,119,293,276,17,3
2021,Barnet 031D,E01000309,708,339,165,174,15,15,39,14,25,315,301,14,0
2021,Barnet 034C,E01000310,849,294,163,131,0,0,102,81,21,453,424,29,0
2021,Barnet 034D,E01000311,519,341,158,183,2,2,10,2,8,165,149,16,1
2021,Barnet 036E,E01000312,720,277,121,156,3,3,182,148,34,258,247,11,0
2021,Barnet 036F,E01000313,709,249,129,120,1,1,68,36,32,391,372,19,0
2021,Barnet 032F,E01000314,781,312,175,137,1,1,18,6,12,450,433,17,0
2021,Barnet 022F,E01000315,633,237,108,129,9,9,265,149,116,117,103,14,5
2021,Barnet 027E,E01000316,892,380,179,201,16,16,131,16,115,357,330,27,8
2021,Barnet 019D,E01000317,637,364,206,158,0,0,48,30,18,224,215,9,1
2021,Barnet 019E,E01000318,634,435,249,186,3,3,26,17,9,169,149,20,1
2021,Barnet 027F,E01000319,498,372,176,196,2,2,27,22,5,97,91,6,0
2021,Barnet 011D,E01000320,808,476,268,208,46,46,51,12,39,235,224,11,0
2021,Barnet 012E,E01000321,829,350,170,180,4,4,43,23,20,432,396,36,0
2021,Barnet 011E,E01000322,806,365,176,189,8,8,62,31,31,370,350,20,1
2021,Barnet 019F,E01000323,1018,346,166,180,4,4,58,28,30,610,593,17,0
2021,Barnet 015F,E01000324,648,435,203,232,3,3,55,27,28,155,143,12,0
2021,Bexley 014A,E01000325,585,541,288,253,1,1,12,6,6,31,29,2,0
2021,Bexley 014B,E01000326,543,428,162,266,4,4,21,17,4,90,82,8,0
2021,Bexley 017A,E01000327,626,536,290,246,0,0,31,0,31,59,47,12,0
2021,Bexley 017B,E01000328,612,519,267,252,0,0,42,8,34,51,47,4,0
2021,Bexley 017C,E01000329,659,448,216,232,14,14,92,19,73,105,94,11,0
2021,Bexley 017D,E01000330,767,494,279,215,7,7,126,17,109,140,125,15,0
2021,Bexley 017E,E01000331,617,386,165,221,0,0,179,37,142,52,49,3,0
2021,Bexley 005A,E01000332,613,471,260,211,1,1,56,9,47,85,73,12,0
2021,Bexley 003A,E01000333,811,451,196,255,5,5,163,36,127,192,170,22,0
2021,Bexley 006A,E01000334,635,490,261,229,10,10,36,10,26,99,83,16,0
2021,Bexley 003B,E01000335,1045,452,143,309,4,4,173,34,139,413,384,29,3
2021,Bexley 003C,E01000336,790,253,93,160,4,4,324,65,259,208,191,17,1
2021,Bexley 003D,E01000337,642,389,164,225,7,7,94,30,64,152,148,4,0
2021,Bexley 003E,E01000338,691,432,194,238,6,6,49,14,35,204,192,12,0
2021,Bexley 025A,E01000339,601,424,192,232,2,2,121,9,112,54,47,7,0
2021,Bexley 018A,E01000340,624,527,262,265,2,2,18,5,13,77,68,9,0
2021,Bexley 022A,E01000341,623,543,306,237,1,1,16,3,13,63,54,9,0
2021,Bexley 022B,E01000342,634,529,239,290,8,8,8,3,5,89,83,6,0
2021,Bexley 022C,E01000343,558,469,232,237,2,2,7,2,5,80,69,11,0
2021,Bexley 025B,E01000344,637,537,265,272,2,2,12,2,10,86,75,11,0
2021,Bexley 022D,E01000345,489,446,208,238,1,1,5,3,2,37,31,6,0
2021,Bexley 021A,E01000346,614,546,242,304,4,4,8,1,7,56,49,7,0
2021,Bexley 021B,E01000347,627,503,238,265,5,5,25,4,21,94,85,9,0
2021,Bexley 020A,E01000348,525,496,234,262,0,0,5,0,5,24,17,7,0
2021,Bexley 020B,E01000349,656,610,309,301,2,2,7,3,4,37,26,11,0
2021,Bexley 021C,E01000350,526,464,229,235,3,3,6,0,6,53,49,4,0
2021,Bexley 024A,E01000351,624,564,288,276,2,2,3,0,3,55,49,6,0
2021,Bexley 021D,E01000352,667,492,244,248,8,8,42,6,36,124,115,9,1
2021,Bexley 011A,E01000353,654,625,387,238,0,0,2,1,1,27,22,5,0
2021,Bexley 011B,E01000354,607,388,197,191,3,3,138,13,125,78,70,8,0
2021,Bexley 011C,E01000355,601,553,337,216,4,4,7,0,7,37,29,8,0
2021,Bexley 009A,E01000356,629,530,326,204,3,3,7,3,4,89,75,14,0
2021,Bexley 009B,E01000357,488,465,229,236,0,0,5,1,4,18,16,2,0
2021,Bexley 011D,E01000358,665,534,302,232,0,0,20,4,16,111,100,11,0
2021,Bexley 009C,E01000359,495,443,231,212,0,0,4,2,2,48,37,11,0
2021,Bexley 015A,E01000360,770,484,239,245,2,2,22,8,14,261,242,19,1
2021,Bexley 020C,E01000361,598,471,217,254,1,1,40,3,37,86,73,13,0
2021,Bexley 015B,E01000362,777,581,300,281,49,49,62,11,51,85,71,14,0
2021,Bexley 020D,E01000363,563,494,256,238,1,1,5,1,4,63,62,1,0
2021,Bexley 023A,E01000364,648,508,255,253,0,0,45,5,40,95,89,6,0
2021,Bexley 015C,E01000365,705,516,293,223,0,0,43,15,28,146,133,13,0
2021,Bexley 015D,E01000366,661,515,231,284,5,5,27,4,23,113,103,10,1
2021,Bexley 010A,E01000367,798,373,162,211,74,74,278,46,232,72,64,8,1
2021,Bexley 010B,E01000368,626,283,94,189,5,5,274,34,240,64,58,6,0
2021,Bexley 014C,E01000369,629,520,243,277,5,5,48,8,40,56,47,9,0
2021,Bexley 014D,E01000370,633,507,268,239,7,7,57,6,51,62,56,6,0
2021,Bexley 014E,E01000371,630,530,237,293,2,2,25,7,18,72,61,11,1
2021,Bexley 010C,E01000372,590,346,155,191,5,5,196,39,157,43,38,5,0
2021,Bexley 008A,E01000373,459,154,33,121,51,51,196,24,172,58,53,5,0
2021,Bexley 019A,E01000374,523,264,93,171,2,2,219,50,169,38,31,7,0
2021,Bexley 019B,E01000375,785,516,166,350,2,2,126,22,104,141,130,11,0
2021,Bexley 019C,E01000376,611,467,176,291,2,2,68,11,57,74,66,8,0
2021,Bexley 019D,E01000377,656,506,238,268,0,0,57,29,28,93,83,10,0
2021,Bexley 019F,E01000379,669,471,197,274,5,5,106,19,87,87,78,9,0
2021,Bexley 010D,E01000380,901,372,131,241,47,47,342,18,324,138,128,10,2
2021,Bexley 028A,E01000381,656,384,182,202,3,3,182,29,153,87,77,10,0
2021,Bexley 027A,E01000382,590,532,279,253,1,1,21,3,18,36,29,7,0
2021,Bexley 028B,E01000383,625,505,274,231,0,0,67,17,50,53,45,8,0
2021,Bexley 027B,E01000384,758,502,219,283,2,2,117,19,98,137,122,15,0
2021,Bexley 028C,E01000385,786,355,152,203,55,55,306,54,252,70,62,8,0
2021,Bexley 028D,E01000386,645,216,88,128,13,13,319,48,271,97,90,7,0
2021,Bexley 027C,E01000387,625,536,292,244,4,4,31,6,25,54,46,8,0
2021,Bexley 016A,E01000388,599,534,301,233,0,0,10,2,8,55,47,8,0
2021,Bexley 020E,E01000389,712,496,249,247,9,9,90,13,77,116,110,6,1
2021,Bexley 020F,E01000390,515,433,225,208,3,3,32,6,26,47,37,10,0
2021,Bexley 021E,E01000391,640,525,217,308,2,2,41,11,30,72,62,10,0
2021,Bexley 016B,E01000392,764,326,131,195,35,35,194,22,172,209,193,16,0
2021,Bexley 020G,E01000393,625,522,227,295,6,6,2,0,2,95,82,13,0
2021,Bexley 015E,E01000394,670,463,240,223,24,24,49,2,47,134,122,12,0
2021,Bexley 018B,E01000395,544,482,230,252,2,2,18,1,17,42,25,17,0
2021,Bexley 018C,E01000396,507,453,231,222,5,5,5,1,4,44,35,9,0
2021,Bexley 029A,E01000398,610,443,213,230,6,6,121,19,102,40,32,8,0
2021,Bexley 029B,E01000399,622,488,258,230,4,4,34,4,30,96,83,13,0
2021,Bexley 029C,E01000400,591,468,231,237,6,6,30,4,26,86,78,8,1
2021,Bexley 013A,E01000401,691,374,182,192,6,6,174,26,148,137,123,14,0
2021,Bexley 005B,E01000402,649,330,137,193,2,2,188,27,161,129,117,12,0
2021,Bexley 004A,E01000403,1062,352,209,143,129,129,431,59,372,150,138,12,0
2021,Bexley 004B,E01000404,987,266,66,200,23,23,363,96,267,334,318,16,1
2021,Bexley 004C,E01000405,564,338,97,241,3,3,91,37,54,130,116,14,2
2021,Bexley 005C,E01000406,788,476,151,325,55,55,75,30,45,181,153,28,1
2021,Bexley 005D,E01000407,759,558,272,286,25,25,85,14,71,91,76,15,0
2021,Bexley 004D,E01000408,581,362,141,221,5,5,57,22,35,157,132,25,0
2021,Bexley 016C,E01000409,653,586,266,320,3,3,6,1,5,58,47,11,0
2021,Bexley 018D,E01000410,598,520,229,291,0,0,7,2,5,71,67,4,0
2021,Bexley 016D,E01000411,554,498,227,271,4,4,5,1,4,47,45,2,0
2021,Bexley 018E,E01000412,643,542,231,311,1,1,7,4,3,93,83,10,0
2021,Bexley 018F,E01000413,522,437,198,239,5,5,23,4,19,57,47,10,0
2021,Bexley 016E,E01000414,725,486,264,222,11,11,17,5,12,211,189,22,0
2021,Bexley 016F,E01000415,517,484,265,219,0,0,7,1,6,26,22,4,0
2021,Bexley 002A,E01000416,511,241,123,118,4,4,113,23,90,153,143,10,0
2021,Bexley 006B,E01000417,707,400,205,195,23,23,136,16,120,148,133,15,0
2021,Bexley 002B,E01000418,727,390,187,203,1,1,130,28,102,204,187,17,2
2021,Bexley 006C,E01000419,583,525,299,226,2,2,5,1,4,51,37,14,0
2021,Bexley 006D,E01000420,590,482,262,220,4,4,28,11,17,76,66,10,0
2021,Bexley 009D,E01000421,597,556,338,218,1,1,3,0,3,37,30,7,0
2021,Bexley 002C,E01000422,502,67,31,36,3,3,373,52,321,58,39,19,1
2021,Bexley 025C,E01000423,607,557,280,277,1,1,5,2,3,44,35,9,0
2021,Bexley 026A,E01000424,754,611,293,318,1,1,49,0,49,93,82,11,0
2021,Bexley 025D,E01000425,608,574,298,276,1,1,11,0,11,20,14,6,2
2021,Bexley 026B,E01000426,707,506,207,299,6,6,62,9,53,133,126,7,0
2021,Bexley 026C,E01000427,907,636,351,285,18,18,157,25,132,96,84,12,0
2021,Bexley 027D,E01000428,907,333,179,154,38,38,288,24,264,248,228,20,0
2021,Bexley 008B,E01000429,708,250,72,178,1,1,232,57,175,222,212,10,3
2021,Bexley 008C,E01000430,706,443,113,330,9,9,142,39,103,112,100,12,0
2021,Bexley 008D,E01000431,431,207,82,125,3,3,146,30,116,75,73,2,0
2021,Bexley 008F,E01000433,714,284,110,174,6,6,321,66,255,102,90,12,1
2021,Bexley 008G,E01000434,574,170,67,103,5,5,342,38,304,56,53,3,1
2021,Bexley 010E,E01000435,585,305,143,162,2,2,201,38,163,77,71,6,0
2021,Bexley 011E,E01000436,622,564,303,261,0,0,13,4,9,45,43,2,0
2021,Bexley 007A,E01000437,502,417,209,208,4,4,35,4,31,46,35,11,0
2021,Bexley 007B,E01000438,601,461,207,254,2,2,37,18,19,101,91,10,0
2021,Bexley 007C,E01000439,515,317,144,173,2,2,77,17,60,119,107,12,0
2021,Bexley 007D,E01000440,514,470,270,200,1,1,9,2,7,34,32,2,0
2021,Bexley 007E,E01000441,700,335,143,192,5,5,248,45,203,111,92,19,1
2021,Bexley 006E,E01000442,626,525,282,243,1,1,49,8,41,51,45,6,0
2021,Bexley 024B,E01000443,518,374,176,198,3,3,94,18,76,47,42,5,0
2021,Bexley 023B,E01000444,635,570,321,249,0,0,10,3,7,55,47,8,0
2021,Bexley 024C,E01000445,672,594,334,260,2,2,4,1,3,72,60,12,0
2021,Bexley 024D,E01000446,597,524,215,309,5,5,9,1,8,59,54,5,0
2021,Bexley 023C,E01000447,881,530,233,297,31,31,87,7,80,233,218,15,0
2021,Bexley 023D,E01000448,513,482,264,218,3,3,4,1,3,24,20,4,0
2021,Bexley 023E,E01000449,643,558,324,234,1,1,20,2,18,63,55,8,1
2021,Bexley 009E,E01000450,633,440,180,260,7,7,130,17,113,56,42,14,0
2021,Bexley 009F,E01000451,622,557,244,313,5,5,7,2,5,53,46,7,0
2021,Bexley 009G,E01000452,491,452,192,260,3,3,7,1,6,29,25,4,0
2021,Bexley 013B,E01000453,514,458,200,258,2,2,2,0,2,51,40,11,1
2021,Bexley 013C,E01000454,632,436,200,236,5,5,121,17,104,70,66,4,0
2021,Bexley 013D,E01000455,617,529,253,276,3,3,7,3,4,78,69,9,0
2021,Bexley 013E,E01000456,483,439,208,231,2,2,2,1,1,39,36,3,1
2021,Bexley 026D,E01000457,995,500,257,243,43,43,54,3,51,398,373,25,0
2021,Bexley 027E,E01000458,686,555,352,203,1,1,56,1,55,74,68,6,0
2021,Bexley 027F,E01000459,883,522,328,194,28,28,142,14,128,191,177,14,0
2021,Bexley 022E,E01000460,483,428,242,186,2,2,9,1,8,44,40,4,0
2021,Bexley 024E,E01000461,569,529,259,270,0,0,4,0,4,36,29,7,0
2021,Bexley 026E,E01000462,835,453,235,218,12,12,98,9,89,272,246,26,0
2021,Bexley 025E,E01000463,453,416,181,235,3,3,7,2,5,27,23,4,0
2021,Bexley 002D,E01000464,551,176,87,89,2,2,268,38,230,103,93,10,2
2021,Bexley 002E,E01000465,728,156,66,90,0,0,479,64,415,89,82,7,4
2021,Bexley 001A,E01000466,600,175,79,96,2,2,331,48,283,90,81,9,2
2021,Bexley 001B,E01000467,593,259,94,165,3,3,172,42,130,156,144,12,3
2021,Bexley 001C,E01000468,943,434,92,342,1,1,175,72,103,323,307,16,10
2021,Bexley 001D,E01000469,639,314,110,204,9,9,124,47,77,189,176,13,3
2021,Bexley 002F,E01000470,528,76,42,34,1,1,377,68,309,71,66,5,3
2021,Brent 026A,E01000471,494,305,148,157,0,0,51,36,15,138,125,13,0
2021,Brent 029A,E01000472,913,261,113,148,127,127,117,18,99,408,392,16,0
2021,Brent 029B,E01000473,789,264,139,125,40,40,179,48,131,306,247,59,0
2021,Brent 026B,E01000474,519,300,135,165,3,3,83,78,5,133,110,23,0
2021,Brent 029C,E01000475,613,299,157,142,7,7,88,19,69,219,202,17,0
2021,Brent 026C,E01000476,554,325,194,131,6,6,54,28,26,169,152,17,0
2021,Brent 026D,E01000477,682,303,116,187,3,3,64,36,28,312,278,34,0
2021,Brent 029D,E01000478,717,321,169,152,15,15,110,23,87,270,227,43,1
2021,Brent 009A,E01000479,514,386,222,164,1,1,9,2,7,117,106,11,1
2021,Brent 006A,E01000480,511,354,194,160,1,1,13,5,8,143,129,14,0
2021,Brent 009B,E01000481,604,225,118,107,3,3,135,90,45,240,227,13,1
2021,Brent 009D,E01000483,656,173,87,86,3,3,254,64,190,225,206,19,1
2021,Brent 006B,E01000484,612,106,54,52,15,15,386,106,280,105,98,7,0
2021,Brent 006C,E01000485,531,215,113,102,6,6,120,106,14,188,177,11,2
2021,Brent 006D,E01000486,520,361,185,176,2,2,11,7,4,146,128,18,0
2021,Brent 006E,E01000487,697,286,155,131,4,4,112,19,93,295,274,21,0
2021,Brent 022A,E01000488,549,219,110,109,1,1,106,81,25,223,203,20,0
2021,Brent 030A,E01000489,685,327,145,182,2,2,157,86,71,197,183,14,2
2021,Brent 023A,E01000490,887,237,105,132,7,7,180,59,121,461,446,15,2
2021,Brent 030B,E01000491,865,360,175,185,20,20,208,125,83,276,251,25,1
2021,Brent 030C,E01000492,451,308,144,164,4,4,49,16,33,90,85,5,0
2021,Brent 030D,E01000493,564,401,220,181,4,4,32,13,19,127,117,10,0
2021,Brent 023B,E01000494,722,257,133,124,6,6,129,47,82,326,307,19,4
2021,Brent 023C,E01000495,782,197,77,120,11,11,302,165,137,270,248,22,2
2021,Brent 011A,E01000497,684,292,201,91,23,23,164,35,129,205,191,14,0
2021,Brent 010B,E01000498,513,243,168,75,2,2,79,25,54,189,175,14,0
2021,Brent 011B,E01000499,587,212,125,87,7,7,100,46,54,267,252,15,1
2021,Brent 011C,E01000501,757,214,102,112,18,18,312,168,144,213,206,7,0
2021,Brent 011D,E01000502,658,296,143,153,22,22,132,33,99,204,195,9,4
2021,Brent 011E,E01000503,777,336,205,131,4,4,183,146,37,253,237,16,1
2021,Brent 018A,E01000504,698,299,124,175,6,6,167,86,81,226,214,12,0
2021,Brent 018B,E01000505,571,242,156,86,5,5,192,33,159,131,122,9,1
2021,Brent 014A,E01000506,665,153,85,68,11,11,196,48,148,304,297,7,1
2021,Brent 018C,E01000507,519,273,170,103,2,2,83,33,50,160,142,18,1
2021,Brent 025A,E01000508,862,190,95,95,48,48,356,98,258,268,253,15,0
2021,Brent 014B,E01000509,454,230,159,71,1,1,31,16,15,191,170,21,1
2021,Brent 014C,E01000510,573,188,113,75,3,3,47,20,27,334,316,18,1
2021,Brent 014D,E01000511,560,242,131,111,3,3,60,35,25,254,236,18,1
2021,Brent 018D,E01000512,651,343,209,134,5,5,58,30,28,244,227,17,1
2021,Brent 002A,E01000513,469,314,160,154,3,3,25,16,9,127,109,18,0
2021,Brent 002B,E01000514,494,306,148,158,4,4,23,15,8,160,145,15,1
2021,Brent 003A,E01000515,648,222,96,126,8,8,194,80,114,222,213,9,2
2021,Brent 002C,E01000516,747,372,180,192,19,19,44,9,35,312,290,22,0
2021,Brent 003B,E01000517,489,326,200,126,2,2,16,9,7,145,126,19,0
2021,Brent 005A,E01000518,627,287,152,135,7,7,158,106,52,175,161,14,0
2021,Brent 005B,E01000519,632,282,135,147,3,3,93,76,17,254,239,15,0
2021,Brent 002D,E01000520,609,288,145,143,3,3,85,39,46,233,202,31,0
2021,Brent 025B,E01000521,921,130,67,63,14,14,357,53,304,418,392,26,2
2021,Brent 025C,E01000522,698,201,88,113,3,3,296,86,210,197,186,11,1
2021,Brent 031A,E01000523,868,218,112,106,20,20,243,67,176,386,375,11,1
2021,Brent 031B,E01000524,987,120,60,60,25,25,414,91,323,426,406,20,2
2021,Brent 031C,E01000525,756,152,60,92,7,7,319,101,218,276,263,13,2
2021,Brent 025D,E01000526,807,102,43,59,15,15,554,106,448,134,123,11,2
2021,Brent 025E,E01000527,730,206,117,89,5,5,264,60,204,253,236,17,2
2021,Brent 025F,E01000528,737,158,41,117,71,71,395,72,323,113,107,6,0
2021,Brent 033A,E01000530,670,417,236,181,4,4,78,18,60,171,160,11,0
2021,Brent 033B,E01000531,859,255,105,150,9,9,300,55,245,293,274,19,2
2021,Brent 033C,E01000532,608,255,115,140,3,3,198,94,104,151,143,8,1
2021,Brent 031E,E01000533,878,171,68,103,13,13,390,72,318,300,284,16,4
2021,Brent 033D,E01000534,660,351,161,190,7,7,95,21,74,207,180,27,0
2021,Brent 031F,E01000535,846,320,137,183,12,12,172,34,138,340,314,26,2
2021,Brent 004A,E01000536,507,367,221,146,3,3,19,6,13,118,107,11,0
2021,Brent 004B,E01000538,485,403,211,192,1,1,6,6,0,75,67,8,0
2021,Brent 004C,E01000539,540,379,225,154,1,1,39,5,34,121,104,17,0
2021,Brent 004D,E01000540,483,378,224,154,2,2,1,1,0,101,90,11,1
2021,Brent 004E,E01000541,489,246,154,92,5,5,44,35,9,194,176,18,0
2021,Brent 003E,E01000543,495,291,174,117,1,1,44,30,14,159,149,10,0
2021,Brent 034A,E01000544,739,137,56,81,13,13,370,249,121,218,194,24,1
2021,Brent 028A,E01000545,911,213,108,105,2,2,227,76,151,468,449,19,1
2021,Brent 028B,E01000546,752,248,123,125,6,6,141,36,105,357,345,12,0
2021,Brent 028C,E01000547,687,297,116,181,6,6,169,42,127,214,196,18,1
2021,Brent 028D,E01000548,1001,218,96,122,6,6,312,177,135,462,439,23,3
2021,Brent 028E,E01000549,891,340,137,203,9,9,162,32,130,380,366,14,0
2021,Brent 034B,E01000550,909,157,54,103,25,25,501,293,208,224,207,17,2
2021,Brent 034C,E01000551,1176,138,53,85,20,20,844,508,336,171,159,12,3
2021,Brent 034D,E01000552,580,95,23,72,25,25,400,214,186,60,58,2,0
2021,Brent 015A,E01000553,743,275,166,109,3,3,96,35,61,364,347,17,5
2021,Brent 015B,E01000554,758,298,143,155,39,39,156,38,118,262,245,17,3
2021,Brent 015C,E01000555,526,276,153,123,5,5,60,34,26,185,174,11,0
2021,Brent 015D,E01000556,859,130,66,64,2,2,157,31,126,570,521,49,0
2021,Brent 015E,E01000557,831,222,105,117,3,3,186,24,162,418,400,18,2
2021,Brent 015F,E01000558,644,229,110,119,5,5,156,44,112,251,236,15,3
2021,Brent 018E,E01000559,656,191,84,107,12,12,158,15,143,295,283,12,0
2021,Brent 023D,E01000560,663,257,137,120,8,8,109,35,74,289,270,19,0
2021,Brent 023E,E01000561,823,201,89,112,7,7,297,267,30,316,302,14,2
2021,Brent 008A,E01000562,478,355,222,133,11,11,39,9,30,73,71,2,0
2021,Brent 008B,E01000563,483,402,225,177,0,0,10,1,9,71,59,12,0
2021,Brent 013A,E01000564,489,225,116,109,1,1,31,16,15,232,215,17,0
2021,Brent 013B,E01000565,487,243,132,111,8,8,115,62,53,119,106,13,2
2021,Brent 008C,E01000566,464,349,196,153,3,3,14,8,6,98,85,13,0
2021,Brent 016A,E01000567,459,260,133,127,6,6,49,19,30,144,135,9,0
2021,Brent 008D,E01000568,663,191,99,92,8,8,191,14,177,273,259,14,0
2021,Brent 008E,E01000569,480,398,235,163,0,0,12,9,3,70,62,8,0
2021,Brent 012A,E01000570,513,261,146,115,5,5,86,70,16,161,148,13,0
2021,Brent 012B,E01000571,497,312,175,137,4,4,18,7,11,163,143,20,0
2021,Brent 007A,E01000572,464,320,177,143,1,1,14,4,10,129,120,9,0
2021,Brent 007B,E01000573,480,287,172,115,1,1,16,5,11,176,161,15,0
2021,Brent 007C,E01000574,457,283,159,124,5,5,11,5,6,158,148,10,0
2021,Brent 007D,E01000575,661,273,156,117,0,0,45,13,32,343,314,29,0
2021,Brent 012C,E01000576,570,329,195,134,8,8,29,6,23,203,187,16,1
2021,Brent 007E,E01000577,862,141,60,81,24,24,314,87,227,381,362,19,2
2021,Brent 012D,E01000578,832,310,158,152,45,45,237,20,217,238,206,32,2
2021,Brent 032A,E01000579,634,286,135,151,7,7,151,53,98,190,181,9,0
2021,Brent 032B,E01000580,855,394,208,186,2,2,206,145,61,253,232,21,0
2021,Brent 030E,E01000581,593,269,134,135,3,3,125,30,95,194,174,20,2
2021,Brent 032C,E01000582,685,392,174,218,0,0,109,32,77,184,170,14,0
2021,Brent 032D,E01000583,902,375,196,179,9,9,181,71,110,337,314,23,0
2021,Brent 033E,E01000584,551,351,192,159,3,3,58,11,47,138,129,9,1
2021,Brent 033F,E01000585,592,290,131,159,2,2,86,16,70,214,206,8,0
2021,Brent 032E,E01000586,1083,339,115,224,16,16,197,108,89,530,499,31,1
2021,Brent 001A,E01000587,461,325,194,131,4,4,7,3,4,125,111,14,0
2021,Brent 001B,E01000589,804,472,252,220,17,17,51,5,46,264,236,28,0
2021,Brent 001C,E01000590,633,420,238,182,10,10,28,7,21,175,162,13,0
2021,Brent 003F,E01000591,642,301,194,107,7,7,66,29,37,267,252,15,1
2021,Brent 001D,E01000592,618,303,173,130,42,42,114,12,102,159,139,20,0
2021,Brent 001E,E01000593,668,302,162,140,26,26,152,18,134,186,170,16,2
2021,Brent 001F,E01000594,559,260,160,100,6,6,35,22,13,257,243,14,1
2021,Brent 027A,E01000595,653,130,72,58,9,9,309,114,195,203,192,11,2
2021,Brent 021A,E01000596,626,98,62,36,2,2,375,259,116,148,140,8,3
2021,Brent 027D,E01000599,697,75,5,70,67,67,477,152,325,74,67,7,4
2021,Brent 021B,E01000601,513,73,35,38,1,1,332,121,211,107,97,10,0
2021,Brent 021C,E01000602,502,146,84,62,2,2,262,217,45,90,72,18,2
2021,Brent 021D,E01000603,563,130,78,52,22,22,196,58,138,214,204,10,1
2021,Brent 021E,E01000604,513,106,42,64,5,5,343,302,41,58,53,5,1
2021,Brent 021F,E01000605,570,92,47,45,1,1,407,313,94,66,60,6,4
2021,Brent 016B,E01000606,578,264,149,115,4,4,65,29,36,245,229,16,0
2021,Brent 013C,E01000607,687,391,187,204,6,6,21,8,13,269,262,7,0
2021,Brent 013D,E01000608,808,289,141,148,5,5,138,48,90,376,337,39,0
2021,Brent 016C,E01000609,632,344,175,169,6,6,69,11,58,213,197,16,0
2021,Brent 019A,E01000610,687,273,145,128,3,3,114,42,72,297,279,18,0
2021,Brent 016D,E01000611,605,285,98,187,50,50,115,15,100,153,147,6,2
2021,Brent 019B,E01000612,543,242,108,134,1,1,101,70,31,199,175,24,0
2021,Brent 013E,E01000613,636,212,124,88,19,19,113,18,95,291,273,18,1
2021,Brent 036A,E01000615,827,273,143,130,20,20,83,16,67,449,433,16,2
2021,Brent 020A,E01000616,592,211,128,83,6,6,56,27,29,319,297,22,0
2021,Brent 036B,E01000617,722,287,174,113,3,3,112,26,86,317,287,30,3
2021,Brent 036D,E01000618,481,291,194,97,3,3,46,15,31,140,125,15,1
2021,Brent 036C,E01000619,477,320,199,121,5,5,29,12,17,123,117,6,0
2021,Brent 020B,E01000620,510,304,208,96,9,9,27,6,21,170,158,12,0
2021,Brent 020C,E01000621,516,293,187,106,3,3,22,11,11,198,172,26,0
2021,Brent 010D,E01000622,706,236,115,121,8,8,106,82,24,355,346,9,1
2021,Brent 005C,E01000623,567,330,174,156,2,2,19,13,6,216,207,9,0
2021,Brent 005D,E01000624,588,424,255,169,2,2,16,8,8,146,132,14,0
2021,Brent 009E,E01000625,589,282,161,121,3,3,102,20,82,202,187,15,0
2021,Brent 010E,E01000626,605,81,31,50,69,69,322,33,289,132,126,6,1
2021,Brent 014E,E01000627,689,185,116,69,5,5,207,101,106,292,273,19,0
2021,Brent 014F,E01000628,641,213,133,80,8,8,121,62,59,299,278,21,0
2021,Brent 005E,E01000629,623,401,217,184,1,1,23,13,10,197,180,17,1
2021,Brent 026E,E01000630,907,220,116,104,24,24,299,98,201,363,340,23,1
2021,Brent 019C,E01000631,582,300,183,117,16,16,35,10,25,231,217,14,0
2021,Brent 029E,E01000632,597,326,210,116,3,3,12,4,8,256,227,29,0
2021,Brent 019D,E01000633,614,214,138,76,6,6,73,22,51,320,286,34,1
2021,Brent 019E,E01000634,762,274,125,149,10,10,126,28,98,351,326,25,1
2021,Brent 020E,E01000636,764,331,207,124,24,24,93,21,72,316,297,19,0
2021,Brent 022B,E01000637,615,188,106,82,4,4,153,39,114,270,255,15,0
2021,Brent 024A,E01000638,788,147,80,67,8,8,190,38,152,442,427,15,1
2021,Brent 022C,E01000639,752,201,91,110,2,2,105,23,82,440,424,16,4
2021,Brent 024B,E01000640,817,178,111,67,20,20,170,27,143,448,423,25,1
2021,Brent 024C,E01000641,735,183,92,91,20,20,223,54,169,305,298,7,4
2021,Brent 022D,E01000642,1028,233,124,109,38,38,210,63,147,545,506,39,2
2021,Brent 024D,E01000643,897,166,57,109,58,58,517,141,376,150,137,13,6
2021,Brent 022E,E01000644,763,249,139,110,12,12,179,52,127,321,282,39,2
2021,Bromley 007A,E01000645,542,487,255,232,0,0,6,0,6,49,44,5,0
2021,Bromley 016A,E01000646,783,523,270,253,0,0,34,2,32,226,205,21,0
2021,Bromley 016B,E01000647,648,487,188,299,2,2,43,6,37,116,105,11,0
2021,Bromley 016C,E01000648,726,572,236,336,2,2,18,1,17,134,122,12,0
2021,Bromley 007B,E01000649,817,646,320,326,10,10,55,2,53,106,101,5,0
2021,Bromley 022A,E01000650,748,568,317,251,1,1,115,5,110,64,58,6,0
2021,Bromley 020A,E01000651,625,456,211,245,1,1,66,2,64,102,95,7,0
2021,Bromley 022B,E01000652,673,595,305,290,2,2,25,1,24,51,47,4,0
2021,Bromley 016D,E01000653,595,482,263,219,0,0,51,2,49,62,57,5,0
2021,Bromley 039A,E01000654,488,449,193,256,2,2,11,2,9,26,21,5,0
2021,Bromley 039B,E01000655,490,427,183,244,2,2,11,2,9,50,44,6,0
2021,Bromley 039C,E01000656,565,525,263,262,1,1,7,3,4,31,23,8,1
2021,Bromley 039D,E01000657,673,484,228,256,11,11,91,8,83,86,79,7,1
2021,Bromley 042A,E01000658,562,508,358,150,5,5,15,2,13,34,26,8,0
2021,Bromley 039E,E01000659,523,479,190,289,0,0,6,0,6,38,28,10,0
2021,Bromley 026A,E01000661,1179,492,176,316,27,27,467,71,396,193,173,20,0
2021,Bromley 026B,E01000662,652,482,191,291,1,1,98,10,88,71,67,4,0
2021,Bromley 026C,E01000663,667,440,196,244,6,6,185,17,168,36,32,4,0
2021,Bromley 026D,E01000664,599,466,199,267,0,0,93,10,83,40,33,7,0
2021,Bromley 033A,E01000665,744,568,276,292,10,10,46,7,39,120,110,10,0
2021,Bromley 033B,E01000666,802,705,412,293,0,0,15,0,15,82,63,19,0
2021,Bromley 033C,E01000667,627,602,310,292,0,0,5,0,5,20,13,7,0
2021,Bromley 020B,E01000668,976,637,241,396,12,12,96,14,82,231,217,14,0
2021,Bromley 020C,E01000669,747,574,229,345,0,0,43,4,39,130,113,17,0
2021,Bromley 018A,E01000670,833,498,271,227,3,3,52,3,49,280,256,24,0
2021,Bromley 020D,E01000671,1018,543,219,324,44,44,107,5,102,324,302,22,0
2021,Bromley 011A,E01000672,694,507,224,283,6,6,16,2,14,165,147,18,0
2021,Bromley 011B,E01000673,636,483,199,284,7,7,45,9,36,100,89,11,1
2021,Bromley 008A,E01000674,799,394,164,230,1,1,141,11,130,263,244,19,0
2021,Bromley 008B,E01000676,964,297,119,178,1,1,198,18,180,464,431,33,4
2021,Bromley 018C,E01000677,801,471,176,295,11,11,50,12,38,269,257,12,0
2021,Bromley 016E,E01000678,697,509,215,294,8,8,41,2,39,139,130,9,0
2021,Bromley 020E,E01000679,676,514,185,329,4,4,21,2,19,137,126,11,0
2021,Bromley 037A,E01000680,647,569,316,253,0,0,20,2,18,58,49,9,0
2021,Bromley 035A,E01000681,649,597,304,293,1,1,4,0,4,47,37,10,0
2021,Bromley 035B,E01000682,638,584,338,246,0,0,3,0,3,51,46,5,0
2021,Bromley 035C,E01000683,704,491,226,265,0,0,61,10,51,152,137,15,0
2021,Bromley 035D,E01000684,749,673,327,346,1,1,5,1,4,70,63,7,0
2021,Bromley 037B,E01000685,611,468,196,272,3,3,76,10,66,63,54,9,1
2021,Bromley 037C,E01000686,644,508,277,231,9,9,67,5,62,60,46,14,0
2021,Bromley 037D,E01000687,661,564,322,242,2,2,17,1,16,78,70,8,0
2021,Bromley 037E,E01000688,507,469,260,209,0,0,16,1,15,22,18,4,0
2021,Bromley 002A,E01000689,614,358,179,179,3,3,127,12,115,126,110,16,0
2021,Bromley 002B,E01000690,535,466,229,237,1,1,28,1,27,40,35,5,0
2021,Bromley 002C,E01000691,636,427,175,252,2,2,117,5,112,90,72,18,0
2021,Bromley 002D,E01000692,680,515,247,268,0,0,33,0,33,132,118,14,0
2021,Bromley 010A,E01000693,645,522,351,171,2,2,44,6,38,77,60,17,0
2021,Bromley 007C,E01000694,881,716,338,378,35,35,33,1,32,97,87,10,0
2021,Bromley 007D,E01000695,617,516,262,254,1,1,24,0,24,76,71,5,0
2021,Bromley 007E,E01000696,688,576,336,240,1,1,12,1,11,99,85,14,0
2021,Bromley 007F,E01000697,776,549,247,302,4,4,18,1,17,205,185,20,0
2021,Bromley 010B,E01000698,438,415,214,201,2,2,5,0,5,16,11,5,0
2021,Bromley 015A,E01000699,663,335,103,232,6,6,123,14,109,199,187,12,0
2021,Bromley 013A,E01000700,667,440,143,297,22,22,115,8,107,90,76,14,0
2021,Bromley 015B,E01000701,606,429,133,296,8,8,40,5,35,129,123,6,0
2021,Bromley 013B,E01000702,637,402,137,265,1,1,74,1,73,160,150,10,0
2021,Bromley 013C,E01000703,700,429,169,260,9,9,66,7,59,195,183,12,1
2021,Bromley 015C,E01000704,599,454,211,243,7,7,32,6,26,106,96,10,0
2021,Bromley 015D,E01000705,573,352,150,202,2,2,89,12,77,130,120,10,0
2021,Bromley 013D,E01000706,610,403,153,250,1,1,104,11,93,102,92,10,0
2021,Bromley 041A,E01000707,530,464,162,302,2,2,9,1,8,55,55,0,0
2021,Bromley 041B,E01000708,713,506,244,262,18,18,50,10,40,139,130,9,0
2021,Bromley 006A,E01000709,737,410,228,182,3,3,125,7,118,198,185,13,1
2021,Bromley 006B,E01000710,1158,697,257,440,53,53,61,2,59,347,329,18,0
2021,Bromley 006C,E01000711,1026,505,238,267,12,12,125,13,112,384,353,31,0
2021,Bromley 012A,E01000712,879,525,296,229,3,3,24,3,21,327,298,29,0
2021,Bromley 012B,E01000713,888,557,263,294,3,3,34,2,32,294,268,26,0
2021,Bromley 006D,E01000714,1091,540,295,245,14,14,68,4,64,469,438,31,0
2021,Bromley 012C,E01000715,927,559,303,256,5,5,55,3,52,307,287,20,1
2021,Bromley 011C,E01000716,711,497,271,226,0,0,35,3,32,179,166,13,0
2021,Bromley 011D,E01000717,865,505,271,234,2,2,56,8,48,302,282,20,0
2021,Bromley 006E,E01000718,924,394,150,244,21,21,268,26,242,241,215,26,0
2021,Bromley 019A,E01000719,865,447,163,284,48,48,205,43,162,165,135,30,0
2021,Bromley 019B,E01000720,684,355,150,205,3,3,213,38,175,113,107,6,0
2021,Bromley 019C,E01000721,616,235,76,159,25,25,296,39,257,60,49,11,0
2021,Bromley 023A,E01000722,759,517,258,259,14,14,96,13,83,132,123,9,0
2021,Bromley 029A,E01000723,552,507,319,188,3,3,12,2,10,30,22,8,0
2021,Bromley 019D,E01000724,652,249,106,143,3,3,339,62,277,61,58,3,0
2021,Bromley 023B,E01000725,793,397,181,216,7,7,203,18,185,185,170,15,1
2021,Bromley 029B,E01000726,578,470,274,196,7,7,16,0,16,85,71,14,0
2021,Bromley 028A,E01000727,762,556,295,261,13,13,83,6,77,110,101,9,0
2021,Bromley 019E,E01000728,699,472,250,222,1,1,110,24,86,116,105,11,0
2021,Bromley 014A,E01000729,834,286,88,198,22,22,466,90,376,60,54,6,0
2021,Bromley 014B,E01000730,669,225,89,136,17,17,347,39,308,80,73,7,0
2021,Bromley 023C,E01000731,514,323,145,178,4,4,139,19,120,47,41,6,1
2021,Bromley 023D,E01000732,586,460,221,239,2,2,86,8,78,38,33,5,0
2021,Bromley 023E,E01000733,634,442,190,252,11,11,119,13,106,62,51,11,0
2021,Bromley 028B,E01000734,511,380,165,215,0,0,52,7,45,79,73,6,0
2021,Bromley 014C,E01000735,556,312,121,191,8,8,182,28,154,54,46,8,0
2021,Bromley 010C,E01000736,629,372,161,211,3,3,201,24,177,53,49,4,0
2021,Bromley 010D,E01000737,583,337,149,188,4,4,183,27,156,58,52,6,1
2021,Bromley 014D,E01000738,647,478,218,260,4,4,94,16,78,71,61,10,0
2021,Bromley 014E,E01000739,637,251,103,148,3,3,312,47,265,71,67,4,0
2021,Bromley 005B,E01000741,931,355,73,282,3,3,239,18,221,334,321,13,0
2021,Bromley 005C,E01000742,1022,378,102,276,11,11,241,38,203,391,379,12,1
2021,Bromley 009A,E01000743,851,214,66,148,43,43,368,50,318,224,205,19,2
2021,Bromley 009B,E01000744,662,186,70,116,4,4,369,56,313,103,91,12,0
2021,Bromley 005D,E01000745,899,418,121,297,10,10,224,21,203,247,226,21,0
2021,Bromley 005E,E01000746,965,463,161,302,5,5,169,8,161,326,305,21,2
2021,Bromley 042B,E01000747,791,613,333,280,8,8,60,6,54,110,75,35,0
2021,Bromley 042C,E01000748,704,637,418,219,4,4,9,1,8,54,36,18,0
2021,Bromley 036A,E01000749,637,553,315,238,1,1,32,5,27,51,41,10,0
2021,Bromley 036B,E01000750,654,253,144,109,3,3,372,10,362,26,21,5,0
2021,Bromley 036C,E01000751,888,729,341,388,6,6,38,2,36,115,101,14,0
2021,Bromley 036D,E01000752,786,624,392,232,0,0,57,3,54,105,86,19,0
2021,Bromley 031A,E01000753,756,685,382,303,0,0,5,2,3,66,59,7,0
2021,Bromley 031B,E01000754,735,585,314,271,2,2,24,3,21,124,112,12,0
2021,Bromley 031C,E01000755,630,564,289,275,0,0,11,0,11,55,49,6,0
2021,Bromley 033D,E01000756,650,565,320,245,0,0,12,1,11,73,59,14,0
2021,Bromley 031D,E01000757,603,572,353,219,0,0,8,1,7,23,17,6,0
2021,Bromley 031E,E01000758,552,503,271,232,1,1,14,1,13,34,31,3,0
2021,Bromley 034A,E01000759,576,541,267,274,0,0,6,2,4,29,23,6,0
2021,Bromley 034B,E01000760,585,466,264,202,14,14,22,3,19,83,74,9,0
2021,Bromley 034C,E01000761,571,549,273,276,2,2,5,0,5,15,12,3,0
2021,Bromley 018D,E01000762,747,571,277,294,1,1,15,1,14,160,144,16,0
2021,Bromley 027A,E01000763,523,490,244,246,0,0,3,0,3,30,27,3,0
2021,Bromley 027B,E01000764,660,526,231,295,2,2,87,5,82,45,35,10,0
2021,Bromley 034D,E01000765,703,545,281,264,3,3,25,1,24,127,113,14,3
2021,Bromley 027C,E01000766,646,617,319,298,0,0,7,1,6,22,19,3,0
2021,Bromley 027D,E01000767,601,570,281,289,0,0,8,2,6,23,18,5,0
2021,Bromley 034E,E01000768,613,473,265,208,1,1,49,2,47,90,81,9,0
2021,Bromley 024A,E01000769,454,355,166,189,0,0,69,2,67,30,23,7,0
2021,Bromley 012D,E01000770,687,515,342,173,3,3,22,1,21,147,135,12,0
2021,Bromley 041C,E01000771,621,545,282,263,0,0,2,1,1,74,65,9,0
2021,Bromley 012E,E01000772,755,590,370,220,3,3,28,2,26,134,115,19,0
2021,Bromley 024B,E01000773,606,468,211,257,0,0,99,0,99,39,33,6,0
2021,Bromley 041D,E01000774,582,448,211,237,2,2,22,4,18,110,102,8,0
2021,Bromley 024C,E01000775,854,700,328,372,3,3,23,2,21,128,114,14,0
2021,Bromley 024D,E01000777,559,484,220,264,2,2,6,0,6,67,54,13,0
2021,Bromley 024E,E01000778,637,480,206,274,11,11,91,15,76,55,52,3,0
2021,Bromley 001A,E01000779,590,408,214,194,2,2,49,2,47,130,114,16,1
2021,Bromley 001B,E01000780,649,372,169,203,6,6,172,28,144,99,84,15,0
2021,Bromley 001C,E01000781,626,249,76,173,16,16,271,36,235,88,76,12,2
2021,Bromley 001D,E01000782,653,238,67,171,2,2,287,36,251,126,116,10,0
2021,Bromley 001E,E01000783,636,292,90,202,5,5,225,34,191,113,92,21,1
2021,Bromley 002E,E01000784,590,446,176,270,4,4,53,5,48,87,82,5,0
2021,Bromley 001F,E01000785,632,294,116,178,5,5,231,38,193,102,83,19,0
2021,Bromley 032A,E01000786,636,581,359,222,0,0,24,5,19,31,27,4,0
2021,Bromley 029C,E01000787,675,503,278,225,5,5,98,15,83,69,61,8,0
2021,Bromley 029D,E01000788,614,435,231,204,11,11,88,15,73,79,68,11,1
2021,Bromley 032B,E01000789,662,141,58,83,11,11,434,58,376,73,68,5,3
2021,Bromley 028C,E01000790,1045,571,284,287,12,12,80,8,72,382,345,37,0
2021,Bromley 029E,E01000791,619,537,301,236,0,0,38,5,33,44,36,8,0
2021,Bromley 032C,E01000792,573,425,205,220,12,12,72,8,64,64,57,7,0
2021,Bromley 032D,E01000793,627,582,350,232,4,4,5,1,4,36,31,5,0
2021,Bromley 035E,E01000794,605,570,346,224,0,0,9,2,7,26,19,7,0
2021,Bromley 032E,E01000795,534,397,220,177,0,0,104,8,96,33,28,5,0
2021,Bromley 009C,E01000796,621,99,32,67,6,6,445,61,384,70,62,8,1
2021,Bromley 013E,E01000797,691,477,202,275,2,2,85,8,77,127,116,11,0
2021,Bromley 009D,E01000798,737,179,51,128,4,4,365,55,310,187,173,14,2
2021,Bromley 004A,E01000799,754,404,157,247,13,13,120,17,103,216,204,12,1
2021,Bromley 009E,E01000800,799,286,89,197,28,28,223,24,199,262,246,16,0
2021,Bromley 015E,E01000801,651,377,174,203,4,4,133,22,111,137,126,11,0
2021,Bromley 004B,E01000802,803,483,161,322,1,1,160,20,140,159,147,12,0
2021,Bromley 004C,E01000803,747,382,128,254,12,12,183,13,170,169,166,3,1
2021,Bromley 004D,E01000804,565,477,226,251,1,1,24,4,20,63,55,8,0
2021,Bromley 004E,E01000805,798,415,174,241,17,17,157,14,143,209,183,26,0
2021,Bromley 009F,E01000806,775,209,52,157,8,8,294,67,227,264,252,12,0
2021,Bromley 022C,E01000807,636,466,244,222,3,3,45,4,41,122,112,10,0
2021,Bromley 025A,E01000808,620,531,279,252,0,0,47,7,40,42,37,5,0
2021,Bromley 022D,E01000809,641,571,303,268,3,3,10,1,9,57,49,8,0
2021,Bromley 025B,E01000810,595,565,294,271,1,1,6,0,6,22,19,3,1
2021,Bromley 025C,E01000811,571,465,219,246,1,1,4,1,3,101,89,12,0
2021,Bromley 028D,E01000812,676,496,250,246,2,2,67,11,56,111,99,12,0
2021,Bromley 025D,E01000813,621,565,315,250,2,2,1,0,1,53,49,4,0
2021,Bromley 028E,E01000814,580,559,318,241,0,0,0,0,0,21,16,5,0
2021,Bromley 025E,E01000815,561,536,294,242,0,0,8,2,6,17,13,4,0
2021,Bromley 040A,E01000816,615,491,243,248,4,4,36,2,34,84,75,9,0
2021,Bromley 040B,E01000818,641,568,280,288,1,1,22,0,22,50,44,6,0
2021,Bromley 040C,E01000819,759,354,141,213,22,22,252,12,240,131,118,13,0
2021,Bromley 008C,E01000820,701,423,175,248,0,0,128,8,120,147,136,11,3
2021,Bromley 008D,E01000822,713,429,165,264,0,0,89,22,67,195,185,10,0
2021,Bromley 008E,E01000823,734,494,215,279,3,3,46,1,45,191,168,23,0
2021,Bromley 008F,E01000824,579,341,121,220,6,6,76,4,72,156,149,7,0
2021,Bromley 008G,E01000825,809,457,223,234,5,5,92,5,87,254,234,20,1
2021,Bromley 021A,E01000826,563,523,266,257,0,0,9,0,9,31,25,6,0
2021,Bromley 021B,E01000827,780,522,314,208,1,1,46,5,41,211,194,17,0
2021,Bromley 011E,E01000828,772,530,267,263,1,1,93,0,93,148,140,8,0
2021,Bromley 018E,E01000829,700,472,204,268,0,0,41,4,37,185,173,12,2
2021,Bromley 021C,E01000830,556,524,268,256,1,1,8,3,5,23,16,7,0
2021,Bromley 021D,E01000831,774,523,291,232,1,1,67,7,60,182,166,16,1
2021,Bromley 030A,E01000832,586,515,273,242,1,1,4,2,2,65,58,7,1
2021,Bromley 021E,E01000833,497,473,225,248,0,0,4,0,4,20,18,2,0
2021,Bromley 027E,E01000834,462,428,167,261,1,1,8,1,7,25,20,5,0
2021,Bromley 030B,E01000835,699,458,248,210,4,4,21,2,19,216,196,20,0
2021,Bromley 030C,E01000836,496,460,214,246,1,1,7,0,7,28,22,6,0
2021,Bromley 030D,E01000837,652,498,278,220,0,0,64,11,53,90,75,15,0
2021,Bromley 030E,E01000838,541,481,265,216,0,0,12,0,12,48,44,4,0
2021,Bromley 030F,E01000839,541,506,301,205,12,12,1,0,1,22,13,9,0
2021,Bromley 030G,E01000840,686,519,331,188,2,2,139,0,139,26,23,3,0
2021,Bromley 030H,E01000841,662,583,305,278,3,3,10,1,9,66,59,7,0
2021,Camden 011A,E01000842,704,296,183,113,2,2,86,30,56,320,293,27,0
2021,Camden 014A,E01000843,651,270,148,122,0,0,84,69,15,296,276,20,1
2021,Camden 011B,E01000844,819,301,173,128,2,2,88,22,66,428,408,20,0
2021,Camden 014B,E01000845,697,302,159,143,2,2,97,67,30,294,271,23,2
2021,Camden 014C,E01000846,583,136,89,47,3,3,317,288,29,123,110,13,4
2021,Camden 014D,E01000847,617,202,135,67,0,0,249,222,27,165,152,13,1
2021,Camden 011C,E01000848,738,300,156,144,5,5,68,57,11,364,348,16,1
2021,Camden 011D,E01000849,733,257,142,115,4,4,63,24,39,409,379,30,0
2021,Camden 026A,E01000850,573,127,83,44,6,6,97,50,47,340,314,26,3
2021,Camden 026B,E01000851,631,155,92,63,1,1,92,53,39,383,359,24,0
2021,Camden 029H,E01000853,720,94,61,33,3,3,472,352,120,146,131,15,5
2021,Camden 028A,E01000855,809,253,171,82,6,6,192,23,169,355,291,64,3
2021,Camden 019A,E01000856,648,136,75,61,7,7,278,185,93,220,198,22,7
2021,Camden 018A,E01000857,636,257,144,113,2,2,169,137,32,208,198,10,0
2021,Camden 018B,E01000858,799,91,44,47,4,4,464,213,251,234,220,14,6
2021,Camden 018C,E01000859,698,300,173,127,3,3,92,46,46,303,280,23,0
2021,Camden 018D,E01000860,675,168,101,67,4,4,350,46,304,152,128,24,1
2021,Camden 019B,E01000861,696,159,75,84,2,2,231,192,39,302,286,16,2
2021,Camden 018E,E01000862,807,434,243,191,2,2,100,42,58,271,242,29,0
2021,Camden 021A,E01000863,694,181,99,82,8,8,155,35,120,350,323,27,0
2021,Camden 009A,E01000866,927,269,135,134,4,4,411,242,169,242,227,15,1
2021,Camden 015C,E01000867,767,126,59,67,21,21,325,213,112,292,265,27,3
2021,Camden 015D,E01000868,746,116,43,73,2,2,513,489,24,113,100,13,2
2021,Camden 015E,E01000869,879,282,140,142,6,6,220,137,83,370,345,25,1
2021,Camden 009B,E01000870,726,210,101,109,5,5,324,288,36,185,167,18,2
2021,Camden 005A,E01000871,651,355,175,180,14,14,90,67,23,192,177,15,0
2021,Camden 005B,E01000872,856,223,96,127,3,3,144,78,66,485,467,18,1
2021,Camden 005C,E01000873,666,333,140,193,2,2,89,13,76,241,226,15,1
2021,Camden 005D,E01000874,629,355,177,178,2,2,43,26,17,229,219,10,0
2021,Camden 013A,E01000875,771,222,98,124,8,8,136,54,82,405,392,13,0
2021,Camden 013B,E01000876,827,174,68,106,17,17,348,270,78,284,274,10,4
2021,Camden 005E,E01000877,661,265,126,139,3,3,43,17,26,350,327,23,0
2021,Camden 004A,E01000878,764,346,199,147,20,20,107,30,77,288,264,24,3
2021,Camden 004B,E01000879,573,251,139,112,0,0,56,40,16,266,246,20,0
2021,Camden 004C,E01000880,579,278,144,134,4,4,29,26,3,268,241,27,0
2021,Camden 008A,E01000881,602,177,106,71,4,4,62,47,15,359,332,27,0
2021,Camden 008B,E01000882,665,312,187,125,1,1,28,20,8,324,298,26,0
2021,Camden 008C,E01000883,755,237,129,108,3,3,36,19,17,479,450,29,0
2021,Camden 004D,E01000884,585,333,181,152,3,3,35,21,14,214,204,10,0
2021,Camden 004E,E01000885,527,319,227,92,1,1,42,35,7,165,133,32,0
2021,Camden 006A,E01000886,592,335,181,154,3,3,96,80,16,158,141,17,0
2021,Camden 006B,E01000887,655,267,124,143,2,2,143,124,19,243,225,18,0
2021,Camden 006C,E01000888,640,273,143,130,3,3,208,119,89,155,140,15,1
2021,Camden 007A,E01000889,706,134,56,78,2,2,492,356,136,77,71,6,1
2021,Camden 007B,E01000890,606,75,41,34,1,1,476,472,4,49,44,5,5
2021,Camden 007C,E01000891,615,90,33,57,3,3,399,380,19,116,109,7,7
2021,Camden 006D,E01000892,818,305,167,138,23,23,245,214,31,244,215,29,1
2021,Camden 002A,E01000893,657,380,245,135,4,4,27,16,11,246,222,24,0
2021,Camden 002B,E01000894,565,319,208,111,3,3,33,23,10,210,197,13,0
2021,Camden 002C,E01000895,782,253,160,93,3,3,194,146,48,326,294,32,6
2021,Camden 002D,E01000896,661,381,245,136,3,3,28,16,12,249,229,20,0
2021,Camden 008D,E01000897,655,364,216,148,1,1,26,16,10,264,244,20,0
2021,Camden 008E,E01000898,828,158,90,68,0,0,432,216,216,233,207,26,5
2021,Camden 002E,E01000899,708,444,286,158,1,1,33,5,28,229,192,37,1
2021,Camden 012A,E01000900,716,240,107,133,1,1,300,270,30,173,160,13,2
2021,Camden 007D,E01000901,731,95,41,54,17,17,471,307,164,147,139,8,1
2021,Camden 012B,E01000902,547,83,38,45,4,4,316,280,36,140,122,18,4
2021,Camden 006E,E01000903,626,213,121,92,4,4,204,62,142,204,187,17,1
2021,Camden 012C,E01000904,897,194,103,91,3,3,450,410,40,250,232,18,0
2021,Camden 012D,E01000905,763,101,29,72,0,0,553,541,12,105,90,15,4
2021,Camden 012E,E01000906,733,293,161,132,2,2,85,84,1,353,318,35,0
2021,Camden 001A,E01000907,614,185,85,100,0,0,326,299,27,94,85,9,9
2021,Camden 001B,E01000908,771,229,111,118,12,12,402,393,9,127,118,9,1
2021,Camden 001C,E01000909,645,402,239,163,4,4,116,91,25,121,101,20,2
2021,Camden 003A,E01000910,558,326,191,135,0,0,94,77,17,138,117,21,0
2021,Camden 003B,E01000911,632,272,138,134,0,0,260,97,163,98,86,12,2
2021,Camden 001D,E01000912,680,194,108,86,13,13,362,276,86,106,94,12,5
2021,Camden 001E,E01000913,683,494,324,170,0,0,12,4,8,177,145,32,0
2021,Camden 028B,E01000914,764,185,121,64,6,6,184,125,59,387,353,34,2
2021,Camden 027A,E01000915,589,88,50,38,1,1,360,296,64,135,118,17,5
2021,Camden 027B,E01000916,932,207,96,111,2,2,380,230,150,342,317,25,1
2021,Camden 027C,E01000917,750,77,38,39,4,4,565,349,216,98,87,11,6
2021,Camden 028C,E01000918,815,146,92,54,14,14,385,212,173,267,235,32,3
2021,Camden 028D,E01000919,715,143,91,52,13,13,303,120,183,254,226,28,2
2021,Camden 027D,E01000920,815,184,113,71,2,2,263,157,106,363,327,36,3
2021,Camden 003C,E01000921,922,246,103,143,12,12,181,76,105,479,451,28,4
2021,Camden 007E,E01000922,689,199,96,103,11,11,248,167,81,226,215,11,5
2021,Camden 003D,E01000923,633,273,134,139,3,3,216,117,99,138,128,10,3
2021,Camden 009C,E01000924,726,286,133,153,2,2,179,124,55,256,234,22,3
2021,Camden 009D,E01000925,571,101,46,55,1,1,370,340,30,96,85,11,3
2021,Camden 009E,E01000926,609,159,69,90,0,0,224,201,23,225,214,11,1
2021,Camden 007F,E01000927,690,307,166,141,3,3,151,121,30,227,210,17,2
2021,Camden 003E,E01000928,752,297,147,150,4,4,233,177,56,217,200,17,1
2021,Camden 020A,E01000929,724,141,75,66,3,3,391,373,18,184,162,22,5
2021,Camden 020B,E01000930,1104,165,60,105,3,3,480,256,224,449,419,30,7
2021,Camden 013C,E01000931,923,174,55,119,13,13,367,264,103,367,351,16,2
2021,Camden 013D,E01000932,880,235,76,159,4,4,233,157,76,401,377,24,7
2021,Camden 020C,E01000933,818,248,105,143,6,6,169,106,63,394,380,14,1
2021,Camden 020D,E01000934,719,109,52,57,34,34,356,274,82,217,205,12,3
2021,Camden 020E,E01000935,705,83,43,40,0,0,445,377,68,171,152,19,6
2021,Camden 029G,E01000937,417,113,80,33,0,0,99,73,26,205,193,12,0
2021,Camden 029A,E01000938,626,65,32,33,2,2,292,93,199,266,245,21,1
2021,Camden 029B,E01000939,486,52,27,25,6,6,292,220,72,128,120,8,8
2021,Camden 029D,E01000941,532,55,29,26,3,3,399,238,161,69,60,9,6
2021,Camden 029C,E01000942,507,144,98,46,2,2,146,128,18,214,193,21,1
2021,Camden 029F,E01000943,439,96,64,32,2,2,151,77,74,190,159,31,0
2021,Camden 023A,E01000944,566,82,49,33,3,3,340,298,42,135,124,11,6
2021,Camden 021B,E01000946,687,191,134,57,5,5,258,86,172,233,197,36,0
2021,Camden 021C,E01000947,817,148,70,78,2,2,216,143,73,450,428,22,1
2021,Camden 021D,E01000948,745,234,132,102,4,4,257,204,53,246,209,37,4
2021,Camden 023C,E01000949,693,43,29,14,3,3,571,138,433,74,66,8,2
2021,Camden 023E,E01000951,563,86,48,38,4,4,367,350,17,105,104,1,1
2021,Camden 022A,E01000952,659,82,33,49,7,7,405,373,32,161,150,11,4
2021,Camden 022C,E01000954,650,24,18,6,0,0,550,368,182,74,73,1,2
2021,Camden 022D,E01000955,535,28,11,17,1,1,445,139,306,60,52,8,1
2021,Camden 022E,E01000956,604,72,36,36,5,5,338,224,114,188,174,14,1
2021,Camden 019C,E01000957,652,137,71,66,28,28,209,135,74,274,240,34,4
2021,Camden 019D,E01000958,954,148,67,81,46,46,466,295,171,294,273,21,0
2021,Camden 019E,E01000959,688,92,44,48,4,4,414,399,15,176,161,15,2
2021,Camden 017A,E01000960,895,254,136,118,4,4,159,132,27,475,438,37,3
2021,Camden 017B,E01000961,726,178,94,84,26,26,288,233,55,230,214,16,4
2021,Camden 016A,E01000962,754,288,135,153,2,2,42,26,16,422,397,25,0
2021,Camden 017C,E01000963,827,280,181,99,4,4,87,25,62,456,410,46,0
2021,Camden 016B,E01000964,754,223,110,113,2,2,253,137,116,274,259,15,2
2021,Camden 016C,E01000965,813,238,113,125,11,11,189,107,82,374,356,18,1
2021,Camden 016D,E01000966,699,327,173,154,2,2,37,27,10,333,316,17,0
2021,Camden 017D,E01000967,638,273,165,108,2,2,109,70,39,254,223,31,0
2021,Camden 016E,E01000968,727,240,118,122,3,3,133,65,68,350,332,18,1
2021,Camden 010A,E01000969,890,362,176,186,2,2,36,22,14,488,447,41,2
2021,Camden 010B,E01000970,760,236,101,135,2,2,63,25,38,458,437,21,1
2021,Camden 010C,E01000971,577,290,156,134,2,2,60,42,18,223,213,10,2
2021,Camden 010D,E01000972,961,119,60,59,5,5,462,204,258,371,354,17,4
2021,Camden 010E,E01000973,1120,252,97,155,24,24,289,136,153,551,532,19,4
2021,Camden 013E,E01000974,765,173,66,107,0,0,250,121,129,341,325,16,1
2021,Croydon 022A,E01000975,1038,406,159,247,25,25,104,32,72,501,479,22,2
2021,Croydon 022B,E01000976,872,341,116,225,1,1,137,88,49,385,371,14,8
2021,Croydon 022C,E01000977,946,315,150,165,7,7,234,171,63,385,351,34,5
2021,Croydon 022D,E01000978,840,287,116,171,2,2,108,26,82,443,421,22,0
2021,Croydon 022E,E01000979,775,342,161,181,13,13,67,18,49,350,334,16,3
2021,Croydon 017A,E01000980,579,334,128,206,3,3,111,15,96,131,113,18,0
2021,Croydon 017B,E01000981,658,428,166,262,13,13,51,21,30,165,149,16,1
2021,Croydon 017C,E01000982,676,363,130,233,7,7,94,24,70,212,185,27,0
2021,Croydon 017D,E01000983,724,519,227,292,6,6,29,4,25,170,161,9,0
2021,Croydon 022F,E01000984,786,261,112,149,14,14,242,99,143,267,262,5,2
2021,Croydon 021A,E01000985,521,436,228,208,0,0,41,3,38,44,37,7,0
2021,Croydon 021B,E01000986,688,493,264,229,13,13,38,5,33,144,134,10,0
2021,Croydon 021C,E01000987,514,444,236,208,1,1,5,3,2,64,58,6,0
2021,Croydon 018A,E01000989,629,535,249,286,3,3,26,4,22,65,58,7,0
2021,Croydon 045A,E01000990,535,193,82,111,1,1,289,240,49,49,43,6,3
2021,Croydon 018B,E01000991,684,615,334,281,0,0,14,5,9,55,47,8,0
2021,Croydon 014A,E01000992,685,340,126,214,3,3,254,183,71,86,81,5,2
2021,Croydon 021D,E01000993,600,417,196,221,7,7,44,11,33,132,118,14,0
2021,Croydon 009A,E01000994,537,364,150,214,1,1,31,20,11,141,127,14,0
2021,Croydon 009B,E01000995,604,301,147,154,4,4,40,24,16,258,232,26,1
2021,Croydon 009C,E01000996,448,318,153,165,4,4,24,13,11,102,90,12,0
2021,Croydon 009D,E01000997,491,273,133,140,1,1,48,19,29,168,158,10,1
2021,Croydon 010A,E01000998,587,235,104,131,7,7,111,47,64,233,219,14,1
2021,Croydon 009E,E01000999,435,294,168,126,3,3,20,6,14,118,106,12,0
2021,Croydon 010B,E01001000,509,226,118,108,11,11,42,14,28,230,218,12,0
2021,Croydon 013A,E01001001,582,245,103,142,1,1,113,72,41,221,201,20,2
2021,Croydon 009F,E01001002,523,299,112,187,5,5,66,24,42,153,145,8,0
2021,Croydon 010C,E01001003,597,242,108,134,39,39,116,17,99,200,172,28,0
2021,Croydon 015A,E01001004,779,323,105,218,30,30,172,26,146,254,238,16,0
2021,Croydon 019A,E01001005,601,291,137,154,6,6,78,19,59,225,210,15,1
2021,Croydon 016A,E01001006,690,316,75,241,11,11,204,20,184,159,148,11,0
2021,Croydon 016B,E01001007,597,381,157,224,5,5,49,23,26,161,147,14,1
2021,Croydon 019B,E01001008,531,262,105,157,3,3,166,136,30,97,91,6,3
2021,Croydon 019C,E01001009,667,316,113,203,33,33,122,38,84,194,176,18,2
2021,Croydon 019D,E01001010,607,227,91,136,5,5,242,174,68,131,122,9,2
2021,Croydon 019E,E01001011,858,201,71,130,23,23,245,106,139,381,356,25,8
2021,Croydon 020A,E01001012,812,252,97,155,22,22,154,41,113,382,364,18,2
2021,Croydon 020B,E01001013,902,191,74,117,7,7,420,357,63,284,260,24,0
2021,Croydon 041A,E01001015,557,294,139,155,24,24,191,72,119,48,44,4,0
2021,Croydon 041B,E01001016,652,523,267,256,16,16,47,39,8,66,60,6,0
2021,Croydon 043A,E01001017,630,566,261,305,0,0,19,12,7,45,40,5,0
2021,Croydon 044A,E01001018,635,570,285,285,2,2,17,12,5,46,41,5,0
2021,Croydon 044B,E01001019,593,516,301,215,2,2,49,44,5,26,20,6,0
2021,Croydon 044C,E01001020,642,553,273,280,0,0,36,31,5,53,46,7,0
2021,Croydon 044D,E01001021,546,249,109,140,1,1,252,241,11,39,34,5,5
2021,Croydon 044E,E01001022,619,579,341,238,2,2,8,6,2,30,24,6,0
2021,Croydon 041C,E01001023,1119,563,185,378,104,104,161,70,91,289,271,18,2
2021,Croydon 043B,E01001024,527,439,199,240,4,4,18,7,11,65,59,6,1
2021,Croydon 043C,E01001025,490,443,186,257,1,1,13,13,0,33,31,2,0
2021,Croydon 043D,E01001026,671,494,190,304,3,3,118,51,67,56,49,7,0
2021,Croydon 043E,E01001027,992,835,234,601,14,14,76,25,51,67,61,6,0
2021,Croydon 038A,E01001028,538,493,232,261,1,1,4,1,3,40,35,5,0
2021,Croydon 038B,E01001029,641,424,193,231,3,3,50,16,34,164,153,11,0
2021,Croydon 038C,E01001030,493,445,193,252,1,1,7,3,4,40,36,4,0
2021,Croydon 038D,E01001031,515,452,214,238,1,1,5,3,2,57,49,8,0
2021,Croydon 035A,E01001032,556,498,262,236,0,0,4,3,1,53,48,5,1
2021,Croydon 031A,E01001033,682,417,155,262,4,4,63,30,33,197,180,17,1
2021,Croydon 031B,E01001034,664,384,144,240,15,15,33,14,19,231,213,18,1
2021,Croydon 047C,E01001035,838,335,123,212,10,10,80,9,71,412,391,21,1
2021,Croydon 029A,E01001036,661,495,249,246,1,1,27,11,16,138,125,13,0
2021,Croydon 029B,E01001037,682,312,99,213,3,3,126,32,94,240,229,11,1
2021,Croydon 029C,E01001038,949,395,127,268,23,23,120,25,95,410,388,22,1
2021,Croydon 029D,E01001039,596,493,242,251,4,4,18,4,14,81,68,13,0
2021,Croydon 029E,E01001040,745,432,145,287,12,12,67,28,39,234,225,9,0
2021,Croydon 031C,E01001041,727,322,102,220,16,16,109,30,79,275,264,11,5
2021,Croydon 024B,E01001042,943,293,101,192,42,42,197,59,138,406,380,26,5
2021,Croydon 023A,E01001044,834,499,255,244,2,2,40,5,35,293,278,15,0
2021,Croydon 023B,E01001046,796,355,188,167,3,3,16,5,11,422,401,21,0
2021,Croydon 047A,E01001047,845,305,106,199,4,4,89,21,68,444,432,12,3
2021,Croydon 023C,E01001049,519,420,237,183,1,1,2,2,0,96,91,5,0
2021,Croydon 023D,E01001050,789,202,93,109,3,3,282,20,262,301,279,22,1
2021,Croydon 030A,E01001051,563,136,59,77,1,1,365,316,49,58,54,4,3
2021,Croydon 030B,E01001052,453,137,60,77,2,2,271,217,54,41,40,1,2
2021,Croydon 032A,E01001053,534,284,141,143,4,4,208,162,46,37,30,7,1
2021,Croydon 030C,E01001054,593,266,127,139,0,0,269,218,51,58,53,5,0
2021,Croydon 032B,E01001055,573,203,96,107,1,1,306,225,81,59,56,3,4
2021,Croydon 030D,E01001056,576,107,30,77,1,1,405,348,57,61,58,3,2
2021,Croydon 030E,E01001057,602,86,39,47,2,2,470,434,36,39,33,6,5
2021,Croydon 034A,E01001058,525,428,205,223,3,3,29,10,19,65,54,11,0
2021,Croydon 034B,E01001059,667,452,219,233,7,7,45,21,24,162,150,12,1
2021,Croydon 034C,E01001060,646,458,195,263,6,6,70,40,30,112,100,12,0
2021,Croydon 034D,E01001061,652,387,145,242,5,5,109,82,27,150,137,13,1
2021,Croydon 026A,E01001062,558,472,293,179,0,0,21,7,14,65,48,17,0
2021,Croydon 026B,E01001063,575,490,255,235,0,0,4,2,2,80,75,5,1
2021,Croydon 026C,E01001064,609,530,301,229,2,2,6,3,3,71,59,12,0
2021,Croydon 034E,E01001065,650,447,220,227,3,3,39,30,9,159,150,9,2
2021,Croydon 034F,E01001066,526,171,76,95,3,3,290,221,69,57,51,6,5
2021,Croydon 041D,E01001067,575,539,241,298,1,1,5,4,1,29,23,6,1
2021,Croydon 042A,E01001068,752,498,221,277,15,15,129,30,99,110,95,15,0
2021,Croydon 040A,E01001069,506,417,178,239,12,12,16,15,1,60,54,6,1
2021,Croydon 040B,E01001070,647,464,191,273,4,4,113,87,26,65,54,11,1
2021,Croydon 042B,E01001071,723,548,213,335,16,16,99,65,34,60,52,8,0
2021,Croydon 042C,E01001072,538,499,276,223,1,1,7,4,3,31,26,5,0
2021,Croydon 037A,E01001073,582,378,163,215,2,2,43,10,33,158,149,9,1
2021,Croydon 041E,E01001074,816,430,168,262,36,36,176,17,159,174,162,12,0
2021,Croydon 040C,E01001075,643,446,140,306,5,5,55,38,17,136,131,5,1
2021,Croydon 036A,E01001076,570,270,113,157,6,6,191,148,43,102,96,6,1
2021,Croydon 032C,E01001077,516,386,182,204,13,13,53,18,35,64,52,12,0
2021,Croydon 032D,E01001078,510,242,116,126,3,3,224,105,119,40,35,5,1
2021,Croydon 036B,E01001079,588,273,122,151,6,6,253,191,62,54,43,11,2
2021,Croydon 036C,E01001080,582,118,49,69,1,1,424,311,113,37,37,0,2
2021,Croydon 036D,E01001081,494,262,123,139,6,6,173,139,34,52,45,7,1
2021,Croydon 032E,E01001082,523,268,127,141,3,3,201,160,41,47,39,8,4
2021,Croydon 003A,E01001083,545,449,262,187,2,2,9,4,5,85,76,9,0
2021,Croydon 002A,E01001084,665,498,270,228,1,1,24,13,11,142,104,38,0
2021,Croydon 004A,E01001085,645,333,174,159,8,8,81,19,62,222,204,18,1
2021,Croydon 003B,E01001086,589,457,234,223,1,1,19,11,8,112,95,17,0
2021,Croydon 003C,E01001087,1133,423,198,225,19,19,269,208,61,413,387,26,9
2021,Croydon 004B,E01001088,578,376,150,226,6,6,89,82,7,107,97,10,0
2021,Croydon 004C,E01001089,645,272,124,148,3,3,147,137,10,223,204,19,0
2021,Croydon 004D,E01001090,888,335,145,190,24,24,198,132,66,329,310,19,2
2021,Croydon 004E,E01001091,561,408,213,195,1,1,14,7,7,138,117,21,0
2021,Croydon 037B,E01001092,701,512,239,273,15,15,47,15,32,126,113,13,1
2021,Croydon 037C,E01001093,711,462,208,254,17,17,74,40,34,158,140,18,0
2021,Croydon 038E,E01001094,567,491,248,243,0,0,18,11,7,58,51,7,0
2021,Croydon 031D,E01001095,595,348,136,212,10,10,60,18,42,177,160,17,0
2021,Croydon 037D,E01001096,531,480,232,248,0,0,12,1,11,39,33,6,0
2021,Croydon 037E,E01001097,1170,457,232,225,65,65,224,83,141,421,403,18,3
2021,Croydon 037F,E01001098,537,484,232,252,1,1,13,7,6,38,31,7,1
2021,Croydon 040D,E01001099,599,360,131,229,17,17,145,62,83,76,67,9,1
2021,Croydon 031E,E01001100,601,425,185,240,4,4,35,25,10,137,132,5,0
2021,Croydon 035B,E01001101,506,478,233,245,2,2,3,0,3,23,20,3,0
2021,Croydon 035C,E01001102,636,515,336,179,1,1,39,33,6,81,66,15,0
2021,Croydon 039A,E01001103,644,574,337,237,4,4,30,24,6,36,27,9,0
2021,Croydon 042D,E01001104,642,554,260,294,1,1,24,12,12,63,56,7,0
2021,Croydon 039B,E01001105,625,440,188,252,0,0,144,135,9,41,37,4,0
2021,Croydon 039C,E01001106,559,437,213,224,15,15,54,31,23,53,44,9,0
2021,Croydon 035D,E01001107,668,543,310,233,1,1,16,4,12,108,100,8,0
2021,Croydon 035E,E01001108,642,610,314,296,1,1,7,4,3,24,22,2,0
2021,Croydon 013B,E01001109,963,284,106,178,62,62,310,148,162,303,290,13,4
2021,Croydon 020D,E01001110,891,212,88,124,32,32,266,68,198,381,371,10,0
2021,Croydon 010D,E01001111,641,351,133,218,3,3,74,34,40,212,201,11,1
2021,Croydon 013C,E01001112,854,298,91,207,22,22,254,57,197,278,262,16,2
2021,Croydon 013D,E01001113,858,331,105,226,1,1,142,41,101,382,364,18,2
2021,Croydon 013E,E01001114,601,210,63,147,2,2,227,145,82,161,152,9,1
2021,Croydon 015B,E01001115,651,243,83,160,3,3,256,189,67,145,137,8,4
2021,Croydon 013F,E01001116,610,310,129,181,3,3,73,37,36,223,198,25,1
2021,Croydon 020E,E01001118,881,252,98,154,4,4,332,250,82,290,278,12,3
2021,Croydon 034G,E01001119,578,526,283,243,1,1,23,6,17,28,26,2,0
2021,Croydon 033A,E01001120,508,428,212,216,11,11,14,9,5,54,45,9,1
2021,Croydon 039D,E01001121,539,503,310,193,2,2,9,8,1,25,18,7,0
2021,Croydon 033B,E01001122,457,422,221,201,0,0,1,1,0,34,32,2,0
2021,Croydon 033C,E01001123,602,544,279,265,1,1,6,3,3,51,45,6,0
2021,Croydon 033D,E01001124,603,559,349,210,2,2,10,4,6,32,29,3,0
2021,Croydon 033E,E01001125,609,485,254,231,1,1,32,28,4,91,75,16,0
2021,Croydon 034H,E01001126,597,512,271,241,4,4,27,15,12,54,46,8,0
2021,Croydon 025A,E01001127,587,525,303,222,0,0,25,18,7,35,28,7,2
2021,Croydon 025B,E01001128,569,197,86,111,1,1,323,232,91,46,41,5,2
2021,Croydon 026D,E01001129,505,481,255,226,0,0,7,4,3,17,17,0,0
2021,Croydon 025C,E01001130,559,109,32,77,2,2,389,360,29,54,51,3,5
2021,Croydon 018C,E01001131,659,477,188,289,2,2,95,8,87,84,73,11,1
2021,Croydon 018D,E01001132,646,564,320,244,4,4,34,9,25,44,34,10,0
2021,Croydon 026E,E01001133,728,591,383,208,4,4,50,18,32,83,69,14,0
2021,Croydon 018E,E01001134,675,547,275,272,0,0,33,3,30,95,82,13,0
2021,Croydon 025D,E01001135,639,539,297,242,3,3,19,4,15,78,70,8,0
2021,Croydon 007A,E01001136,981,354,95,259,15,15,136,52,84,475,446,29,1
2021,Croydon 001A,E01001137,968,578,231,347,9,9,128,103,25,252,236,16,1
2021,Croydon 001B,E01001138,720,377,146,231,14,14,141,57,84,188,177,11,0
2021,Croydon 007B,E01001139,715,471,177,294,3,3,54,15,39,187,166,21,0
2021,Croydon 007C,E01001140,763,438,151,287,3,3,92,32,60,228,217,11,2
2021,Croydon 008A,E01001141,572,205,77,128,15,15,179,59,120,173,164,9,0
2021,Croydon 007D,E01001142,746,470,182,288,4,4,65,10,55,207,195,12,0
2021,Croydon 008B,E01001143,825,359,140,219,2,2,228,98,130,235,222,13,1
2021,Croydon 007E,E01001144,799,290,87,203,6,6,184,72,112,317,303,14,2
2021,Croydon 008C,E01001145,873,205,100,105,0,0,388,289,99,274,262,12,6
2021,Croydon 006A,E01001146,607,415,195,220,4,4,53,27,26,134,118,16,1
2021,Croydon 005A,E01001147,670,301,108,193,21,21,157,71,86,190,174,16,1
2021,Croydon 005B,E01001148,703,438,162,276,12,12,87,41,46,166,157,9,0
2021,Croydon 006B,E01001149,624,396,149,247,3,3,51,20,31,173,161,12,1
2021,Croydon 006C,E01001150,637,435,163,272,11,11,65,9,56,124,110,14,2
2021,Croydon 005C,E01001151,671,251,87,164,4,4,228,103,125,183,160,23,5
2021,Croydon 005D,E01001152,791,297,137,160,2,2,147,45,102,341,317,24,4
2021,Croydon 006D,E01001153,611,387,180,207,2,2,68,29,39,153,141,12,1
2021,Croydon 006E,E01001154,727,336,143,193,7,7,115,42,73,268,235,33,1
2021,Croydon 010E,E01001155,785,206,69,137,18,18,316,239,77,240,200,40,5
2021,Croydon 001C,E01001156,721,335,122,213,3,3,229,129,100,153,132,21,1
2021,Croydon 002B,E01001157,623,418,179,239,3,3,82,64,18,119,102,17,1
2021,Croydon 005E,E01001158,670,367,144,223,21,21,100,47,53,181,169,12,1
2021,Croydon 002C,E01001159,741,518,231,287,21,21,50,35,15,152,137,15,0
2021,Croydon 002D,E01001160,627,492,244,248,6,6,22,4,18,107,98,9,0
2021,Croydon 003D,E01001161,553,228,91,137,1,1,246,173,73,76,67,9,2
2021,Croydon 001D,E01001162,801,340,124,216,17,17,278,152,126,164,150,14,2
2021,Croydon 002E,E01001163,834,561,223,338,25,25,93,64,29,155,121,34,0
2021,Croydon 001E,E01001164,992,411,163,248,7,7,180,69,111,392,368,24,2
2021,Croydon 024C,E01001165,724,428,141,287,12,12,65,12,53,219,208,11,0
2021,Croydon 024D,E01001166,876,289,124,165,7,7,276,153,123,303,283,20,1
2021,Croydon 028A,E01001167,819,482,189,293,20,20,121,58,63,193,187,6,3
2021,Croydon 024E,E01001168,733,426,186,240,1,1,61,24,37,244,226,18,1
2021,Croydon 028B,E01001169,639,278,109,169,7,7,286,245,41,68,61,7,0
2021,Croydon 047D,E01001170,895,337,158,179,2,2,182,98,84,371,347,24,3
2021,Croydon 028C,E01001171,681,314,133,181,10,10,202,172,30,150,140,10,5
2021,Croydon 028D,E01001172,730,213,72,141,26,26,372,256,116,116,99,17,3
2021,Croydon 028E,E01001173,1120,511,202,309,51,51,254,44,210,304,266,38,0
2021,Croydon 011A,E01001174,510,331,177,154,4,4,29,11,18,146,135,11,0
2021,Croydon 011B,E01001175,556,300,124,176,5,5,80,33,47,169,154,15,2
2021,Croydon 011C,E01001176,620,285,145,140,23,23,111,51,60,200,183,17,1
2021,Croydon 016C,E01001177,555,234,81,153,0,0,182,93,89,137,125,12,2
2021,Croydon 015D,E01001178,599,123,46,77,6,6,202,100,102,251,231,20,17
2021,Croydon 016D,E01001179,548,328,153,175,4,4,53,17,36,162,143,19,1
2021,Croydon 016E,E01001180,672,304,122,182,1,1,97,29,68,269,246,23,1
2021,Croydon 015E,E01001181,889,176,65,111,49,49,388,212,176,272,256,16,4
2021,Croydon 011D,E01001182,461,284,148,136,1,1,10,4,6,166,145,21,0
2021,Croydon 011E,E01001183,635,267,145,122,5,5,117,74,43,242,222,20,4
2021,Croydon 011F,E01001184,444,313,184,129,0,0,28,26,2,103,88,15,0
2021,Croydon 014B,E01001185,743,442,168,274,19,19,52,19,33,229,209,20,1
2021,Croydon 014C,E01001186,816,347,141,206,9,9,199,63,136,260,245,15,1
2021,Croydon 017E,E01001187,808,406,160,246,32,32,152,100,52,217,205,12,1
2021,Croydon 014D,E01001188,750,365,125,240,17,17,149,44,105,218,208,10,1
2021,Croydon 045B,E01001189,459,317,116,201,5,5,55,20,35,82,72,10,0
2021,Croydon 045C,E01001190,602,386,131,255,0,0,115,30,85,100,90,10,1
2021,Croydon 008D,E01001191,863,309,115,194,2,2,167,40,127,384,364,20,1
2021,Croydon 008E,E01001192,689,340,95,245,4,4,170,64,106,173,168,5,2
2021,Croydon 014E,E01001193,568,149,52,97,48,48,308,19,289,63,52,11,0
2021,Croydon 045D,E01001194,615,433,138,295,3,3,54,21,33,125,112,13,0
2021,Ealing 021A,E01001195,616,338,204,134,0,0,41,19,22,235,223,12,2
2021,Ealing 015A,E01001196,693,182,113,69,8,8,262,41,221,241,221,20,0
2021,Ealing 021B,E01001197,719,257,142,115,3,3,147,59,88,311,301,10,1
2021,Ealing 021C,E01001198,595,291,124,167,1,1,63,8,55,240,231,9,0
2021,Ealing 021D,E01001199,671,200,80,120,12,12,188,37,151,270,250,20,1
2021,Ealing 025A,E01001200,628,334,148,186,2,2,52,12,40,240,228,12,0
2021,Ealing 025B,E01001201,631,304,128,176,5,5,125,19,106,197,187,10,0
2021,Ealing 025C,E01001202,999,237,107,130,43,43,320,174,146,396,379,17,3
2021,Ealing 025D,E01001203,854,220,95,125,5,5,262,42,220,364,346,18,3
2021,Ealing 018A,E01001204,594,411,211,200,0,0,65,35,30,117,111,6,1
2021,Ealing 018B,E01001205,654,212,107,105,10,10,228,48,180,204,197,7,0
2021,Ealing 018C,E01001206,552,114,46,68,1,1,304,283,21,129,126,3,4
2021,Ealing 018D,E01001207,757,362,153,209,12,12,45,7,38,337,314,23,1
2021,Ealing 018E,E01001208,510,416,219,197,1,1,23,18,5,70,62,8,0
2021,Ealing 013A,E01001209,652,475,248,227,1,1,9,4,5,167,155,12,0
2021,Ealing 016A,E01001210,756,179,89,90,12,12,444,378,66,115,100,15,6
2021,Ealing 013B,E01001211,717,376,200,176,26,26,90,60,30,223,208,15,2
2021,Ealing 018F,E01001212,724,421,233,188,4,4,57,10,47,242,229,13,0
2021,Ealing 023A,E01001213,537,277,154,123,1,1,83,61,22,173,148,25,3
2021,Ealing 023B,E01001214,498,330,236,94,1,1,10,7,3,157,142,15,0
2021,Ealing 023C,E01001215,623,266,163,103,5,5,127,67,60,223,210,13,2
2021,Ealing 023D,E01001216,495,243,150,93,7,7,44,30,14,201,180,21,0
2021,Ealing 014A,E01001217,439,332,175,157,5,5,7,1,6,95,84,11,0
2021,Ealing 012A,E01001218,724,251,144,107,8,8,255,163,92,202,188,14,8
2021,Ealing 029A,E01001219,765,201,90,111,32,32,374,317,57,152,140,12,6
2021,Ealing 029B,E01001220,470,95,46,49,20,20,288,246,42,65,58,7,2
2021,Ealing 041B,E01001223,632,297,177,120,1,1,49,5,44,285,270,15,0
2021,Ealing 019B,E01001224,580,408,222,186,2,2,18,8,10,152,147,5,0
2021,Ealing 041A,E01001225,847,304,175,129,1,1,157,10,147,385,359,26,0
2021,Ealing 019C,E01001226,669,278,155,123,1,1,61,2,59,329,306,23,0
2021,Ealing 019D,E01001227,603,357,189,168,5,5,37,7,30,204,195,9,0
2021,Ealing 019E,E01001228,826,312,162,150,4,4,64,11,53,445,418,27,1
2021,Ealing 031A,E01001229,592,246,106,140,7,7,218,208,10,120,109,11,1
2021,Ealing 031B,E01001230,607,310,167,143,1,1,63,6,57,233,215,18,0
2021,Ealing 027A,E01001231,786,400,222,178,13,13,29,7,22,344,313,31,0
2021,Ealing 031C,E01001232,617,298,142,156,20,20,126,116,10,170,147,23,3
2021,Ealing 031D,E01001233,621,279,142,137,3,3,143,95,48,192,181,11,4
2021,Ealing 027B,E01001234,609,255,118,137,6,6,69,12,57,279,268,11,0
2021,Ealing 042D,E01001235,780,252,105,147,24,24,54,20,34,447,424,23,3
2021,Ealing 042C,E01001236,686,263,131,132,2,2,114,17,97,306,291,15,1
2021,Ealing 031E,E01001237,674,305,149,156,4,4,47,22,25,317,304,13,1
2021,Ealing 015C,E01001239,564,151,75,76,32,32,199,42,157,180,172,8,2
2021,Ealing 024A,E01001240,657,187,114,73,4,4,101,88,13,363,339,24,2
2021,Ealing 024B,E01001241,654,251,147,104,22,22,131,58,73,250,237,13,0
2021,Ealing 024C,E01001242,609,232,119,113,19,19,190,13,177,168,157,11,0
2021,Ealing 024D,E01001243,960,286,136,150,12,12,222,156,66,440,394,46,0
2021,Ealing 024E,E01001244,1169,267,128,139,58,58,395,227,168,444,387,57,5
2021,Ealing 024F,E01001245,921,383,134,249,128,128,74,28,46,325,296,29,11
2021,Ealing 015D,E01001246,818,217,125,92,12,12,153,35,118,435,406,29,1
2021,Ealing 015E,E01001247,813,381,234,147,16,16,89,51,38,324,309,15,3
2021,Ealing 035A,E01001248,567,333,178,155,6,6,102,72,30,123,109,14,3
2021,Ealing 028A,E01001249,1090,193,57,136,56,56,351,77,274,480,461,19,10
2021,Ealing 028B,E01001250,976,314,154,160,23,23,294,69,225,344,332,12,1
2021,Ealing 030A,E01001251,733,417,196,221,8,8,60,21,39,248,237,11,0
2021,Ealing 030B,E01001252,966,357,190,167,59,59,184,48,136,365,337,28,1
2021,Ealing 030C,E01001253,774,441,173,268,14,14,102,61,41,216,200,16,1
2021,Ealing 030D,E01001254,744,434,177,257,35,35,97,21,76,177,162,15,1
2021,Ealing 028C,E01001255,586,438,192,246,1,1,38,16,22,109,94,15,0
2021,Ealing 008A,E01001257,809,188,54,134,116,116,393,142,251,112,97,15,0
2021,Ealing 010B,E01001258,646,411,190,221,4,4,56,40,16,172,162,10,3
2021,Ealing 014B,E01001259,518,303,156,147,12,12,29,10,19,173,169,4,1
2021,Ealing 012B,E01001260,690,406,218,188,6,6,39,31,8,238,215,23,1
2021,Ealing 012C,E01001261,858,329,159,170,55,55,146,88,58,326,302,24,2
2021,Ealing 010C,E01001262,542,242,95,147,7,7,175,152,23,113,103,10,5
2021,Ealing 010D,E01001263,735,269,114,155,39,39,272,108,164,151,142,9,4
2021,Ealing 010E,E01001264,623,381,180,201,4,4,124,104,20,114,109,5,0
2021,Ealing 006A,E01001265,633,306,140,166,7,7,73,61,12,245,233,12,2
2021,Ealing 006B,E01001266,596,401,231,170,6,6,13,6,7,176,162,14,0
2021,Ealing 006C,E01001267,820,357,173,184,12,12,227,182,45,211,192,19,13
2021,Ealing 012D,E01001268,641,460,226,234,5,5,11,6,5,164,154,10,1
2021,Ealing 001A,E01001269,794,382,184,198,2,2,51,5,46,359,340,19,0
2021,Ealing 004A,E01001270,584,426,175,251,4,4,18,8,10,135,125,10,1
2021,Ealing 001B,E01001271,633,357,173,184,13,13,57,31,26,205,182,23,1
2021,Ealing 006D,E01001272,592,296,162,134,7,7,30,6,24,259,242,17,0
2021,Ealing 041C,E01001273,586,359,216,143,5,5,13,6,7,209,192,17,0
2021,Ealing 041E,E01001274,585,277,166,111,2,2,53,8,45,253,233,20,0
2021,Ealing 041D,E01001275,905,306,161,145,10,10,115,15,100,474,423,51,0
2021,Ealing 011A,E01001276,696,321,174,147,6,6,35,15,20,334,323,11,0
2021,Ealing 011B,E01001277,716,312,189,123,4,4,46,23,23,354,336,18,0
2021,Ealing 011C,E01001278,800,342,186,156,8,8,50,31,19,399,375,24,1
2021,Ealing 013C,E01001279,556,466,273,193,1,1,13,4,9,76,71,5,0
2021,Ealing 011D,E01001280,774,363,196,167,42,42,15,7,8,354,337,17,0
2021,Ealing 013D,E01001281,622,458,231,227,2,2,13,4,9,149,140,9,0
2021,Ealing 016B,E01001282,611,244,86,158,15,15,246,214,32,99,92,7,7
2021,Ealing 016C,E01001283,775,274,130,144,2,2,349,295,54,145,135,10,5
2021,Ealing 022A,E01001284,590,406,210,196,6,6,21,10,11,156,143,13,1
2021,Ealing 016D,E01001285,574,296,130,166,2,2,136,114,22,137,127,10,3
2021,Ealing 016E,E01001286,613,328,146,182,6,6,144,122,22,132,122,10,3
2021,Ealing 016F,E01001287,505,187,105,82,4,4,248,207,41,63,55,8,3
2021,Ealing 022B,E01001288,536,336,170,166,5,5,53,32,21,141,126,15,1
2021,Ealing 022C,E01001289,477,307,139,168,3,3,47,27,20,120,110,10,0
2021,Ealing 022D,E01001290,796,364,182,182,30,30,126,17,109,275,251,24,1
2021,Ealing 014C,E01001291,509,335,163,172,5,5,21,7,14,147,124,23,1
2021,Ealing 014D,E01001292,513,365,215,150,2,2,14,8,6,132,123,9,0
2021,Ealing 014E,E01001293,566,296,151,145,2,2,81,7,74,187,143,44,0
2021,Ealing 017A,E01001294,571,350,192,158,4,4,20,7,13,197,179,18,0
2021,Ealing 017B,E01001295,526,351,181,170,0,0,15,8,7,160,137,23,0
2021,Ealing 017C,E01001296,417,247,142,105,1,1,40,37,3,129,116,13,0
2021,Ealing 017D,E01001297,518,289,174,115,1,1,59,42,17,168,146,22,1
2021,Ealing 017E,E01001298,582,324,205,119,3,3,56,41,15,198,139,59,1
2021,Ealing 035B,E01001299,645,487,285,202,5,5,24,12,12,129,112,17,0
2021,Ealing 039A,E01001300,597,441,203,238,2,2,12,5,7,142,130,12,0
2021,Ealing 039B,E01001301,809,276,132,144,5,5,139,88,51,387,368,19,2
2021,Ealing 039C,E01001302,618,405,189,216,2,2,24,6,18,187,178,9,0
2021,Ealing 032A,E01001303,649,407,220,187,0,0,23,16,7,219,204,15,0
2021,Ealing 039D,E01001304,698,355,121,234,6,6,122,47,75,215,198,17,0
2021,Ealing 035C,E01001305,632,507,251,256,3,3,18,6,12,104,94,10,0
2021,Ealing 035D,E01001306,696,493,256,237,5,5,20,11,9,178,167,11,0
2021,Ealing 002A,E01001307,607,396,196,200,11,11,3,0,3,197,186,11,0
2021,Ealing 002B,E01001308,685,470,288,182,8,8,9,4,5,198,182,16,0
2021,Ealing 001C,E01001309,598,428,193,235,2,2,16,7,9,152,141,11,0
2021,Ealing 001D,E01001310,756,397,160,237,20,20,57,16,41,281,263,18,1
2021,Ealing 001E,E01001311,955,290,103,187,1,1,461,205,256,202,187,15,1
2021,Ealing 002C,E01001312,608,370,178,192,1,1,40,10,30,197,175,22,0
2021,Ealing 002D,E01001313,519,342,196,146,2,2,18,8,10,157,140,17,0
2021,Ealing 002E,E01001314,511,363,172,191,0,0,18,2,16,130,114,16,0
2021,Ealing 003A,E01001315,500,295,118,177,24,24,65,24,41,116,106,10,0
2021,Ealing 003B,E01001316,613,232,119,113,5,5,257,219,38,113,106,7,6
2021,Ealing 003C,E01001317,730,329,119,210,14,14,163,125,38,222,208,14,2
2021,Ealing 003D,E01001318,717,259,88,171,11,11,307,213,94,116,104,12,24
2021,Ealing 004B,E01001319,507,329,148,181,3,3,47,23,24,126,111,15,2
2021,Ealing 003E,E01001320,550,180,69,111,3,3,280,161,119,86,78,8,1
2021,Ealing 003F,E01001321,793,418,207,211,15,15,140,45,95,220,209,11,0
2021,Ealing 004C,E01001322,736,375,194,181,2,2,118,89,29,239,218,21,2
2021,Ealing 004D,E01001323,773,362,177,185,1,1,52,15,37,358,334,24,0
2021,Ealing 008B,E01001324,644,255,106,149,21,21,93,29,64,274,263,11,1
2021,Ealing 009A,E01001325,619,348,128,220,4,4,167,131,36,94,82,12,6
2021,Ealing 008C,E01001326,675,261,114,147,5,5,229,157,72,177,164,13,3
2021,Ealing 009B,E01001327,590,311,122,189,2,2,144,115,29,133,121,12,0
2021,Ealing 009C,E01001328,593,262,102,160,3,3,209,174,35,117,109,8,2
2021,Ealing 009D,E01001329,641,322,139,183,1,1,148,125,23,164,156,8,6
2021,Ealing 008D,E01001330,645,206,72,134,15,15,291,208,83,130,122,8,3
2021,Ealing 009E,E01001331,626,171,66,105,4,4,272,223,49,175,164,11,4
2021,Ealing 008E,E01001332,581,153,54,99,23,23,270,135,135,135,125,10,0
2021,Ealing 038A,E01001333,711,178,102,76,5,5,204,97,107,317,289,28,7
2021,Ealing 029C,E01001334,516,156,96,60,1,1,248,174,74,103,95,8,8
2021,Ealing 038B,E01001335,515,357,175,182,9,9,53,41,12,95,78,17,1
2021,Ealing 038C,E01001336,565,235,123,112,3,3,156,30,126,170,158,12,1
2021,Ealing 029D,E01001337,766,272,108,164,87,87,239,25,214,167,133,34,1
2021,Ealing 029E,E01001338,532,291,174,117,5,5,75,57,18,160,146,14,1
2021,Ealing 029F,E01001339,701,277,79,198,53,53,283,35,248,86,73,13,2
2021,Ealing 029G,E01001340,545,158,27,131,42,42,215,25,190,128,112,16,2
2021,Ealing 005A,E01001341,587,344,172,172,6,6,18,4,14,219,192,27,0
2021,Ealing 005B,E01001342,641,345,183,162,5,5,15,8,7,275,258,17,1
2021,Ealing 005C,E01001343,476,336,195,141,2,2,9,6,3,129,106,23,0
2021,Ealing 007A,E01001344,902,426,206,220,13,13,125,64,61,338,321,17,0
2021,Ealing 005D,E01001345,524,330,151,179,4,4,62,56,6,128,117,11,0
2021,Ealing 007B,E01001346,680,429,225,204,3,3,21,8,13,226,211,15,1
2021,Ealing 007C,E01001347,686,334,180,154,7,7,26,15,11,319,279,40,0
2021,Ealing 007D,E01001348,669,321,171,150,10,10,47,11,36,290,274,16,1
2021,Ealing 006E,E01001349,490,236,130,106,2,2,168,31,137,82,74,8,2
2021,Ealing 027C,E01001350,617,284,153,131,2,2,97,26,71,232,212,20,2
2021,Ealing 025E,E01001351,833,288,113,175,17,17,162,55,107,364,346,18,2
2021,Ealing 027D,E01001352,643,255,125,130,6,6,80,31,49,302,290,12,0
2021,Ealing 033A,E01001353,636,242,116,126,3,3,141,27,114,247,235,12,3
2021,Ealing 027E,E01001354,891,397,195,202,6,6,92,11,81,396,376,20,0
2021,Ealing 033B,E01001355,892,367,131,236,18,18,183,60,123,324,306,18,0
2021,Ealing 033C,E01001356,631,71,39,32,13,13,385,310,75,157,133,24,5
2021,Ealing 033D,E01001357,1137,412,53,359,123,123,380,43,337,222,204,18,0
2021,Ealing 033E,E01001358,820,260,47,213,110,110,293,81,212,155,147,8,2
2021,Ealing 026A,E01001359,624,275,169,106,4,4,93,36,57,252,229,23,0
2021,Ealing 026B,E01001360,553,332,214,118,2,2,23,11,12,195,173,22,1
2021,Ealing 023E,E01001361,604,152,101,51,5,5,117,21,96,328,297,31,2
2021,Ealing 026C,E01001362,715,267,156,111,39,39,164,28,136,245,214,31,0
2021,Ealing 026D,E01001363,527,241,147,94,15,15,47,32,15,223,196,27,1
2021,Ealing 026E,E01001364,549,159,96,63,16,16,243,89,154,128,114,14,3
2021,Ealing 026F,E01001365,676,336,214,122,4,4,68,13,55,267,237,30,1
2021,Ealing 044C,E01001366,564,247,154,93,5,5,68,22,46,244,219,25,0
2021,Ealing 043B,E01001367,747,197,100,97,5,5,95,24,71,449,403,46,1
2021,Ealing 044D,E01001368,471,229,134,95,5,5,86,16,70,151,136,15,0
2021,Ealing 038D,E01001369,554,206,121,85,1,1,68,35,33,276,231,45,3
2021,Ealing 044A,E01001370,570,287,145,142,2,2,45,17,28,234,213,21,2
2021,Ealing 044B,E01001371,618,253,156,97,19,19,109,21,88,237,217,20,0
2021,Ealing 043C,E01001372,697,273,122,151,46,46,73,28,45,303,278,25,2
2021,Ealing 043A,E01001373,585,250,111,139,29,29,67,17,50,237,207,30,2
2021,Ealing 040A,E01001374,902,438,177,261,2,2,101,67,34,361,346,15,0
2021,Ealing 034A,E01001375,709,509,248,261,3,3,11,5,6,186,173,13,0
2021,Ealing 040B,E01001376,734,288,105,183,5,5,174,90,84,263,245,18,4
2021,Ealing 034B,E01001377,697,450,247,203,3,3,73,50,23,171,157,14,0
2021,Ealing 034C,E01001379,715,494,228,266,0,0,39,8,31,181,164,17,1
2021,Ealing 040C,E01001380,1058,574,219,355,26,26,103,41,62,355,346,9,0
2021,Ealing 034D,E01001381,857,372,148,224,9,9,66,11,55,410,387,23,0
2021,Ealing 032B,E01001382,563,449,243,206,0,0,10,1,9,104,96,8,0
2021,Ealing 028D,E01001383,648,421,200,221,0,0,31,7,24,196,178,18,0
2021,Ealing 032C,E01001384,700,411,168,243,0,0,36,7,29,253,239,14,0
2021,Ealing 032D,E01001385,668,434,237,197,7,7,16,5,11,211,200,11,0
2021,Ealing 031F,E01001386,754,472,238,234,0,0,42,18,24,238,222,16,2
2021,Ealing 032E,E01001387,725,279,146,133,4,4,105,76,29,337,318,19,0
2021,Ealing 028E,E01001388,669,184,86,98,24,24,266,53,213,195,173,22,0
2021,Ealing 028F,E01001389,761,319,140,179,10,10,123,28,95,306,280,26,3
2021,Enfield 036A,E01001390,713,430,231,199,1,1,11,7,4,269,253,16,2
2021,Enfield 036B,E01001391,733,269,143,126,6,6,48,17,31,410,382,28,0
2021,Enfield 032A,E01001392,668,461,257,204,5,5,27,6,21,174,156,18,1
2021,Enfield 036C,E01001393,820,395,197,198,6,6,34,13,21,385,367,18,0
2021,Enfield 035A,E01001394,671,301,168,133,16,16,99,44,55,252,238,14,3
2021,Enfield 035B,E01001395,599,216,123,93,5,5,227,80,147,146,135,11,5
2021,Enfield 036D,E01001396,524,293,189,104,4,4,19,10,9,208,190,18,0
2021,Enfield 035C,E01001397,766,359,174,185,8,8,113,25,88,286,274,12,0
2021,Enfield 021A,E01001398,500,420,207,213,3,3,5,3,2,72,64,8,0
2021,Enfield 021B,E01001399,500,413,224,189,0,0,12,6,6,75,67,8,0
2021,Enfield 021C,E01001400,575,496,308,188,1,1,7,2,5,71,65,6,0
2021,Enfield 016A,E01001401,500,400,195,205,2,2,13,12,1,85,74,11,0
2021,Enfield 021D,E01001402,699,525,268,257,2,2,9,4,5,163,153,10,0
2021,Enfield 021E,E01001403,641,492,283,209,1,1,31,17,14,116,100,16,1
2021,Enfield 026A,E01001404,515,383,195,188,2,2,45,38,7,85,77,8,0
2021,Enfield 015A,E01001405,832,536,334,202,4,4,52,21,31,236,224,12,4
2021,Enfield 015B,E01001406,651,345,139,206,2,2,94,63,31,209,198,11,1
2021,Enfield 005A,E01001407,593,415,188,227,2,2,73,60,13,102,91,11,1
2021,Enfield 004A,E01001408,709,502,209,293,4,4,54,44,10,147,134,13,2
2021,Enfield 005B,E01001409,782,370,149,221,6,6,162,64,98,244,229,15,0
2021,Enfield 005C,E01001410,815,210,86,124,57,57,353,210,143,190,180,10,5
2021,Enfield 004B,E01001411,741,516,238,278,4,4,79,36,43,141,126,15,1
2021,Enfield 004C,E01001412,660,401,216,185,4,4,133,102,31,121,90,31,1
2021,Enfield 004D,E01001413,609,513,274,239,2,2,39,30,9,55,49,6,0
2021,Enfield 004E,E01001414,693,206,100,106,20,20,373,337,36,89,79,10,5
2021,Enfield 011A,E01001415,871,493,228,265,42,42,126,86,40,208,186,22,2
2021,Enfield 013A,E01001416,592,512,272,240,0,0,17,2,15,63,55,8,0
2021,Enfield 011B,E01001417,668,576,300,276,0,0,12,8,4,79,65,14,1
2021,Enfield 011C,E01001418,720,444,242,202,6,6,107,64,43,163,144,19,0
2021,Enfield 020A,E01001419,768,445,259,186,5,5,54,46,8,263,241,22,1
2021,Enfield 020B,E01001420,635,320,156,164,6,6,164,158,6,143,129,14,2
2021,Enfield 020C,E01001421,621,316,172,144,6,6,72,56,16,227,208,19,0
2021,Enfield 011D,E01001422,617,524,308,216,2,2,3,1,2,88,77,11,0
2021,Enfield 027A,E01001423,624,267,121,146,2,2,170,133,37,180,160,20,5
2021,Enfield 030A,E01001424,478,82,21,61,9,9,224,29,195,161,157,4,2
2021,Enfield 027B,E01001425,739,160,83,77,6,6,274,107,167,293,283,10,6
2021,Enfield 030B,E01001426,620,228,106,122,5,5,192,175,17,189,174,15,6
2021,Enfield 030C,E01001427,640,146,75,71,10,10,303,285,18,170,154,16,11
2021,Enfield 027C,E01001428,565,228,105,123,3,3,164,121,43,168,158,10,2
2021,Enfield 030D,E01001429,1012,82,31,51,57,57,673,161,512,196,180,16,4
2021,Enfield 030E,E01001430,651,137,46,91,1,1,325,281,44,183,165,18,5
2021,Enfield 033A,E01001431,653,175,87,88,13,13,199,108,91,261,246,15,5
2021,Enfield 033B,E01001432,732,302,189,113,7,7,113,38,75,310,291,19,0
2021,Enfield 007A,E01001433,579,198,76,122,7,7,216,168,48,156,147,9,2
2021,Enfield 007B,E01001434,537,333,146,187,0,0,54,42,12,150,138,12,0
2021,Enfield 007C,E01001435,485,314,160,154,1,1,41,32,9,128,118,10,1
2021,Enfield 007D,E01001436,652,392,203,189,2,2,49,26,23,209,191,18,0
2021,Enfield 014A,E01001437,896,263,116,147,9,9,348,247,101,266,248,18,10
2021,Enfield 007E,E01001438,549,269,116,153,5,5,118,43,75,157,148,9,0
2021,Enfield 006A,E01001439,771,214,104,110,8,8,213,141,72,332,309,23,4
2021,Enfield 012A,E01001440,575,308,152,156,3,3,111,91,20,152,140,12,1
2021,Enfield 006B,E01001441,623,236,102,134,9,9,217,168,49,160,157,3,1
2021,Enfield 002A,E01001442,637,176,99,77,5,5,275,223,52,178,167,11,3
2021,Enfield 001A,E01001444,649,360,184,176,2,2,76,47,29,209,198,11,2
2021,Enfield 003B,E01001445,1140,418,151,267,162,162,174,56,118,383,364,19,3
2021,Enfield 001B,E01001446,707,352,179,173,16,16,90,39,51,249,228,21,0
2021,Enfield 003C,E01001447,741,225,116,109,19,19,284,182,102,212,195,17,1
2021,Enfield 003D,E01001448,663,299,133,166,2,2,146,109,37,215,207,8,1
2021,Enfield 003E,E01001449,545,276,112,164,16,16,98,69,29,155,146,9,0
2021,Enfield 015C,E01001450,1111,446,237,209,0,0,83,70,13,581,554,27,1
2021,Enfield 017A,E01001451,693,513,300,213,1,1,22,14,8,157,145,12,0
2021,Enfield 017B,E01001452,482,411,216,195,1,1,20,15,5,50,44,6,0
2021,Enfield 017C,E01001453,648,530,305,225,4,4,27,7,20,87,78,9,0
2021,Enfield 017D,E01001454,666,518,301,217,1,1,15,9,6,132,114,18,0
2021,Enfield 021F,E01001455,562,445,245,200,4,4,18,10,8,94,83,11,1
2021,Enfield 022A,E01001456,491,430,197,233,1,1,6,4,2,54,49,5,0
2021,Enfield 010A,E01001457,843,546,298,248,2,2,28,13,15,267,247,20,0
2021,Enfield 037A,E01001458,641,167,73,94,3,3,270,226,44,194,183,11,7
2021,Enfield 024A,E01001459,559,350,193,157,4,4,30,21,9,174,160,14,1
2021,Enfield 024B,E01001460,672,215,94,121,0,0,96,67,29,357,336,21,4
2021,Enfield 027D,E01001461,627,184,101,83,4,4,197,141,56,240,231,9,2
2021,Enfield 024C,E01001462,529,225,122,103,3,3,97,45,52,201,187,14,3
2021,Enfield 031A,E01001463,513,323,169,154,1,1,61,44,17,127,111,16,1
2021,Enfield 027E,E01001464,423,196,93,103,2,2,139,124,15,84,68,16,2
2021,Enfield 031B,E01001465,498,325,171,154,0,0,28,21,7,145,126,19,0
2021,Enfield 031C,E01001466,623,298,153,145,3,3,70,35,35,250,242,8,2
2021,Enfield 031D,E01001467,665,316,147,169,0,0,52,34,18,294,284,10,3
2021,Enfield 010B,E01001468,575,389,176,213,2,2,89,10,79,95,85,10,0
2021,Enfield 008A,E01001469,671,425,195,230,2,2,108,91,17,133,123,10,3
2021,Enfield 013B,E01001470,650,532,294,238,2,2,35,29,6,81,72,9,0
2021,Enfield 010C,E01001471,966,604,324,280,1,1,51,32,19,310,289,21,0
2021,Enfield 010D,E01001472,757,497,262,235,5,5,46,41,5,206,185,21,3
2021,Enfield 013C,E01001473,547,378,189,189,5,5,101,53,48,63,53,10,0
2021,Enfield 010E,E01001474,860,597,348,249,2,2,48,28,20,213,193,20,0
2021,Enfield 013D,E01001475,637,559,310,249,1,1,8,4,4,69,60,9,0
2021,Enfield 018A,E01001476,609,322,171,151,3,3,91,62,29,193,176,17,0
2021,Enfield 018B,E01001477,611,287,138,149,3,3,181,137,44,140,137,3,0
2021,Enfield 016B,E01001478,571,352,158,194,9,9,85,69,16,123,109,14,2
2021,Enfield 023A,E01001479,640,260,127,133,3,3,78,30,48,299,276,23,0
2021,Enfield 024D,E01001480,580,311,163,148,1,1,60,31,29,208,197,11,0
2021,Enfield 018C,E01001481,555,307,156,151,2,2,50,33,17,195,181,14,1
2021,Enfield 023B,E01001482,657,267,149,118,5,5,124,96,28,260,232,28,1
2021,Enfield 025A,E01001483,532,159,81,78,1,1,97,49,48,272,262,10,3
2021,Enfield 016C,E01001484,500,334,175,159,0,0,14,9,5,152,134,18,0
2021,Enfield 025B,E01001485,667,238,131,107,3,3,188,119,69,233,215,18,5
2021,Enfield 025C,E01001486,803,216,110,106,9,9,347,190,157,230,215,15,1
2021,Enfield 023C,E01001487,667,259,146,113,30,30,96,37,59,278,258,20,4
2021,Enfield 024E,E01001488,665,305,158,147,2,2,87,31,56,270,249,21,1
2021,Enfield 023D,E01001489,655,293,151,142,6,6,79,44,35,277,258,19,0
2021,Enfield 023E,E01001491,693,247,132,115,11,11,149,70,79,284,271,13,2
2021,Enfield 025E,E01001492,665,316,174,142,5,5,98,45,53,245,237,8,1
2021,Enfield 026B,E01001493,731,345,173,172,2,2,192,120,72,191,154,37,1
2021,Enfield 026C,E01001494,500,402,221,181,0,0,9,5,4,89,82,7,0
2021,Enfield 029A,E01001495,722,405,198,207,2,2,6,2,4,309,287,22,0
2021,Enfield 026D,E01001496,642,469,258,211,3,3,19,9,10,151,139,12,0
2021,Enfield 031E,E01001497,507,355,177,178,1,1,36,32,4,115,107,8,0
2021,Enfield 029B,E01001498,697,364,184,180,2,2,7,6,1,324,308,16,0
2021,Enfield 031F,E01001499,535,380,227,153,0,0,30,10,20,125,107,18,0
2021,Enfield 035D,E01001500,551,357,197,160,2,2,22,5,17,170,159,11,0
2021,Enfield 036E,E01001501,921,336,159,177,36,36,172,25,147,377,361,16,0
2021,Enfield 018D,E01001502,662,306,168,138,19,19,145,56,89,189,182,7,3
2021,Enfield 018E,E01001503,643,333,174,159,4,4,105,81,24,198,182,16,3
2021,Enfield 012B,E01001504,563,311,146,165,7,7,74,34,40,169,156,13,2
2021,Enfield 012C,E01001505,597,286,106,180,2,2,103,64,39,204,189,15,2
2021,Enfield 012D,E01001507,812,217,113,104,11,11,192,91,101,389,369,20,3
2021,Enfield 012E,E01001508,789,260,114,146,44,44,191,72,119,292,272,20,2
2021,Enfield 014C,E01001509,647,248,120,128,6,6,91,52,39,301,289,12,1
2021,Enfield 016D,E01001511,671,435,183,252,1,1,27,13,14,206,191,15,2
2021,Enfield 015D,E01001512,991,527,201,326,7,7,94,29,65,363,344,19,0
2021,Enfield 012F,E01001513,724,274,105,169,5,5,284,246,38,155,139,16,6
2021,Enfield 016E,E01001514,670,374,127,247,3,3,112,97,15,181,168,13,0
2021,Enfield 015E,E01001515,746,212,81,131,8,8,297,268,29,226,211,15,3
2021,Enfield 005D,E01001516,668,342,121,221,1,1,161,138,23,159,146,13,5
2021,Enfield 006C,E01001517,686,162,55,107,0,0,369,304,65,148,143,5,7
2021,Enfield 016F,E01001518,661,415,194,221,1,1,41,25,16,204,191,13,0
2021,Enfield 019A,E01001520,696,399,230,169,5,5,128,105,23,164,152,12,0
2021,Enfield 028A,E01001521,680,419,217,202,12,12,45,36,9,204,190,14,0
2021,Enfield 019B,E01001522,745,380,148,232,41,41,85,6,79,239,227,12,0
2021,Enfield 019C,E01001523,722,518,292,226,2,2,10,7,3,192,169,23,0
2021,Enfield 019D,E01001524,549,318,154,164,1,1,82,6,76,148,138,10,0
2021,Enfield 020E,E01001525,758,473,255,218,8,8,42,29,13,235,218,17,0
2021,Enfield 019E,E01001526,636,509,289,220,0,0,4,3,1,123,117,6,0
2021,Enfield 036F,E01001527,784,431,229,202,49,49,71,32,39,229,211,18,4
2021,Enfield 032B,E01001528,684,251,82,169,17,17,243,178,65,171,161,10,2
2021,Enfield 032C,E01001529,655,181,84,97,1,1,149,100,49,321,304,17,3
2021,Enfield 032D,E01001530,618,303,156,147,33,33,146,25,121,134,124,10,2
2021,Enfield 028B,E01001531,530,435,203,232,0,0,1,0,1,94,75,19,0
2021,Enfield 028C,E01001532,664,504,273,231,0,0,5,4,1,154,139,15,1
2021,Enfield 028D,E01001533,536,490,279,211,1,1,3,1,2,42,38,4,0
2021,Enfield 032E,E01001534,606,398,223,175,1,1,12,7,5,194,175,19,1
2021,Enfield 028E,E01001535,497,388,229,159,1,1,18,10,8,90,71,19,0
2021,Enfield 008B,E01001536,847,479,237,242,4,4,123,86,37,239,215,24,2
2021,Enfield 005E,E01001537,689,435,213,222,2,2,24,19,5,228,221,7,0
2021,Enfield 009A,E01001538,596,527,286,241,2,2,22,6,16,45,37,8,0
2021,Enfield 009B,E01001539,642,507,251,256,3,3,36,27,9,96,86,10,0
2021,Enfield 008C,E01001540,798,489,251,238,1,1,23,12,11,285,262,23,0
2021,Enfield 008D,E01001541,645,501,219,282,19,19,18,12,6,107,100,7,0
2021,Enfield 008E,E01001542,655,334,162,172,9,9,142,92,50,170,153,17,0
2021,Enfield 009C,E01001543,584,500,251,249,0,0,20,9,11,64,59,5,0
2021,Enfield 009D,E01001544,643,520,296,224,1,1,9,4,5,113,99,14,0
2021,Enfield 002B,E01001545,664,168,67,101,10,10,332,216,116,148,131,17,6
2021,Enfield 001C,E01001546,614,309,154,155,1,1,123,56,67,177,163,14,4
2021,Enfield 002C,E01001547,724,368,199,169,8,8,114,61,53,232,211,21,2
2021,Enfield 002D,E01001548,674,301,137,164,13,13,166,117,49,194,186,8,0
2021,Enfield 006D,E01001549,813,209,97,112,3,3,263,194,69,333,324,9,5
2021,Enfield 006E,E01001550,577,274,116,158,3,3,162,113,49,132,131,1,6
2021,Enfield 002E,E01001551,641,255,134,121,4,4,238,167,71,142,100,42,2
2021,Enfield 001D,E01001552,662,408,210,198,1,1,80,60,20,173,153,20,0
2021,Enfield 037B,E01001553,545,207,89,118,2,2,189,160,29,137,128,9,10
2021,Enfield 037C,E01001554,685,139,54,85,2,2,391,336,55,141,130,11,12
2021,Enfield 033C,E01001555,774,300,137,163,6,6,114,55,59,353,337,16,1
2021,Enfield 035E,E01001556,531,375,209,166,0,0,33,25,8,119,104,15,4
2021,Enfield 033D,E01001557,548,272,129,143,2,2,101,83,18,171,156,15,2
2021,Enfield 033E,E01001558,605,158,77,81,2,2,181,158,23,261,233,28,3
2021,Enfield 033F,E01001559,672,276,135,141,7,7,118,63,55,270,259,11,1
2021,Enfield 035F,E01001560,512,277,153,124,0,0,107,54,53,128,112,16,0
2021,Enfield 037D,E01001562,824,95,29,66,35,35,442,93,349,246,239,7,6
2021,Enfield 029C,E01001563,701,400,159,241,3,3,18,9,9,280,264,16,0
2021,Enfield 022B,E01001564,640,463,217,246,1,1,20,14,6,156,140,16,0
2021,Enfield 029D,E01001565,708,430,225,205,7,7,88,9,79,183,154,29,0
2021,Enfield 029E,E01001566,627,433,182,251,1,1,18,10,8,175,165,10,0
2021,Enfield 022C,E01001567,606,510,279,231,0,0,19,6,13,76,72,4,1
2021,Enfield 022D,E01001568,567,528,264,264,1,1,4,2,2,34,24,10,0
2021,Enfield 022E,E01001569,750,399,200,199,2,2,58,51,7,291,267,24,0
2021,Enfield 026E,E01001570,725,455,217,238,2,2,89,62,27,178,169,9,1
2021,Greenwich 008A,E01001571,628,331,142,189,0,0,74,55,19,223,198,25,0
2021,Greenwich 008B,E01001572,652,355,173,182,2,2,84,30,54,210,195,15,1
2021,Greenwich 008C,E01001573,526,334,170,164,1,1,68,54,14,123,115,8,0
2021,Greenwich 008D,E01001574,749,195,80,115,3,3,431,407,24,114,109,5,6
2021,Greenwich 003A,E01001575,622,214,75,139,2,2,311,271,40,94,85,9,1
2021,Greenwich 003B,E01001576,670,197,64,133,2,2,352,310,42,116,113,3,3
2021,Greenwich 003C,E01001577,729,243,84,159,5,5,324,283,41,156,138,18,1
2021,Greenwich 003D,E01001578,850,316,130,186,7,7,219,134,85,306,290,16,2
2021,Greenwich 003E,E01001579,625,228,86,142,3,3,283,249,34,108,100,8,3
2021,Greenwich 021A,E01001580,793,393,180,213,0,0,72,51,21,326,317,9,2
2021,Greenwich 016A,E01001581,729,303,96,207,17,17,218,125,93,189,177,12,2
2021,Greenwich 021B,E01001582,662,331,155,176,0,0,202,142,60,128,113,15,1
2021,Greenwich 021C,E01001583,767,353,173,180,5,5,143,69,74,266,243,23,0
2021,Greenwich 021D,E01001584,664,395,198,197,1,1,67,53,14,201,186,15,0
2021,Greenwich 016B,E01001585,601,363,141,222,1,1,109,75,34,127,120,7,1
2021,Greenwich 016C,E01001586,663,306,150,156,2,2,242,184,58,113,105,8,0
2021,Greenwich 016D,E01001587,950,466,217,249,67,67,171,125,46,245,235,10,1
2021,Greenwich 012A,E01001588,639,235,97,138,1,1,295,276,19,105,91,14,3
2021,Greenwich 012B,E01001589,675,230,101,129,1,1,271,200,71,171,156,15,2
2021,Greenwich 014A,E01001590,715,368,147,221,3,3,156,45,111,187,167,20,1
2021,Greenwich 012C,E01001591,808,200,63,137,4,4,464,226,238,135,124,11,5
2021,Greenwich 014B,E01001592,736,438,155,283,7,7,98,60,38,193,172,21,0
2021,Greenwich 014C,E01001593,765,509,229,280,2,2,102,76,26,152,139,13,0
2021,Greenwich 014D,E01001594,836,174,53,121,21,21,478,100,378,163,114,49,0
2021,Greenwich 012D,E01001595,732,222,101,121,19,19,404,78,326,86,77,9,1
2021,Greenwich 032A,E01001596,638,549,249,300,4,4,16,11,5,69,56,13,0
2021,Greenwich 031A,E01001597,633,431,217,214,2,2,85,31,54,115,104,11,0
2021,Greenwich 031B,E01001598,606,479,244,235,3,3,51,45,6,73,66,7,0
2021,Greenwich 032B,E01001599,602,413,194,219,5,5,129,114,15,52,46,6,3
2021,Greenwich 032C,E01001600,638,412,197,215,2,2,77,53,24,144,125,19,3
2021,Greenwich 032D,E01001601,567,444,212,232,1,1,70,25,45,52,43,9,0
2021,Greenwich 031C,E01001602,714,351,136,215,1,1,305,275,30,55,51,4,2
2021,Greenwich 031D,E01001603,739,275,104,171,2,2,395,374,21,64,53,11,3
2021,Greenwich 027A,E01001604,599,410,204,206,3,3,66,30,36,120,112,8,0
2021,Greenwich 023A,E01001605,567,514,263,251,1,1,20,12,8,32,26,6,0
2021,Greenwich 023B,E01001606,610,523,232,291,6,6,17,15,2,64,55,9,0
2021,Greenwich 027B,E01001607,669,406,192,214,17,17,167,30,137,78,70,8,1
2021,Greenwich 027C,E01001608,582,432,220,212,2,2,89,49,40,59,57,2,0
2021,Greenwich 027D,E01001609,740,410,221,189,4,4,198,171,27,125,106,19,3
2021,Greenwich 023C,E01001610,704,510,241,269,2,2,104,19,85,88,79,9,0
2021,Greenwich 023D,E01001611,711,406,177,229,3,3,214,117,97,86,75,11,2
2021,Greenwich 028A,E01001613,799,418,219,199,8,8,188,173,15,182,163,19,3
2021,Greenwich 028B,E01001614,547,487,257,230,1,1,26,15,11,32,27,5,1
2021,Greenwich 028C,E01001615,938,409,188,221,16,16,205,144,61,307,286,21,1
2021,Greenwich 028D,E01001617,734,552,322,230,8,8,51,37,14,123,108,15,0
2021,Greenwich 030C,E01001618,757,448,163,285,16,16,212,89,123,81,69,12,0
2021,Greenwich 030D,E01001619,828,483,201,282,36,36,95,16,79,214,196,18,0
2021,Greenwich 025A,E01001620,504,244,100,144,0,0,197,180,17,63,48,15,0
2021,Greenwich 025B,E01001621,666,280,109,171,46,46,251,217,34,86,79,7,3
2021,Greenwich 025C,E01001623,668,279,89,190,16,16,244,198,46,128,117,11,1
2021,Greenwich 025D,E01001624,626,331,129,202,9,9,235,128,107,50,44,6,1
2021,Greenwich 025E,E01001625,619,256,104,152,1,1,303,279,24,58,53,5,1
2021,Greenwich 009A,E01001629,838,192,61,131,15,15,431,346,85,199,191,8,1
2021,Greenwich 007B,E01001631,787,114,53,61,6,6,540,338,202,121,111,10,6
2021,Greenwich 007C,E01001632,662,244,122,122,5,5,135,28,107,278,251,27,0
2021,Greenwich 009B,E01001633,778,173,65,108,2,2,430,391,39,170,160,10,3
2021,Greenwich 009C,E01001634,657,127,47,80,10,10,447,416,31,68,57,11,5
2021,Greenwich 007D,E01001635,641,348,134,214,2,2,122,40,82,168,149,19,1
2021,Greenwich 007E,E01001636,604,244,109,135,2,2,130,62,68,225,211,14,3
2021,Greenwich 009D,E01001637,689,287,110,177,3,3,185,97,88,213,199,14,1
2021,Greenwich 038A,E01001638,680,109,32,77,2,2,430,339,91,133,120,13,6
2021,Greenwich 038B,E01001641,816,327,126,201,2,2,265,140,125,222,199,23,0
2021,Greenwich 038C,E01001642,757,490,240,250,2,2,99,39,60,166,151,15,0
2021,Greenwich 038D,E01001644,1179,507,197,310,25,25,179,109,70,468,443,25,0
2021,Greenwich 022A,E01001645,704,368,146,222,0,0,240,218,22,96,89,7,0
2021,Greenwich 019A,E01001646,1129,349,75,274,24,24,398,158,240,358,341,17,0
2021,Greenwich 022B,E01001647,568,387,186,201,2,2,104,97,7,74,70,4,1
2021,Greenwich 022C,E01001648,697,419,159,260,2,2,117,111,6,158,153,5,1
2021,Greenwich 022D,E01001649,575,303,98,205,6,6,206,169,37,60,51,9,0
2021,Greenwich 019B,E01001650,610,300,133,167,2,2,224,190,34,84,72,12,0
2021,Greenwich 019C,E01001651,743,270,101,169,3,3,367,354,13,100,90,10,3
2021,Greenwich 019D,E01001652,707,379,169,210,2,2,145,128,17,181,168,13,0
2021,Greenwich 029A,E01001653,598,193,60,133,1,1,337,325,12,63,54,9,4
2021,Greenwich 029B,E01001654,569,240,99,141,5,5,257,233,24,66,59,7,1
2021,Greenwich 029C,E01001655,632,185,55,130,2,2,368,321,47,74,65,9,3
2021,Greenwich 034A,E01001656,587,313,170,143,3,3,174,165,9,97,85,12,0
2021,Greenwich 034B,E01001657,704,414,208,206,7,7,128,113,15,155,142,13,0
2021,Greenwich 034C,E01001658,731,401,204,197,6,6,138,104,34,185,166,19,1
2021,Greenwich 034D,E01001659,553,399,217,182,1,1,89,81,8,64,58,6,0
2021,Greenwich 029D,E01001660,564,272,117,155,4,4,233,169,64,51,45,6,4
2021,Greenwich 029E,E01001661,578,311,133,178,1,1,188,177,11,74,63,11,4
2021,Greenwich 037B,E01001664,885,338,129,209,7,7,241,159,82,299,276,23,0
2021,Greenwich 037C,E01001665,772,347,128,219,17,17,161,120,41,247,232,15,0
2021,Greenwich 041G,E01001666,743,354,85,269,0,0,236,183,53,151,135,16,2
2021,Greenwich 033A,E01001669,915,310,149,161,37,37,390,179,211,175,130,45,3
2021,Greenwich 033B,E01001671,683,387,161,226,1,1,149,114,35,146,138,8,0
2021,Greenwich 006A,E01001672,642,227,92,135,0,0,136,102,34,278,253,25,1
2021,Greenwich 006B,E01001673,801,189,95,94,4,4,278,172,106,320,294,26,10
2021,Greenwich 006C,E01001674,711,341,143,198,1,1,120,64,56,242,224,18,7
2021,Greenwich 006D,E01001675,700,240,101,139,3,3,165,58,107,291,243,48,1
2021,Greenwich 033C,E01001676,674,184,71,113,9,9,301,233,68,179,168,11,1
2021,Greenwich 006E,E01001677,729,300,117,183,6,6,152,74,78,270,255,15,1
2021,Greenwich 017A,E01001678,647,421,188,233,6,6,84,64,20,135,124,11,1
2021,Greenwich 020A,E01001679,556,381,156,225,0,0,95,25,70,80,70,10,0
2021,Greenwich 020B,E01001680,616,483,263,220,1,1,28,22,6,103,92,11,1
2021,Greenwich 020C,E01001681,527,296,135,161,2,2,92,43,49,135,131,4,2
2021,Greenwich 020D,E01001682,551,367,191,176,10,10,100,48,52,72,67,5,2
2021,Greenwich 017B,E01001683,598,281,126,155,2,2,173,90,83,138,112,26,4
2021,Greenwich 017C,E01001684,567,293,138,155,1,1,193,94,99,79,72,7,1
2021,Greenwich 017D,E01001685,652,378,192,186,5,5,139,90,49,130,120,10,0
2021,Greenwich 020E,E01001686,751,288,107,181,3,3,216,150,66,239,230,9,5
2021,Greenwich 002A,E01001687,513,166,68,98,7,7,210,31,179,128,118,10,2
2021,Greenwich 002B,E01001688,935,298,82,216,28,28,282,70,212,323,314,9,4
2021,Greenwich 001A,E01001690,814,144,62,82,37,37,560,46,514,69,60,9,4
2021,Greenwich 001B,E01001692,558,92,34,58,4,4,397,59,338,64,55,9,1
2021,Greenwich 001C,E01001693,613,77,28,49,4,4,480,66,414,52,47,5,0
2021,Greenwich 001D,E01001694,613,255,97,158,1,1,192,36,156,162,150,12,3
2021,Greenwich 011A,E01001695,561,142,56,86,2,2,289,263,26,128,118,10,0
2021,Greenwich 011B,E01001696,1146,282,42,240,103,103,440,132,308,320,310,10,1
2021,Greenwich 011C,E01001697,936,215,103,112,22,22,283,134,149,415,393,22,1
2021,Greenwich 015A,E01001698,755,167,46,121,3,3,396,347,49,187,172,15,2
2021,Greenwich 015B,E01001699,664,154,15,139,11,11,293,186,107,205,136,69,1
2021,Greenwich 011D,E01001700,797,203,79,124,27,27,256,178,78,310,290,20,1
2021,Greenwich 015C,E01001701,774,230,60,170,25,25,234,150,84,281,179,102,4
2021,Greenwich 015D,E01001702,441,101,29,72,3,3,282,259,23,54,48,6,1
2021,Greenwich 011E,E01001703,763,118,30,88,7,7,509,480,29,127,117,10,2
2021,Greenwich 011F,E01001704,619,298,128,170,3,3,152,61,91,165,151,14,1
2021,Greenwich 005A,E01001705,847,160,39,121,32,32,461,314,147,193,184,9,1
2021,Greenwich 005C,E01001708,687,360,142,218,3,3,191,143,48,133,123,10,0
2021,Greenwich 005D,E01001710,651,68,27,41,2,2,478,398,80,96,83,13,7
2021,Greenwich 042A,E01001712,911,153,45,108,5,5,542,462,80,205,196,9,6
2021,Hackney 002A,E01001714,856,155,55,100,43,43,346,206,140,308,293,15,4
2021,Hackney 007A,E01001715,658,163,63,100,1,1,115,23,92,379,363,16,0
2021,Hackney 007B,E01001716,838,141,61,80,28,28,398,231,167,257,241,16,14
2021,Hackney 007C,E01001717,427,136,63,73,23,23,149,13,136,118,113,5,1
2021,Hackney 007D,E01001718,825,300,121,179,3,3,72,31,41,448,437,11,2
2021,Hackney 007E,E01001719,699,216,36,180,42,42,328,254,74,107,99,8,6
2021,Hackney 007F,E01001720,789,285,102,183,0,0,122,24,98,382,362,20,0
2021,Hackney 029A,E01001722,924,178,70,108,11,11,462,137,325,272,259,13,1
2021,Hackney 006A,E01001723,683,223,117,106,1,1,158,47,111,300,279,21,1
2021,Hackney 006B,E01001724,1071,252,89,163,47,47,199,35,164,571,547,24,2
2021,Hackney 004A,E01001725,565,152,91,61,4,4,180,49,131,227,219,8,2
2021,Hackney 004B,E01001726,462,72,28,44,1,1,268,61,207,121,116,5,0
2021,Hackney 006C,E01001727,561,206,127,79,2,2,146,54,92,206,194,12,1
2021,Hackney 029B,E01001728,587,87,45,42,0,0,274,89,185,225,201,24,1
2021,Hackney 019A,E01001729,498,74,19,55,31,31,244,147,97,149,140,9,0
2021,Hackney 019B,E01001730,1130,165,40,125,73,73,721,430,291,166,156,10,5
2021,Hackney 017A,E01001731,1156,216,81,135,32,32,487,269,218,420,402,18,1
2021,Hackney 019C,E01001732,756,118,30,88,42,42,490,147,343,105,96,9,1
2021,Hackney 015A,E01001733,735,281,117,164,14,14,138,61,77,302,292,10,0
2021,Hackney 017B,E01001734,851,204,78,126,6,6,243,155,88,397,379,18,1
2021,Hackney 019D,E01001735,654,214,94,120,4,4,280,188,92,153,144,9,3
2021,Hackney 012A,E01001736,679,257,105,152,9,9,154,76,78,258,243,15,1
2021,Hackney 012B,E01001737,706,302,109,193,14,14,165,70,95,223,213,10,2
2021,Hackney 012C,E01001738,791,298,89,209,4,4,228,163,65,261,246,15,0
2021,Hackney 012D,E01001739,886,419,177,242,10,10,185,92,93,271,257,14,1
2021,Hackney 014A,E01001740,630,133,27,106,25,25,385,309,76,86,79,7,1
2021,Hackney 009A,E01001741,576,312,134,178,1,1,106,59,47,156,148,8,1
2021,Hackney 008A,E01001742,782,241,77,164,26,26,350,166,184,163,148,15,2
2021,Hackney 031A,E01001744,815,237,91,146,9,9,365,242,123,202,191,11,2
2021,Hackney 016A,E01001745,914,171,77,94,22,22,501,171,330,218,212,6,2
2021,Hackney 016B,E01001746,599,53,11,42,12,12,478,173,305,51,43,8,5
2021,Hackney 014B,E01001747,1074,320,105,215,36,36,273,158,115,445,404,41,0
2021,Hackney 020B,E01001749,664,265,116,149,16,16,193,41,152,190,175,15,0
2021,Hackney 031D,E01001750,926,228,82,146,36,36,366,244,122,290,279,11,6
2021,Hackney 031B,E01001751,647,339,160,179,10,10,73,18,55,225,214,11,0
2021,Hackney 025B,E01001753,626,73,35,38,17,17,449,424,25,86,78,8,1
2021,Hackney 025D,E01001755,690,97,36,61,21,21,387,178,209,183,176,7,2
2021,Hackney 030C,E01001756,957,332,131,201,5,5,200,98,102,417,394,23,3
2021,Hackney 016C,E01001757,608,86,34,52,8,8,432,96,336,82,75,7,0
2021,Hackney 016D,E01001758,1081,190,50,140,26,26,564,127,437,298,282,16,3
2021,Hackney 016E,E01001759,725,198,75,123,9,9,330,166,164,188,169,19,0
2021,Hackney 017C,E01001760,869,207,81,126,17,17,312,100,212,333,319,14,0
2021,Hackney 016F,E01001761,925,165,54,111,26,26,533,80,453,199,186,13,2
2021,Hackney 017D,E01001762,799,205,66,139,19,19,244,92,152,329,318,11,2
2021,Hackney 020C,E01001763,813,209,93,116,11,11,381,157,224,212,198,14,0
2021,Hackney 010A,E01001764,670,186,60,126,18,18,314,148,166,151,139,12,1
2021,Hackney 010B,E01001765,751,79,23,56,10,10,530,340,190,127,121,6,5
2021,Hackney 010D,E01001767,629,235,85,150,2,2,193,102,91,198,184,14,1
2021,Hackney 006D,E01001768,748,270,108,162,25,25,148,61,87,305,274,31,0
2021,Hackney 006E,E01001769,634,200,75,125,1,1,238,78,160,195,180,15,0
2021,Hackney 010E,E01001770,771,176,62,114,17,17,375,265,110,201,193,8,2
2021,Hackney 024A,E01001772,769,119,35,84,32,32,462,220,242,152,136,16,4
2021,Hackney 025E,E01001773,1043,146,45,101,110,110,435,274,161,350,339,11,2
2021,Hackney 024B,E01001774,852,182,47,135,7,7,308,247,61,353,330,23,2
2021,Hackney 024C,E01001775,706,95,26,69,7,7,457,340,117,147,132,15,0
2021,Hackney 025F,E01001776,752,84,34,50,53,53,453,262,191,161,147,14,1
2021,Hackney 033A,E01001777,1145,142,42,100,40,40,434,396,38,524,508,16,5
2021,Hackney 032D,E01001780,848,112,54,58,19,19,524,413,111,190,176,14,3
2021,Hackney 026B,E01001781,684,82,25,57,4,4,457,405,52,140,131,9,1
2021,Hackney 026D,E01001783,668,72,27,45,6,6,467,435,32,119,111,8,4
2021,Hackney 032A,E01001784,756,144,68,76,9,9,392,364,28,208,191,17,3
2021,Hackney 015B,E01001785,585,252,116,136,1,1,197,98,99,135,128,7,0
2021,Hackney 013A,E01001786,840,163,38,125,6,6,523,122,401,145,130,15,3
2021,Hackney 013B,E01001787,650,123,51,72,5,5,429,345,84,90,87,3,3
2021,Hackney 013C,E01001788,647,93,55,38,1,1,451,248,203,100,88,12,2
2021,Hackney 015C,E01001789,625,274,100,174,3,3,226,105,121,122,113,9,0
2021,Hackney 013D,E01001790,585,66,27,39,2,2,412,132,280,105,97,8,0
2021,Hackney 015D,E01001791,494,189,69,120,4,4,219,136,83,81,76,5,1
2021,Hackney 011A,E01001792,712,304,176,128,11,11,221,138,83,175,161,14,1
2021,Hackney 011B,E01001793,605,257,106,151,11,11,151,75,76,186,175,11,0
2021,Hackney 011C,E01001794,644,302,137,165,15,15,110,23,87,216,197,19,1
2021,Hackney 011D,E01001795,515,217,101,116,7,7,100,40,60,190,176,14,1
2021,Hackney 011E,E01001796,634,209,70,139,4,4,163,43,120,257,239,18,1
2021,Hackney 028A,E01001798,728,137,52,85,2,2,329,192,137,259,246,13,1
2021,Hackney 003A,E01001799,449,130,60,70,7,7,94,47,47,218,203,15,0
2021,Hackney 004C,E01001800,661,45,21,24,14,14,400,90,310,198,185,13,4
2021,Hackney 008B,E01001801,547,136,66,70,16,16,264,45,219,130,119,11,1
2021,Hackney 003B,E01001802,459,119,60,59,10,10,209,118,91,118,109,9,3
2021,Hackney 008C,E01001803,684,315,142,173,6,6,107,53,54,255,242,13,1
2021,Hackney 003C,E01001804,459,147,64,83,4,4,105,83,22,202,192,10,1
2021,Hackney 009B,E01001805,508,164,70,94,5,5,141,73,68,198,186,12,0
2021,Hackney 008D,E01001806,674,231,104,127,9,9,275,216,59,157,145,12,2
2021,Hackney 003D,E01001807,651,116,54,62,3,3,229,125,104,302,289,13,1
2021,Hackney 001A,E01001808,544,112,67,45,1,1,118,16,102,313,294,19,0
2021,Hackney 001B,E01001809,569,142,81,61,6,6,171,34,137,250,230,20,0
2021,Hackney 002D,E01001811,672,75,35,40,17,17,367,224,143,212,200,12,1
2021,Hackney 003E,E01001812,565,101,61,40,3,3,230,111,119,231,223,8,0
2021,Hackney 002E,E01001813,793,46,16,30,37,37,538,397,141,164,130,34,8
2021,Hackney 001C,E01001814,551,132,64,68,50,50,93,40,53,276,255,21,0
2021,Hackney 024D,E01001815,668,169,75,94,2,2,408,283,125,89,82,7,0
2021,Hackney 020D,E01001816,617,257,112,145,14,14,225,181,44,121,104,17,0
2021,Hackney 020E,E01001819,746,251,113,138,4,4,378,190,188,112,98,14,1
2021,Hackney 024E,E01001820,573,123,52,71,1,1,358,322,36,90,82,8,1
2021,Hackney 024F,E01001821,584,97,42,55,5,5,407,356,51,73,66,7,2
2021,Hackney 029C,E01001822,676,98,42,56,5,5,341,247,94,229,205,24,3
2021,Hackney 001D,E01001823,520,136,74,62,36,36,145,83,62,201,187,14,2
2021,Hackney 004D,E01001824,504,100,57,43,8,8,255,163,92,139,122,17,2
2021,Hackney 001E,E01001825,402,139,95,44,2,2,48,18,30,213,164,49,0
2021,Hackney 004E,E01001826,524,98,57,41,9,9,238,163,75,178,166,12,1
2021,Hackney 029D,E01001827,596,113,57,56,1,1,330,185,145,152,143,9,0
2021,Hackney 028B,E01001828,815,172,67,105,19,19,458,227,231,165,156,9,1
2021,Hackney 009C,E01001829,662,402,178,224,8,8,65,28,37,187,174,13,0
2021,Hackney 014C,E01001830,895,142,50,92,3,3,443,183,260,305,284,21,2
2021,Hackney 009D,E01001831,786,218,88,130,4,4,179,116,63,383,361,22,2
2021,Hackney 009E,E01001832,623,223,94,129,3,3,162,39,123,235,225,10,0
2021,Hackney 014D,E01001833,922,282,106,176,6,6,344,130,214,287,267,20,3
2021,Hackney 014E,E01001834,806,219,90,129,5,5,255,128,127,325,305,20,2
2021,Hackney 014F,E01001835,491,247,87,160,5,5,87,50,37,151,139,12,1
2021,Hackney 022A,E01001836,812,169,61,108,15,15,400,130,270,227,209,18,1
2021,Hackney 023B,E01001837,638,237,113,124,7,7,198,16,182,196,175,21,0
2021,Hackney 019E,E01001838,696,95,31,64,18,18,510,370,140,71,66,5,2
2021,Hackney 023C,E01001839,1039,204,54,150,24,24,307,213,94,499,465,34,5
2021,Hackney 022B,E01001840,660,128,55,73,10,10,413,296,117,104,95,9,5
2021,Hackney 022C,E01001841,632,199,105,94,14,14,325,94,231,92,85,7,2
2021,Hackney 023D,E01001842,643,129,40,89,2,2,368,125,243,142,131,11,2
2021,Hackney 023E,E01001843,478,137,58,79,9,9,235,33,202,97,88,9,0
2021,Hackney 022D,E01001844,708,233,93,140,8,8,271,49,222,194,182,12,2
2021,Hackney 022E,E01001845,725,85,26,59,6,6,561,119,442,71,66,5,2
2021,Hackney 018A,E01001846,538,94,34,60,26,26,333,234,99,83,76,7,2
2021,Hackney 018B,E01001847,556,120,41,79,12,12,246,121,125,178,171,7,0
2021,Hackney 018C,E01001848,697,167,67,100,23,23,369,141,228,138,122,16,0
2021,Hackney 018D,E01001849,1017,268,62,206,70,70,303,76,227,372,341,31,4
2021,Hackney 019F,E01001850,707,85,40,45,2,2,495,460,35,123,114,9,2
2021,Hammersmith and Fulham 010A,E01001851,647,308,128,180,0,0,107,39,68,231,215,16,1
2021,Hammersmith and Fulham 007A,E01001852,922,263,99,164,8,8,167,29,138,484,459,25,0
2021,Hammersmith and Fulham 007B,E01001853,665,273,117,156,0,0,125,40,85,267,255,12,0
2021,Hammersmith and Fulham 007C,E01001854,884,271,118,153,7,7,192,93,99,412,383,29,2
2021,Hammersmith and Fulham 010B,E01001855,884,282,139,143,3,3,162,45,117,436,417,19,1
2021,Hammersmith and Fulham 010C,E01001856,725,166,90,76,6,6,274,71,203,279,268,11,0
2021,Hammersmith and Fulham 007D,E01001857,781,119,72,47,5,5,401,336,65,248,235,13,8
2021,Hammersmith and Fulham 006A,E01001858,724,186,86,100,16,16,270,99,171,250,227,23,2
2021,Hammersmith and Fulham 008A,E01001859,1149,330,130,200,111,111,365,182,183,343,323,20,0
2021,Hammersmith and Fulham 006B,E01001860,773,150,68,82,17,17,322,139,183,283,275,8,1
2021,Hammersmith and Fulham 006C,E01001861,627,164,71,93,8,8,247,92,155,206,199,7,2
2021,Hammersmith and Fulham 005A,E01001862,837,211,72,139,4,4,362,150,212,257,239,18,3
2021,Hammersmith and Fulham 006D,E01001863,628,250,107,143,13,13,151,25,126,214,198,16,0
2021,Hammersmith and Fulham 006E,E01001864,695,224,110,114,11,11,192,89,103,266,251,15,2
2021,Hammersmith and Fulham 008B,E01001865,668,360,140,220,4,4,100,11,89,204,189,15,0
2021,Hammersmith and Fulham 012A,E01001866,656,252,151,101,6,6,95,35,60,303,279,24,0
2021,Hammersmith and Fulham 012B,E01001867,537,178,115,63,2,2,93,81,12,261,244,17,3
2021,Hammersmith and Fulham 012C,E01001868,593,80,38,42,2,2,367,168,199,139,133,6,5
2021,Hammersmith and Fulham 010D,E01001869,588,248,139,109,2,2,138,46,92,200,176,24,0
2021,Hammersmith and Fulham 012D,E01001870,909,241,115,126,5,5,123,39,84,540,517,23,0
2021,Hammersmith and Fulham 012E,E01001871,702,266,165,101,3,3,89,46,43,344,320,24,0
2021,Hammersmith and Fulham 012F,E01001872,713,224,104,120,7,7,152,61,91,328,300,28,2
2021,Hammersmith and Fulham 010E,E01001873,708,189,95,94,0,0,254,143,111,262,243,19,3
2021,Hammersmith and Fulham 001B,E01001875,654,151,84,67,0,0,343,84,259,159,150,9,1
2021,Hammersmith and Fulham 001C,E01001876,811,110,54,56,26,26,582,148,434,93,81,12,0
2021,Hammersmith and Fulham 001D,E01001877,610,181,96,85,60,60,167,31,136,202,192,10,0
2021,Hammersmith and Fulham 001E,E01001878,591,144,87,57,1,1,338,42,296,107,96,11,1
2021,Hammersmith and Fulham 019A,E01001879,631,212,110,102,4,4,208,63,145,203,187,16,4
2021,Hammersmith and Fulham 017A,E01001880,745,165,74,91,22,22,275,43,232,283,258,25,0
2021,Hammersmith and Fulham 017B,E01001881,820,314,154,160,5,5,109,40,69,391,354,37,1
2021,Hammersmith and Fulham 017C,E01001882,710,306,125,181,3,3,83,22,61,318,286,32,0
2021,Hammersmith and Fulham 017D,E01001883,945,260,111,149,12,12,243,154,89,429,400,29,1
2021,Hammersmith and Fulham 017E,E01001884,916,166,79,87,16,16,439,144,295,294,273,21,1
2021,Hammersmith and Fulham 015A,E01001885,517,62,35,27,0,0,383,334,49,71,68,3,1
2021,Hammersmith and Fulham 016A,E01001886,629,196,98,98,6,6,236,174,62,189,167,22,2
2021,Hammersmith and Fulham 016B,E01001887,637,153,71,82,3,3,280,188,92,199,192,7,2
2021,Hammersmith and Fulham 018A,E01001888,614,331,146,185,10,10,89,42,47,184,164,20,0
2021,Hammersmith and Fulham 014A,E01001889,577,259,120,139,6,6,110,45,65,201,181,20,1
2021,Hammersmith and Fulham 016C,E01001890,740,173,76,97,4,4,255,70,185,307,281,26,1
2021,Hammersmith and Fulham 018B,E01001891,1154,448,208,240,22,22,68,33,35,616,564,52,0
2021,Hammersmith and Fulham 016D,E01001892,581,147,57,90,3,3,301,227,74,130,117,13,0
2021,Hammersmith and Fulham 013A,E01001893,641,136,70,66,4,4,298,203,95,201,188,13,2
2021,Hammersmith and Fulham 013B,E01001894,705,157,87,70,4,4,249,144,105,289,265,24,6
2021,Hammersmith and Fulham 009A,E01001895,643,249,110,139,2,2,185,44,141,205,191,14,2
2021,Hammersmith and Fulham 009B,E01001896,706,188,82,106,17,17,230,55,175,270,239,31,1
2021,Hammersmith and Fulham 009C,E01001897,558,247,132,115,2,2,154,25,129,155,145,10,0
2021,Hammersmith and Fulham 013C,E01001898,951,290,110,180,20,20,169,57,112,471,428,43,1
2021,Hammersmith and Fulham 013D,E01001899,792,117,58,59,13,13,422,273,149,237,224,13,3
2021,Hammersmith and Fulham 013E,E01001900,720,135,71,64,1,1,349,54,295,232,208,24,3
2021,Hammersmith and Fulham 019B,E01001901,683,324,141,183,3,3,101,44,57,255,236,19,0
2021,Hammersmith and Fulham 019C,E01001902,805,235,100,135,3,3,181,60,121,386,356,30,0
2021,Hammersmith and Fulham 019D,E01001903,594,217,102,115,2,2,157,76,81,218,197,21,0
2021,Hammersmith and Fulham 022A,E01001904,711,358,163,195,6,6,55,36,19,288,267,21,4
2021,Hammersmith and Fulham 022B,E01001905,708,302,132,170,8,8,95,24,71,302,281,21,1
2021,Hammersmith and Fulham 022C,E01001906,624,274,124,150,2,2,89,51,38,258,240,18,1
2021,Hammersmith and Fulham 022D,E01001907,544,273,136,137,2,2,66,27,39,203,194,9,0
2021,Hammersmith and Fulham 015B,E01001908,763,196,86,110,7,7,121,34,87,439,412,27,0
2021,Hammersmith and Fulham 015C,E01001909,861,237,99,138,11,11,256,158,98,356,327,29,1
2021,Hammersmith and Fulham 014B,E01001910,737,231,103,128,3,3,163,74,89,340,314,26,0
2021,Hammersmith and Fulham 015D,E01001911,710,105,41,64,18,18,448,323,125,136,128,8,3
2021,Hammersmith and Fulham 015E,E01001912,521,56,35,21,1,1,333,289,44,126,123,3,5
2021,Hammersmith and Fulham 014C,E01001913,714,250,117,133,4,4,59,14,45,401,356,45,0
2021,Hammersmith and Fulham 014D,E01001914,828,165,68,97,7,7,160,66,94,494,465,29,2
2021,Hammersmith and Fulham 024A,E01001915,628,338,187,151,12,12,97,35,62,181,168,13,0
2021,Hammersmith and Fulham 024B,E01001916,605,369,275,94,3,3,35,21,14,197,165,32,1
2021,Hammersmith and Fulham 018C,E01001917,698,296,150,146,5,5,188,152,36,209,192,17,0
2021,Hammersmith and Fulham 018D,E01001918,612,319,152,167,2,2,101,78,23,189,168,21,1
2021,Hammersmith and Fulham 018E,E01001919,599,366,182,184,3,3,86,60,26,144,135,9,0
2021,Hammersmith and Fulham 020A,E01001920,773,163,86,77,9,9,363,179,184,236,216,20,2
2021,Hammersmith and Fulham 020B,E01001921,603,285,139,146,3,3,111,37,74,204,188,16,0
2021,Hammersmith and Fulham 020C,E01001922,642,317,177,140,3,3,87,41,46,234,208,26,1
2021,Hammersmith and Fulham 020D,E01001923,648,261,116,145,3,3,158,117,41,225,205,20,1
2021,Hammersmith and Fulham 020E,E01001924,610,348,168,180,4,4,45,24,21,213,192,21,0
2021,Hammersmith and Fulham 025A,E01001925,617,346,179,167,1,1,73,26,47,197,171,26,0
2021,Hammersmith and Fulham 024C,E01001926,582,321,173,148,9,9,37,20,17,214,191,23,1
2021,Hammersmith and Fulham 008C,E01001927,516,383,216,167,0,0,34,9,25,99,90,9,0
2021,Hammersmith and Fulham 011A,E01001928,683,261,142,119,23,23,224,87,137,174,152,22,1
2021,Hammersmith and Fulham 009D,E01001929,589,353,173,180,0,0,68,20,48,168,155,13,0
2021,Hammersmith and Fulham 008D,E01001930,769,268,144,124,3,3,271,59,212,227,203,24,0
2021,Hammersmith and Fulham 011B,E01001931,658,216,98,118,27,27,108,19,89,307,291,16,0
2021,Hammersmith and Fulham 011C,E01001932,746,219,108,111,7,7,182,89,93,338,320,18,0
2021,Hammersmith and Fulham 011D,E01001933,687,312,183,129,16,16,138,52,86,220,201,19,1
2021,Hammersmith and Fulham 025B,E01001934,796,227,108,119,10,10,317,253,64,242,225,17,0
2021,Hammersmith and Fulham 023A,E01001935,924,379,167,212,7,7,244,161,83,292,260,32,2
2021,Hammersmith and Fulham 025C,E01001937,724,335,150,185,0,0,76,32,44,312,289,23,1
2021,Hammersmith and Fulham 025D,E01001938,630,154,66,88,34,34,297,157,140,144,132,12,1
2021,Hammersmith and Fulham 005B,E01001940,708,133,58,75,15,15,304,110,194,254,240,14,2
2021,Hammersmith and Fulham 005C,E01001941,771,171,72,99,24,24,139,29,110,436,413,23,1
2021,Hammersmith and Fulham 005D,E01001942,866,215,103,112,1,1,242,69,173,407,383,24,1
2021,Hammersmith and Fulham 004A,E01001943,1100,214,114,100,23,23,346,93,253,516,487,29,1
2021,Hammersmith and Fulham 004B,E01001944,800,72,32,40,5,5,598,524,74,113,104,9,12
2021,Hammersmith and Fulham 004C,E01001945,749,248,128,120,2,2,238,54,184,261,238,23,0
2021,Hammersmith and Fulham 004D,E01001946,854,235,116,119,10,10,244,106,138,362,331,31,3
2021,Hammersmith and Fulham 021A,E01001947,587,72,28,44,2,2,413,362,51,97,88,9,3
2021,Hammersmith and Fulham 021B,E01001948,842,341,159,182,32,32,137,47,90,332,305,27,0
2021,Hammersmith and Fulham 021C,E01001949,644,287,134,153,2,2,61,25,36,293,278,15,1
2021,Hammersmith and Fulham 021D,E01001950,593,307,139,168,3,3,43,22,21,239,225,14,1
2021,Hammersmith and Fulham 021E,E01001951,697,248,131,117,3,3,161,134,27,285,260,25,0
2021,Hammersmith and Fulham 024D,E01001952,827,239,103,136,8,8,140,69,71,439,406,33,1
2021,Hammersmith and Fulham 021F,E01001953,681,151,73,78,4,4,199,160,39,325,305,20,2
2021,Hammersmith and Fulham 003A,E01001954,665,219,105,114,2,2,274,69,205,169,147,22,1
2021,Hammersmith and Fulham 002A,E01001955,822,217,90,127,52,52,373,296,77,175,167,8,5
2021,Hammersmith and Fulham 003B,E01001956,598,222,120,102,3,3,250,63,187,123,112,11,0
2021,Hammersmith and Fulham 002B,E01001957,586,79,32,47,4,4,416,372,44,85,82,3,2
2021,Hammersmith and Fulham 002C,E01001958,599,73,24,49,8,8,428,408,20,88,86,2,2
2021,Hammersmith and Fulham 003C,E01001959,578,195,94,101,14,14,264,166,98,104,92,12,1
2021,Hammersmith and Fulham 003D,E01001960,774,241,94,147,11,11,178,57,121,344,323,21,0
2021,Hammersmith and Fulham 002D,E01001961,534,82,36,46,1,1,363,345,18,80,71,9,8
2021,Haringey 004A,E01001962,640,404,189,215,9,9,117,88,29,109,105,4,1
2021,Haringey 009A,E01001963,677,497,245,252,1,1,25,13,12,154,146,8,0
2021,Haringey 009B,E01001964,639,354,157,197,4,4,70,36,34,210,201,9,1
2021,Haringey 009C,E01001965,629,438,190,248,2,2,75,49,26,114,100,14,0
2021,Haringey 009D,E01001966,516,400,225,175,2,2,17,15,2,96,94,2,1
2021,Haringey 014A,E01001967,603,453,232,221,0,0,50,12,38,100,93,7,0
2021,Haringey 014B,E01001968,695,403,185,218,1,1,57,30,27,234,224,10,0
2021,Haringey 001A,E01001969,870,264,130,134,7,7,216,65,151,381,341,40,2
2021,Haringey 004B,E01001970,747,148,75,73,38,38,313,108,205,245,238,7,3
2021,Haringey 001B,E01001971,815,143,68,75,16,16,450,249,201,203,187,16,3
2021,Haringey 004C,E01001972,730,266,140,126,4,4,252,220,32,202,184,18,6
2021,Haringey 004D,E01001973,1000,450,231,219,20,20,239,86,153,291,273,18,0
2021,Haringey 001C,E01001974,973,373,168,205,5,5,66,29,37,527,507,20,2
2021,Haringey 001D,E01001975,814,286,127,159,10,10,126,63,63,391,373,18,1
2021,Haringey 011A,E01001976,687,235,108,127,18,18,149,49,100,283,268,15,2
2021,Haringey 011B,E01001977,605,180,86,94,1,1,167,76,91,251,240,11,6
2021,Haringey 011C,E01001978,786,196,84,112,6,6,289,164,125,291,277,14,4
2021,Haringey 011D,E01001979,927,182,75,107,34,34,308,81,227,400,378,22,3
2021,Haringey 018A,E01001980,703,276,125,151,4,4,115,49,66,307,266,41,1
2021,Haringey 018B,E01001981,647,216,111,105,2,2,106,42,64,319,303,16,4
2021,Haringey 018C,E01001982,717,267,120,147,3,3,130,48,82,317,297,20,0
2021,Haringey 018D,E01001983,649,300,144,156,8,8,100,34,66,240,220,20,1
2021,Haringey 033A,E01001984,953,330,158,172,67,67,191,76,115,361,339,22,4
2021,Haringey 033B,E01001985,725,444,202,242,5,5,60,19,41,216,207,9,0
2021,Haringey 034A,E01001986,696,370,166,204,10,10,116,25,91,199,188,11,1
2021,Haringey 033C,E01001987,760,454,247,207,5,5,55,12,43,245,226,19,1
2021,Haringey 034B,E01001988,790,366,165,201,2,2,111,22,89,310,298,12,1
2021,Haringey 033D,E01001989,758,443,226,217,14,14,102,40,62,199,188,11,0
2021,Haringey 034C,E01001990,937,331,137,194,19,19,58,24,34,529,506,23,0
2021,Haringey 017A,E01001991,739,264,116,148,8,8,82,41,41,384,378,6,1
2021,Haringey 017B,E01001992,679,450,265,185,3,3,34,19,15,192,172,20,0
2021,Haringey 017C,E01001993,602,472,259,213,1,1,34,28,6,94,90,4,1
2021,Haringey 030A,E01001994,741,402,222,180,2,2,62,16,46,275,252,23,0
2021,Haringey 017D,E01001995,939,434,146,288,34,34,308,225,83,158,144,14,5
2021,Haringey 014C,E01001996,615,328,122,206,2,2,50,9,41,234,222,12,1
2021,Haringey 014D,E01001997,702,316,143,173,6,6,29,7,22,351,334,17,0
2021,Haringey 023A,E01001998,824,347,154,193,2,2,57,23,34,418,401,17,0
2021,Haringey 023B,E01001999,962,354,168,186,3,3,72,32,40,531,515,16,2
2021,Haringey 031A,E01002000,739,326,151,175,5,5,75,32,43,332,311,21,1
2021,Haringey 031B,E01002001,686,365,142,223,1,1,58,20,38,262,250,12,0
2021,Haringey 031C,E01002002,796,251,111,140,12,12,82,27,55,451,437,14,0
2021,Haringey 023C,E01002003,1139,224,68,156,27,27,279,131,148,607,588,19,2
2021,Haringey 023D,E01002004,718,351,185,166,3,3,88,35,53,275,260,15,1
2021,Haringey 035A,E01002005,735,290,109,181,1,1,53,21,32,389,375,14,2
2021,Haringey 035B,E01002006,772,324,139,185,3,3,61,48,13,384,364,20,0
2021,Haringey 035C,E01002007,685,374,214,160,1,1,44,14,30,263,243,20,3
2021,Haringey 030B,E01002008,527,375,239,136,3,3,38,21,17,111,84,27,0
2021,Haringey 035D,E01002009,653,381,207,174,3,3,37,8,29,232,215,17,0
2021,Haringey 030C,E01002010,698,338,182,156,4,4,202,168,34,154,139,15,0
2021,Haringey 030D,E01002011,778,353,176,177,13,13,141,102,39,267,241,26,4
2021,Haringey 022A,E01002013,569,369,146,223,6,6,60,55,5,133,129,4,1
2021,Haringey 020B,E01002014,834,310,124,186,0,0,151,66,85,373,359,14,0
2021,Haringey 020C,E01002015,629,227,101,126,5,5,262,172,90,132,125,7,3
2021,Haringey 028A,E01002016,878,337,114,223,5,5,294,77,217,240,233,7,2
2021,Haringey 028B,E01002017,655,335,108,227,9,9,113,37,76,197,181,16,1
2021,Haringey 020D,E01002018,595,310,136,174,2,2,182,163,19,99,90,9,2
2021,Haringey 022B,E01002019,546,416,222,194,8,8,32,20,12,90,80,10,0
2021,Haringey 021A,E01002020,701,345,160,185,2,2,102,51,51,252,239,13,0
2021,Haringey 022C,E01002021,566,416,226,190,3,3,56,44,12,90,79,11,1
2021,Haringey 021B,E01002022,979,421,219,202,12,12,79,33,46,464,439,25,3
2021,Haringey 021C,E01002023,587,406,240,166,2,2,50,33,17,128,110,18,1
2021,Haringey 022D,E01002024,524,304,139,165,11,11,94,89,5,114,102,12,1
2021,Haringey 021D,E01002025,596,445,230,215,0,0,14,11,3,137,130,7,0
2021,Haringey 016A,E01002026,756,106,45,61,14,14,498,242,256,136,126,10,2
2021,Haringey 010A,E01002027,546,202,105,97,3,3,154,140,14,183,176,7,4
2021,Haringey 010B,E01002028,623,240,112,128,8,8,149,134,15,224,209,15,2
2021,Haringey 016B,E01002029,727,148,64,84,65,65,286,151,135,224,215,9,4
2021,Haringey 016C,E01002030,638,256,127,129,9,9,89,29,60,284,259,25,0
2021,Haringey 016D,E01002031,747,215,120,95,8,8,121,76,45,401,384,17,2
2021,Haringey 010C,E01002032,732,183,63,120,7,7,315,298,17,219,187,32,8
2021,Haringey 010D,E01002033,692,198,92,106,3,3,283,257,26,205,187,18,3
2021,Haringey 037A,E01002034,1021,107,44,63,85,85,514,367,147,303,272,31,12
2021,Haringey 002A,E01002036,696,199,90,109,9,9,223,156,67,264,250,14,1
2021,Haringey 002B,E01002037,682,120,59,61,4,4,329,215,114,226,211,15,3
2021,Haringey 037B,E01002038,712,113,49,64,21,21,285,149,136,290,278,12,3
2021,Haringey 002C,E01002039,623,88,27,61,2,2,403,351,52,118,113,5,12
2021,Haringey 002D,E01002040,878,235,121,114,15,15,272,163,109,355,341,14,1
2021,Haringey 037C,E01002041,731,214,108,106,20,20,251,169,82,238,222,16,8
2021,Haringey 027A,E01002042,591,279,128,151,12,12,70,30,40,230,219,11,0
2021,Haringey 026A,E01002043,699,284,129,155,6,6,89,53,36,318,301,17,2
2021,Haringey 027B,E01002044,711,250,124,126,5,5,100,51,49,354,344,10,2
2021,Haringey 026B,E01002045,828,203,81,122,26,26,278,176,102,315,298,17,6
2021,Haringey 026C,E01002046,659,192,90,102,1,1,240,166,74,211,182,29,15
2021,Haringey 027C,E01002047,633,231,103,128,5,5,90,74,16,306,290,16,1
2021,Haringey 027D,E01002048,738,270,125,145,6,6,172,138,34,288,268,20,2
2021,Haringey 026D,E01002049,698,252,120,132,14,14,231,167,64,197,183,14,4
2021,Haringey 029A,E01002050,470,189,127,62,6,6,44,16,28,231,213,18,0
2021,Haringey 029B,E01002051,685,108,58,50,8,8,217,109,108,347,326,21,5
2021,Haringey 029C,E01002052,507,171,97,74,29,29,93,56,37,214,183,31,0
2021,Haringey 032A,E01002053,725,139,65,74,10,10,318,191,127,257,243,14,1
2021,Haringey 032B,E01002054,681,117,53,64,4,4,385,361,24,170,156,14,5
2021,Haringey 029D,E01002055,502,137,87,50,6,6,69,45,24,288,271,17,2
2021,Haringey 032C,E01002056,923,205,80,125,19,19,294,235,59,403,384,19,2
2021,Haringey 032D,E01002057,595,213,108,105,11,11,115,39,76,255,240,15,1
2021,Haringey 031D,E01002058,648,215,111,104,28,28,144,69,75,259,246,13,2
2021,Haringey 028C,E01002059,699,317,125,192,11,11,229,126,103,141,124,17,1
2021,Haringey 028D,E01002060,751,418,165,253,2,2,127,37,90,204,196,8,0
2021,Haringey 036A,E01002061,692,362,143,219,3,3,83,42,41,244,229,15,0
2021,Haringey 034D,E01002062,823,394,160,234,4,4,133,76,57,291,282,9,1
2021,Haringey 036B,E01002063,710,267,97,170,3,3,221,155,66,219,200,19,0
2021,Haringey 036C,E01002064,655,226,89,137,2,2,236,139,97,187,172,15,4
2021,Haringey 036D,E01002065,739,226,84,142,3,3,166,85,81,341,330,11,3
2021,Haringey 025A,E01002066,905,121,41,80,54,54,454,168,286,270,232,38,6
2021,Haringey 024A,E01002067,734,181,84,97,4,4,322,108,214,220,206,14,7
2021,Haringey 025B,E01002068,858,214,107,107,34,34,209,91,118,397,379,18,4
2021,Haringey 024B,E01002069,964,201,84,117,25,25,324,110,214,405,377,28,9
2021,Haringey 024C,E01002070,1075,431,186,245,29,29,171,62,109,441,422,19,3
2021,Haringey 025C,E01002071,699,134,56,78,14,14,310,231,79,236,223,13,5
2021,Haringey 025D,E01002072,676,169,81,88,3,3,277,158,119,223,204,19,4
2021,Haringey 024D,E01002073,662,167,69,98,2,2,261,197,64,228,214,14,4
2021,Haringey 012A,E01002074,856,201,91,110,28,28,333,240,93,289,273,16,5
2021,Haringey 015A,E01002075,722,189,81,108,4,4,258,137,121,267,253,14,4
2021,Haringey 015B,E01002076,678,243,130,113,6,6,161,123,38,265,254,11,3
2021,Haringey 012B,E01002077,857,132,54,78,37,37,435,193,242,247,235,12,6
2021,Haringey 015C,E01002078,1132,360,125,235,16,16,377,283,94,368,348,20,11
2021,Haringey 012C,E01002079,611,261,131,130,4,4,86,43,43,260,246,14,0
2021,Haringey 012D,E01002081,682,145,72,73,3,3,348,264,84,180,152,28,6
2021,Haringey 013A,E01002082,568,63,41,22,2,2,438,217,221,60,54,6,5
2021,Haringey 019A,E01002083,534,297,174,123,3,3,19,10,9,215,210,5,0
2021,Haringey 019B,E01002084,657,301,142,159,27,27,71,51,20,258,241,17,0
2021,Haringey 019C,E01002085,798,270,121,149,12,12,200,100,100,314,292,22,2
2021,Haringey 013B,E01002086,617,359,120,239,4,4,96,64,32,154,140,14,4
2021,Haringey 019D,E01002087,848,220,115,105,7,7,154,50,104,464,393,71,3
2021,Haringey 013C,E01002088,670,289,151,138,12,12,88,29,59,280,255,25,1
2021,Haringey 013D,E01002089,512,47,33,14,1,1,401,381,20,50,46,4,13
2021,Haringey 005A,E01002090,634,314,109,205,1,1,199,141,58,119,110,9,1
2021,Haringey 006A,E01002091,635,195,87,108,6,6,304,261,43,120,113,7,10
2021,Haringey 006B,E01002092,644,128,44,84,19,19,215,155,60,280,264,16,2
2021,Haringey 005B,E01002093,660,174,81,93,10,10,334,240,94,139,130,9,3
2021,Haringey 006C,E01002094,525,186,71,115,0,0,242,191,51,96,86,10,1
2021,Haringey 006D,E01002095,618,150,58,92,3,3,342,215,127,117,111,6,6
2021,Haringey 005C,E01002096,584,182,75,107,4,4,296,227,69,98,93,5,4
2021,Haringey 005D,E01002097,596,197,76,121,4,4,257,232,25,132,121,11,6
2021,Haringey 007A,E01002098,646,287,125,162,22,22,95,27,68,242,223,19,0
2021,Haringey 008A,E01002099,802,152,60,92,5,5,440,370,70,197,184,13,8
2021,Haringey 008B,E01002100,660,223,120,103,11,11,179,109,70,243,228,15,4
2021,Haringey 007B,E01002101,735,303,155,148,4,4,45,21,24,383,364,19,0
2021,Haringey 007C,E01002102,717,232,117,115,1,1,141,77,64,343,328,15,0
2021,Haringey 008C,E01002103,684,304,159,145,7,7,83,52,31,290,269,21,0
2021,Haringey 008D,E01002104,514,228,129,99,4,4,100,62,38,181,173,8,1
2021,Haringey 007D,E01002105,890,206,96,110,2,2,180,92,88,499,475,24,3
2021,Harrow 008A,E01002106,645,495,236,259,1,1,26,23,3,122,103,19,1
2021,Harrow 012A,E01002107,564,462,215,247,0,0,8,4,4,94,85,9,0
2021,Harrow 008B,E01002108,552,457,240,217,1,1,3,3,0,88,76,12,3
2021,Harrow 008C,E01002109,648,518,252,266,0,0,21,19,2,109,88,21,0
2021,Harrow 008D,E01002110,530,412,223,189,2,2,5,1,4,111,101,10,0
2021,Harrow 008E,E01002111,681,452,229,223,2,2,44,33,11,182,171,11,1
2021,Harrow 001A,E01002112,733,510,281,229,3,3,47,37,10,172,156,16,1
2021,Harrow 002A,E01002113,598,366,180,186,2,2,131,100,31,95,79,16,4
2021,Harrow 001B,E01002114,1013,438,281,157,25,25,229,42,187,320,273,47,1
2021,Harrow 002B,E01002115,507,368,214,154,0,0,43,35,8,96,79,17,0
2021,Harrow 002C,E01002116,623,447,277,170,11,11,4,3,1,160,142,18,1
2021,Harrow 002E,E01002118,675,311,193,118,4,4,18,6,12,342,305,37,0
2021,Harrow 007A,E01002119,866,400,167,233,23,23,102,72,30,341,324,17,0
2021,Harrow 007B,E01002120,479,179,103,76,1,1,168,153,15,125,116,9,6
2021,Harrow 007C,E01002121,525,362,201,161,1,1,10,8,2,152,136,16,0
2021,Harrow 007D,E01002122,560,354,198,156,3,3,13,8,5,190,180,10,0
2021,Harrow 007E,E01002123,511,289,177,112,3,3,6,1,5,213,200,13,0
2021,Harrow 010A,E01002124,493,324,193,131,1,1,13,4,9,155,139,16,0
2021,Harrow 010B,E01002125,553,257,148,109,3,3,46,31,15,247,227,20,0
2021,Harrow 023B,E01002127,648,358,223,135,2,2,21,6,15,267,247,20,0
2021,Harrow 020A,E01002128,805,315,156,159,11,11,38,20,18,440,428,12,1
2021,Harrow 023C,E01002129,1196,369,164,205,10,10,121,36,85,695,658,37,1
2021,Harrow 020B,E01002130,1111,294,140,154,8,8,150,40,110,657,617,40,2
2021,Harrow 023D,E01002131,611,232,116,116,21,21,227,137,90,128,121,7,3
2021,Harrow 029A,E01002132,815,423,198,225,5,5,21,8,13,366,341,25,0
2021,Harrow 027A,E01002133,809,239,135,104,10,10,356,265,91,197,180,17,7
2021,Harrow 029B,E01002134,586,325,160,165,3,3,17,3,14,241,199,42,0
2021,Harrow 029C,E01002135,710,353,154,199,21,21,97,79,18,236,222,14,3
2021,Harrow 027B,E01002136,711,410,212,198,3,3,15,8,7,283,268,15,0
2021,Harrow 029D,E01002137,450,250,122,128,1,1,5,4,1,194,120,74,0
2021,Harrow 027C,E01002138,512,320,137,183,3,3,27,16,11,162,154,8,0
2021,Harrow 006A,E01002139,501,155,66,89,2,2,285,150,135,55,51,4,4
2021,Harrow 005A,E01002140,616,361,193,168,5,5,90,64,26,158,149,9,2
2021,Harrow 005B,E01002141,657,445,227,218,6,6,72,14,58,131,118,13,3
2021,Harrow 005C,E01002142,656,450,251,199,1,1,13,7,6,192,176,16,0
2021,Harrow 005D,E01002143,537,309,137,172,2,2,81,53,28,145,137,8,0
2021,Harrow 004A,E01002144,572,438,222,216,1,1,52,48,4,80,65,15,1
2021,Harrow 005E,E01002145,622,391,231,160,10,10,82,18,64,139,126,13,0
2021,Harrow 004B,E01002146,505,440,213,227,0,0,4,3,1,61,59,2,0
2021,Harrow 004C,E01002147,491,405,243,162,2,2,7,4,3,77,64,13,0
2021,Harrow 006B,E01002148,485,408,200,208,3,3,24,24,0,50,41,9,0
2021,Harrow 004D,E01002149,471,434,256,178,1,1,7,2,5,29,28,1,0
2021,Harrow 006C,E01002150,893,440,252,188,3,3,76,5,71,373,345,28,1
2021,Harrow 006D,E01002151,526,206,99,107,0,0,234,194,40,82,76,6,4
2021,Harrow 006E,E01002152,630,500,277,223,4,4,4,3,1,122,111,11,0
2021,Harrow 019A,E01002153,624,484,278,206,0,0,3,1,2,137,127,10,0
2021,Harrow 019B,E01002155,631,509,257,252,5,5,20,18,2,95,85,10,2
2021,Harrow 015B,E01002156,521,458,245,213,0,0,4,2,2,59,53,6,0
2021,Harrow 019C,E01002157,584,363,191,172,15,15,18,9,9,188,166,22,0
2021,Harrow 019D,E01002158,486,433,221,212,0,0,2,2,0,50,39,11,1
2021,Harrow 021A,E01002159,687,451,243,208,0,0,40,29,11,193,180,13,3
2021,Harrow 021B,E01002160,940,369,170,199,22,22,76,17,59,470,452,18,3
2021,Harrow 021C,E01002161,711,388,210,178,22,22,80,31,49,221,203,18,0
2021,Harrow 015C,E01002162,680,379,187,192,7,7,96,71,25,197,187,10,1
2021,Harrow 015D,E01002163,539,435,211,224,4,4,15,5,10,85,74,11,0
2021,Harrow 021D,E01002164,711,434,197,237,13,13,29,8,21,233,220,13,2
2021,Harrow 017A,E01002165,534,287,172,115,3,3,30,17,13,210,190,20,4
2021,Harrow 017B,E01002166,488,335,217,118,2,2,17,11,6,134,111,23,0
2021,Harrow 017C,E01002167,473,248,146,102,2,2,80,71,9,142,134,8,1
2021,Harrow 017D,E01002168,508,208,78,130,2,2,191,178,13,101,89,12,6
2021,Harrow 017E,E01002169,527,256,158,98,4,4,110,28,82,156,135,21,1
2021,Harrow 033A,E01002170,407,267,132,135,2,2,49,41,8,88,78,10,1
2021,Harrow 033B,E01002171,539,339,219,120,9,9,9,6,3,182,171,11,0
2021,Harrow 033C,E01002172,490,320,161,159,30,30,35,23,12,105,98,7,0
2021,Harrow 033D,E01002173,568,446,292,154,3,3,10,3,7,109,102,7,0
2021,Harrow 033E,E01002174,493,382,235,147,1,1,1,1,0,109,99,10,0
2021,Harrow 033F,E01002175,403,302,194,108,0,0,11,1,10,90,79,11,0
2021,Harrow 033G,E01002176,516,351,218,133,2,2,6,3,3,157,144,13,0
2021,Harrow 033H,E01002177,474,352,173,179,3,3,10,7,3,108,96,12,1
2021,Harrow 033I,E01002178,507,418,221,197,3,3,6,6,0,80,70,10,0
2021,Harrow 013A,E01002179,911,360,184,176,53,53,117,20,97,381,364,17,0
2021,Harrow 020C,E01002181,849,510,190,320,19,19,26,7,19,294,275,19,0
2021,Harrow 020D,E01002182,691,364,168,196,3,3,15,4,11,309,285,24,0
2021,Harrow 013C,E01002183,669,384,213,171,11,11,23,13,10,251,230,21,0
2021,Harrow 013D,E01002184,651,318,161,157,9,9,84,53,31,238,230,8,2
2021,Harrow 009A,E01002185,647,242,103,139,10,10,278,197,81,112,106,6,5
2021,Harrow 009B,E01002186,785,389,210,179,5,5,121,101,20,266,246,20,4
2021,Harrow 009C,E01002187,760,504,269,235,8,8,94,79,15,152,136,16,2
2021,Harrow 016A,E01002188,627,551,332,219,4,4,5,4,1,67,60,7,0
2021,Harrow 016B,E01002189,728,467,265,202,15,15,41,7,34,205,194,11,0
2021,Harrow 009D,E01002190,603,532,305,227,0,0,8,3,5,63,51,12,0
2021,Harrow 022A,E01002191,658,517,227,290,0,0,16,2,14,124,114,10,1
2021,Harrow 016C,E01002192,666,493,280,213,6,6,44,9,35,123,113,10,0
2021,Harrow 016D,E01002193,742,417,204,213,6,6,122,109,13,195,189,6,2
2021,Harrow 022B,E01002194,656,524,270,254,2,2,38,32,6,91,81,10,1
2021,Harrow 022C,E01002195,602,475,239,236,0,0,31,26,5,96,89,7,0
2021,Harrow 022D,E01002196,611,541,278,263,1,1,17,8,9,52,47,5,0
2021,Harrow 012B,E01002197,425,340,183,157,3,3,3,1,2,79,73,6,0
2021,Harrow 010C,E01002198,499,319,174,145,2,2,3,1,2,175,164,11,0
2021,Harrow 012C,E01002199,474,346,199,147,0,0,5,3,2,122,116,6,1
2021,Harrow 010D,E01002200,570,316,162,154,2,2,28,21,7,224,209,15,0
2021,Harrow 012D,E01002201,504,391,230,161,2,2,4,3,1,106,90,16,1
2021,Harrow 012E,E01002202,706,223,121,102,5,5,53,26,27,423,391,32,2
2021,Harrow 010E,E01002203,551,325,163,162,1,1,21,7,14,204,190,14,0
2021,Harrow 032A,E01002204,637,263,137,126,1,1,36,26,10,337,315,22,0
2021,Harrow 032B,E01002206,455,300,162,138,5,5,13,6,7,137,127,10,0
2021,Harrow 032C,E01002207,546,417,214,203,1,1,15,5,10,112,106,6,1
2021,Harrow 025A,E01002208,487,426,226,200,1,1,2,1,1,57,52,5,1
2021,Harrow 025B,E01002209,665,396,192,204,4,4,13,10,3,252,229,23,0
2021,Harrow 032D,E01002210,491,364,189,175,0,0,9,6,3,118,105,13,0
2021,Harrow 028A,E01002211,470,203,102,101,4,4,167,48,119,96,86,10,0
2021,Harrow 028B,E01002212,649,297,126,171,4,4,93,68,25,250,236,14,5
2021,Harrow 031A,E01002214,614,361,151,210,4,4,91,76,15,156,148,8,2
2021,Harrow 031B,E01002215,615,227,91,136,1,1,239,189,50,142,132,10,6
2021,Harrow 028C,E01002216,518,372,171,201,2,2,14,6,8,130,117,13,0
2021,Harrow 028D,E01002217,781,287,32,255,9,9,386,35,351,97,84,13,2
2021,Harrow 030A,E01002218,644,379,210,169,12,12,49,16,33,204,186,18,0
2021,Harrow 030B,E01002219,626,267,128,139,5,5,54,16,38,300,274,26,0
2021,Harrow 031C,E01002220,495,348,169,179,2,2,37,26,11,108,98,10,0
2021,Harrow 030C,E01002221,521,260,144,116,1,1,65,7,58,195,180,15,0
2021,Harrow 030D,E01002222,496,357,171,186,2,2,14,9,5,123,106,17,0
2021,Harrow 031D,E01002223,577,412,214,198,4,4,17,9,8,144,133,11,0
2021,Harrow 031E,E01002224,530,303,113,190,2,2,134,87,47,91,83,8,0
2021,Harrow 001C,E01002225,690,573,341,232,1,1,10,7,3,106,93,13,0
2021,Harrow 001D,E01002226,1103,668,343,325,4,4,123,37,86,308,291,17,0
2021,Harrow 003A,E01002227,647,261,110,151,3,3,297,246,51,82,77,5,4
2021,Harrow 003B,E01002228,787,419,229,190,28,28,125,16,109,214,126,88,1
2021,Harrow 003C,E01002229,744,424,253,171,2,2,119,108,11,194,168,26,5
2021,Harrow 003D,E01002230,632,519,278,241,3,3,3,2,1,107,95,12,0
2021,Harrow 013E,E01002231,665,374,169,205,19,19,77,15,62,193,181,12,2
2021,Harrow 011A,E01002232,739,387,199,188,4,4,82,58,24,266,254,12,0
2021,Harrow 011B,E01002233,832,310,140,170,8,8,119,56,63,391,376,15,4
2021,Harrow 011C,E01002234,614,323,146,177,5,5,43,13,30,243,227,16,0
2021,Harrow 011D,E01002235,602,245,123,122,3,3,217,177,40,135,125,10,2
2021,Harrow 011E,E01002236,758,342,144,198,15,15,84,22,62,317,292,25,0
2021,Harrow 024A,E01002237,809,358,163,195,2,2,74,51,23,373,360,13,2
2021,Harrow 024B,E01002238,619,392,212,180,4,4,38,7,31,185,166,19,0
2021,Harrow 025C,E01002239,754,469,255,214,1,1,13,3,10,269,255,14,2
2021,Harrow 024C,E01002240,666,336,163,173,25,25,155,99,56,145,138,7,5
2021,Harrow 025D,E01002241,657,312,154,158,59,59,161,17,144,123,105,18,2
2021,Harrow 024D,E01002242,625,498,282,216,1,1,6,4,2,118,109,9,2
2021,Havering 013A,E01002243,835,291,113,178,20,20,289,120,169,235,225,10,0
2021,Havering 011A,E01002244,726,451,183,268,38,38,59,12,47,178,170,8,0
2021,Havering 011B,E01002245,624,413,165,248,8,8,77,72,5,125,109,16,1
2021,Havering 017A,E01002246,635,495,278,217,1,1,23,19,4,115,103,12,1
2021,Havering 017B,E01002247,893,482,186,296,13,13,144,49,95,253,242,11,1
2021,Havering 017C,E01002248,631,331,161,170,2,2,125,102,23,168,148,20,5
2021,Havering 017E,E01002250,700,434,173,261,9,9,81,25,56,175,159,16,1
2021,Havering 017F,E01002251,514,296,119,177,0,0,154,145,9,64,57,7,0
2021,Havering 018A,E01002252,634,553,333,220,9,9,24,21,3,48,39,9,0
2021,Havering 019A,E01002253,611,577,319,258,2,2,6,6,0,26,23,3,0
2021,Havering 019B,E01002254,637,585,339,246,1,1,8,7,1,43,39,4,0
2021,Havering 022A,E01002255,636,538,256,282,2,2,7,5,2,88,81,7,1
2021,Havering 018B,E01002256,612,540,305,235,1,1,13,8,5,58,48,10,0
2021,Havering 019C,E01002257,655,597,345,252,0,0,17,11,6,41,35,6,0
2021,Havering 018C,E01002258,766,475,266,209,5,5,166,154,12,118,102,16,2
2021,Havering 018D,E01002259,604,520,268,252,2,2,18,16,2,64,50,14,0
2021,Havering 026A,E01002260,625,500,255,245,6,6,25,18,7,93,83,10,1
2021,Havering 026B,E01002261,656,499,248,251,1,1,14,6,8,142,123,19,0
2021,Havering 026C,E01002262,674,470,236,234,9,9,124,112,12,71,62,9,0
2021,Havering 026D,E01002263,606,541,276,265,6,6,18,15,3,41,36,5,0
2021,Havering 026E,E01002264,701,302,123,179,7,7,308,255,53,82,72,10,2
2021,Havering 025A,E01002265,630,523,265,258,3,3,15,14,1,89,77,12,0
2021,Havering 027A,E01002266,602,484,275,209,2,2,47,29,18,69,58,11,0
2021,Havering 027B,E01002267,754,438,201,237,3,3,221,146,75,91,77,14,1
2021,Havering 010A,E01002268,527,434,191,243,1,1,37,36,1,54,48,6,1
2021,Havering 010B,E01002269,678,582,310,272,1,1,20,7,13,75,64,11,0
2021,Havering 015A,E01002270,647,500,277,223,1,1,102,8,94,43,40,3,1
2021,Havering 015B,E01002271,520,492,282,210,0,0,4,3,1,24,18,6,0
2021,Havering 014A,E01002272,541,465,242,223,1,1,3,2,1,72,65,7,0
2021,Havering 015C,E01002273,484,446,263,183,0,0,5,1,4,33,31,2,0
2021,Havering 014B,E01002274,677,583,314,269,0,0,5,5,0,89,82,7,0
2021,Havering 015D,E01002275,501,464,289,175,2,2,4,3,1,31,23,8,0
2021,Havering 001A,E01002276,693,429,190,239,8,8,168,139,29,88,83,5,0
2021,Havering 002A,E01002277,608,295,143,152,2,2,233,215,18,77,71,6,1
2021,Havering 001B,E01002278,628,305,120,185,1,1,257,226,31,65,61,4,0
2021,Havering 002B,E01002279,649,377,150,227,7,7,180,162,18,85,76,9,0
2021,Havering 004A,E01002280,664,209,74,135,28,28,333,279,54,92,87,5,2
2021,Havering 002C,E01002281,972,405,84,321,5,5,399,376,23,162,147,15,1
2021,Havering 004B,E01002282,717,229,73,156,3,3,392,313,79,90,72,18,3
2021,Havering 002D,E01002283,605,338,146,192,13,13,197,132,65,57,49,8,0
2021,Havering 004C,E01002284,778,423,150,273,13,13,224,195,29,113,97,16,5
2021,Havering 025B,E01002285,545,474,273,201,0,0,13,12,1,58,48,10,0
2021,Havering 025C,E01002286,608,574,321,253,1,1,6,5,1,27,22,5,0
2021,Havering 023A,E01002287,603,524,269,255,0,0,8,7,1,71,64,7,0
2021,Havering 025D,E01002288,610,513,288,225,12,12,36,8,28,49,40,9,0
2021,Havering 022B,E01002289,633,536,265,271,2,2,38,37,1,57,51,6,0
2021,Havering 025E,E01002290,623,558,350,208,3,3,16,13,3,46,38,8,0
2021,Havering 023B,E01002291,751,553,330,223,1,1,14,9,5,182,159,23,1
2021,Havering 022C,E01002292,649,466,228,238,2,2,110,101,9,71,60,11,0
2021,Havering 007B,E01002294,631,477,263,214,0,0,72,45,27,82,70,12,0
2021,Havering 010C,E01002295,806,470,228,242,80,80,95,45,50,161,155,6,0
2021,Havering 007C,E01002296,697,577,329,248,0,0,33,5,28,86,73,13,1
2021,Havering 004D,E01002297,674,258,97,161,0,0,319,292,27,94,87,7,3
2021,Havering 007D,E01002298,648,495,258,237,2,2,49,6,43,102,86,16,0
2021,Havering 002E,E01002299,659,429,155,274,2,2,143,110,33,85,77,8,0
2021,Havering 007E,E01002300,843,624,328,296,2,2,60,52,8,157,134,23,0
2021,Havering 003A,E01002301,622,538,310,228,2,2,29,20,9,53,48,5,0
2021,Havering 005A,E01002302,627,481,229,252,10,10,61,17,44,74,63,11,1
2021,Havering 003B,E01002303,813,432,203,229,10,10,246,165,81,125,111,14,0
2021,Havering 003C,E01002304,529,427,239,188,2,2,34,19,15,66,53,13,0
2021,Havering 005B,E01002305,615,464,240,224,4,4,60,52,8,85,72,13,2
2021,Havering 003D,E01002306,662,271,108,163,4,4,312,269,43,74,67,7,1
2021,Havering 003E,E01002307,665,444,178,266,19,19,138,117,21,64,52,12,0
2021,Havering 005C,E01002308,670,435,190,245,3,3,145,98,47,86,75,11,1
2021,Havering 006A,E01002309,653,374,182,192,4,4,176,149,27,96,89,7,3
2021,Havering 006B,E01002310,732,343,132,211,6,6,298,211,87,82,73,9,3
2021,Havering 006C,E01002311,679,405,158,247,5,5,179,157,22,88,77,11,2
2021,Havering 001C,E01002312,701,478,266,212,1,1,162,131,31,58,43,15,2
2021,Havering 001D,E01002313,853,517,180,337,5,5,212,180,32,119,104,15,0
2021,Havering 004E,E01002314,646,262,98,164,1,1,308,251,57,74,65,9,1
2021,Havering 006D,E01002315,642,385,145,240,1,1,161,135,26,95,81,14,0
2021,Havering 004F,E01002316,819,240,84,156,9,9,466,391,75,98,84,14,6
2021,Havering 014C,E01002317,551,509,283,226,1,1,14,7,7,27,24,3,0
2021,Havering 014D,E01002318,624,547,320,227,1,1,34,19,15,42,35,7,0
2021,Havering 016A,E01002319,730,490,240,250,9,9,107,100,7,120,109,11,4
2021,Havering 021A,E01002320,540,476,240,236,3,3,7,3,4,54,45,9,0
2021,Havering 021B,E01002321,700,566,310,256,8,8,12,2,10,114,102,12,0
2021,Havering 021C,E01002322,729,625,304,321,2,2,28,6,22,74,63,11,0
2021,Havering 021D,E01002323,628,554,262,292,0,0,8,7,1,65,60,5,1
2021,Havering 021E,E01002324,657,441,246,195,0,0,136,131,5,79,65,14,1
2021,Havering 011C,E01002325,833,462,234,228,3,3,261,248,13,106,101,5,1
2021,Havering 005D,E01002326,643,432,217,215,7,7,63,57,6,140,131,9,1
2021,Havering 009A,E01002327,604,504,242,262,0,0,42,34,8,58,47,11,0
2021,Havering 009B,E01002328,641,534,236,298,4,4,20,16,4,83,73,10,0
2021,Havering 011D,E01002329,648,528,253,275,3,3,16,15,1,100,91,9,1
2021,Havering 011E,E01002330,701,465,203,262,2,2,104,64,40,130,122,8,0
2021,Havering 005E,E01002331,610,513,245,268,1,1,35,29,6,61,53,8,0
2021,Havering 009C,E01002332,691,535,272,263,1,1,58,56,2,97,88,9,0
2021,Havering 008A,E01002333,517,480,292,188,1,1,4,1,3,32,24,8,0
2021,Havering 008B,E01002334,663,595,336,259,2,2,11,10,1,55,43,12,0
2021,Havering 009D,E01002335,569,385,221,164,12,12,109,104,5,63,58,5,0
2021,Havering 008C,E01002336,619,507,295,212,4,4,19,14,5,87,77,10,2
2021,Havering 012A,E01002337,496,421,235,186,1,1,24,11,13,50,42,8,0
2021,Havering 009E,E01002338,514,415,184,231,2,2,7,1,6,90,78,12,0
2021,Havering 008D,E01002339,597,556,292,264,0,0,16,11,5,25,23,2,0
2021,Havering 009F,E01002340,509,410,202,208,1,1,5,3,2,93,86,7,0
2021,Havering 008E,E01002341,546,504,291,213,0,0,8,6,2,34,31,3,0
2021,Havering 030A,E01002342,613,380,171,209,3,3,74,31,43,155,137,18,1
2021,Havering 029A,E01002343,636,573,307,266,2,2,9,5,4,52,45,7,0
2021,Havering 029B,E01002344,746,540,295,245,7,7,62,23,39,133,126,7,4
2021,Havering 030B,E01002345,786,329,129,200,18,18,165,103,62,274,256,18,0
2021,Havering 030C,E01002346,552,338,133,205,0,0,103,51,52,109,98,11,2
2021,Havering 030D,E01002347,546,464,235,229,2,2,9,7,2,71,65,6,0
2021,Havering 029C,E01002348,647,595,352,243,0,0,4,4,0,48,39,9,0
2021,Havering 029D,E01002349,597,491,292,199,0,0,52,7,45,54,45,9,0
2021,Havering 016B,E01002350,683,296,126,170,1,1,115,108,7,268,255,13,3
2021,Havering 016C,E01002351,695,471,183,288,1,1,35,26,9,187,170,17,1
2021,Havering 016D,E01002352,808,448,190,258,19,19,111,45,66,230,213,17,0
2021,Havering 013B,E01002353,858,509,254,255,20,20,122,47,75,206,188,18,1
2021,Havering 012B,E01002354,569,487,276,211,0,0,20,13,7,62,58,4,0
2021,Havering 014E,E01002355,569,496,235,261,1,1,4,4,0,68,61,7,0
2021,Havering 013C,E01002356,947,304,117,187,53,53,178,73,105,411,392,19,1
2021,Havering 016E,E01002358,874,441,169,272,16,16,91,41,50,326,314,12,0
2021,Havering 020A,E01002359,519,485,285,200,0,0,4,3,1,30,23,7,0
2021,Havering 020B,E01002360,729,474,295,179,1,1,139,126,13,113,105,8,2
2021,Havering 020C,E01002361,895,432,234,198,3,3,158,34,124,302,290,12,0
2021,Havering 022D,E01002362,628,487,252,235,3,3,12,7,5,126,115,11,0
2021,Havering 020D,E01002363,627,399,209,190,3,3,153,112,41,72,58,14,0
2021,Havering 023C,E01002364,538,481,285,196,0,0,14,0,14,43,36,7,0
2021,Havering 023D,E01002365,533,401,201,200,3,3,32,24,8,97,84,13,0
2021,Havering 023E,E01002366,566,463,214,249,0,0,34,22,12,69,58,11,0
2021,Havering 020E,E01002367,704,493,249,244,0,0,16,11,5,195,187,8,0
2021,Havering 028A,E01002368,984,353,125,228,80,80,431,42,389,118,103,15,2
2021,Havering 028B,E01002369,740,536,251,285,7,7,73,15,58,123,108,15,1
2021,Havering 028C,E01002370,865,516,179,337,3,3,227,149,78,119,107,12,0
2021,Havering 028D,E01002371,655,533,279,254,0,0,23,19,4,99,86,13,0
2021,Havering 027C,E01002372,612,489,264,225,1,1,37,21,16,85,72,13,0
2021,Havering 027D,E01002373,624,506,262,244,3,3,34,26,8,81,72,9,0
2021,Havering 027E,E01002374,632,449,213,236,5,5,89,84,5,87,76,11,2
2021,Havering 028E,E01002375,693,403,184,219,10,10,186,161,25,92,80,12,2
2021,Havering 012C,E01002376,525,482,238,244,0,0,4,4,0,39,36,3,0
2021,Havering 010D,E01002377,748,534,217,317,6,6,64,8,56,144,134,10,0
2021,Havering 010E,E01002378,605,542,222,320,0,0,11,3,8,52,50,2,0
2021,Havering 012D,E01002379,667,447,242,205,2,2,12,10,2,206,190,16,0
2021,Havering 012E,E01002380,1067,494,205,289,22,22,248,188,60,300,281,19,3
2021,Havering 012F,E01002381,635,434,237,197,8,8,106,15,91,86,83,3,1
2021,Havering 014F,E01002382,753,539,223,316,2,2,39,25,14,173,162,11,0
2021,Havering 010F,E01002383,652,539,271,268,8,8,18,5,13,87,78,9,0
2021,Havering 019D,E01002384,677,559,306,253,1,1,18,16,2,99,89,10,0
2021,Havering 024A,E01002385,600,524,303,221,1,1,13,9,4,62,52,10,0
2021,Havering 022E,E01002386,915,583,317,266,2,2,30,20,10,300,274,26,0
2021,Havering 024B,E01002387,604,568,341,227,0,0,8,5,3,28,21,7,0
2021,Havering 024C,E01002388,599,563,304,259,3,3,8,6,2,25,19,6,0
2021,Havering 024D,E01002389,617,581,373,208,1,1,5,3,2,30,25,5,0
2021,Havering 024E,E01002390,527,505,282,223,0,0,5,4,1,17,13,4,0
2021,Havering 018E,E01002391,629,548,312,236,2,2,18,18,0,60,42,18,1
2021,Hillingdon 020A,E01002392,610,202,72,130,10,10,293,243,50,102,94,8,3
2021,Hillingdon 020B,E01002393,722,371,145,226,11,11,126,77,49,214,199,15,0
2021,Hillingdon 021A,E01002394,519,319,135,184,2,2,45,33,12,152,137,15,1
2021,Hillingdon 021B,E01002395,433,263,130,133,16,16,37,5,32,117,103,14,0
2021,Hillingdon 026A,E01002396,574,274,143,131,5,5,165,89,76,124,107,17,6
2021,Hillingdon 021C,E01002397,576,233,114,119,2,2,82,27,55,259,229,30,0
2021,Hillingdon 021D,E01002398,507,290,155,135,2,2,26,17,9,189,174,15,0
2021,Hillingdon 021E,E01002399,493,337,166,171,0,0,12,11,1,144,128,16,0
2021,Hillingdon 024A,E01002400,636,342,135,207,1,1,144,93,51,149,141,8,0
2021,Hillingdon 024B,E01002401,762,341,137,204,10,10,127,78,49,284,268,16,0
2021,Hillingdon 024C,E01002402,512,242,103,139,5,5,147,110,37,117,108,9,1
2021,Hillingdon 024D,E01002403,733,341,114,227,17,17,178,79,99,197,185,12,0
2021,Hillingdon 024E,E01002404,676,265,99,166,5,5,236,187,49,169,161,8,1
2021,Hillingdon 027A,E01002405,646,317,126,191,9,9,145,88,57,174,162,12,1
2021,Hillingdon 019A,E01002408,662,255,106,149,5,5,208,163,45,192,172,20,2
2021,Hillingdon 019B,E01002409,700,337,143,194,5,5,184,130,54,173,163,10,1
2021,Hillingdon 017A,E01002410,678,437,219,218,3,3,44,15,29,194,180,14,0
2021,Hillingdon 022A,E01002411,714,324,134,190,8,8,228,134,94,152,129,23,2
2021,Hillingdon 017B,E01002412,792,491,232,259,3,3,78,15,63,218,198,20,2
2021,Hillingdon 022B,E01002413,599,287,123,164,2,2,209,174,35,99,90,9,2
2021,Hillingdon 015A,E01002414,531,270,142,128,1,1,47,32,15,212,191,21,1
2021,Hillingdon 010A,E01002415,640,548,248,300,3,3,15,9,6,74,68,6,0
2021,Hillingdon 008A,E01002416,593,486,232,254,1,1,30,18,12,76,72,4,0
2021,Hillingdon 008B,E01002417,751,562,285,277,3,3,26,13,13,158,145,13,2
2021,Hillingdon 006A,E01002418,657,511,257,254,0,0,91,77,14,55,51,4,0
2021,Hillingdon 006B,E01002419,644,497,217,280,5,5,14,10,4,128,115,13,0
2021,Hillingdon 008C,E01002420,670,434,215,219,4,4,127,46,81,105,91,14,0
2021,Hillingdon 008D,E01002421,627,498,238,260,3,3,36,30,6,89,80,9,1
2021,Hillingdon 018A,E01002422,495,319,145,174,8,8,24,12,12,143,126,17,1
2021,Hillingdon 018B,E01002423,604,428,201,227,12,12,47,4,43,117,105,12,0
2021,Hillingdon 018C,E01002424,531,370,168,202,9,9,16,5,11,136,122,14,0
2021,Hillingdon 018D,E01002425,601,307,123,184,9,9,135,110,25,150,137,13,0
2021,Hillingdon 021F,E01002426,651,373,157,216,3,3,33,16,17,242,224,18,0
2021,Hillingdon 018E,E01002427,520,378,185,193,24,24,25,7,18,93,85,8,0
2021,Hillingdon 018F,E01002428,514,394,168,226,5,5,24,14,10,91,82,9,0
2021,Hillingdon 019C,E01002429,523,263,92,171,9,9,146,115,31,105,99,6,0
2021,Hillingdon 007A,E01002430,523,489,281,208,0,0,11,4,7,23,20,3,0
2021,Hillingdon 006C,E01002431,487,441,257,184,2,2,7,4,3,37,35,2,0
2021,Hillingdon 006D,E01002432,634,438,262,176,0,0,23,8,15,173,163,10,0
2021,Hillingdon 004A,E01002433,1013,604,293,311,24,24,200,102,98,184,162,22,1
2021,Hillingdon 007B,E01002434,496,436,270,166,1,1,25,3,22,34,30,4,0
2021,Hillingdon 007C,E01002435,570,507,278,229,9,9,13,9,4,41,38,3,0
2021,Hillingdon 004B,E01002436,676,498,246,252,2,2,89,39,50,87,73,14,0
2021,Hillingdon 006E,E01002437,592,517,345,172,4,4,37,34,3,34,31,3,0
2021,Hillingdon 003A,E01002438,564,434,214,220,3,3,45,35,10,82,72,10,0
2021,Hillingdon 003B,E01002439,621,387,212,175,1,1,125,110,15,108,91,17,0
2021,Hillingdon 003C,E01002440,634,411,212,199,11,11,166,146,20,46,43,3,0
2021,Hillingdon 003D,E01002441,707,439,211,228,3,3,154,93,61,111,92,19,0
2021,Hillingdon 003E,E01002442,652,417,200,217,2,2,148,120,28,83,70,13,2
2021,Hillingdon 032A,E01002443,685,293,132,161,2,2,16,7,9,374,359,15,0
2021,Hillingdon 031A,E01002444,665,323,194,129,2,2,81,55,26,256,236,20,3
2021,Hillingdon 029A,E01002445,625,230,106,124,4,4,257,209,48,134,117,17,0
2021,Hillingdon 031B,E01002446,633,277,141,136,1,1,72,18,54,283,268,15,0
2021,Hillingdon 031C,E01002447,717,194,83,111,5,5,87,53,34,431,414,17,0
2021,Hillingdon 032B,E01002448,762,325,153,172,5,5,96,35,61,336,313,23,0
2021,Hillingdon 032C,E01002449,735,272,115,157,7,7,69,38,31,386,368,18,1
2021,Hillingdon 014A,E01002450,495,394,152,242,5,5,11,4,7,85,79,6,0
2021,Hillingdon 014B,E01002451,501,370,169,201,1,1,31,27,4,99,90,9,0
2021,Hillingdon 014C,E01002452,510,387,170,217,1,1,33,5,28,89,84,5,0
2021,Hillingdon 014D,E01002453,620,464,206,258,6,6,43,34,9,107,97,10,0
2021,Hillingdon 014E,E01002454,652,406,168,238,2,2,143,120,23,101,91,10,0
2021,Hillingdon 019D,E01002455,701,359,174,185,15,15,105,88,17,222,213,9,0
2021,Hillingdon 017C,E01002456,636,380,169,211,3,3,106,60,46,147,135,12,0
2021,Hillingdon 019E,E01002457,525,222,95,127,1,1,164,78,86,138,129,9,0
2021,Hillingdon 011A,E01002458,534,472,269,203,1,1,2,1,1,58,53,5,1
2021,Hillingdon 011B,E01002459,632,576,337,239,2,2,5,2,3,49,37,12,0
2021,Hillingdon 011C,E01002460,619,438,245,193,2,2,51,38,13,128,112,16,0
2021,Hillingdon 013A,E01002461,527,434,236,198,1,1,18,14,4,74,62,12,0
2021,Hillingdon 011D,E01002462,523,410,210,200,1,1,8,7,1,104,43,61,0
2021,Hillingdon 013B,E01002463,523,458,248,210,0,0,31,7,24,34,29,5,0
2021,Hillingdon 011E,E01002464,619,493,227,266,2,2,46,37,9,77,71,6,1
2021,Hillingdon 009A,E01002465,640,399,179,220,4,4,36,30,6,201,186,15,0
2021,Hillingdon 010B,E01002466,632,548,261,287,2,2,4,2,2,78,68,10,0
2021,Hillingdon 009B,E01002467,627,547,304,243,2,2,8,5,3,70,65,5,0
2021,Hillingdon 010C,E01002468,638,528,231,297,3,3,15,10,5,92,87,5,0
2021,Hillingdon 010D,E01002469,643,554,287,267,2,2,8,4,4,79,75,4,0
2021,Hillingdon 007D,E01002470,715,401,204,197,14,14,87,5,82,213,203,10,0
2021,Hillingdon 008E,E01002471,632,533,242,291,3,3,19,13,6,77,65,12,0
2021,Hillingdon 002A,E01002472,800,378,232,146,5,5,92,33,59,325,300,25,0
2021,Hillingdon 001A,E01002473,683,464,237,227,0,0,163,9,154,56,49,7,0
2021,Hillingdon 002B,E01002474,691,397,203,194,1,1,96,47,49,197,186,11,0
2021,Hillingdon 001B,E01002475,708,355,203,152,2,2,170,34,136,181,150,31,0
2021,Hillingdon 001C,E01002476,634,484,280,204,3,3,20,17,3,127,107,20,0
2021,Hillingdon 001D,E01002477,568,331,191,140,1,1,60,52,8,176,158,18,0
2021,Hillingdon 002C,E01002478,670,400,216,184,4,4,62,55,7,204,183,21,0
2021,Hillingdon 004C,E01002479,658,384,162,222,8,8,188,135,53,78,70,8,0
2021,Hillingdon 004D,E01002480,695,557,304,253,0,0,17,6,11,120,101,19,1
2021,Hillingdon 004E,E01002481,653,355,168,187,3,3,204,180,24,91,82,9,0
2021,Hillingdon 001E,E01002482,622,530,250,280,2,2,8,4,4,82,72,10,0
2021,Hillingdon 002D,E01002483,730,431,224,207,2,2,52,33,19,245,234,11,0
2021,Hillingdon 002E,E01002484,581,326,166,160,4,4,134,112,22,117,110,7,0
2021,Hillingdon 002F,E01002485,834,372,197,175,1,1,140,70,70,321,310,11,0
2021,Hillingdon 028A,E01002486,693,354,139,215,7,7,174,95,79,157,141,16,1
2021,Hillingdon 028B,E01002487,628,294,134,160,3,3,137,42,95,194,168,26,0
2021,Hillingdon 030B,E01002488,524,326,142,184,1,1,57,13,44,138,128,10,2
2021,Hillingdon 030C,E01002489,555,305,155,150,1,1,44,21,23,205,188,17,0
2021,Hillingdon 030D,E01002490,676,375,176,199,10,10,47,13,34,241,224,17,3
2021,Hillingdon 032D,E01002491,525,238,125,113,4,4,146,118,28,136,124,12,1
2021,Hillingdon 030E,E01002492,498,278,123,155,1,1,46,9,37,173,154,19,0
2021,Hillingdon 032E,E01002493,612,218,83,135,4,4,211,165,46,164,148,16,15
2021,Hillingdon 009C,E01002494,637,451,183,268,5,5,70,63,7,109,101,8,2
2021,Hillingdon 010E,E01002495,701,377,157,220,12,12,71,12,59,239,136,103,2
2021,Hillingdon 033A,E01002496,777,441,178,263,9,9,79,68,11,246,232,14,2
2021,Hillingdon 033B,E01002497,990,526,209,317,22,22,104,76,28,334,313,21,4
2021,Hillingdon 033C,E01002498,525,425,216,209,1,1,24,15,9,75,65,10,0
2021,Hillingdon 033D,E01002499,682,443,224,219,4,4,68,56,12,165,152,13,2
2021,Hillingdon 026B,E01002501,514,279,130,149,7,7,93,44,49,133,118,15,2
2021,Hillingdon 026C,E01002502,566,243,89,154,5,5,143,119,24,173,161,12,2
2021,Hillingdon 027C,E01002503,546,217,72,145,5,5,157,112,45,166,148,18,1
2021,Hillingdon 026D,E01002505,661,187,70,117,31,31,269,133,136,171,164,7,3
2021,Hillingdon 027E,E01002506,652,154,74,80,5,5,188,151,37,300,280,20,5
2021,Hillingdon 027F,E01002507,548,301,128,173,9,9,63,8,55,175,160,15,0
2021,Hillingdon 026E,E01002508,708,232,77,155,0,0,348,307,41,124,113,11,4
2021,Hillingdon 017D,E01002509,509,451,230,221,0,0,4,3,1,54,47,7,0
2021,Hillingdon 017E,E01002511,643,325,162,163,4,4,177,95,82,136,126,10,1
2021,Hillingdon 013C,E01002512,769,592,326,266,0,0,36,12,24,141,125,16,0
2021,Hillingdon 013D,E01002513,588,437,264,173,1,1,72,6,66,78,70,8,0
2021,Hillingdon 015C,E01002514,882,453,238,215,9,9,112,75,37,306,287,19,2
2021,Hillingdon 013E,E01002516,497,407,213,194,3,3,19,15,4,68,53,15,0
2021,Hillingdon 022C,E01002518,489,334,172,162,0,0,24,14,10,131,110,21,0
2021,Hillingdon 022D,E01002519,958,437,182,255,60,60,178,138,40,282,265,17,1
2021,Hillingdon 016B,E01002520,782,310,138,172,24,24,188,95,93,260,241,19,0
2021,Hillingdon 016C,E01002521,1017,241,98,143,34,34,379,296,83,358,340,18,5
2021,Hillingdon 016D,E01002523,545,303,138,165,6,6,59,49,10,176,159,17,1
2021,Hillingdon 029B,E01002525,686,448,199,249,18,18,60,34,26,160,141,19,0
2021,Hillingdon 028C,E01002526,999,400,111,289,45,45,285,125,160,269,252,17,0
2021,Hillingdon 031D,E01002527,627,330,183,147,6,6,123,36,87,168,156,12,0
2021,Hillingdon 028D,E01002528,580,300,140,160,4,4,189,135,54,87,83,4,0
2021,Hillingdon 029C,E01002529,908,383,139,244,10,10,149,28,121,366,344,22,0
2021,Hillingdon 029D,E01002530,616,233,102,131,6,6,270,199,71,103,95,8,4
2021,Hillingdon 029E,E01002531,651,383,197,186,9,9,129,15,114,129,117,12,1
2021,Hillingdon 005A,E01002533,584,369,158,211,8,8,134,53,81,73,65,8,0
2021,Hillingdon 005B,E01002534,598,437,208,229,0,0,102,83,19,58,52,6,1
2021,Hillingdon 007E,E01002535,1000,527,290,237,11,11,57,6,51,405,378,27,0
2021,Hillingdon 009D,E01002536,590,308,167,141,5,5,16,8,8,261,163,98,0
2021,Hillingdon 009E,E01002537,1039,640,279,361,38,38,62,7,55,299,224,75,0
2021,Hillingdon 005C,E01002538,762,522,274,248,13,13,103,93,10,124,103,21,0
2021,Hillingdon 005D,E01002539,696,532,304,228,1,1,88,30,58,74,64,10,1
2021,Hillingdon 020C,E01002540,644,301,111,190,10,10,161,98,63,172,160,12,0
2021,Hillingdon 023A,E01002541,802,515,204,311,37,37,59,12,47,191,184,7,0
2021,Hillingdon 020D,E01002542,704,237,99,138,4,4,216,186,30,245,229,16,2
2021,Hillingdon 020E,E01002543,641,296,108,188,7,7,163,99,64,175,168,7,0
2021,Hillingdon 023B,E01002544,557,359,162,197,2,2,25,8,17,171,160,11,0
2021,Hillingdon 023C,E01002545,492,86,53,33,1,1,339,24,315,66,62,4,0
2021,Hillingdon 023D,E01002546,456,278,117,161,0,0,43,34,9,134,117,17,1
2021,Hillingdon 023E,E01002547,507,227,121,106,13,13,69,22,47,196,175,21,2
2021,Hillingdon 025A,E01002548,733,282,126,156,9,9,305,248,57,133,127,6,4
2021,Hillingdon 025B,E01002549,715,414,175,239,5,5,151,75,76,145,136,9,0
2021,Hillingdon 022E,E01002550,795,297,110,187,17,17,158,99,59,321,312,9,2
2021,Hillingdon 025C,E01002551,686,339,142,197,5,5,165,132,33,175,154,21,2
2021,Hillingdon 025D,E01002552,569,266,104,162,5,5,167,128,39,131,121,10,0
2021,Hillingdon 025E,E01002553,624,243,101,142,14,14,238,156,82,129,120,9,0
2021,Hounslow 022A,E01002555,704,439,210,229,7,7,43,19,24,215,197,18,0
2021,Hounslow 022B,E01002556,662,382,153,229,4,4,86,68,18,189,175,14,1
2021,Hounslow 023A,E01002557,734,366,144,222,32,32,147,106,41,187,174,13,2
2021,Hounslow 023B,E01002558,819,295,116,179,51,51,290,57,233,180,169,11,3
2021,Hounslow 023C,E01002559,919,321,114,207,76,76,314,236,78,204,195,9,4
2021,Hounslow 023D,E01002560,661,334,144,190,37,37,172,129,43,117,102,15,1
2021,Hounslow 023E,E01002561,597,117,31,86,76,76,315,161,154,89,86,3,0
2021,Hounslow 030D,E01002562,523,234,113,121,6,6,199,191,8,82,73,9,2
2021,Hounslow 006A,E01002563,746,421,217,204,61,61,78,25,53,185,165,20,1
2021,Hounslow 031E,E01002564,730,317,127,190,3,3,277,233,44,124,113,11,9
2021,Hounslow 006B,E01002565,1054,479,189,290,34,34,248,127,121,291,262,29,2
2021,Hounslow 006C,E01002567,872,480,233,247,5,5,103,82,21,284,270,14,0
2021,Hounslow 001A,E01002569,964,478,225,253,42,42,78,49,29,365,347,18,1
2021,Hounslow 001B,E01002570,667,270,132,138,1,1,99,40,59,297,282,15,0
2021,Hounslow 007A,E01002571,589,415,230,185,3,3,21,12,9,150,145,5,0
2021,Hounslow 007B,E01002572,619,202,72,130,5,5,287,234,53,120,100,20,5
2021,Hounslow 001C,E01002573,638,393,231,162,1,1,72,16,56,172,163,9,0
2021,Hounslow 001D,E01002574,684,352,175,177,4,4,99,63,36,229,205,24,0
2021,Hounslow 001E,E01002575,665,390,215,175,0,0,58,46,12,217,204,13,0
2021,Hounslow 008A,E01002576,704,321,147,174,0,0,236,149,87,145,132,13,2
2021,Hounslow 007C,E01002577,681,383,187,196,1,1,60,39,21,235,216,19,2
2021,Hounslow 007D,E01002578,590,385,188,197,2,2,82,47,35,121,105,16,0
2021,Hounslow 008B,E01002579,771,480,267,213,2,2,94,83,11,189,164,25,6
2021,Hounslow 008C,E01002580,680,228,95,133,4,4,195,73,122,253,246,7,0
2021,Hounslow 008D,E01002581,841,438,192,246,6,6,57,41,16,339,314,25,1
2021,Hounslow 008E,E01002582,694,480,224,256,3,3,64,51,13,147,135,12,0
2021,Hounslow 013A,E01002583,535,279,146,133,5,5,41,15,26,210,198,12,0
2021,Hounslow 013B,E01002584,635,250,143,107,4,4,19,14,5,359,338,21,3
2021,Hounslow 013C,E01002585,521,223,115,108,5,5,112,107,5,178,166,12,3
2021,Hounslow 013D,E01002586,499,267,171,96,1,1,9,8,1,222,206,16,0
2021,Hounslow 016A,E01002587,739,327,214,113,4,4,138,74,64,268,256,12,2
2021,Hounslow 016B,E01002588,744,93,32,61,4,4,539,62,477,103,87,16,5
2021,Hounslow 013E,E01002589,816,247,94,153,24,24,268,239,29,275,192,83,2
2021,Hounslow 022C,E01002590,998,419,171,248,2,2,340,271,69,209,191,18,28
2021,Hounslow 024A,E01002591,609,370,144,226,7,7,154,131,23,77,67,10,1
2021,Hounslow 022D,E01002592,776,362,170,192,2,2,201,185,16,205,194,11,6
2021,Hounslow 024B,E01002593,697,413,188,225,5,5,74,68,6,203,170,33,2
2021,Hounslow 024C,E01002594,647,408,190,218,14,14,48,34,14,176,161,15,1
2021,Hounslow 022E,E01002595,715,318,140,178,15,15,251,213,38,128,114,14,3
2021,Hounslow 027A,E01002596,756,318,81,237,25,25,122,25,97,290,271,19,1
2021,Hounslow 025B,E01002598,657,316,130,186,19,19,174,130,44,147,134,13,1
2021,Hounslow 025C,E01002599,557,306,122,184,9,9,161,62,99,81,75,6,0
2021,Hounslow 025D,E01002600,513,269,105,164,5,5,157,142,15,82,75,7,0
2021,Hounslow 027B,E01002601,667,370,120,250,30,30,85,42,43,182,179,3,0
2021,Hounslow 027C,E01002602,550,437,175,262,8,8,36,29,7,67,60,7,2
2021,Hounslow 025E,E01002603,648,280,75,205,14,14,191,71,120,160,151,9,3
2021,Hounslow 026A,E01002604,557,104,37,67,3,3,391,91,300,56,48,8,3
2021,Hounslow 026B,E01002605,831,346,154,192,24,24,262,74,188,198,186,12,1
2021,Hounslow 026C,E01002606,616,192,76,116,1,1,341,308,33,73,67,6,9
2021,Hounslow 026D,E01002607,778,417,161,256,31,31,118,37,81,212,200,12,0
2021,Hounslow 028A,E01002608,663,307,120,187,15,15,215,177,38,124,115,9,2
2021,Hounslow 028B,E01002609,664,475,216,259,22,22,45,31,14,121,114,7,1
2021,Hounslow 028C,E01002610,631,283,125,158,13,13,253,233,20,79,68,11,3
2021,Hounslow 024D,E01002611,673,390,175,215,3,3,152,30,122,128,116,12,0
2021,Hounslow 024E,E01002612,825,367,171,196,10,10,206,128,78,236,209,27,6
2021,Hounslow 024F,E01002613,632,387,165,222,10,10,109,98,11,126,114,12,0
2021,Hounslow 027D,E01002614,822,428,172,256,26,26,59,17,42,306,291,15,3
2021,Hounslow 026E,E01002615,634,194,72,122,8,8,361,313,48,68,62,6,3
2021,Hounslow 027E,E01002616,567,362,190,172,18,18,85,48,37,102,98,4,0
2021,Hounslow 028D,E01002617,638,483,228,255,3,3,37,17,20,115,103,12,0
2021,Hounslow 011A,E01002618,560,397,207,190,5,5,12,5,7,142,128,14,4
2021,Hounslow 010A,E01002619,633,390,226,164,1,1,68,58,10,168,156,12,6
2021,Hounslow 004A,E01002620,897,335,94,241,41,41,226,77,149,291,280,11,4
2021,Hounslow 011B,E01002621,607,282,124,158,6,6,126,51,75,185,170,15,8
2021,Hounslow 010B,E01002622,573,279,161,118,3,3,107,9,98,184,172,12,0
2021,Hounslow 011C,E01002623,543,232,110,122,1,1,137,23,114,173,161,12,0
2021,Hounslow 017A,E01002624,516,212,117,95,10,10,101,67,34,192,175,17,1
2021,Hounslow 004B,E01002625,488,324,168,156,2,2,21,12,9,140,122,18,1
2021,Hounslow 004C,E01002626,485,310,157,153,3,3,27,13,14,145,115,30,0
2021,Hounslow 004D,E01002627,609,230,94,136,2,2,234,228,6,139,131,8,4
2021,Hounslow 011D,E01002628,651,389,224,165,1,1,28,14,14,232,222,10,1
2021,Hounslow 011E,E01002629,883,325,174,151,64,64,218,85,133,273,251,22,3
2021,Hounslow 012A,E01002630,679,270,151,119,0,0,38,13,25,371,342,29,0
2021,Hounslow 004E,E01002631,557,317,131,186,4,4,50,37,13,184,168,16,2
2021,Hounslow 010C,E01002632,626,328,164,164,16,16,143,101,42,138,127,11,1
2021,Hounslow 005A,E01002633,744,232,88,144,6,6,367,313,54,136,130,6,3
2021,Hounslow 005B,E01002634,540,143,57,86,13,13,280,263,17,97,86,11,7
2021,Hounslow 010D,E01002635,556,300,169,131,3,3,52,45,7,201,184,17,0
2021,Hounslow 010E,E01002636,618,368,189,179,5,5,39,33,6,202,183,19,4
2021,Hounslow 005C,E01002637,614,229,115,114,13,13,214,203,11,152,137,15,6
2021,Hounslow 005D,E01002638,620,245,96,149,3,3,205,136,69,164,139,25,3
2021,Hounslow 012B,E01002639,548,290,184,106,2,2,4,3,1,250,238,12,2
2021,Hounslow 012C,E01002640,625,285,165,120,1,1,16,9,7,321,306,15,2
2021,Hounslow 018A,E01002641,988,243,162,81,9,9,229,136,93,506,487,19,1
2021,Hounslow 015B,E01002643,1047,381,208,173,92,92,309,151,158,261,245,16,4
2021,Hounslow 015C,E01002645,777,313,149,164,1,1,157,50,107,305,295,10,1
2021,Hounslow 017B,E01002646,748,210,102,108,13,13,275,207,68,245,229,16,5
2021,Hounslow 021A,E01002647,754,308,135,173,25,25,205,113,92,215,201,14,1
2021,Hounslow 018D,E01002649,730,244,107,137,3,3,104,51,53,375,362,13,4
2021,Hounslow 021B,E01002650,795,328,138,190,18,18,148,27,121,299,284,15,2
2021,Hounslow 021C,E01002651,564,251,144,107,5,5,41,11,30,267,253,14,0
2021,Hounslow 021D,E01002652,563,307,172,135,1,1,42,24,18,213,200,13,0
2021,Hounslow 019A,E01002653,599,395,219,176,3,3,11,4,7,190,182,8,0
2021,Hounslow 019B,E01002654,662,466,239,227,8,8,17,6,11,171,150,21,0
2021,Hounslow 019C,E01002655,629,412,209,203,2,2,18,11,7,196,186,10,1
2021,Hounslow 019D,E01002656,523,378,197,181,0,0,45,36,9,100,90,10,0
2021,Hounslow 018E,E01002657,682,449,220,229,4,4,29,12,17,200,188,12,0
2021,Hounslow 015D,E01002658,494,363,175,188,1,1,18,5,13,112,108,4,0
2021,Hounslow 019E,E01002659,511,337,142,195,9,9,51,21,30,110,96,14,4
2021,Hounslow 016C,E01002660,614,233,136,97,7,7,98,32,66,276,263,13,0
2021,Hounslow 016D,E01002661,617,290,180,110,2,2,9,4,5,315,281,34,1
2021,Hounslow 017C,E01002662,917,337,205,132,1,1,69,13,56,509,481,28,1
2021,Hounslow 017D,E01002663,688,230,119,111,8,8,195,166,29,250,240,10,5
2021,Hounslow 016E,E01002665,567,207,119,88,11,11,166,155,11,176,161,15,7
2021,Hounslow 021E,E01002666,483,279,138,141,6,6,50,43,7,148,140,8,0
2021,Hounslow 020A,E01002667,913,450,177,273,13,13,237,130,107,213,193,20,0
2021,Hounslow 014A,E01002668,981,477,170,307,12,12,157,100,57,335,314,21,0
2021,Hounslow 014B,E01002669,710,279,101,178,10,10,304,236,68,115,104,11,2
2021,Hounslow 020B,E01002670,728,465,180,285,6,6,90,28,62,166,158,8,1
2021,Hounslow 020C,E01002671,666,419,175,244,3,3,155,149,6,89,83,6,0
2021,Hounslow 020D,E01002672,661,172,74,98,18,18,263,232,31,208,200,8,0
2021,Hounslow 020E,E01002673,584,85,41,44,1,1,437,428,9,58,53,5,3
2021,Hounslow 012D,E01002674,748,416,196,220,4,4,20,7,13,308,287,21,0
2021,Hounslow 009A,E01002675,876,519,223,296,47,47,94,6,88,216,201,15,0
2021,Hounslow 012E,E01002676,561,392,214,178,1,1,8,3,5,160,147,13,0
2021,Hounslow 015E,E01002677,838,380,121,259,39,39,120,38,82,296,275,21,3
2021,Hounslow 009B,E01002678,760,411,231,180,1,1,25,3,22,323,286,37,0
2021,Hounslow 009C,E01002679,621,369,187,182,1,1,30,7,23,221,192,29,0
2021,Hounslow 009D,E01002680,742,413,192,221,4,4,50,16,34,275,251,24,0
2021,Hounslow 014C,E01002681,873,299,114,185,29,29,293,13,280,252,234,18,0
2021,Hounslow 014D,E01002682,899,440,160,280,29,29,186,129,57,242,209,33,2
2021,Hounslow 006E,E01002686,669,206,78,128,7,7,341,309,32,109,92,17,6
2021,Hounslow 029A,E01002687,760,319,152,167,8,8,74,46,28,358,338,20,1
2021,Hounslow 007E,E01002689,754,371,216,155,0,0,209,191,18,168,154,14,6
2021,Hounslow 007F,E01002690,583,349,185,164,1,1,108,58,50,123,109,14,2
2021,Hounslow 029B,E01002691,586,346,181,165,2,2,10,3,7,228,216,12,0
2021,Hounslow 029C,E01002692,1013,368,164,204,11,11,136,92,44,497,473,24,1
2021,Hounslow 029D,E01002693,885,393,236,157,4,4,147,99,48,339,323,16,2
2021,Islington 019A,E01002694,666,61,26,35,9,9,475,70,405,120,117,3,1
2021,Islington 021A,E01002695,744,130,63,67,13,13,251,66,185,350,327,23,0
2021,Islington 020A,E01002696,860,274,147,127,22,22,227,145,82,337,318,19,0
2021,Islington 019B,E01002697,827,75,35,40,13,13,513,64,449,223,210,13,3
2021,Islington 017A,E01002698,1038,358,153,205,5,5,299,155,144,373,345,28,3
2021,Islington 017B,E01002699,740,225,125,100,5,5,311,109,202,198,186,12,1
2021,Islington 017C,E01002700,609,353,196,157,2,2,95,65,30,159,149,10,0
2021,Islington 023A,E01002701,680,103,48,55,1,1,415,278,137,158,143,15,3
2021,Islington 023B,E01002702,1113,118,59,59,61,61,614,458,156,316,302,14,4
2021,Islington 023C,E01002703,1126,222,84,138,36,36,515,429,86,349,322,27,4
2021,Islington 023D,E01002704,1122,224,92,132,26,26,528,221,307,342,318,24,2
2021,Islington 023E,E01002706,913,156,71,85,5,5,509,241,268,238,218,20,5
2021,Islington 022B,E01002707,890,164,82,82,15,15,383,323,60,322,308,14,6
2021,Islington 015A,E01002708,999,210,92,118,12,12,422,278,144,351,332,19,4
2021,Islington 019C,E01002709,700,104,54,50,9,9,357,167,190,228,214,14,2
2021,Islington 019D,E01002710,645,125,58,67,6,6,360,250,110,148,139,9,6
2021,Islington 021B,E01002711,962,202,91,111,28,28,307,93,214,423,396,27,2
2021,Islington 015B,E01002712,610,151,59,92,7,7,225,117,108,226,211,15,1
2021,Islington 015C,E01002713,1050,183,73,110,24,24,639,474,165,199,185,14,5
2021,Islington 017D,E01002714,722,265,128,137,2,2,132,60,72,323,297,26,0
2021,Islington 019E,E01002715,687,100,37,63,8,8,442,367,75,135,128,7,2
2021,Islington 014A,E01002716,1033,178,57,121,16,16,600,440,160,235,219,16,4
2021,Islington 016A,E01002717,535,202,98,104,2,2,184,175,9,145,124,21,2
2021,Islington 014B,E01002718,750,310,142,168,6,6,150,72,78,284,264,20,0
2021,Islington 016B,E01002719,690,305,159,146,5,5,182,112,70,195,171,24,3
2021,Islington 016C,E01002720,934,142,45,97,37,37,610,488,122,144,136,8,1
2021,Islington 014C,E01002721,801,223,72,151,6,6,346,290,56,224,215,9,2
2021,Islington 018A,E01002722,698,130,55,75,5,5,348,312,36,209,197,12,6
2021,Islington 022C,E01002723,736,146,62,84,20,20,385,367,18,184,168,16,1
2021,Islington 022D,E01002724,963,279,137,142,2,2,223,63,160,459,407,52,0
2021,Islington 022E,E01002725,560,77,38,39,2,2,389,353,36,89,77,12,3
2021,Islington 022F,E01002726,782,176,82,94,10,10,363,312,51,230,218,12,3
2021,Islington 021C,E01002727,802,246,123,123,3,3,309,264,45,241,219,22,3
2021,Islington 021D,E01002728,437,88,44,44,5,5,222,203,19,120,112,8,2
2021,Islington 021E,E01002729,659,228,124,104,4,4,242,203,39,184,173,11,1
2021,Islington 007A,E01002730,793,189,91,98,6,6,186,72,114,409,384,25,3
2021,Islington 005A,E01002732,813,107,40,67,5,5,500,152,348,199,181,18,2
2021,Islington 007C,E01002733,606,263,108,155,7,7,115,35,80,221,205,16,0
2021,Islington 005B,E01002734,937,110,44,66,9,9,432,339,93,379,364,15,7
2021,Islington 003A,E01002735,1131,266,111,155,22,22,298,160,138,543,518,25,2
2021,Islington 005C,E01002736,576,75,39,36,5,5,410,386,24,78,74,4,8
2021,Islington 005D,E01002737,758,146,56,90,2,2,457,328,129,149,133,16,4
2021,Islington 009A,E01002738,847,325,162,163,12,12,268,132,136,239,214,25,3
2021,Islington 013A,E01002739,815,369,167,202,10,10,206,93,113,230,210,20,0
2021,Islington 013B,E01002740,980,366,184,182,33,33,156,68,88,425,392,33,0
2021,Islington 009B,E01002741,633,135,52,83,9,9,366,321,45,121,108,13,2
2021,Islington 006A,E01002742,713,321,142,179,0,0,162,65,97,230,221,9,0
2021,Islington 009C,E01002743,628,231,84,147,4,4,199,135,64,191,181,10,3
2021,Islington 009D,E01002744,677,261,107,154,7,7,223,176,47,184,168,16,2
2021,Islington 013C,E01002745,685,287,149,138,5,5,205,99,106,187,177,10,1
2021,Islington 006B,E01002747,649,310,151,159,0,0,129,38,91,210,199,11,0
2021,Islington 006C,E01002748,695,150,54,96,2,2,333,150,183,209,195,14,1
2021,Islington 006D,E01002749,602,203,80,123,22,22,245,174,71,132,124,8,0
2021,Islington 005E,E01002751,875,139,77,62,7,7,509,428,81,215,202,13,5
2021,Islington 009E,E01002752,707,242,100,142,2,2,270,212,58,187,180,7,6
2021,Islington 002A,E01002753,627,135,62,73,10,10,281,145,136,199,189,10,2
2021,Islington 002B,E01002754,630,295,140,155,3,3,147,102,45,183,176,7,2
2021,Islington 001A,E01002755,611,140,57,83,0,0,375,278,97,96,89,7,0
2021,Islington 001B,E01002756,585,246,96,150,6,6,193,137,56,139,133,6,1
2021,Islington 002C,E01002757,599,226,94,132,13,13,252,184,68,108,96,12,0
2021,Islington 001C,E01002758,755,101,28,73,17,17,478,378,100,156,144,12,3
2021,Islington 002D,E01002759,615,297,130,167,2,2,165,127,38,151,147,4,0
2021,Islington 002E,E01002760,689,163,52,111,27,27,379,301,78,116,108,8,4
2021,Islington 011C,E01002762,859,261,129,132,10,10,247,108,139,338,322,16,3
2021,Islington 007D,E01002763,572,133,66,67,3,3,240,163,77,195,177,18,1
2021,Islington 010A,E01002764,796,197,95,102,1,1,367,196,171,226,198,28,5
2021,Islington 015D,E01002765,1075,157,50,107,52,52,562,206,356,296,283,13,8
2021,Islington 015E,E01002766,933,128,51,77,45,45,577,195,382,179,159,20,4
2021,Islington 011D,E01002767,943,220,92,128,30,30,442,374,68,248,229,19,3
2021,Islington 004A,E01002768,848,199,83,116,19,19,408,111,297,222,215,7,0
2021,Islington 008A,E01002769,705,326,174,152,3,3,228,67,161,148,135,13,0
2021,Islington 004B,E01002770,909,267,98,169,7,7,183,128,55,450,427,23,2
2021,Islington 004C,E01002771,674,167,73,94,2,2,295,120,175,210,202,8,0
2021,Islington 002F,E01002772,879,255,114,141,20,20,265,169,96,337,321,16,2
2021,Islington 004D,E01002773,685,122,37,85,7,7,441,409,32,111,98,13,4
2021,Islington 004E,E01002774,1028,213,97,116,6,6,484,195,289,320,296,24,5
2021,Islington 014D,E01002775,661,219,90,129,3,3,178,142,36,261,235,26,0
2021,Islington 014E,E01002776,889,271,98,173,17,17,342,252,90,256,243,13,3
2021,Islington 012A,E01002777,762,226,86,140,12,12,272,144,128,251,234,17,1
2021,Islington 012B,E01002778,755,105,37,68,2,2,473,395,78,173,164,9,2
2021,Islington 012C,E01002779,775,263,100,163,11,11,219,148,71,282,269,13,0
2021,Islington 014F,E01002780,769,221,92,129,8,8,356,266,90,184,173,11,0
2021,Islington 012D,E01002781,644,129,57,72,3,3,304,273,31,204,165,39,4
2021,Islington 012E,E01002782,559,85,35,50,5,5,367,338,29,98,90,8,4
2021,Islington 010B,E01002783,797,165,59,106,12,12,394,350,44,222,211,11,4
2021,Islington 010C,E01002784,753,184,62,122,12,12,388,319,69,167,155,12,2
2021,Islington 008B,E01002785,782,355,169,186,9,9,157,65,92,261,242,19,0
2021,Islington 010D,E01002786,884,174,66,108,7,7,441,319,122,261,241,20,1
2021,Islington 010E,E01002787,625,146,55,91,15,15,267,174,93,193,178,15,4
2021,Islington 008C,E01002788,889,353,145,208,6,6,222,101,121,306,277,29,2
2021,Islington 008D,E01002789,779,408,203,205,0,0,149,37,112,222,210,12,0
2021,Islington 016D,E01002790,693,80,41,39,4,4,495,133,362,113,98,15,1
2021,Islington 016E,E01002791,850,286,141,145,18,18,209,156,53,336,318,18,1
2021,Islington 017E,E01002792,883,297,136,161,1,1,240,138,102,345,317,28,0
2021,Islington 016F,E01002793,899,155,52,103,7,7,491,309,182,242,228,14,4
2021,Islington 020B,E01002794,1016,275,147,128,27,27,297,64,233,417,397,20,0
2021,Islington 013D,E01002795,855,245,104,141,13,13,289,183,106,302,290,12,6
2021,Islington 013E,E01002796,506,139,63,76,3,3,214,128,86,149,137,12,1
2021,Islington 018B,E01002797,872,158,56,102,23,23,407,307,100,281,263,18,3
2021,Islington 018C,E01002798,898,463,201,262,5,5,197,135,62,233,211,22,0
2021,Islington 018D,E01002799,859,143,61,82,3,3,505,319,186,206,200,6,2
2021,Islington 018E,E01002800,795,142,47,95,9,9,432,139,293,210,197,13,2
2021,Islington 020C,E01002801,758,304,166,138,7,7,196,120,76,251,234,17,0
2021,Islington 020D,E01002802,822,271,139,132,21,21,244,87,157,284,265,19,2
2021,Islington 001D,E01002804,710,145,55,90,3,3,354,174,180,207,197,10,1
2021,Islington 003B,E01002805,718,195,73,122,4,4,174,126,48,344,332,12,1
2021,Islington 003C,E01002806,701,301,114,187,0,0,211,153,58,186,161,25,3
2021,Islington 001E,E01002807,806,159,68,91,6,6,372,284,88,244,238,6,25
2021,Islington 003D,E01002808,865,279,110,169,11,11,245,185,60,323,311,12,7
2021,Islington 003E,E01002809,737,217,74,143,6,6,281,106,175,233,218,15,0
2021,Islington 003F,E01002810,794,185,72,113,16,16,340,224,116,226,216,10,27
2021,Islington 001F,E01002811,733,191,81,110,4,4,401,333,68,132,120,12,5
2021,Kensington and Chelsea 013A,E01002812,732,237,153,84,0,0,13,1,12,482,456,26,0
2021,Kensington and Chelsea 011A,E01002813,682,365,250,115,0,0,42,11,31,275,249,26,0
2021,Kensington and Chelsea 015A,E01002814,1020,269,184,85,25,25,330,91,239,395,355,40,1
2021,Kensington and Chelsea 011B,E01002815,630,216,142,74,3,3,58,6,52,352,322,30,1
2021,Kensington and Chelsea 011C,E01002816,545,179,125,54,1,1,13,7,6,352,326,26,0
2021,Kensington and Chelsea 011D,E01002817,607,307,189,118,2,2,24,8,16,273,238,35,1
2021,Kensington and Chelsea 012A,E01002818,719,181,137,44,7,7,26,7,19,505,437,68,0
2021,Kensington and Chelsea 012B,E01002819,570,199,133,66,2,2,53,43,10,314,278,36,2
2021,Kensington and Chelsea 014A,E01002821,537,255,172,83,3,3,41,23,18,238,211,27,0
2021,Kensington and Chelsea 014B,E01002823,606,130,86,44,2,2,339,86,253,133,116,17,2
2021,Kensington and Chelsea 008A,E01002824,549,291,189,102,2,2,40,22,18,216,186,30,0
2021,Kensington and Chelsea 008B,E01002825,729,355,258,97,6,6,76,13,63,292,248,44,0
2021,Kensington and Chelsea 008C,E01002826,635,230,155,75,5,5,29,12,17,371,322,49,0
2021,Kensington and Chelsea 008D,E01002827,792,390,249,141,3,3,23,6,17,376,352,24,0
2021,Kensington and Chelsea 008E,E01002828,623,262,164,98,6,6,108,76,32,244,209,35,3
2021,Kensington and Chelsea 004A,E01002829,723,122,62,60,3,3,429,35,394,166,160,6,3
2021,Kensington and Chelsea 004B,E01002830,826,128,68,60,15,15,464,161,303,213,197,16,6
2021,Kensington and Chelsea 004C,E01002831,885,167,73,94,1,1,497,197,300,218,188,30,2
2021,Kensington and Chelsea 004D,E01002832,787,148,83,65,7,7,403,148,255,229,202,27,0
2021,Kensington and Chelsea 007A,E01002833,651,225,139,86,5,5,142,30,112,279,257,22,0
2021,Kensington and Chelsea 013B,E01002834,610,228,124,104,5,5,62,4,58,315,275,40,0
2021,Kensington and Chelsea 016C,E01002835,646,260,164,96,3,3,26,6,20,357,310,47,0
2021,Kensington and Chelsea 016D,E01002836,708,273,187,86,0,0,60,7,53,375,340,35,0
2021,Kensington and Chelsea 016E,E01002837,493,209,137,72,2,2,27,5,22,255,230,25,0
2021,Kensington and Chelsea 013C,E01002839,855,195,113,82,3,3,172,10,162,485,459,26,0
2021,Kensington and Chelsea 021A,E01002840,541,144,111,33,3,3,336,259,77,58,44,14,0
2021,Kensington and Chelsea 021B,E01002841,607,221,106,115,9,9,188,106,82,189,161,28,0
2021,Kensington and Chelsea 021C,E01002842,404,54,35,19,2,2,315,294,21,30,26,4,3
2021,Kensington and Chelsea 021D,E01002843,631,90,52,38,4,4,457,166,291,80,69,11,0
2021,Kensington and Chelsea 019A,E01002844,615,252,181,71,4,4,110,18,92,249,214,35,0
2021,Kensington and Chelsea 019B,E01002845,615,227,145,82,5,5,184,166,18,196,169,27,3
2021,Kensington and Chelsea 017A,E01002846,716,147,63,84,8,8,159,25,134,401,375,26,1
2021,Kensington and Chelsea 015B,E01002847,713,228,124,104,2,2,81,11,70,402,374,28,0
2021,Kensington and Chelsea 015C,E01002848,710,162,89,73,3,3,197,33,164,348,331,17,0
2021,Kensington and Chelsea 017B,E01002849,739,248,144,104,3,3,111,10,101,376,350,26,1
2021,Kensington and Chelsea 013D,E01002850,631,191,102,89,6,6,69,6,63,365,326,39,0
2021,Kensington and Chelsea 015D,E01002851,797,107,58,49,6,6,411,27,384,270,262,8,3
2021,Kensington and Chelsea 001A,E01002852,849,96,44,52,47,47,556,241,315,149,124,25,1
2021,Kensington and Chelsea 001B,E01002853,587,47,19,28,8,8,408,74,334,123,112,11,1
2021,Kensington and Chelsea 001C,E01002854,461,57,25,32,2,2,344,328,16,55,43,12,3
2021,Kensington and Chelsea 001D,E01002855,722,102,49,53,10,10,472,330,142,133,119,14,5
2021,Kensington and Chelsea 004E,E01002856,767,111,62,49,7,7,394,33,361,253,239,14,2
2021,Kensington and Chelsea 001E,E01002857,554,50,19,31,0,0,467,342,125,34,26,8,3
2021,Kensington and Chelsea 014C,E01002858,636,157,127,30,2,2,192,183,9,284,250,34,1
2021,Kensington and Chelsea 012C,E01002859,660,242,157,85,4,4,16,4,12,398,330,68,0
2021,Kensington and Chelsea 012D,E01002860,575,250,169,81,2,2,25,14,11,298,261,37,0
2021,Kensington and Chelsea 014D,E01002861,554,192,132,60,0,0,133,10,123,229,206,23,0
2021,Kensington and Chelsea 014E,E01002862,711,85,59,26,3,3,279,48,231,344,323,21,0
2021,Kensington and Chelsea 012E,E01002863,555,191,132,59,2,2,25,10,15,337,301,36,0
2021,Kensington and Chelsea 009A,E01002864,531,272,196,76,1,1,39,4,35,219,193,26,0
2021,Kensington and Chelsea 011E,E01002865,562,237,164,73,0,0,17,7,10,308,289,19,0
2021,Kensington and Chelsea 009B,E01002866,766,239,132,107,8,8,202,83,119,316,286,30,1
2021,Kensington and Chelsea 009C,E01002867,809,258,131,127,16,16,146,24,122,389,364,25,0
2021,Kensington and Chelsea 009D,E01002868,529,340,251,89,3,3,20,8,12,166,145,21,0
2021,Kensington and Chelsea 009E,E01002869,748,224,134,90,6,6,163,28,135,355,299,56,0
2021,Kensington and Chelsea 005A,E01002870,690,52,26,26,35,35,527,299,228,69,58,11,7
2021,Kensington and Chelsea 007B,E01002871,644,337,210,127,2,2,41,2,39,264,237,27,0
2021,Kensington and Chelsea 005B,E01002872,654,99,58,41,6,6,454,88,366,93,85,8,2
2021,Kensington and Chelsea 007C,E01002873,657,237,142,95,9,9,211,12,199,200,169,31,0
2021,Kensington and Chelsea 007D,E01002874,587,192,99,93,3,3,194,64,130,197,170,27,1
2021,Kensington and Chelsea 007E,E01002875,579,277,197,80,2,2,105,18,87,195,157,38,0
2021,Kensington and Chelsea 003A,E01002876,692,328,187,141,2,2,195,27,168,167,160,7,0
2021,Kensington and Chelsea 003B,E01002877,760,116,62,54,40,40,479,317,162,121,91,30,4
2021,Kensington and Chelsea 003C,E01002878,754,200,108,92,13,13,323,86,237,214,199,15,4
2021,Kensington and Chelsea 005C,E01002879,704,75,41,34,12,12,451,352,99,163,152,11,3
2021,Kensington and Chelsea 005D,E01002880,456,46,31,15,16,16,326,272,54,65,57,8,3
2021,Kensington and Chelsea 005E,E01002881,512,78,44,34,20,20,341,223,118,71,64,7,2
2021,Kensington and Chelsea 006A,E01002882,559,204,134,70,3,3,169,60,109,179,157,22,4
2021,Kensington and Chelsea 006B,E01002883,648,320,230,90,5,5,38,8,30,285,223,62,0
2021,Kensington and Chelsea 006C,E01002884,595,155,101,54,30,30,111,17,94,298,282,16,1
2021,Kensington and Chelsea 006D,E01002885,803,210,119,91,4,4,70,13,57,518,480,38,1
2021,Kensington and Chelsea 006E,E01002886,665,288,179,109,5,5,96,30,66,276,240,36,0
2021,Kensington and Chelsea 010A,E01002887,551,190,120,70,2,2,23,6,17,336,303,33,0
2021,Kensington and Chelsea 013E,E01002888,828,275,176,99,3,3,49,3,46,501,466,35,0
2021,Kensington and Chelsea 010B,E01002889,565,254,205,49,1,1,32,4,28,278,255,23,0
2021,Kensington and Chelsea 010C,E01002890,564,312,221,91,4,4,14,3,11,234,196,38,0
2021,Kensington and Chelsea 010D,E01002891,558,219,154,65,2,2,28,8,20,308,260,48,1
2021,Kensington and Chelsea 010E,E01002892,640,234,141,93,2,2,33,4,29,370,323,47,1
2021,Kensington and Chelsea 017C,E01002893,903,259,133,126,4,4,210,90,120,430,392,38,0
2021,Kensington and Chelsea 017D,E01002894,656,206,104,102,0,0,93,32,61,356,324,32,1
2021,Kensington and Chelsea 020C,E01002896,758,338,207,131,2,2,39,23,16,379,347,32,0
2021,Kensington and Chelsea 020D,E01002897,696,223,123,100,6,6,136,63,73,331,306,25,0
2021,Kensington and Chelsea 017E,E01002898,674,314,199,115,1,1,67,4,63,287,257,30,5
2021,Kensington and Chelsea 018A,E01002899,634,174,128,46,1,1,223,98,125,234,211,23,2
2021,Kensington and Chelsea 018B,E01002900,568,293,178,115,1,1,54,4,50,220,181,39,0
2021,Kensington and Chelsea 018C,E01002901,440,180,125,55,2,2,73,15,58,185,138,47,0
2021,Kensington and Chelsea 018D,E01002902,714,201,139,62,2,2,124,13,111,386,317,69,1
2021,Kensington and Chelsea 018E,E01002903,566,334,233,101,2,2,15,4,11,214,189,25,1
2021,Kensington and Chelsea 002A,E01002904,497,17,13,4,9,9,452,75,377,18,10,8,1
2021,Kensington and Chelsea 002B,E01002905,653,82,34,48,36,36,438,216,222,82,69,13,15
2021,Kensington and Chelsea 002C,E01002906,645,158,84,74,43,43,312,170,142,127,109,18,5
2021,Kensington and Chelsea 002D,E01002907,514,17,9,8,0,0,473,67,406,19,12,7,5
2021,Kensington and Chelsea 003D,E01002908,592,218,104,114,18,18,202,62,140,154,142,12,0
2021,Kensington and Chelsea 003E,E01002909,1021,227,122,105,15,15,540,57,483,239,206,33,0
2021,Kensington and Chelsea 019C,E01002910,632,260,190,70,1,1,151,128,23,217,166,51,3
2021,Kensington and Chelsea 019D,E01002911,599,334,204,130,1,1,25,17,8,237,210,27,2
2021,Kensington and Chelsea 020E,E01002912,684,244,167,77,0,0,113,85,28,325,274,51,2
2021,Kensington and Chelsea 021E,E01002913,814,302,150,152,18,18,154,62,92,339,310,29,1
2021,Kensington and Chelsea 019E,E01002914,573,283,194,89,2,2,32,12,20,256,225,31,0
2021,Kingston upon Thames 014A,E01002915,484,412,211,201,0,0,13,7,6,59,56,3,0
2021,Kingston upon Thames 014B,E01002916,533,452,233,219,1,1,9,1,8,71,63,8,0
2021,Kingston upon Thames 014C,E01002917,494,438,245,193,1,1,3,3,0,52,48,4,0
2021,Kingston upon Thames 017A,E01002918,609,430,174,256,3,3,28,14,14,147,132,15,1
2021,Kingston upon Thames 017B,E01002919,799,343,161,182,6,6,95,39,56,355,326,29,0
2021,Kingston upon Thames 014D,E01002920,585,499,252,247,7,7,35,30,5,43,39,4,1
2021,Kingston upon Thames 011A,E01002921,904,308,109,199,2,2,125,60,65,468,456,12,1
2021,Kingston upon Thames 010A,E01002922,716,461,246,215,0,0,82,61,21,172,164,8,1
2021,Kingston upon Thames 013A,E01002923,859,183,63,120,1,1,431,307,124,236,226,10,8
2021,Kingston upon Thames 014E,E01002924,554,499,260,239,0,0,7,3,4,48,39,9,0
2021,Kingston upon Thames 013B,E01002925,799,427,142,285,4,4,74,34,40,294,280,14,0
2021,Kingston upon Thames 010B,E01002926,600,441,211,230,1,1,11,8,3,147,141,6,0
2021,Kingston upon Thames 008A,E01002927,644,459,224,235,0,0,45,41,4,140,129,11,0
2021,Kingston upon Thames 008B,E01002928,743,398,220,178,2,2,61,8,53,282,256,26,0
2021,Kingston upon Thames 007A,E01002929,670,517,267,250,5,5,18,15,3,130,117,13,0
2021,Kingston upon Thames 007B,E01002930,796,411,172,239,13,13,75,57,18,295,276,19,2
2021,Kingston upon Thames 007C,E01002931,720,559,247,312,13,13,37,7,30,111,99,12,0
2021,Kingston upon Thames 006A,E01002932,674,208,74,134,32,32,280,94,186,153,144,9,1
2021,Kingston upon Thames 004A,E01002933,810,421,181,240,2,2,232,188,44,147,139,8,8
2021,Kingston upon Thames 004B,E01002934,663,422,201,221,5,5,31,7,24,205,95,110,0
2021,Kingston upon Thames 003A,E01002935,811,390,149,241,3,3,40,15,25,375,349,26,3
2021,Kingston upon Thames 004D,E01002937,663,529,186,343,0,0,22,12,10,112,110,2,0
2021,Kingston upon Thames 003B,E01002938,784,555,245,310,0,0,66,54,12,163,144,19,0
2021,Kingston upon Thames 018A,E01002939,599,380,166,214,6,6,79,62,17,133,115,18,1
2021,Kingston upon Thames 020A,E01002940,616,423,190,233,0,0,123,107,16,70,56,14,0
2021,Kingston upon Thames 018B,E01002941,640,477,243,234,5,5,44,37,7,114,97,17,0
2021,Kingston upon Thames 018C,E01002942,526,452,231,221,2,2,36,33,3,35,31,4,1
2021,Kingston upon Thames 020B,E01002943,510,351,149,202,2,2,110,95,15,47,42,5,0
2021,Kingston upon Thames 019A,E01002944,529,396,168,228,6,6,71,35,36,56,49,7,0
2021,Kingston upon Thames 019B,E01002945,640,493,200,293,10,10,31,24,7,105,95,10,1
2021,Kingston upon Thames 019C,E01002946,606,511,240,271,3,3,15,7,8,77,67,10,0
2021,Kingston upon Thames 019D,E01002947,617,515,235,280,2,2,18,12,6,82,73,9,0
2021,Kingston upon Thames 020C,E01002948,819,483,217,266,6,6,177,33,144,153,133,20,0
2021,Kingston upon Thames 020D,E01002949,686,529,254,275,7,7,60,15,45,90,79,11,0
2021,Kingston upon Thames 020E,E01002950,710,418,183,235,3,3,185,169,16,102,92,10,2
2021,Kingston upon Thames 003C,E01002951,579,390,204,186,3,3,6,3,3,180,168,12,0
2021,Kingston upon Thames 002A,E01002952,470,377,226,151,1,1,15,11,4,77,60,17,0
2021,Kingston upon Thames 002B,E01002953,436,329,182,147,0,0,3,0,3,104,93,11,0
2021,Kingston upon Thames 003D,E01002954,629,207,115,92,2,2,93,59,34,325,298,27,2
2021,Kingston upon Thames 002C,E01002955,530,340,155,185,3,3,20,19,1,167,149,18,0
2021,Kingston upon Thames 002D,E01002956,442,344,203,141,1,1,37,32,5,58,50,8,2
2021,Kingston upon Thames 003E,E01002957,574,188,84,104,2,2,213,198,15,168,154,14,3
2021,Kingston upon Thames 008C,E01002958,653,515,230,285,2,2,23,11,12,113,110,3,0
2021,Kingston upon Thames 002E,E01002959,473,416,230,186,0,0,5,4,1,52,49,3,0
2021,Kingston upon Thames 006B,E01002960,583,442,218,224,1,1,3,2,1,137,129,8,0
2021,Kingston upon Thames 008D,E01002961,600,497,254,243,0,0,11,9,2,91,78,13,1
2021,Kingston upon Thames 006C,E01002962,528,322,158,164,1,1,103,92,11,100,89,11,2
2021,Kingston upon Thames 007D,E01002963,773,341,162,179,4,4,67,60,7,361,343,18,0
2021,Kingston upon Thames 005A,E01002964,1052,354,128,226,10,10,323,216,107,363,337,26,2
2021,Kingston upon Thames 009A,E01002965,1144,446,215,231,7,7,133,77,56,557,536,21,1
2021,Kingston upon Thames 010C,E01002966,780,466,169,297,2,2,84,48,36,228,209,19,0
2021,Kingston upon Thames 009B,E01002967,954,485,217,268,7,7,37,14,23,425,403,22,0
2021,Kingston upon Thames 009C,E01002968,1147,470,231,239,10,10,65,30,35,601,552,49,1
2021,Kingston upon Thames 005B,E01002969,658,87,47,40,2,2,471,455,16,90,83,7,8
2021,Kingston upon Thames 006D,E01002970,641,268,109,159,15,15,162,130,32,194,180,14,2
2021,Kingston upon Thames 005C,E01002971,728,412,147,265,3,3,103,56,47,209,201,8,1
2021,Kingston upon Thames 005D,E01002972,889,347,154,193,15,15,123,54,69,403,381,22,1
2021,Kingston upon Thames 006E,E01002973,527,204,89,115,1,1,141,135,6,179,164,15,2
2021,Kingston upon Thames 005E,E01002974,717,414,184,230,5,5,137,128,9,157,148,9,4
2021,Kingston upon Thames 012A,E01002975,498,356,175,181,0,0,35,31,4,107,100,7,0
2021,Kingston upon Thames 015A,E01002976,645,544,255,289,1,1,22,13,9,77,70,7,1
2021,Kingston upon Thames 012B,E01002977,647,338,173,165,3,3,191,177,14,113,97,16,2
2021,Kingston upon Thames 015B,E01002978,723,546,304,242,1,1,16,3,13,160,146,14,0
2021,Kingston upon Thames 015C,E01002979,599,439,237,202,4,4,50,21,29,106,100,6,0
2021,Kingston upon Thames 012C,E01002980,479,404,226,178,1,1,4,1,3,69,62,7,1
2021,Kingston upon Thames 012D,E01002981,523,434,220,214,2,2,3,2,1,84,73,11,0
2021,Kingston upon Thames 015D,E01002982,517,396,211,185,1,1,45,43,2,75,65,10,0
2021,Kingston upon Thames 015E,E01002983,594,527,269,258,1,1,3,2,1,63,54,9,0
2021,Kingston upon Thames 012E,E01002984,588,326,186,140,4,4,107,81,26,148,138,10,3
2021,Kingston upon Thames 007E,E01002985,598,363,164,199,1,1,38,28,10,196,179,17,0
2021,Kingston upon Thames 008E,E01002986,478,336,174,162,3,3,45,42,3,92,84,8,2
2021,Kingston upon Thames 011B,E01002987,955,312,149,163,4,4,89,12,77,550,521,29,0
2021,Kingston upon Thames 011C,E01002988,630,351,147,204,4,4,66,13,53,209,197,12,0
2021,Kingston upon Thames 011D,E01002989,915,523,193,330,4,4,33,13,20,355,334,21,0
2021,Kingston upon Thames 009D,E01002990,887,389,167,222,1,1,65,29,36,432,409,23,0
2021,Kingston upon Thames 009E,E01002991,680,421,188,233,1,1,37,13,24,221,214,7,0
2021,Kingston upon Thames 010D,E01002992,487,295,124,171,2,2,27,22,5,163,154,9,0
2021,Kingston upon Thames 013C,E01002993,815,312,152,160,4,4,54,13,41,445,427,18,0
2021,Kingston upon Thames 016A,E01002994,597,410,188,222,0,0,11,3,8,176,169,7,0
2021,Kingston upon Thames 013D,E01002995,635,432,189,243,9,9,5,3,2,189,178,11,0
2021,Kingston upon Thames 016B,E01002996,593,412,165,247,3,3,19,11,8,158,151,7,1
2021,Kingston upon Thames 016C,E01002997,604,454,172,282,0,0,16,8,8,134,128,6,0
2021,Kingston upon Thames 016D,E01002998,603,355,120,235,6,6,131,122,9,111,102,9,0
2021,Kingston upon Thames 013E,E01002999,767,279,116,163,2,2,89,51,38,397,377,20,0
2021,Kingston upon Thames 017C,E01003000,672,453,148,305,12,12,116,102,14,89,77,12,2
2021,Kingston upon Thames 017D,E01003001,636,501,223,278,6,6,18,12,6,111,95,16,0
2021,Kingston upon Thames 016E,E01003002,797,425,153,272,5,5,175,63,112,192,183,9,0
2021,Kingston upon Thames 017E,E01003003,660,368,157,211,8,8,39,16,23,244,226,18,1
2021,Kingston upon Thames 018D,E01003004,608,441,193,248,4,4,26,18,8,137,125,12,0
2021,Kingston upon Thames 018E,E01003005,581,487,218,269,2,2,23,15,8,69,57,12,0
2021,Kingston upon Thames 001A,E01003006,597,440,241,199,0,0,47,3,44,109,105,4,1
2021,Kingston upon Thames 001B,E01003007,560,467,228,239,0,0,18,17,1,75,66,9,0
2021,Kingston upon Thames 001C,E01003008,508,444,210,234,1,1,2,1,1,61,58,3,0
2021,Kingston upon Thames 001D,E01003009,777,504,233,271,17,17,112,33,79,143,130,13,1
2021,Kingston upon Thames 001E,E01003010,530,421,225,196,3,3,37,2,35,68,64,4,1
2021,Kingston upon Thames 004E,E01003011,697,480,266,214,4,4,48,31,17,164,150,14,1
2021,Lambeth 036A,E01003013,720,147,78,69,15,15,91,25,66,467,426,41,0
2021,Lambeth 036B,E01003014,638,185,100,85,3,3,322,210,112,126,111,15,2
2021,Lambeth 002A,E01003015,800,196,61,135,1,1,470,343,127,130,116,14,3
2021,Lambeth 036C,E01003016,419,94,61,33,3,3,155,24,131,167,141,26,0
2021,Lambeth 036D,E01003017,767,139,79,60,11,11,433,68,365,183,160,23,1
2021,Lambeth 020A,E01003018,933,339,120,219,5,5,128,59,69,461,440,21,0
2021,Lambeth 015A,E01003019,890,356,109,247,15,15,191,63,128,327,298,29,1
2021,Lambeth 016A,E01003020,829,310,103,207,18,18,245,160,85,255,206,49,1
2021,Lambeth 021A,E01003021,635,165,55,110,4,4,334,262,72,131,122,9,1
2021,Lambeth 021B,E01003022,734,299,91,208,3,3,217,125,92,213,198,15,2
2021,Lambeth 021C,E01003023,1105,369,84,285,57,57,250,139,111,427,392,35,2
2021,Lambeth 021D,E01003024,783,163,27,136,0,0,407,372,35,211,196,15,2
2021,Lambeth 021E,E01003025,850,329,120,209,14,14,295,144,151,211,191,20,1
2021,Lambeth 019A,E01003026,624,271,107,164,5,5,111,27,84,236,217,19,1
2021,Lambeth 019B,E01003027,521,371,134,237,1,1,27,15,12,122,108,14,0
2021,Lambeth 019C,E01003028,599,294,112,182,5,5,136,117,19,164,154,10,0
2021,Lambeth 017A,E01003029,893,279,113,166,2,2,230,160,70,381,354,27,1
2021,Lambeth 019D,E01003030,746,315,114,201,2,2,77,54,23,351,331,20,1
2021,Lambeth 023A,E01003031,711,168,44,124,4,4,252,241,11,284,269,15,3
2021,Lambeth 017B,E01003032,815,205,87,118,5,5,349,294,55,255,238,17,1
2021,Lambeth 019E,E01003033,589,307,116,191,2,2,109,85,24,170,156,14,1
2021,Lambeth 012A,E01003034,697,230,94,136,12,12,253,194,59,202,186,16,0
2021,Lambeth 012B,E01003035,764,191,78,113,7,7,200,66,134,365,345,20,1
2021,Lambeth 012C,E01003036,757,256,96,160,1,1,235,194,41,264,250,14,1
2021,Lambeth 013A,E01003037,598,141,52,89,1,1,312,293,19,141,136,5,3
2021,Lambeth 013B,E01003038,771,368,142,226,14,14,103,60,43,286,260,26,0
2021,Lambeth 013C,E01003039,962,385,181,204,19,19,99,36,63,458,421,37,1
2021,Lambeth 013D,E01003040,595,248,121,127,3,3,121,96,25,223,210,13,0
2021,Lambeth 017C,E01003041,677,116,37,79,16,16,354,262,92,189,172,17,2
2021,Lambeth 013E,E01003042,507,129,49,80,3,3,202,140,62,173,160,13,0
2021,Lambeth 018A,E01003043,673,261,100,161,14,14,226,88,138,172,162,10,0
2021,Lambeth 018B,E01003044,687,50,13,37,98,98,502,37,465,35,26,9,2
2021,Lambeth 011A,E01003045,699,79,17,62,6,6,546,348,198,68,62,6,0
2021,Lambeth 009A,E01003046,744,100,27,73,1,1,519,356,163,119,104,15,5
2021,Lambeth 011B,E01003047,820,123,45,78,2,2,371,244,127,323,300,23,1
2021,Lambeth 009B,E01003048,741,97,41,56,15,15,517,440,77,106,99,7,6
2021,Lambeth 011C,E01003049,751,132,56,76,83,83,371,289,82,160,149,11,5
2021,Lambeth 016B,E01003050,754,187,79,108,19,19,244,139,105,304,288,16,0
2021,Lambeth 018C,E01003051,879,231,57,174,40,40,323,100,223,285,262,23,0
2021,Lambeth 016C,E01003052,785,141,71,70,5,5,548,228,320,89,76,13,2
2021,Lambeth 015B,E01003053,741,270,93,177,8,8,120,25,95,343,321,22,0
2021,Lambeth 015C,E01003054,1003,290,95,195,14,14,156,82,74,543,514,29,0
2021,Lambeth 016D,E01003055,829,231,72,159,20,20,322,144,178,251,231,20,5
2021,Lambeth 015D,E01003056,769,216,71,145,3,3,226,78,148,324,308,16,0
2021,Lambeth 017D,E01003057,719,136,39,97,4,4,389,292,97,189,177,12,1
2021,Lambeth 015E,E01003058,857,257,82,175,16,16,222,28,194,362,341,21,0
2021,Lambeth 011D,E01003059,873,231,52,179,11,11,456,159,297,173,165,8,2
2021,Lambeth 011E,E01003060,688,147,35,112,30,30,355,195,160,151,135,16,5
2021,Lambeth 011F,E01003061,648,174,44,130,14,14,243,54,189,217,198,19,0
2021,Lambeth 033A,E01003062,862,315,93,222,17,17,197,66,131,332,320,12,1
2021,Lambeth 033B,E01003063,601,162,45,117,1,1,327,212,115,110,103,7,1
2021,Lambeth 028A,E01003064,627,347,111,236,2,2,56,26,30,221,206,15,1
2021,Lambeth 031A,E01003065,684,181,49,132,22,22,400,265,135,80,68,12,1
2021,Lambeth 028B,E01003066,805,255,85,170,1,1,319,224,95,230,214,16,0
2021,Lambeth 033C,E01003067,632,336,105,231,0,0,102,73,29,194,180,14,0
2021,Lambeth 031B,E01003068,643,295,90,205,0,0,229,177,52,118,110,8,1
2021,Lambeth 033D,E01003069,522,253,90,163,3,3,171,137,34,93,90,3,2
2021,Lambeth 033E,E01003070,660,158,39,119,3,3,360,298,62,137,133,4,2
2021,Lambeth 018D,E01003071,1002,395,139,256,53,53,228,77,151,326,306,20,0
2021,Lambeth 014A,E01003072,704,351,160,191,0,0,150,48,102,202,188,14,1
2021,Lambeth 014B,E01003073,661,206,61,145,4,4,325,43,282,126,114,12,0
2021,Lambeth 018E,E01003074,1091,461,178,283,4,4,306,177,129,320,276,44,0
2021,Lambeth 009C,E01003075,671,122,25,97,3,3,467,264,203,78,70,8,1
2021,Lambeth 014C,E01003076,962,239,54,185,41,41,292,81,211,390,364,26,0
2021,Lambeth 014D,E01003077,790,269,92,177,3,3,188,66,122,330,305,25,0
2021,Lambeth 014E,E01003078,621,425,182,243,2,2,85,43,42,109,95,14,0
2021,Lambeth 027A,E01003079,732,273,76,197,7,7,248,132,116,203,193,10,1
2021,Lambeth 027B,E01003080,672,363,126,237,1,1,99,30,69,209,197,12,0
2021,Lambeth 028C,E01003081,821,268,81,187,6,6,226,128,98,320,304,16,1
2021,Lambeth 031C,E01003082,634,245,90,155,5,5,266,235,31,114,103,11,4
2021,Lambeth 030A,E01003083,575,360,140,220,0,0,100,59,41,115,102,13,0
2021,Lambeth 030B,E01003084,634,345,115,230,16,16,88,29,59,185,170,15,0
2021,Lambeth 030C,E01003085,693,443,196,247,9,9,135,56,79,105,92,13,1
2021,Lambeth 031D,E01003086,624,214,63,151,10,10,319,180,139,79,73,6,2
2021,Lambeth 031E,E01003087,602,141,38,103,3,3,326,297,29,129,127,2,3
2021,Lambeth 010A,E01003088,655,151,50,101,4,4,287,247,40,211,199,12,2
2021,Lambeth 008A,E01003089,737,128,36,92,7,7,366,326,40,236,227,9,0
2021,Lambeth 012D,E01003090,1107,329,94,235,58,58,277,138,139,440,409,31,3
2021,Lambeth 008B,E01003091,677,150,45,105,2,2,292,276,16,232,213,19,1
2021,Lambeth 008C,E01003092,955,144,44,100,8,8,463,414,49,333,306,27,7
2021,Lambeth 010B,E01003093,954,90,25,65,52,52,640,81,559,167,152,15,5
2021,Lambeth 010C,E01003094,653,212,100,112,3,3,255,38,217,183,170,13,0
2021,Lambeth 012E,E01003095,693,305,118,187,1,1,157,93,64,230,212,18,0
2021,Lambeth 010D,E01003096,859,277,104,173,11,11,148,40,108,423,405,18,0
2021,Lambeth 006A,E01003097,687,126,40,86,5,5,363,298,65,188,177,11,5
2021,Lambeth 005A,E01003098,652,247,121,126,3,3,225,65,160,175,158,17,2
2021,Lambeth 005B,E01003099,759,157,56,101,7,7,317,49,268,278,255,23,0
2021,Lambeth 005C,E01003100,891,261,94,167,4,4,95,45,50,531,503,28,0
2021,Lambeth 003A,E01003101,639,122,48,74,0,0,321,59,262,196,176,20,0
2021,Lambeth 004A,E01003102,786,199,83,116,17,17,306,51,255,263,246,17,1
2021,Lambeth 004C,E01003104,865,202,108,94,2,2,257,121,136,403,380,23,1
2021,Lambeth 003B,E01003105,748,126,59,67,30,30,418,259,159,173,152,21,1
2021,Lambeth 003C,E01003106,972,259,132,127,78,78,432,264,168,202,177,25,1
2021,Lambeth 003D,E01003107,884,347,151,196,24,24,204,130,74,308,271,37,1
2021,Lambeth 002B,E01003108,713,143,59,84,4,4,407,357,50,157,149,8,2
2021,Lambeth 002C,E01003110,925,356,168,188,23,23,297,112,185,249,227,22,0
2021,Lambeth 002D,E01003111,804,144,51,93,6,6,548,346,202,102,81,21,4
2021,Lambeth 002E,E01003112,807,196,77,119,11,11,412,203,209,186,159,27,2
2021,Lambeth 032A,E01003113,741,315,98,217,24,24,107,41,66,294,284,10,1
2021,Lambeth 032B,E01003114,1004,454,118,336,47,47,113,27,86,389,375,14,1
2021,Lambeth 034A,E01003115,665,273,81,192,5,5,147,74,73,239,226,13,1
2021,Lambeth 029A,E01003116,633,390,182,208,2,2,103,10,93,138,128,10,0
2021,Lambeth 029B,E01003117,822,332,111,221,5,5,129,36,93,356,337,19,0
2021,Lambeth 029C,E01003118,701,326,138,188,11,11,93,64,29,270,259,11,1
2021,Lambeth 032C,E01003119,850,347,103,244,7,7,89,38,51,406,384,22,1
2021,Lambeth 032D,E01003120,1111,269,74,195,7,7,134,88,46,699,686,13,2
2021,Lambeth 006B,E01003121,637,60,17,43,1,1,483,38,445,92,82,10,1
2021,Lambeth 004D,E01003122,893,244,81,163,16,16,280,171,109,352,322,30,1
2021,Lambeth 006C,E01003123,700,287,137,150,1,1,180,76,104,231,205,26,1
2021,Lambeth 006D,E01003124,610,125,63,62,1,1,268,203,65,215,202,13,1
2021,Lambeth 006E,E01003125,696,97,45,52,10,10,468,391,77,117,104,13,4
2021,Lambeth 008D,E01003126,715,138,53,85,5,5,341,67,274,231,212,19,0
2021,Lambeth 010E,E01003127,791,260,96,164,14,14,306,94,212,209,199,10,2
2021,Lambeth 008E,E01003128,713,119,38,81,36,36,393,60,333,165,156,9,0
2021,Lambeth 004E,E01003129,795,217,87,130,6,6,222,59,163,349,322,27,1
2021,Lambeth 026A,E01003130,782,374,149,225,10,10,96,49,47,301,280,21,1
2021,Lambeth 026B,E01003131,947,395,124,271,33,33,129,22,107,389,370,19,1
2021,Lambeth 024A,E01003132,539,182,56,126,6,6,250,223,27,101,95,6,0
2021,Lambeth 027C,E01003133,709,306,89,217,3,3,137,49,88,263,237,26,0
2021,Lambeth 027D,E01003134,622,343,121,222,4,4,137,125,12,138,124,14,0
2021,Lambeth 026C,E01003135,754,251,69,182,4,4,304,297,7,192,184,8,3
2021,Lambeth 022A,E01003136,745,232,89,143,24,24,197,38,159,292,275,17,0
2021,Lambeth 022B,E01003137,752,172,55,117,18,18,268,191,77,292,276,16,2
2021,Lambeth 026D,E01003138,648,359,102,257,3,3,43,16,27,243,230,13,0
2021,Lambeth 035A,E01003139,539,308,136,172,12,12,30,15,15,189,173,16,0
2021,Lambeth 035B,E01003140,494,325,174,151,10,10,39,26,13,119,110,9,1
2021,Lambeth 034B,E01003141,736,334,131,203,31,31,165,62,103,206,187,19,0
2021,Lambeth 035C,E01003142,453,284,151,133,3,3,36,22,14,129,116,13,1
2021,Lambeth 035D,E01003143,511,208,114,94,2,2,184,40,144,117,109,8,0
2021,Lambeth 034C,E01003144,526,416,198,218,1,1,18,14,4,91,79,12,0
2021,Lambeth 034D,E01003145,748,268,85,183,6,6,111,29,82,362,336,26,1
2021,Lambeth 035E,E01003146,549,245,102,143,4,4,144,19,125,156,147,9,0
2021,Lambeth 034E,E01003147,799,383,147,236,2,2,145,102,43,267,253,14,2
2021,Lambeth 032E,E01003148,760,385,112,273,7,7,101,64,37,267,259,8,0
2021,Lambeth 030D,E01003149,695,434,184,250,5,5,27,11,16,229,210,19,0
2021,Lambeth 032F,E01003150,836,256,91,165,12,12,258,171,87,307,295,12,3
2021,Lambeth 026E,E01003151,815,191,48,143,6,6,396,305,91,218,205,13,4
2021,Lambeth 027E,E01003152,759,449,170,279,10,10,49,14,35,251,225,26,0
2021,Lambeth 029D,E01003153,1019,403,98,305,3,3,55,10,45,558,523,35,0
2021,Lambeth 030E,E01003154,825,272,92,180,44,44,295,202,93,214,198,16,0
2021,Lambeth 029E,E01003155,730,412,177,235,8,8,68,33,35,242,227,15,0
2021,Lambeth 023B,E01003156,662,260,84,176,5,5,217,81,136,180,170,10,0
2021,Lambeth 023C,E01003157,576,347,118,229,0,0,101,10,91,128,115,13,0
2021,Lambeth 023D,E01003158,724,393,106,287,2,2,104,24,80,225,208,17,0
2021,Lambeth 022C,E01003159,840,189,63,126,98,98,372,58,314,181,162,19,0
2021,Lambeth 022D,E01003160,642,76,17,59,26,26,331,175,156,207,163,44,2
2021,Lambeth 023E,E01003161,530,248,85,163,4,4,124,80,44,154,146,8,0
2021,Lambeth 022E,E01003162,743,110,43,67,4,4,450,103,347,177,149,28,2
2021,Lambeth 023F,E01003163,601,344,161,183,1,1,119,61,58,137,128,9,0
2021,Lambeth 025A,E01003164,1010,297,88,209,8,8,291,67,224,413,391,22,1
2021,Lambeth 025B,E01003165,699,334,144,190,2,2,208,138,70,154,139,15,1
2021,Lambeth 028D,E01003166,1115,385,124,261,49,49,191,41,150,487,457,30,3
2021,Lambeth 028E,E01003167,683,474,213,261,2,2,62,19,43,145,130,15,0
2021,Lambeth 025C,E01003168,662,72,21,51,0,0,506,80,426,83,79,4,1
2021,Lambeth 025D,E01003169,1024,435,135,300,16,16,277,90,187,296,267,29,0
2021,Lambeth 025E,E01003170,772,502,246,256,5,5,96,60,36,169,156,13,0
2021,Lambeth 020B,E01003171,782,334,111,223,7,7,203,97,106,238,221,17,0
2021,Lambeth 024B,E01003172,778,213,67,146,20,20,384,304,80,160,143,17,1
2021,Lambeth 020C,E01003173,668,373,156,217,4,4,60,9,51,231,208,23,0
2021,Lambeth 024C,E01003174,827,145,34,111,2,2,504,75,429,174,162,12,2
2021,Lambeth 024D,E01003175,610,146,57,89,15,15,367,45,322,82,72,10,0
2021,Lambeth 016E,E01003176,766,96,41,55,30,30,395,242,153,244,224,20,1
2021,Lambeth 020D,E01003177,668,190,71,119,3,3,205,102,103,270,258,12,0
2021,Lambeth 020E,E01003178,653,290,109,181,3,3,122,16,106,238,225,13,0
2021,Lambeth 024E,E01003179,637,109,26,83,3,3,417,379,38,108,97,11,0
2021,Lambeth 005D,E01003180,656,217,72,145,4,4,288,212,76,146,135,11,1
2021,Lambeth 007A,E01003181,699,155,77,78,3,3,360,281,79,181,169,12,0
2021,Lambeth 009D,E01003182,744,217,52,165,10,10,307,248,59,208,194,14,2
2021,Lambeth 005E,E01003183,679,123,45,78,4,4,439,295,144,110,94,16,3
2021,Lambeth 007B,E01003184,596,93,17,76,47,47,357,275,82,97,87,10,2
2021,Lambeth 007C,E01003185,796,188,51,137,7,7,316,114,202,277,265,12,8
2021,Lambeth 007D,E01003186,1191,393,145,248,27,27,294,54,240,477,452,25,0
2021,Lambeth 007E,E01003187,987,279,48,231,74,74,419,348,71,213,194,19,2
2021,Lambeth 009E,E01003188,551,112,26,86,1,1,366,319,47,69,66,3,3
2021,Lewisham 034A,E01003189,650,201,61,140,4,4,323,90,233,120,96,24,2
2021,Lewisham 034B,E01003190,948,227,85,142,36,36,477,304,173,204,188,16,4
2021,Lewisham 034C,E01003191,704,264,108,156,22,22,247,55,192,171,153,18,0
2021,Lewisham 034D,E01003192,739,169,55,114,6,6,408,108,300,156,141,15,0
2021,Lewisham 029A,E01003193,684,347,152,195,11,11,173,123,50,152,135,17,1
2021,Lewisham 029B,E01003194,728,275,115,160,3,3,285,121,164,162,149,13,3
2021,Lewisham 029C,E01003195,619,410,162,248,8,8,64,48,16,137,129,8,0
2021,Lewisham 029D,E01003196,670,225,83,142,2,2,279,71,208,163,133,30,1
2021,Lewisham 029E,E01003197,650,213,67,146,2,2,308,84,224,126,109,17,1
2021,Lewisham 009A,E01003198,645,304,121,183,1,1,163,132,31,177,169,8,0
2021,Lewisham 007A,E01003199,903,446,187,259,9,9,132,90,42,315,296,19,1
2021,Lewisham 009B,E01003200,690,305,150,155,1,1,99,64,35,284,253,31,1
2021,Lewisham 007B,E01003201,690,235,97,138,20,20,275,119,156,160,143,17,0
2021,Lewisham 009C,E01003202,743,429,248,181,1,1,40,26,14,273,253,20,0
2021,Lewisham 009D,E01003203,967,269,93,176,1,1,372,263,109,322,304,18,3
2021,Lewisham 007C,E01003204,736,240,95,145,21,21,244,83,161,230,217,13,1
2021,Lewisham 007D,E01003205,577,131,34,97,53,53,269,127,142,121,113,8,3
2021,Lewisham 007E,E01003206,635,296,130,166,1,1,119,86,33,219,208,11,0
2021,Lewisham 005A,E01003207,999,156,36,120,36,36,442,222,220,363,346,17,2
2021,Lewisham 005B,E01003209,723,204,65,139,13,13,278,170,108,226,214,12,2
2021,Lewisham 005C,E01003210,807,279,85,194,39,39,152,42,110,336,316,20,1
2021,Lewisham 008B,E01003211,702,271,81,190,5,5,170,90,80,255,244,11,1
2021,Lewisham 005D,E01003212,827,420,176,244,4,4,177,81,96,226,210,16,0
2021,Lewisham 008C,E01003213,793,357,119,238,2,2,160,80,80,274,255,19,0
2021,Lewisham 008D,E01003214,764,281,90,191,10,10,271,170,101,201,176,25,1
2021,Lewisham 005E,E01003215,640,154,45,109,8,8,185,72,113,292,273,19,1
2021,Lewisham 025A,E01003216,618,334,113,221,4,4,92,20,72,187,170,17,1
2021,Lewisham 022A,E01003217,654,471,176,295,4,4,33,11,22,145,134,11,1
2021,Lewisham 022B,E01003218,548,401,168,233,5,5,54,14,40,88,81,7,0
2021,Lewisham 025B,E01003219,661,496,223,273,1,1,51,14,37,113,101,12,0
2021,Lewisham 022C,E01003220,600,320,117,203,1,1,90,22,68,189,179,10,0
2021,Lewisham 025C,E01003221,766,390,156,234,16,16,164,41,123,194,179,15,2
2021,Lewisham 022D,E01003222,618,390,156,234,0,0,78,21,57,150,139,11,0
2021,Lewisham 025D,E01003223,597,435,218,217,2,2,39,10,29,121,108,13,0
2021,Lewisham 022E,E01003224,638,407,142,265,1,1,76,21,55,154,144,10,0
2021,Lewisham 015A,E01003225,587,476,160,316,10,10,21,5,16,80,68,12,0
2021,Lewisham 019A,E01003226,705,427,167,260,4,4,59,15,44,215,199,16,0
2021,Lewisham 019B,E01003227,658,410,156,254,16,16,63,22,41,169,161,8,0
2021,Lewisham 019C,E01003228,670,404,110,294,2,2,87,12,75,177,159,18,0
2021,Lewisham 019D,E01003229,779,287,96,191,11,11,274,108,166,204,192,12,3
2021,Lewisham 019E,E01003230,870,388,115,273,3,3,238,113,125,239,218,21,2
2021,Lewisham 015B,E01003231,651,302,110,192,4,4,135,50,85,210,189,21,0
2021,Lewisham 015C,E01003232,622,441,200,241,13,13,45,8,37,123,111,12,0
2021,Lewisham 015D,E01003233,662,413,144,269,2,2,85,27,58,159,144,15,3
2021,Lewisham 038A,E01003235,523,308,113,195,0,0,145,33,112,70,60,10,0
2021,Lewisham 037A,E01003236,649,244,98,146,1,1,237,76,161,165,159,6,2
2021,Lewisham 037B,E01003237,614,259,92,167,2,2,235,64,171,117,105,12,1
2021,Lewisham 037C,E01003238,567,250,92,158,9,9,208,57,151,100,98,2,0
2021,Lewisham 037D,E01003239,575,245,67,178,2,2,224,55,169,102,93,9,2
2021,Lewisham 038B,E01003240,714,305,125,180,8,8,259,52,207,141,132,9,1
2021,Lewisham 038C,E01003241,701,345,168,177,3,3,262,73,189,91,83,8,0
2021,Lewisham 038D,E01003243,588,246,104,142,6,6,205,49,156,130,119,11,1
2021,Lewisham 001A,E01003244,732,67,35,32,15,15,474,434,40,173,170,3,3
2021,Lewisham 001B,E01003245,642,50,9,41,43,43,485,73,412,63,55,8,1
2021,Lewisham 002A,E01003246,1018,317,33,284,16,16,393,168,225,290,275,15,2
2021,Lewisham 001C,E01003247,874,251,82,169,21,21,180,59,121,422,408,14,0
2021,Lewisham 002B,E01003248,682,129,51,78,20,20,360,200,160,170,165,5,3
2021,Lewisham 001D,E01003249,855,154,49,105,53,53,416,158,258,232,211,21,0
2021,Lewisham 002C,E01003251,637,70,24,46,16,16,407,363,44,140,128,12,4
2021,Lewisham 002D,E01003252,606,74,29,45,9,9,463,379,84,56,46,10,4
2021,Lewisham 002E,E01003253,650,149,57,92,6,6,298,228,70,195,180,15,2
2021,Lewisham 021A,E01003254,601,401,188,213,2,2,96,31,65,101,101,0,1
2021,Lewisham 021B,E01003255,982,401,129,272,5,5,125,18,107,450,423,27,1
2021,Lewisham 028A,E01003256,932,388,141,247,29,29,318,143,175,192,172,20,5
2021,Lewisham 028B,E01003257,635,344,128,216,6,6,169,125,44,113,93,20,3
2021,Lewisham 028C,E01003258,589,167,58,109,3,3,315,104,211,103,93,10,1
2021,Lewisham 028D,E01003259,754,395,132,263,11,11,118,59,59,228,213,15,2
2021,Lewisham 021C,E01003260,637,395,160,235,4,4,120,96,24,118,105,13,0
2021,Lewisham 021D,E01003261,610,351,131,220,0,0,136,62,74,122,113,9,1
2021,Lewisham 021E,E01003262,667,303,100,203,1,1,145,62,83,217,205,12,1
2021,Lewisham 023A,E01003263,741,301,128,173,3,3,253,44,209,183,171,12,1
2021,Lewisham 031A,E01003264,720,360,155,205,13,13,178,23,155,168,150,18,1
2021,Lewisham 031B,E01003265,665,254,63,191,18,18,175,43,132,218,208,10,0
2021,Lewisham 031C,E01003266,730,247,91,156,1,1,369,69,300,113,103,10,0
2021,Lewisham 031D,E01003267,609,281,114,167,4,4,242,66,176,82,69,13,0
2021,Lewisham 023B,E01003268,765,388,128,260,21,21,176,25,151,180,161,19,0
2021,Lewisham 023C,E01003269,637,335,152,183,7,7,191,28,163,103,93,10,1
2021,Lewisham 023D,E01003270,657,462,213,249,13,13,23,4,19,158,144,14,1
2021,Lewisham 023E,E01003271,621,515,259,256,3,3,22,8,14,81,71,10,0
2021,Lewisham 014A,E01003272,794,396,148,248,1,1,127,42,85,270,263,7,0
2021,Lewisham 011A,E01003273,578,351,150,201,4,4,113,79,34,109,95,14,1
2021,Lewisham 014B,E01003274,662,355,135,220,6,6,112,41,71,189,174,15,0
2021,Lewisham 014C,E01003275,616,278,118,160,4,4,220,101,119,113,101,12,1
2021,Lewisham 014D,E01003276,662,399,141,258,2,2,150,79,71,110,86,24,1
2021,Lewisham 011B,E01003277,757,317,116,201,3,3,211,61,150,226,215,11,0
2021,Lewisham 011C,E01003278,881,355,135,220,14,14,224,47,177,288,266,22,0
2021,Lewisham 011D,E01003279,602,408,186,222,2,2,86,45,41,106,93,13,0
2021,Lewisham 016A,E01003280,629,309,134,175,3,3,203,55,148,114,109,5,0
2021,Lewisham 016B,E01003281,581,420,168,252,3,3,88,25,63,70,64,6,0
2021,Lewisham 013A,E01003282,1022,461,165,296,7,7,212,75,137,340,324,16,2
2021,Lewisham 013B,E01003283,868,547,219,328,1,1,77,34,43,240,219,21,3
2021,Lewisham 013C,E01003284,758,433,161,272,7,7,144,78,66,174,159,15,0
2021,Lewisham 016C,E01003285,755,405,196,209,9,9,52,20,32,288,266,22,1
2021,Lewisham 013D,E01003286,767,202,87,115,12,12,406,117,289,147,121,26,0
2021,Lewisham 016D,E01003287,765,517,192,325,3,3,94,54,40,151,139,12,0
2021,Lewisham 041A,E01003288,950,265,95,170,17,17,421,275,146,244,225,19,3
2021,Lewisham 041E,E01003290,814,235,70,165,31,31,304,129,175,244,216,28,0
2021,Lewisham 041D,E01003291,656,156,42,114,2,2,379,200,179,116,104,12,3
2021,Lewisham 017A,E01003292,735,373,138,235,5,5,114,45,69,243,226,17,0
2021,Lewisham 017B,E01003293,639,271,78,193,2,2,151,16,135,215,204,11,0
2021,Lewisham 017D,E01003295,722,285,109,176,26,26,160,58,102,250,237,13,1
2021,Lewisham 003A,E01003297,783,168,48,120,4,4,119,71,48,491,476,15,1
2021,Lewisham 039A,E01003298,474,114,27,87,3,3,266,195,71,88,79,9,3
2021,Lewisham 003B,E01003299,700,211,52,159,8,8,260,193,67,219,202,17,2
2021,Lewisham 039B,E01003300,599,126,47,79,2,2,356,223,133,113,102,11,2
2021,Lewisham 003C,E01003301,933,304,98,206,26,26,234,94,140,367,352,15,2
2021,Lewisham 003D,E01003302,801,212,63,149,56,56,332,215,117,198,183,15,3
2021,Lewisham 039C,E01003303,648,178,69,109,13,13,224,169,55,232,221,11,1
2021,Lewisham 039D,E01003304,1084,253,66,187,21,21,341,175,166,467,435,32,2
2021,Lewisham 003E,E01003305,785,168,61,107,63,63,415,226,189,138,132,6,1
2021,Lewisham 024A,E01003307,647,380,130,250,3,3,135,53,82,129,120,9,0
2021,Lewisham 024B,E01003308,706,366,116,250,3,3,165,40,125,171,154,17,1
2021,Lewisham 027A,E01003309,654,225,70,155,4,4,290,211,79,131,111,20,4
2021,Lewisham 027B,E01003310,732,252,81,171,20,20,249,163,86,209,192,17,2
2021,Lewisham 027C,E01003311,596,464,202,262,1,1,47,15,32,84,77,7,0
2021,Lewisham 027D,E01003312,770,463,205,258,10,10,117,35,82,179,165,14,1
2021,Lewisham 027E,E01003313,624,214,59,155,2,2,272,231,41,134,127,7,2
2021,Lewisham 024C,E01003314,664,384,122,262,8,8,112,41,71,160,149,11,0
2021,Lewisham 024D,E01003315,591,251,69,182,3,3,138,57,81,198,185,13,1
2021,Lewisham 024E,E01003316,576,370,145,225,3,3,67,5,62,135,128,7,1
2021,Lewisham 020B,E01003318,773,197,70,127,13,13,162,68,94,401,364,37,0
2021,Lewisham 018A,E01003319,751,281,137,144,0,0,187,23,164,281,266,15,2
2021,Lewisham 018B,E01003320,621,245,78,167,1,1,186,37,149,188,178,10,1
2021,Lewisham 020C,E01003321,762,320,102,218,6,6,197,29,168,239,219,20,0
2021,Lewisham 020D,E01003322,608,307,122,185,1,1,89,10,79,211,191,20,0
2021,Lewisham 018C,E01003323,624,316,114,202,2,2,143,24,119,163,152,11,0
2021,Lewisham 020E,E01003324,722,199,80,119,9,9,311,116,195,201,179,22,2
2021,Lewisham 018D,E01003325,787,291,108,183,17,17,252,113,139,227,202,25,0
2021,Lewisham 035A,E01003326,690,334,141,193,4,4,179,102,77,171,161,10,2
2021,Lewisham 035B,E01003327,689,369,160,209,3,3,101,46,55,216,200,16,0
2021,Lewisham 035C,E01003328,826,371,120,251,8,8,250,172,78,195,188,7,2
2021,Lewisham 033A,E01003329,661,366,139,227,2,2,161,52,109,129,121,8,3
2021,Lewisham 033B,E01003330,666,207,76,131,5,5,377,176,201,75,69,6,2
2021,Lewisham 033C,E01003331,588,301,142,159,12,12,188,121,67,87,73,14,0
2021,Lewisham 033D,E01003332,712,300,100,200,4,4,268,141,127,140,126,14,0
2021,Lewisham 035D,E01003333,629,321,134,187,5,5,145,49,96,154,144,10,4
2021,Lewisham 033E,E01003334,796,245,85,160,5,5,282,124,158,264,252,12,0
2021,Lewisham 035E,E01003335,618,178,82,96,1,1,378,304,74,60,55,5,1
2021,Lewisham 010A,E01003336,579,142,34,108,8,8,343,278,65,83,73,10,3
2021,Lewisham 010B,E01003337,566,100,27,73,24,24,363,251,112,76,69,7,3
2021,Lewisham 006A,E01003338,843,119,24,95,57,57,473,258,215,194,183,11,0
2021,Lewisham 006B,E01003339,679,234,71,163,2,2,261,183,78,180,154,26,2
2021,Lewisham 006C,E01003340,763,274,108,166,4,4,131,70,61,354,334,20,0
2021,Lewisham 006D,E01003341,564,279,117,162,3,3,127,35,92,154,135,19,1
2021,Lewisham 010C,E01003342,699,335,86,249,3,3,141,53,88,219,206,13,1
2021,Lewisham 006E,E01003343,609,291,121,170,2,2,186,111,75,129,117,12,1
2021,Lewisham 010D,E01003344,677,294,100,194,2,2,226,110,116,155,142,13,0
2021,Lewisham 010E,E01003345,781,328,95,233,40,40,180,76,104,231,214,17,2
2021,Lewisham 026A,E01003346,648,320,154,166,3,3,220,77,143,105,95,10,0
2021,Lewisham 030A,E01003347,651,97,33,64,0,0,417,139,278,137,120,17,0
2021,Lewisham 030B,E01003348,618,331,144,187,20,20,156,32,124,111,103,8,0
2021,Lewisham 026B,E01003349,544,205,64,141,6,6,233,43,190,100,90,10,0
2021,Lewisham 030C,E01003350,476,208,86,122,5,5,147,57,90,116,101,15,0
2021,Lewisham 026C,E01003351,600,249,81,168,5,5,247,58,189,99,86,13,0
2021,Lewisham 030D,E01003352,845,322,165,157,10,10,365,71,294,148,135,13,0
2021,Lewisham 030E,E01003353,627,460,190,270,7,7,41,10,31,119,105,14,0
2021,Lewisham 026D,E01003354,823,451,164,287,10,10,77,35,42,281,270,11,4
2021,Merton 009A,E01003355,822,392,137,255,8,8,17,4,13,405,387,18,0
2021,Merton 009B,E01003356,701,434,193,241,2,2,47,11,36,218,206,12,0
2021,Merton 012A,E01003357,724,164,86,78,12,12,386,103,283,162,153,9,0
2021,Merton 009C,E01003358,791,389,169,220,4,4,45,7,38,353,333,20,0
2021,Merton 006A,E01003359,798,371,123,248,1,1,181,24,157,242,231,11,3
2021,Merton 006B,E01003360,745,445,144,301,2,2,23,4,19,275,257,18,0
2021,Merton 015A,E01003361,613,385,182,203,1,1,43,10,33,184,171,13,0
2021,Merton 021A,E01003362,504,428,229,199,0,0,25,7,18,51,44,7,0
2021,Merton 021B,E01003363,594,514,253,261,2,2,9,3,6,69,59,10,0
2021,Merton 021C,E01003364,663,533,274,259,5,5,49,6,43,76,65,11,0
2021,Merton 021D,E01003365,498,424,236,188,0,0,6,0,6,68,61,7,0
2021,Merton 016A,E01003366,648,324,137,187,5,5,104,30,74,214,204,10,1
2021,Merton 008A,E01003368,586,338,164,174,0,0,63,18,45,185,173,12,0
2021,Merton 005B,E01003369,743,366,120,246,4,4,53,8,45,320,301,19,0
2021,Merton 005C,E01003370,878,320,119,201,39,39,83,13,70,436,413,23,0
2021,Merton 005D,E01003371,629,366,178,188,2,2,36,9,27,225,216,9,0
2021,Merton 008B,E01003372,639,212,72,140,1,1,238,59,179,188,178,10,0
2021,Merton 018A,E01003373,543,147,67,80,2,2,303,72,231,91,85,6,0
2021,Merton 022A,E01003374,667,260,113,147,41,41,162,37,125,203,190,13,1
2021,Merton 022B,E01003375,723,356,165,191,3,3,122,17,105,242,219,23,0
2021,Merton 012B,E01003376,589,235,110,125,1,1,236,28,208,117,109,8,0
2021,Merton 012C,E01003377,547,136,60,76,3,3,309,78,231,97,88,9,2
2021,Merton 018B,E01003378,773,385,159,226,13,13,158,18,140,217,204,13,0
2021,Merton 018C,E01003379,739,223,85,138,3,3,283,84,199,229,213,16,1
2021,Merton 011A,E01003380,670,437,175,262,6,6,24,10,14,203,188,15,0
2021,Merton 016B,E01003381,711,409,188,221,2,2,12,2,10,288,271,17,0
2021,Merton 011B,E01003382,726,483,183,300,1,1,24,3,21,217,204,13,1
2021,Merton 009D,E01003383,673,337,141,196,4,4,19,1,18,313,298,15,0
2021,Merton 009E,E01003384,678,394,168,226,1,1,35,4,31,248,237,11,0
2021,Merton 011C,E01003385,585,418,208,210,1,1,21,8,13,145,135,10,0
2021,Merton 013A,E01003386,760,316,136,180,22,22,84,7,77,338,311,27,0
2021,Merton 014A,E01003387,781,351,132,219,34,34,233,47,186,163,144,19,0
2021,Merton 013B,E01003388,620,282,145,137,5,5,172,20,152,161,136,25,0
2021,Merton 013C,E01003389,642,360,176,184,1,1,48,6,42,233,209,24,0
2021,Merton 018D,E01003390,639,145,51,94,13,13,337,118,219,143,132,11,1
2021,Merton 014B,E01003391,482,156,67,89,1,1,259,79,180,66,57,9,0
2021,Merton 013D,E01003392,517,286,136,150,7,7,37,6,31,187,170,17,0
2021,Merton 008C,E01003393,687,258,81,177,2,2,46,8,38,380,359,21,1
2021,Merton 007A,E01003394,673,386,183,203,5,5,19,4,15,263,242,21,0
2021,Merton 007B,E01003395,535,374,196,178,5,5,12,4,8,144,135,9,0
2021,Merton 007C,E01003396,530,338,170,168,2,2,28,9,19,162,146,16,0
2021,Merton 007D,E01003397,552,349,172,177,3,3,29,7,22,171,149,22,0
2021,Merton 007E,E01003398,657,397,193,204,7,7,46,10,36,207,193,14,0
2021,Merton 011D,E01003399,630,305,134,171,1,1,63,2,61,261,250,11,0
2021,Merton 003A,E01003400,630,320,146,174,1,1,39,3,36,270,251,19,0
2021,Merton 004A,E01003401,626,269,142,127,1,1,75,5,70,281,255,26,0
2021,Merton 004B,E01003402,678,346,221,125,2,2,41,2,39,289,272,17,0
2021,Merton 004C,E01003403,676,380,226,154,0,0,53,2,51,243,218,25,0
2021,Merton 004D,E01003404,913,357,183,174,7,7,151,13,138,397,375,22,1
2021,Merton 018E,E01003405,838,375,127,248,30,30,231,38,193,202,187,15,0
2021,Merton 008D,E01003406,568,240,79,161,3,3,185,28,157,140,130,10,0
2021,Merton 008E,E01003407,788,307,116,191,16,16,85,12,73,380,371,9,0
2021,Merton 012D,E01003408,867,396,153,243,4,4,94,15,79,373,347,26,0
2021,Merton 013E,E01003409,576,300,126,174,14,14,135,42,93,127,112,15,0
2021,Merton 012E,E01003410,625,260,111,149,3,3,127,23,104,234,221,13,1
2021,Merton 014C,E01003411,739,409,139,270,11,11,105,20,85,214,200,14,0
2021,Merton 014D,E01003412,624,298,117,181,11,11,170,20,150,145,134,11,0
2021,Merton 017A,E01003413,729,427,171,256,10,10,67,7,60,225,204,21,0
2021,Merton 017B,E01003414,564,410,201,209,4,4,12,7,5,137,125,12,1
2021,Merton 017C,E01003415,786,517,200,317,4,4,57,6,51,208,185,23,0
2021,Merton 017D,E01003416,536,401,183,218,3,3,20,1,19,112,99,13,0
2021,Merton 025A,E01003417,604,502,230,272,1,1,16,2,14,85,77,8,0
2021,Merton 025B,E01003418,528,485,239,246,2,2,6,3,3,35,29,6,0
2021,Merton 025C,E01003419,663,498,215,283,4,4,24,5,19,136,119,17,1
2021,Merton 025D,E01003420,506,420,172,248,3,3,4,0,4,79,68,11,0
2021,Merton 021E,E01003421,612,414,203,211,2,2,61,11,50,134,121,13,1
2021,Merton 025E,E01003422,526,418,211,207,5,5,21,3,18,82,71,11,0
2021,Merton 011E,E01003423,652,434,196,238,1,1,20,3,17,197,179,18,0
2021,Merton 015B,E01003424,572,507,301,206,1,1,4,0,4,60,56,4,0
2021,Merton 015C,E01003425,518,469,260,209,1,1,2,0,2,46,42,4,0
2021,Merton 015D,E01003426,599,444,253,191,2,2,9,1,8,144,130,14,0
2021,Merton 023A,E01003427,728,319,155,164,1,1,39,10,29,368,334,34,1
2021,Merton 015E,E01003428,633,386,185,201,11,11,89,5,84,147,137,10,0
2021,Merton 019A,E01003429,527,388,158,230,5,5,24,5,19,109,97,12,1
2021,Merton 019B,E01003430,581,204,80,124,1,1,231,39,192,145,128,17,0
2021,Merton 019C,E01003431,569,237,104,133,0,0,237,34,203,95,88,7,0
2021,Merton 019D,E01003432,528,182,72,110,0,0,291,35,256,55,51,4,0
2021,Merton 019E,E01003433,574,362,170,192,4,4,69,15,54,139,119,20,0
2021,Merton 017E,E01003434,500,373,174,199,6,6,20,6,14,101,85,16,0
2021,Merton 014E,E01003435,739,438,175,263,40,40,144,18,126,117,106,11,0
2021,Merton 023B,E01003436,608,332,130,202,3,3,169,57,112,104,97,7,0
2021,Merton 022C,E01003437,771,503,267,236,3,3,83,19,64,181,162,19,1
2021,Merton 024A,E01003438,656,361,141,220,3,3,196,50,146,94,88,6,2
2021,Merton 023C,E01003439,574,229,104,125,5,5,130,42,88,210,198,12,0
2021,Merton 022D,E01003440,633,313,155,158,0,0,159,36,123,161,149,12,0
2021,Merton 022E,E01003441,646,345,140,205,9,9,156,46,110,135,127,8,1
2021,Merton 010A,E01003442,672,445,239,206,4,4,38,2,36,185,168,17,0
2021,Merton 010B,E01003443,634,486,246,240,2,2,20,3,17,126,118,8,0
2021,Merton 010C,E01003444,672,405,216,189,4,4,42,7,35,221,214,7,0
2021,Merton 010D,E01003445,650,453,208,245,2,2,66,16,50,129,118,11,0
2021,Merton 016C,E01003446,900,391,178,213,6,6,75,6,69,428,408,20,0
2021,Merton 016D,E01003447,680,261,92,169,2,2,215,52,163,201,185,16,1
2021,Merton 023D,E01003448,884,436,126,310,8,8,197,52,145,242,224,18,1
2021,Merton 024B,E01003449,658,330,147,183,4,4,122,38,84,199,178,21,3
2021,Merton 024C,E01003450,612,293,125,168,13,13,203,55,148,103,97,6,0
2021,Merton 024D,E01003451,663,456,251,205,2,2,112,2,110,93,77,16,0
2021,Merton 024E,E01003452,813,245,94,151,6,6,422,69,353,140,130,10,0
2021,Merton 023E,E01003453,664,306,132,174,4,4,150,41,109,204,193,11,0
2021,Merton 003B,E01003454,577,325,162,163,12,12,57,4,53,183,175,8,0
2021,Merton 005E,E01003455,746,350,108,242,8,8,96,10,86,292,281,11,0
2021,Merton 003C,E01003456,668,296,147,149,5,5,42,7,35,325,310,15,0
2021,Merton 006C,E01003457,614,431,162,269,3,3,26,5,21,154,148,6,0
2021,Merton 006D,E01003458,721,415,170,245,1,1,25,3,22,280,267,13,0
2021,Merton 006E,E01003459,958,356,121,235,2,2,282,47,235,317,302,15,1
2021,Merton 002A,E01003460,643,389,246,143,0,0,87,16,71,167,144,23,0
2021,Merton 004E,E01003461,676,391,234,157,1,1,11,1,10,273,257,16,0
2021,Merton 002B,E01003462,575,413,268,145,1,1,61,2,59,100,88,12,0
2021,Merton 010E,E01003463,551,429,239,190,9,9,21,3,18,91,82,9,1
2021,Merton 002C,E01003464,542,411,265,146,2,2,20,5,15,109,91,18,0
2021,Merton 002D,E01003465,465,381,242,139,1,1,6,1,5,77,66,11,0
2021,Merton 020A,E01003466,625,489,244,245,5,5,16,3,13,115,101,14,0
2021,Merton 020B,E01003467,666,494,242,252,3,3,49,5,44,120,107,13,0
2021,Merton 020C,E01003468,636,529,235,294,3,3,24,5,19,80,71,9,0
2021,Merton 020D,E01003469,577,343,135,208,5,5,51,17,34,178,167,11,0
2021,Merton 020E,E01003470,748,485,189,296,18,18,32,13,19,206,180,26,7
2021,Merton 016E,E01003471,634,413,184,229,8,8,78,7,71,134,122,12,1
2021,Merton 001A,E01003472,472,394,156,238,0,0,7,0,7,71,66,5,0
2021,Merton 001B,E01003473,564,341,162,179,0,0,5,0,5,218,205,13,0
2021,Merton 001C,E01003474,470,367,195,172,0,0,12,3,9,91,87,4,0
2021,Merton 003D,E01003476,490,250,92,158,3,3,108,28,80,127,117,10,2
2021,Merton 003E,E01003477,594,378,153,225,3,3,27,7,20,186,169,17,0
2021,Merton 001E,E01003478,666,463,177,286,3,3,23,0,23,177,160,17,0
2021,Newham 035A,E01003479,610,180,69,111,2,2,158,31,127,270,253,17,0
2021,Newham 033A,E01003480,585,169,53,116,8,8,217,158,59,190,178,12,1
2021,Newham 035B,E01003481,483,148,42,106,2,2,181,139,42,151,139,12,1
2021,Newham 032A,E01003483,598,172,49,123,26,26,292,87,205,108,97,11,0
2021,Newham 032B,E01003484,561,196,64,132,16,16,73,29,44,276,261,15,0
2021,Newham 035C,E01003485,572,224,95,129,4,4,102,37,65,241,225,16,1
2021,Newham 033C,E01003486,443,31,13,18,3,3,369,49,320,40,35,5,0
2021,Newham 033D,E01003487,412,64,19,45,5,5,279,32,247,62,57,5,2
2021,Newham 019A,E01003488,670,133,50,83,1,1,406,231,175,129,109,20,1
2021,Newham 019B,E01003489,963,243,52,191,39,39,358,243,115,321,307,14,2
2021,Newham 019C,E01003490,565,204,84,120,10,10,104,70,34,246,228,18,1
2021,Newham 022A,E01003491,625,166,87,79,2,2,199,112,87,257,239,18,1
2021,Newham 025A,E01003492,530,261,120,141,2,2,56,36,20,211,191,20,0
2021,Newham 025C,E01003494,611,326,133,193,1,1,71,27,44,212,200,12,1
2021,Newham 025D,E01003495,611,385,140,245,3,3,46,23,23,177,169,8,0
2021,Newham 027A,E01003496,556,103,30,73,4,4,288,144,144,160,149,11,1
2021,Newham 034A,E01003497,592,153,62,91,9,9,238,181,57,191,176,15,1
2021,Newham 027B,E01003498,685,163,53,110,5,5,312,202,110,201,188,13,4
2021,Newham 030A,E01003499,821,191,76,115,7,7,422,346,76,197,170,27,4
2021,Newham 027C,E01003500,721,196,72,124,5,5,351,181,170,169,155,14,0
2021,Newham 030B,E01003501,791,222,87,135,26,26,312,211,101,230,206,24,1
2021,Newham 030C,E01003502,810,150,58,92,10,10,369,249,120,278,254,24,3
2021,Newham 030D,E01003503,1158,244,60,184,96,96,375,236,139,442,424,18,1
2021,Newham 034D,E01003506,481,113,41,72,1,1,257,212,45,106,93,13,4
2021,Newham 031A,E01003507,832,262,111,151,6,6,266,156,110,297,266,31,1
2021,Newham 031B,E01003508,963,302,66,236,78,78,321,164,157,261,244,17,1
2021,Newham 031C,E01003509,776,134,59,75,4,4,138,82,56,497,478,19,3
2021,Newham 036A,E01003511,671,178,35,143,19,19,337,179,158,137,127,10,0
2021,Newham 036B,E01003512,685,211,76,135,8,8,265,200,65,200,187,13,1
2021,Newham 035D,E01003513,547,221,76,145,10,10,75,12,63,240,226,14,1
2021,Newham 036C,E01003514,528,118,37,81,5,5,259,158,101,144,134,10,2
2021,Newham 036D,E01003515,812,139,41,98,42,42,444,276,168,179,165,14,8
2021,Newham 032C,E01003516,649,112,41,71,6,6,409,218,191,121,113,8,1
2021,Newham 036E,E01003517,632,118,29,89,33,33,326,165,161,153,143,10,2
2021,Newham 032D,E01003518,569,249,96,153,10,10,87,60,27,223,207,16,0
2021,Newham 032E,E01003519,495,165,73,92,6,6,149,58,91,175,165,10,0
2021,Newham 018A,E01003520,573,174,98,76,2,2,121,50,71,276,256,20,0
2021,Newham 018B,E01003521,646,210,100,110,8,8,58,26,32,367,334,33,3
2021,Newham 018C,E01003522,530,227,112,115,2,2,85,61,24,214,196,18,2
2021,Newham 024A,E01003523,710,233,98,135,6,6,186,127,59,284,264,20,1
2021,Newham 019D,E01003524,556,207,107,100,3,3,79,53,26,265,242,23,2
2021,Newham 018D,E01003525,534,220,99,121,4,4,76,35,41,232,214,18,2
2021,Newham 018E,E01003526,484,243,135,108,2,2,76,42,34,163,145,18,0
2021,Newham 024B,E01003527,556,325,125,200,1,1,51,31,20,178,166,12,1
2021,Newham 005A,E01003528,409,114,60,54,3,3,204,194,10,85,73,12,3
2021,Newham 010A,E01003529,626,301,164,137,4,4,42,16,26,276,247,29,3
2021,Newham 010B,E01003530,484,253,146,107,4,4,41,23,18,186,173,13,0
2021,Newham 010C,E01003531,559,203,127,76,6,6,131,90,41,219,188,31,0
2021,Newham 010D,E01003532,564,276,185,91,3,3,48,30,18,236,210,26,1
2021,Newham 011A,E01003533,567,250,152,98,6,6,131,60,71,177,156,21,3
2021,Newham 010E,E01003534,629,291,163,128,0,0,76,39,37,262,233,29,0
2021,Newham 023A,E01003535,567,137,36,101,6,6,305,262,43,116,106,10,3
2021,Newham 023B,E01003536,621,272,98,174,2,2,141,70,71,203,182,21,3
2021,Newham 024C,E01003537,641,320,126,194,6,6,101,74,27,213,199,14,1
2021,Newham 029A,E01003538,668,217,87,130,6,6,199,137,62,242,221,21,4
2021,Newham 029B,E01003539,706,316,115,201,7,7,148,114,34,235,215,20,0
2021,Newham 029C,E01003540,604,202,76,126,4,4,232,194,38,164,148,16,2
2021,Newham 029D,E01003541,558,285,96,189,3,3,103,63,40,167,153,14,0
2021,Newham 024D,E01003542,665,221,88,133,8,8,266,243,23,166,146,20,4
2021,Newham 001A,E01003543,838,315,136,179,48,48,202,52,150,272,249,23,1
2021,Newham 001B,E01003544,624,234,97,137,20,20,129,45,84,240,224,16,1
2021,Newham 006A,E01003545,635,168,70,98,10,10,264,69,195,191,184,7,2
2021,Newham 001C,E01003546,575,201,74,127,5,5,202,131,71,166,151,15,1
2021,Newham 007A,E01003547,674,374,178,196,0,0,131,18,113,168,151,17,1
2021,Newham 006B,E01003548,813,296,121,175,4,4,199,94,105,312,297,15,2
2021,Newham 006C,E01003549,780,215,83,132,19,19,260,175,85,283,268,15,3
2021,Newham 001D,E01003550,609,226,103,123,4,4,173,115,58,205,195,10,1
2021,Newham 009A,E01003551,620,160,74,86,8,8,170,35,135,279,271,8,3
2021,Newham 016A,E01003552,529,191,107,84,10,10,115,28,87,211,186,25,2
2021,Newham 009B,E01003553,732,135,50,85,11,11,362,288,74,222,197,25,2
2021,Newham 009C,E01003554,688,253,118,135,8,8,139,41,98,285,261,24,3
2021,Newham 007B,E01003555,480,247,147,100,2,2,69,27,42,159,146,13,3
2021,Newham 008A,E01003556,652,128,69,59,8,8,244,146,98,267,204,63,5
2021,Newham 006D,E01003557,648,172,73,99,7,7,179,56,123,286,267,19,4
2021,Newham 008B,E01003558,540,150,89,61,6,6,93,44,49,290,246,44,1
2021,Newham 009D,E01003559,898,247,106,141,41,41,248,91,157,360,339,21,2
2021,Newham 011B,E01003560,447,225,116,109,5,5,37,25,12,180,158,22,0
2021,Newham 007C,E01003561,468,212,120,92,3,3,44,25,19,208,194,14,1
2021,Newham 014A,E01003562,591,272,175,97,1,1,48,25,23,266,250,16,4
2021,Newham 011C,E01003563,587,261,114,147,1,1,67,26,41,258,235,23,0
2021,Newham 014B,E01003564,654,246,123,123,3,3,103,46,57,300,269,31,2
2021,Newham 014C,E01003565,520,185,108,77,4,4,74,46,28,257,239,18,0
2021,Newham 014D,E01003566,533,148,90,58,2,2,119,107,12,261,235,26,3
2021,Newham 007D,E01003567,508,168,82,86,15,15,90,50,40,233,207,26,2
2021,Newham 017A,E01003568,626,293,177,116,2,2,75,33,42,255,241,14,1
2021,Newham 017B,E01003569,591,225,155,70,3,3,62,26,36,300,271,29,1
2021,Newham 008C,E01003570,542,205,104,101,0,0,82,43,39,254,232,22,1
2021,Newham 008D,E01003571,582,242,158,84,3,3,49,23,26,287,259,28,1
2021,Newham 008E,E01003572,445,193,113,80,2,2,81,24,57,169,153,16,0
2021,Newham 017C,E01003573,576,263,145,118,2,2,76,22,54,235,210,25,0
2021,Newham 017D,E01003574,771,289,156,133,2,2,178,44,134,300,276,24,2
2021,Newham 005B,E01003575,471,211,102,109,2,2,77,56,21,181,161,20,0
2021,Newham 002A,E01003576,635,136,55,81,9,9,280,231,49,208,192,16,2
2021,Newham 005C,E01003577,756,161,53,108,33,33,387,328,59,171,150,21,4
2021,Newham 003A,E01003578,593,140,58,82,4,4,110,42,68,336,313,23,3
2021,Newham 004A,E01003579,494,216,113,103,5,5,73,52,21,199,184,15,1
2021,Newham 005D,E01003580,613,208,89,119,3,3,197,139,58,203,186,17,2
2021,Newham 002B,E01003581,473,204,107,97,2,2,56,29,27,208,192,16,3
2021,Newham 002C,E01003582,453,139,60,79,5,5,130,101,29,179,170,9,0
2021,Newham 002D,E01003583,530,197,90,107,4,4,63,40,23,265,248,17,1
2021,Newham 003B,E01003584,607,321,158,163,14,14,102,49,53,169,156,13,1
2021,Newham 004B,E01003585,411,205,112,93,1,1,47,19,28,158,147,11,0
2021,Newham 003C,E01003586,533,212,119,93,3,3,62,25,37,255,235,20,1
2021,Newham 004C,E01003587,807,195,84,111,14,14,241,94,147,355,335,20,2
2021,Newham 011D,E01003588,426,183,98,85,2,2,68,34,34,171,157,14,2
2021,Newham 011E,E01003589,509,206,115,91,5,5,49,33,16,249,230,19,0
2021,Newham 003D,E01003590,571,127,46,81,10,10,270,148,122,164,155,9,0
2021,Newham 004D,E01003591,684,174,88,86,9,9,179,151,28,317,294,23,5
2021,Newham 022B,E01003592,634,227,101,126,7,7,188,130,58,209,192,17,3
2021,Newham 027D,E01003593,537,143,60,83,13,13,224,144,80,155,146,9,2
2021,Newham 026A,E01003594,578,194,84,110,25,25,161,93,68,196,176,20,2
2021,Newham 026B,E01003595,664,131,58,73,27,27,324,188,136,181,164,17,1
2021,Newham 016B,E01003596,538,186,85,101,2,2,150,55,95,199,184,15,1
2021,Newham 016C,E01003597,535,232,113,119,3,3,121,35,86,178,162,16,1
2021,Newham 021A,E01003598,640,89,36,53,40,40,343,224,119,163,152,11,5
2021,Newham 022C,E01003599,476,152,72,80,1,1,182,129,53,139,125,14,2
2021,Newham 021B,E01003600,586,147,48,99,9,9,246,208,38,181,167,14,3
2021,Newham 028A,E01003601,715,254,111,143,8,8,274,220,54,171,148,23,8
2021,Newham 026C,E01003602,631,235,108,127,6,6,149,99,50,239,209,30,2
2021,Newham 028B,E01003603,606,298,118,180,6,6,89,42,47,212,201,11,1
2021,Newham 031D,E01003604,753,238,98,140,9,9,235,122,113,257,236,21,14
2021,Newham 028C,E01003605,684,248,110,138,5,5,222,158,64,206,183,23,3
2021,Newham 026D,E01003607,603,150,59,91,19,19,190,86,104,241,228,13,3
2021,Newham 028D,E01003608,678,326,114,212,4,4,79,40,39,269,249,20,0
2021,Newham 041C,E01003611,714,98,44,54,14,14,428,356,72,165,155,10,9
2021,Newham 039A,E01003615,618,172,77,95,3,3,213,183,30,230,215,15,0
2021,Newham 012A,E01003616,682,169,67,102,10,10,220,110,110,281,271,10,2
2021,Newham 012C,E01003618,829,251,104,147,13,13,164,63,101,399,381,18,2
2021,Newham 012D,E01003619,1064,173,55,118,63,63,474,196,278,330,313,17,24
2021,Newham 023C,E01003621,453,204,82,122,6,6,46,29,17,196,174,22,1
2021,Newham 023D,E01003622,533,150,54,96,4,4,148,125,23,231,210,21,0
2021,Newham 023E,E01003623,483,186,62,124,3,3,148,129,19,146,139,7,0
2021,Newham 024E,E01003624,493,204,94,110,7,7,150,115,35,131,120,11,1
2021,Newham 015A,E01003625,483,169,70,99,3,3,89,43,46,221,202,19,1
2021,Newham 015B,E01003626,462,196,101,95,1,1,23,13,10,242,214,28,0
2021,Newham 015C,E01003627,458,193,103,90,2,2,55,32,23,208,183,25,0
2021,Newham 015D,E01003628,427,203,95,108,3,3,22,10,12,199,181,18,0
2021,Newham 015E,E01003629,510,198,101,97,3,3,42,23,19,267,252,15,0
2021,Newham 021C,E01003630,682,139,68,71,19,19,331,195,136,187,172,15,6
2021,Newham 020A,E01003631,693,206,84,122,1,1,221,164,57,264,254,10,1
2021,Newham 020B,E01003632,795,305,145,160,16,16,144,69,75,328,316,12,2
2021,Newham 020C,E01003633,687,113,43,70,2,2,431,409,22,137,134,3,4
2021,Newham 020D,E01003634,592,146,46,100,10,10,284,271,13,149,139,10,3
2021,Newham 016D,E01003635,611,242,134,108,4,4,118,49,69,246,223,23,1
2021,Newham 020E,E01003636,693,181,79,102,28,28,321,257,64,160,152,8,3
2021,Newham 021D,E01003637,584,214,98,116,4,4,133,71,62,231,211,20,2
2021,Redbridge 017A,E01003638,661,411,171,240,22,22,113,56,57,111,88,23,4
2021,Redbridge 013A,E01003639,787,370,174,196,16,16,135,98,37,266,248,18,0
2021,Redbridge 013B,E01003640,625,423,190,233,0,0,26,18,8,176,153,23,0
2021,Redbridge 013C,E01003641,608,338,160,178,12,12,127,101,26,130,121,9,1
2021,Redbridge 013D,E01003642,556,319,160,159,3,3,102,52,50,132,118,14,0
2021,Redbridge 017B,E01003643,700,501,233,268,2,2,16,9,7,181,166,15,0
2021,Redbridge 017C,E01003644,503,361,179,182,2,2,16,9,7,124,114,10,0
2021,Redbridge 017D,E01003645,906,355,136,219,20,20,58,27,31,465,439,26,8
2021,Redbridge 012A,E01003646,603,347,175,172,4,4,31,24,7,220,206,14,1
2021,Redbridge 015A,E01003647,633,355,187,168,1,1,33,5,28,244,231,13,0
2021,Redbridge 012B,E01003648,517,425,240,185,1,1,9,3,6,82,64,18,0
2021,Redbridge 012C,E01003649,512,386,185,201,1,1,40,40,0,85,77,8,0
2021,Redbridge 015B,E01003650,590,344,175,169,2,2,76,41,35,165,152,13,3
2021,Redbridge 012D,E01003651,477,401,213,188,2,2,3,2,1,71,59,12,0
2021,Redbridge 015C,E01003652,479,378,181,197,2,2,8,3,5,91,82,9,0
2021,Redbridge 015D,E01003653,724,343,139,204,2,2,72,67,5,306,259,47,1
2021,Redbridge 004A,E01003654,599,405,167,238,3,3,92,88,4,99,90,9,0
2021,Redbridge 004B,E01003655,637,480,229,251,2,2,25,10,15,130,114,16,0
2021,Redbridge 005A,E01003656,652,340,144,196,2,2,185,150,35,124,112,12,1
2021,Redbridge 005B,E01003657,897,638,311,327,6,6,72,62,10,177,157,20,4
2021,Redbridge 004C,E01003658,688,297,131,166,5,5,257,170,87,122,111,11,7
2021,Redbridge 005C,E01003659,634,503,195,308,1,1,10,8,2,120,109,11,0
2021,Redbridge 004D,E01003660,669,546,250,296,1,1,8,4,4,114,104,10,0
2021,Redbridge 038A,E01003661,699,452,180,272,13,13,51,25,26,183,171,12,0
2021,Redbridge 038C,E01003662,763,329,136,193,2,2,68,33,35,357,326,31,7
2021,Redbridge 037A,E01003663,639,512,240,272,0,0,40,17,23,87,71,16,0
2021,Redbridge 037B,E01003664,564,410,145,265,2,2,55,21,34,95,79,16,2
2021,Redbridge 037E,E01003665,517,414,168,246,4,4,8,3,5,91,87,4,0
2021,Redbridge 038B,E01003666,1068,354,116,238,32,32,323,121,202,359,339,20,0
2021,Redbridge 007A,E01003668,806,423,218,205,7,7,31,25,6,344,318,26,1
2021,Redbridge 007B,E01003669,624,467,214,253,0,0,16,5,11,140,131,9,1
2021,Redbridge 007C,E01003670,581,392,194,198,2,2,95,51,44,92,82,10,0
2021,Redbridge 007D,E01003671,558,505,246,259,1,1,5,3,2,47,41,6,0
2021,Redbridge 007E,E01003672,752,285,124,161,27,27,151,46,105,289,270,19,0
2021,Redbridge 007F,E01003673,792,480,211,269,9,9,38,15,23,264,247,17,1
2021,Redbridge 007G,E01003674,1064,427,154,273,4,4,103,42,61,528,510,18,2
2021,Redbridge 036A,E01003675,498,319,183,136,1,1,9,5,4,169,158,11,0
2021,Redbridge 036B,E01003676,523,374,178,196,0,0,22,19,3,123,114,9,4
2021,Redbridge 036C,E01003677,526,422,211,211,1,1,3,2,1,100,91,9,0
2021,Redbridge 036D,E01003678,473,386,180,206,1,1,24,24,0,62,50,12,0
2021,Redbridge 036E,E01003679,495,436,179,257,0,0,3,1,2,56,49,7,0
2021,Redbridge 036F,E01003680,481,391,166,225,0,0,6,1,5,84,77,7,0
2021,Redbridge 036G,E01003681,679,388,188,200,2,2,84,33,51,202,191,11,3
2021,Redbridge 036H,E01003682,510,404,197,207,0,0,3,3,0,103,95,8,0
2021,Redbridge 040C,E01003683,569,289,147,142,1,1,46,23,23,231,210,21,2
2021,Redbridge 040E,E01003684,502,273,133,140,1,1,28,14,14,200,180,20,0
2021,Redbridge 040D,E01003685,547,238,139,99,4,4,26,15,11,279,254,25,0
2021,Redbridge 040A,E01003686,578,307,186,121,3,3,51,26,25,215,199,16,2
2021,Redbridge 040B,E01003688,524,211,125,86,1,1,107,92,15,203,173,30,2
2021,Redbridge 039C,E01003689,727,209,109,100,1,1,74,52,22,438,412,26,5
2021,Redbridge 035A,E01003690,746,305,152,153,9,9,71,18,53,359,345,14,2
2021,Redbridge 035B,E01003691,456,280,133,147,0,0,15,6,9,160,146,14,1
2021,Redbridge 035C,E01003692,478,325,152,173,1,1,11,6,5,141,125,16,0
2021,Redbridge 035D,E01003693,444,351,171,180,3,3,7,4,3,83,71,12,0
2021,Redbridge 035E,E01003694,447,329,195,134,0,0,36,5,31,82,63,19,0
2021,Redbridge 035F,E01003695,495,221,130,91,2,2,23,15,8,248,237,11,1
2021,Redbridge 035G,E01003696,523,367,175,192,2,2,35,18,17,116,104,12,3
2021,Redbridge 035H,E01003697,506,343,166,177,1,1,29,26,3,133,117,16,0
2021,Redbridge 006A,E01003698,522,411,203,208,1,1,21,19,2,89,84,5,0
2021,Redbridge 006B,E01003699,591,405,211,194,1,1,22,15,7,162,141,21,1
2021,Redbridge 006C,E01003700,866,515,227,288,9,9,120,76,44,221,192,29,1
2021,Redbridge 006D,E01003701,684,373,201,172,1,1,35,31,4,275,253,22,0
2021,Redbridge 006E,E01003702,921,528,193,335,23,23,57,18,39,312,292,20,1
2021,Redbridge 006F,E01003703,979,630,280,350,2,2,138,121,17,207,176,31,2
2021,Redbridge 006G,E01003704,695,365,170,195,4,4,145,96,49,180,169,11,1
2021,Redbridge 010A,E01003705,823,516,222,294,20,20,61,18,43,225,207,18,1
2021,Redbridge 010B,E01003706,624,382,200,182,1,1,64,54,10,175,162,13,2
2021,Redbridge 008A,E01003707,490,380,180,200,2,2,31,23,8,77,56,21,0
2021,Redbridge 008B,E01003708,756,335,125,210,16,16,270,154,116,131,123,8,4
2021,Redbridge 008C,E01003709,572,478,237,241,0,0,12,7,5,82,71,11,0
2021,Redbridge 008D,E01003710,504,441,231,210,2,2,9,6,3,52,45,7,0
2021,Redbridge 010C,E01003711,640,425,202,223,4,4,83,45,38,128,114,14,0
2021,Redbridge 010D,E01003712,542,185,86,99,4,4,260,169,91,89,84,5,4
2021,Redbridge 034A,E01003713,491,305,155,150,1,1,9,6,3,176,159,17,0
2021,Redbridge 034B,E01003714,682,333,167,166,1,1,34,19,15,313,283,30,1
2021,Redbridge 034C,E01003715,624,351,168,183,3,3,33,18,15,237,215,22,0
2021,Redbridge 034D,E01003716,593,329,172,157,2,2,56,35,21,204,187,17,2
2021,Redbridge 034E,E01003718,656,255,106,149,9,9,43,18,25,347,335,12,2
2021,Redbridge 034F,E01003719,720,340,173,167,16,16,67,35,32,294,269,25,3
2021,Redbridge 002A,E01003720,786,379,196,183,6,6,244,162,82,156,136,20,1
2021,Redbridge 003A,E01003721,663,371,187,184,5,5,132,118,14,148,132,16,7
2021,Redbridge 002B,E01003722,821,487,156,331,22,22,189,157,32,120,111,9,3
2021,Redbridge 002C,E01003723,718,406,151,255,2,2,228,190,38,82,68,14,0
2021,Redbridge 003B,E01003724,505,354,147,207,9,9,61,53,8,79,74,5,2
2021,Redbridge 003C,E01003725,672,335,122,213,8,8,161,79,82,166,156,10,2
2021,Redbridge 002D,E01003726,939,513,114,399,100,100,210,158,52,111,100,11,5
2021,Redbridge 003D,E01003727,641,351,141,210,6,6,189,162,27,92,84,8,3
2021,Redbridge 032B,E01003729,495,198,104,94,1,1,60,49,11,233,216,17,3
2021,Redbridge 032C,E01003730,458,213,119,94,0,0,30,18,12,214,205,9,1
2021,Redbridge 033A,E01003731,418,196,84,112,0,0,70,46,24,145,133,12,7
2021,Redbridge 032D,E01003732,629,116,44,72,6,6,259,171,88,240,236,4,8
2021,Redbridge 032E,E01003733,489,241,113,128,1,1,34,16,18,213,197,16,0
2021,Redbridge 033B,E01003734,502,243,115,128,2,2,37,21,16,218,203,15,2
2021,Redbridge 033C,E01003735,709,136,57,79,14,14,331,99,232,223,208,15,5
2021,Redbridge 033D,E01003736,492,201,77,124,3,3,60,24,36,228,214,14,0
2021,Redbridge 031A,E01003737,666,488,225,263,0,0,52,22,30,124,109,15,2
2021,Redbridge 031B,E01003738,653,488,200,288,4,4,11,9,2,150,117,33,0
2021,Redbridge 031C,E01003739,671,402,156,246,8,8,62,9,53,199,174,25,0
2021,Redbridge 031D,E01003740,615,417,181,236,4,4,45,25,20,148,137,11,1
2021,Redbridge 031E,E01003741,667,418,192,226,0,0,109,94,15,139,120,19,1
2021,Redbridge 031F,E01003742,636,339,148,191,2,2,28,18,10,266,251,15,1
2021,Redbridge 031G,E01003743,515,295,149,146,4,4,26,17,9,190,172,18,0
2021,Redbridge 001A,E01003744,615,499,286,213,3,3,19,15,4,94,83,11,0
2021,Redbridge 001B,E01003745,477,439,219,220,2,2,6,4,2,30,23,7,0
2021,Redbridge 001C,E01003746,676,543,322,221,2,2,18,7,11,113,97,16,0
2021,Redbridge 001D,E01003747,484,426,220,206,0,0,30,5,25,28,22,6,0
2021,Redbridge 001E,E01003748,625,463,288,175,3,3,8,5,3,151,142,9,0
2021,Redbridge 001F,E01003749,686,456,244,212,2,2,14,9,5,214,194,20,0
2021,Redbridge 001G,E01003750,877,458,254,204,1,1,158,50,108,257,235,22,3
2021,Redbridge 020A,E01003751,667,357,152,205,3,3,63,50,13,242,218,24,2
2021,Redbridge 023A,E01003752,823,526,232,294,6,6,59,9,50,232,222,10,0
2021,Redbridge 020B,E01003753,624,338,158,180,3,3,22,13,9,258,248,10,3
2021,Redbridge 020C,E01003754,557,370,194,176,3,3,28,10,18,152,141,11,4
2021,Redbridge 023B,E01003755,660,416,178,238,2,2,42,26,16,199,180,19,1
2021,Redbridge 023C,E01003756,755,438,218,220,3,3,109,95,14,194,177,17,11
2021,Redbridge 020D,E01003757,640,300,143,157,6,6,41,23,18,288,270,18,5
2021,Redbridge 009A,E01003759,553,478,250,228,1,1,3,3,0,71,63,8,0
2021,Redbridge 009B,E01003760,671,446,170,276,7,7,53,38,15,163,142,21,2
2021,Redbridge 009C,E01003761,678,111,52,59,1,1,440,371,69,122,115,7,4
2021,Redbridge 009D,E01003762,652,446,190,256,1,1,61,9,52,144,135,9,0
2021,Redbridge 009E,E01003763,663,516,231,285,10,10,20,11,9,117,105,12,0
2021,Redbridge 009F,E01003764,860,463,209,254,3,3,97,61,36,296,278,18,1
2021,Redbridge 009G,E01003765,744,438,162,276,7,7,55,39,16,240,226,14,4
2021,Redbridge 024A,E01003766,625,351,182,169,2,2,23,11,12,249,231,18,0
2021,Redbridge 024B,E01003767,659,295,156,139,0,0,20,13,7,344,324,20,0
2021,Redbridge 024C,E01003768,652,209,117,92,2,2,53,19,34,387,371,16,1
2021,Redbridge 022A,E01003769,581,198,110,88,1,1,49,17,32,332,325,7,1
2021,Redbridge 022B,E01003770,873,425,150,275,5,5,177,30,147,266,246,20,0
2021,Redbridge 022C,E01003771,525,270,149,121,4,4,40,20,20,210,195,15,1
2021,Redbridge 024D,E01003772,521,347,169,178,0,0,13,6,7,161,139,22,0
2021,Redbridge 022D,E01003773,557,359,148,211,1,1,23,9,14,174,157,17,0
2021,Redbridge 014A,E01003774,853,511,233,278,5,5,62,37,25,272,262,10,3
2021,Redbridge 014B,E01003775,642,432,231,201,4,4,19,13,6,187,158,29,0
2021,Redbridge 014C,E01003776,899,314,152,162,3,3,322,158,164,257,231,26,3
2021,Redbridge 014D,E01003777,842,509,231,278,3,3,31,13,18,299,288,11,0
2021,Redbridge 014E,E01003778,899,474,237,237,2,2,37,26,11,384,365,19,2
2021,Redbridge 014F,E01003779,721,485,282,203,5,5,77,10,67,154,134,20,0
2021,Redbridge 014G,E01003780,509,467,250,217,0,0,6,3,3,36,29,7,0
2021,Redbridge 026A,E01003781,652,246,129,117,3,3,86,42,44,316,297,19,1
2021,Redbridge 026B,E01003782,481,231,141,90,1,1,34,14,20,210,191,19,5
2021,Redbridge 029A,E01003783,882,222,124,98,0,0,137,81,56,516,475,41,7
2021,Redbridge 029B,E01003784,586,275,132,143,30,30,39,23,16,241,223,18,1
2021,Redbridge 029C,E01003785,667,197,96,101,0,0,46,25,21,424,406,18,0
2021,Redbridge 026C,E01003786,457,315,157,158,4,4,12,5,7,126,110,16,0
2021,Redbridge 026D,E01003787,490,302,170,132,2,2,24,8,16,162,150,12,0
2021,Redbridge 029D,E01003788,634,205,117,88,0,0,38,22,16,390,378,12,1
2021,Redbridge 018A,E01003789,586,369,183,186,1,1,100,2,98,116,108,8,0
2021,Redbridge 027A,E01003790,550,372,179,193,5,5,97,54,43,75,69,6,1
2021,Redbridge 027B,E01003791,536,469,265,204,1,1,8,7,1,57,45,12,1
2021,Redbridge 027C,E01003792,505,407,213,194,0,0,6,3,3,92,85,7,0
2021,Redbridge 027D,E01003793,732,349,161,188,2,2,193,154,39,186,172,14,2
2021,Redbridge 018B,E01003794,581,439,242,197,2,2,62,15,47,78,70,8,0
2021,Redbridge 018C,E01003795,430,392,209,183,0,0,3,2,1,35,32,3,0
2021,Redbridge 018D,E01003796,601,424,211,213,1,1,64,58,6,110,101,9,2
2021,Richmond upon Thames 001A,E01003797,514,420,229,191,0,0,37,1,36,56,48,8,1
2021,Richmond upon Thames 001B,E01003798,652,354,200,154,4,4,109,8,101,184,168,16,1
2021,Richmond upon Thames 001C,E01003799,633,404,212,192,1,1,21,0,21,206,196,10,1
2021,Richmond upon Thames 001D,E01003800,608,319,182,137,2,2,162,59,103,122,109,13,3
2021,Richmond upon Thames 001E,E01003801,540,342,198,144,1,1,7,0,7,190,169,21,0
2021,Richmond upon Thames 001F,E01003802,626,347,207,140,0,0,24,3,21,255,226,29,0
2021,Richmond upon Thames 001G,E01003803,607,194,97,97,0,0,326,97,229,85,76,9,2
2021,Richmond upon Thames 005A,E01003804,752,464,216,248,1,1,43,3,40,244,226,18,0
2021,Richmond upon Thames 012A,E01003805,601,511,251,260,1,1,11,4,7,78,68,10,0
2021,Richmond upon Thames 012B,E01003806,510,439,228,211,1,1,4,0,4,66,58,8,0
2021,Richmond upon Thames 005B,E01003807,840,438,189,249,0,0,95,14,81,306,274,32,1
2021,Richmond upon Thames 005C,E01003808,781,549,236,313,1,1,64,7,57,167,158,9,0
2021,Richmond upon Thames 005D,E01003809,640,528,277,251,0,0,15,1,14,97,88,9,0
2021,Richmond upon Thames 019A,E01003810,622,470,210,260,2,2,53,9,44,95,86,9,2
2021,Richmond upon Thames 018A,E01003811,718,545,223,322,6,6,33,4,29,134,124,10,0
2021,Richmond upon Thames 018B,E01003812,750,466,180,286,3,3,71,5,66,210,198,12,0
2021,Richmond upon Thames 019B,E01003813,625,525,276,249,2,2,23,7,16,75,67,8,0
2021,Richmond upon Thames 019C,E01003814,796,544,246,298,0,0,66,7,59,185,170,15,1
2021,Richmond upon Thames 019D,E01003815,933,544,249,295,1,1,107,14,93,280,274,6,1
2021,Richmond upon Thames 012C,E01003816,619,427,224,203,0,0,103,16,87,87,77,10,2
2021,Richmond upon Thames 012D,E01003817,863,543,330,213,6,6,109,19,90,203,165,38,2
2021,Richmond upon Thames 017A,E01003818,663,481,268,213,10,10,54,10,44,118,109,9,0
2021,Richmond upon Thames 017B,E01003819,734,304,153,151,2,2,323,91,232,104,89,15,1
2021,Richmond upon Thames 017C,E01003820,762,461,221,240,2,2,193,64,129,106,91,15,0
2021,Richmond upon Thames 008A,E01003821,764,360,196,164,5,5,41,2,39,358,330,28,0
2021,Richmond upon Thames 023A,E01003822,525,492,264,228,2,2,1,0,1,30,29,1,0
2021,Richmond upon Thames 023B,E01003823,802,572,384,188,4,4,21,3,18,205,168,37,0
2021,Richmond upon Thames 023C,E01003824,632,506,240,266,5,5,30,3,27,87,81,6,4
2021,Richmond upon Thames 023D,E01003825,647,553,242,311,6,6,29,8,21,59,52,7,0
2021,Richmond upon Thames 023E,E01003826,763,321,131,190,3,3,324,78,246,112,101,11,3
2021,Richmond upon Thames 023F,E01003827,883,504,237,267,10,10,114,20,94,255,240,15,0
2021,Richmond upon Thames 020A,E01003828,618,510,291,219,6,6,26,5,21,76,68,8,0
2021,Richmond upon Thames 020B,E01003829,694,328,161,167,3,3,263,65,198,98,92,6,2
2021,Richmond upon Thames 020C,E01003830,751,508,240,268,1,1,92,26,66,149,132,17,1
2021,Richmond upon Thames 020D,E01003831,684,524,279,245,9,9,40,6,34,110,101,9,1
2021,Richmond upon Thames 020E,E01003832,681,220,105,115,29,29,346,60,286,84,76,8,2
2021,Richmond upon Thames 020F,E01003833,666,361,180,181,15,15,143,28,115,147,136,11,0
2021,Richmond upon Thames 022A,E01003834,783,403,212,191,4,4,88,11,77,288,270,18,0
2021,Richmond upon Thames 022B,E01003835,595,494,212,282,3,3,15,1,14,83,73,10,0
2021,Richmond upon Thames 022C,E01003836,580,335,174,161,6,6,168,41,127,68,60,8,3
2021,Richmond upon Thames 022D,E01003837,891,607,343,264,6,6,84,17,67,194,172,22,0
2021,Richmond upon Thames 022E,E01003838,749,478,223,255,0,0,80,6,74,191,179,12,0
2021,Richmond upon Thames 022F,E01003839,1035,539,249,290,22,22,196,34,162,277,262,15,1
2021,Richmond upon Thames 013A,E01003840,580,382,179,203,1,1,44,14,30,153,145,8,0
2021,Richmond upon Thames 013B,E01003841,824,288,121,167,10,10,347,84,263,173,156,17,6
2021,Richmond upon Thames 013C,E01003842,607,358,159,199,2,2,184,49,135,61,56,5,2
2021,Richmond upon Thames 013D,E01003843,798,466,252,214,12,12,216,46,170,103,93,10,1
2021,Richmond upon Thames 013E,E01003844,550,451,254,197,0,0,39,7,32,60,53,7,0
2021,Richmond upon Thames 013F,E01003845,625,554,315,239,0,0,7,0,7,64,59,5,0
2021,Richmond upon Thames 002A,E01003846,611,513,264,249,4,4,11,2,9,83,77,6,0
2021,Richmond upon Thames 002B,E01003847,830,388,224,164,2,2,49,9,40,391,364,27,0
2021,Richmond upon Thames 004A,E01003848,819,462,177,285,2,2,109,29,80,246,230,16,0
2021,Richmond upon Thames 002C,E01003849,645,443,242,201,2,2,34,6,28,166,158,8,0
2021,Richmond upon Thames 002D,E01003851,655,489,267,222,2,2,14,3,11,150,133,17,0
2021,Richmond upon Thames 003A,E01003852,657,362,179,183,3,3,81,8,73,211,191,20,0
2021,Richmond upon Thames 003B,E01003853,595,382,210,172,0,0,130,25,105,83,69,14,0
2021,Richmond upon Thames 003C,E01003854,636,357,175,182,3,3,84,24,60,189,180,9,3
2021,Richmond upon Thames 003D,E01003855,899,348,145,203,7,7,300,54,246,244,225,19,0
2021,Richmond upon Thames 003E,E01003856,739,376,138,238,8,8,74,16,58,281,263,18,0
2021,Richmond upon Thames 003F,E01003857,751,463,185,278,4,4,67,17,50,217,204,13,0
2021,Richmond upon Thames 003G,E01003858,666,478,182,296,1,1,16,0,16,171,163,8,0
2021,Richmond upon Thames 005E,E01003859,609,464,203,261,1,1,43,8,35,101,96,5,0
2021,Richmond upon Thames 002E,E01003860,779,401,180,221,4,4,97,6,91,277,254,23,0
2021,Richmond upon Thames 004C,E01003861,898,481,168,313,10,10,76,12,64,329,314,15,2
2021,Richmond upon Thames 004D,E01003862,805,356,180,176,29,29,197,30,167,222,206,16,1
2021,Richmond upon Thames 004E,E01003863,622,295,134,161,3,3,230,42,188,93,80,13,1
2021,Richmond upon Thames 002F,E01003864,643,407,241,166,0,0,54,11,43,178,163,15,4
2021,Richmond upon Thames 004F,E01003865,587,337,125,212,0,0,128,20,108,122,118,4,0
2021,Richmond upon Thames 007A,E01003866,671,518,206,312,0,0,14,1,13,138,131,7,1
2021,Richmond upon Thames 011A,E01003867,595,396,178,218,1,1,52,14,38,146,141,5,0
2021,Richmond upon Thames 007B,E01003868,653,419,167,252,0,0,11,2,9,223,213,10,0
2021,Richmond upon Thames 011B,E01003869,687,426,188,238,15,15,6,2,4,240,223,17,0
2021,Richmond upon Thames 011C,E01003870,819,564,210,354,14,14,25,4,21,216,209,7,0
2021,Richmond upon Thames 007C,E01003871,701,448,186,262,15,15,61,5,56,177,163,14,0
2021,Richmond upon Thames 007D,E01003872,682,389,184,205,3,3,32,4,28,258,242,16,0
2021,Richmond upon Thames 006A,E01003873,796,432,238,194,3,3,66,2,64,295,270,25,0
2021,Richmond upon Thames 006B,E01003874,768,383,186,197,2,2,42,4,38,341,315,26,0
2021,Richmond upon Thames 006C,E01003875,647,432,233,199,1,1,67,17,50,147,133,14,0
2021,Richmond upon Thames 008B,E01003876,942,423,265,158,0,0,51,6,45,467,422,45,1
2021,Richmond upon Thames 008C,E01003877,682,404,227,177,2,2,56,7,49,220,211,9,0
2021,Richmond upon Thames 006D,E01003878,631,182,104,78,3,3,346,9,337,98,87,11,2
2021,Richmond upon Thames 008D,E01003879,577,326,179,147,2,2,33,3,30,216,211,5,0
2021,Richmond upon Thames 016A,E01003880,581,439,225,214,2,2,30,4,26,110,95,15,0
2021,Richmond upon Thames 016B,E01003881,473,338,192,146,2,2,23,1,22,110,101,9,0
2021,Richmond upon Thames 014A,E01003882,847,558,253,305,2,2,34,0,34,253,244,9,0
2021,Richmond upon Thames 014B,E01003883,876,593,203,390,11,11,63,8,55,209,186,23,0
2021,Richmond upon Thames 016C,E01003884,739,507,270,237,1,1,84,16,68,147,133,14,0
2021,Richmond upon Thames 016D,E01003885,645,417,201,216,1,1,41,9,32,186,175,11,0
2021,Richmond upon Thames 021A,E01003886,673,465,213,252,1,1,32,1,31,175,160,15,0
2021,Richmond upon Thames 021B,E01003887,804,551,266,285,6,6,18,5,13,229,211,18,0
2021,Richmond upon Thames 021C,E01003888,940,422,207,215,13,13,252,51,201,253,236,17,0
2021,Richmond upon Thames 021D,E01003889,752,534,321,213,3,3,25,1,24,190,176,14,0
2021,Richmond upon Thames 018C,E01003890,693,482,226,256,10,10,47,5,42,153,145,8,1
2021,Richmond upon Thames 018D,E01003891,858,576,343,233,20,20,34,1,33,228,210,18,0
2021,Richmond upon Thames 009A,E01003892,889,535,302,233,2,2,20,2,18,332,302,30,0
2021,Richmond upon Thames 009B,E01003893,751,409,212,197,2,2,42,2,40,298,281,17,0
2021,Richmond upon Thames 009C,E01003894,737,449,189,260,0,0,41,2,39,247,230,17,0
2021,Richmond upon Thames 009D,E01003895,722,443,191,252,3,3,87,14,73,189,177,12,0
2021,Richmond upon Thames 014C,E01003896,878,448,227,221,6,6,16,3,13,407,379,28,1
2021,Richmond upon Thames 014D,E01003897,875,438,182,256,27,27,93,11,82,317,310,7,0
2021,Richmond upon Thames 015A,E01003898,735,468,170,298,11,11,66,6,60,190,180,10,0
2021,Richmond upon Thames 015B,E01003899,622,437,184,253,4,4,19,7,12,162,151,11,0
2021,Richmond upon Thames 015C,E01003900,617,325,153,172,0,0,197,52,145,94,85,9,1
2021,Richmond upon Thames 015D,E01003901,611,500,207,293,5,5,24,5,19,82,78,4,0
2021,Richmond upon Thames 015E,E01003902,500,428,189,239,2,2,3,1,2,67,62,5,0
2021,Richmond upon Thames 015F,E01003903,580,418,198,220,1,1,81,33,48,79,77,2,1
2021,Richmond upon Thames 015G,E01003904,653,424,158,266,1,1,97,26,71,129,117,12,2
2021,Richmond upon Thames 010A,E01003905,532,370,190,180,3,3,17,5,12,142,113,29,0
2021,Richmond upon Thames 010B,E01003906,659,468,216,252,3,3,46,7,39,142,135,7,0
2021,Richmond upon Thames 010C,E01003907,646,319,150,169,14,14,227,28,199,86,79,7,0
2021,Richmond upon Thames 010D,E01003908,666,558,295,263,2,2,12,4,8,94,77,17,0
2021,Richmond upon Thames 010E,E01003909,637,446,254,192,0,0,34,4,30,157,142,15,0
2021,Richmond upon Thames 011D,E01003910,657,569,298,271,4,4,10,4,6,74,62,12,0
2021,Southwark 020A,E01003911,752,153,33,120,5,5,438,358,80,151,136,15,5
2021,Southwark 019A,E01003912,667,44,25,19,4,4,542,456,86,73,58,15,4
2021,Southwark 024A,E01003913,844,329,143,186,18,18,145,44,101,314,277,37,38
2021,Southwark 024B,E01003914,722,319,124,195,2,2,202,100,102,199,182,17,0
2021,Southwark 024C,E01003915,797,236,81,155,1,1,370,319,51,189,140,49,1
2021,Southwark 020B,E01003916,910,324,89,235,36,36,265,194,71,282,250,32,3
2021,Southwark 020C,E01003917,872,288,99,189,19,19,349,268,81,209,192,17,7
2021,Southwark 020D,E01003918,649,146,15,131,20,20,382,247,135,93,84,9,8
2021,Southwark 021A,E01003919,682,190,71,119,23,23,272,39,233,197,184,13,0
2021,Southwark 021B,E01003920,911,176,33,143,38,38,582,470,112,114,99,15,1
2021,Southwark 021C,E01003921,988,260,32,228,38,38,448,61,387,242,227,15,0
2021,Southwark 021D,E01003922,968,217,83,134,37,37,498,281,217,204,186,18,12
2021,Southwark 017A,E01003923,731,192,68,124,18,18,310,250,60,211,190,21,0
2021,Southwark 021E,E01003924,904,110,42,68,5,5,615,603,12,172,162,10,2
2021,Southwark 020E,E01003925,841,161,32,129,81,81,442,311,131,152,138,14,5
2021,Southwark 021F,E01003926,570,89,33,56,4,4,350,301,49,124,105,19,3
2021,Southwark 002B,E01003929,1072,225,82,143,16,16,330,112,218,498,444,54,3
2021,Southwark 034A,E01003930,749,196,87,109,49,49,278,188,90,224,207,17,2
2021,Southwark 034B,E01003932,689,137,44,93,21,21,379,263,116,150,139,11,2
2021,Southwark 034C,E01003933,1021,234,94,140,66,66,338,220,118,382,352,30,1
2021,Southwark 002C,E01003934,1121,295,176,119,14,14,312,115,197,499,454,45,1
2021,Southwark 002D,E01003935,420,61,29,32,3,3,264,124,140,92,81,11,0
2021,Southwark 009A,E01003936,581,121,52,69,3,3,142,15,127,315,297,18,0
2021,Southwark 009B,E01003937,764,212,78,134,9,9,120,95,25,423,394,29,0
2021,Southwark 006A,E01003938,751,123,34,89,31,31,421,319,102,176,168,8,0
2021,Southwark 002E,E01003939,879,156,55,101,15,15,248,206,42,460,413,47,0
2021,Southwark 006B,E01003940,630,81,22,59,4,4,415,385,30,125,116,9,5
2021,Southwark 006C,E01003941,962,275,105,170,18,18,269,189,80,400,367,33,0
2021,Southwark 006D,E01003942,637,123,43,80,17,17,388,254,134,107,100,7,2
2021,Southwark 009C,E01003943,585,77,24,53,4,4,357,338,19,143,120,23,4
2021,Southwark 033A,E01003945,725,442,205,237,23,23,122,113,9,137,123,14,1
2021,Southwark 033B,E01003946,756,448,239,209,11,11,138,109,29,159,134,25,0
2021,Southwark 033C,E01003947,602,123,34,89,4,4,388,378,10,84,74,10,3
2021,Southwark 033D,E01003948,793,425,160,265,15,15,97,72,25,256,240,16,0
2021,Southwark 032A,E01003949,865,407,144,263,13,13,158,55,103,287,262,25,0
2021,Southwark 032B,E01003950,808,228,77,151,6,6,394,201,193,177,153,24,3
2021,Southwark 033E,E01003951,550,356,203,153,0,0,81,64,17,112,90,22,1
2021,Southwark 030A,E01003952,688,367,149,218,2,2,93,41,52,226,217,9,0
2021,Southwark 028A,E01003953,946,435,150,285,2,2,202,46,156,306,284,22,1
2021,Southwark 030B,E01003954,658,418,160,258,2,2,86,41,45,152,140,12,0
2021,Southwark 028B,E01003955,809,420,132,288,6,6,197,106,91,185,172,13,1
2021,Southwark 030C,E01003956,729,426,121,305,7,7,106,60,46,188,176,12,2
2021,Southwark 032C,E01003957,700,417,145,272,0,0,105,47,58,178,165,13,0
2021,Southwark 032D,E01003958,773,406,176,230,5,5,149,107,42,210,190,20,3
2021,Southwark 012A,E01003960,766,199,89,110,22,22,257,163,94,284,269,15,4
2021,Southwark 012B,E01003961,883,116,35,81,9,9,573,445,128,165,151,14,20
2021,Southwark 016A,E01003963,688,83,27,56,4,4,457,348,109,142,130,12,2
2021,Southwark 015B,E01003966,821,117,46,71,12,12,376,324,52,316,295,21,0
2021,Southwark 017B,E01003969,1017,276,104,172,15,15,311,174,137,415,384,31,0
2021,Southwark 015D,E01003971,511,46,13,33,55,55,328,255,73,78,58,20,4
2021,Southwark 016D,E01003972,616,83,24,59,5,5,300,259,41,226,220,6,2
2021,Southwark 016E,E01003973,751,69,28,41,4,4,410,369,41,266,258,8,2
2021,Southwark 004A,E01003975,739,109,31,78,37,37,436,309,127,155,138,17,2
2021,Southwark 036D,E01003976,1142,280,76,204,24,24,428,283,145,409,373,36,1
2021,Southwark 010A,E01003977,830,192,49,143,4,4,418,388,30,212,192,20,4
2021,Southwark 006E,E01003979,890,182,64,118,7,7,394,146,248,306,278,28,1
2021,Southwark 013A,E01003980,885,89,27,62,5,5,518,275,243,272,250,22,1
2021,Southwark 006F,E01003981,662,105,46,59,5,5,358,162,196,193,179,14,1
2021,Southwark 018A,E01003983,673,73,25,48,5,5,503,453,50,82,71,11,10
2021,Southwark 023A,E01003984,1006,301,90,211,12,12,450,327,123,240,230,10,3
2021,Southwark 011A,E01003986,697,116,41,75,21,21,430,261,169,124,111,13,6
2021,Southwark 011B,E01003987,821,159,25,134,15,15,535,262,273,109,103,6,3
2021,Southwark 018B,E01003988,874,162,75,87,8,8,515,455,60,169,157,12,20
2021,Southwark 018C,E01003989,876,185,39,146,14,14,466,428,38,206,190,16,5
2021,Southwark 018D,E01003990,822,136,54,82,6,6,544,398,146,133,117,16,3
2021,Southwark 017C,E01003991,586,110,39,71,3,3,371,367,4,98,91,7,4
2021,Southwark 014A,E01003992,646,100,40,60,7,7,444,355,89,92,84,8,3
2021,Southwark 017D,E01003993,797,100,46,54,27,27,556,472,84,110,97,13,4
2021,Southwark 012E,E01003994,865,228,48,180,77,77,387,309,78,170,156,14,3
2021,Southwark 014B,E01003995,738,144,57,87,7,7,445,282,163,137,123,14,5
2021,Southwark 017E,E01003997,511,146,65,81,3,3,213,208,5,145,128,17,4
2021,Southwark 014D,E01003998,656,197,75,122,4,4,271,155,116,183,149,34,1
2021,Southwark 014E,E01003999,599,158,70,88,1,1,284,272,12,155,140,15,1
2021,Southwark 026A,E01004000,878,322,122,200,6,6,312,195,117,236,186,50,2
2021,Southwark 026B,E01004001,753,160,46,114,2,2,507,288,219,83,77,6,1
2021,Southwark 029A,E01004002,656,420,153,267,4,4,106,56,50,126,114,12,0
2021,Southwark 023B,E01004003,795,168,56,112,2,2,488,432,56,133,120,13,4
2021,Southwark 023C,E01004004,1147,348,114,234,32,32,497,230,267,270,239,31,0
2021,Southwark 023D,E01004005,1007,243,49,194,37,37,554,344,210,166,152,14,7
2021,Southwark 023E,E01004006,790,343,121,222,5,5,287,212,75,152,139,13,3
2021,Southwark 018E,E01004007,543,70,10,60,20,20,390,260,130,60,53,7,3
2021,Southwark 022B,E01004008,798,135,36,99,20,20,501,459,42,136,125,11,6
2021,Southwark 022D,E01004010,631,141,41,100,10,10,264,194,70,211,194,17,5
2021,Southwark 019B,E01004011,826,108,24,84,8,8,594,285,309,116,103,13,0
2021,Southwark 019C,E01004012,922,222,48,174,25,25,402,240,162,269,241,28,4
2021,Southwark 019D,E01004013,657,136,15,121,18,18,406,268,138,94,81,13,3
2021,Southwark 019E,E01004014,816,124,26,98,27,27,555,482,73,105,95,10,5
2021,Southwark 028C,E01004015,705,309,115,194,3,3,146,78,68,243,227,16,4
2021,Southwark 029B,E01004016,989,562,182,380,9,9,226,141,85,190,175,15,2
2021,Southwark 029C,E01004017,650,387,140,247,3,3,89,53,36,171,161,10,0
2021,Southwark 032E,E01004018,779,501,155,346,4,4,64,32,32,209,191,18,1
2021,Southwark 026C,E01004019,842,351,114,237,17,17,294,145,149,178,164,14,2
2021,Southwark 029D,E01004020,739,201,65,136,2,2,402,357,45,128,118,10,6
2021,Southwark 028D,E01004021,998,379,130,249,9,9,156,41,115,454,441,13,0
2021,Southwark 004D,E01004023,712,166,73,93,0,0,341,339,2,205,200,5,0
2021,Southwark 011C,E01004024,814,115,45,70,3,3,513,481,32,182,176,6,1
2021,Southwark 004E,E01004028,1093,218,82,136,95,95,527,393,134,252,230,22,1
2021,Southwark 001A,E01004029,931,273,110,163,58,58,155,39,116,445,392,53,0
2021,Southwark 007A,E01004030,743,181,73,108,5,5,403,175,228,153,140,13,1
2021,Southwark 007B,E01004031,1081,177,79,98,28,28,364,214,150,512,491,21,0
2021,Southwark 001B,E01004032,659,287,125,162,29,29,20,6,14,323,295,28,0
2021,Southwark 007C,E01004033,1144,229,92,137,32,32,491,341,150,390,341,49,2
2021,Southwark 007D,E01004034,654,126,44,82,6,6,351,349,2,167,153,14,4
2021,Southwark 011D,E01004035,592,106,43,63,6,6,352,308,44,127,124,3,1
2021,Southwark 007E,E01004036,862,109,45,64,4,4,500,471,29,248,242,6,1
2021,Southwark 010B,E01004037,875,175,50,125,37,37,336,255,81,326,312,14,1
2021,Southwark 010C,E01004038,1032,227,45,182,82,82,357,34,323,365,353,12,1
2021,Southwark 013B,E01004039,635,182,77,105,1,1,140,136,4,312,292,20,0
2021,Southwark 013C,E01004040,779,55,16,39,55,55,581,341,240,85,70,15,3
2021,Southwark 013D,E01004041,691,88,41,47,2,2,467,207,260,132,120,12,2
2021,Southwark 010D,E01004042,824,129,50,79,20,20,477,390,87,193,181,12,5
2021,Southwark 010E,E01004043,583,245,120,125,3,3,201,142,59,133,120,13,1
2021,Southwark 013E,E01004044,564,117,43,74,2,2,349,334,15,91,82,9,5
2021,Southwark 027A,E01004045,638,121,22,99,8,8,431,418,13,76,72,4,2
2021,Southwark 028E,E01004046,645,326,136,190,3,3,142,51,91,172,158,14,2
2021,Southwark 027B,E01004047,615,133,37,96,6,6,352,341,11,122,110,12,2
2021,Southwark 027C,E01004048,689,289,93,196,1,1,258,173,85,140,132,8,1
2021,Southwark 027D,E01004049,516,136,45,91,12,12,277,253,24,89,79,10,2
2021,Southwark 024D,E01004050,631,328,126,202,4,4,76,32,44,223,210,13,0
2021,Southwark 027E,E01004051,584,381,163,218,1,1,73,61,12,129,105,24,0
2021,Southwark 024E,E01004052,774,347,129,218,14,14,195,151,44,215,198,17,3
2021,Southwark 001C,E01004053,888,373,171,202,16,16,95,22,73,403,377,26,1
2021,Southwark 001D,E01004054,729,326,111,215,10,10,75,13,62,317,298,19,1
2021,Southwark 001E,E01004055,528,97,35,62,7,7,370,162,208,54,52,2,0
2021,Southwark 008A,E01004056,1024,291,82,209,15,15,330,52,278,385,362,23,3
2021,Southwark 008B,E01004057,952,349,142,207,19,19,259,17,242,325,304,21,0
2021,Southwark 008C,E01004058,847,358,168,190,20,20,18,5,13,450,430,20,1
2021,Southwark 008D,E01004059,897,287,109,178,63,63,108,10,98,439,412,27,0
2021,Southwark 008E,E01004060,873,205,63,142,23,23,372,183,189,272,258,14,1
2021,Southwark 025A,E01004061,734,355,144,211,5,5,167,56,111,206,201,5,1
2021,Southwark 025B,E01004062,982,251,82,169,73,73,320,130,190,338,321,17,0
2021,Southwark 025C,E01004063,855,383,146,237,3,3,224,119,105,243,221,22,2
2021,Southwark 026D,E01004064,820,242,72,170,5,5,379,300,79,191,180,11,3
2021,Southwark 025D,E01004065,629,315,117,198,4,4,121,65,56,189,183,6,0
2021,Southwark 025E,E01004066,848,261,100,161,27,27,394,268,126,166,144,22,0
2021,Southwark 022E,E01004067,930,176,66,110,11,11,454,329,125,286,272,14,3
2021,Southwark 026E,E01004068,814,207,66,141,38,38,441,350,91,124,105,19,4
2021,Southwark 031A,E01004069,481,374,207,167,1,1,29,10,19,76,61,15,1
2021,Southwark 031B,E01004070,730,437,195,242,3,3,151,137,14,137,124,13,2
2021,Southwark 030D,E01004071,638,280,102,178,3,3,204,130,74,149,132,17,2
2021,Southwark 030E,E01004072,625,434,191,243,4,4,58,25,33,129,109,20,0
2021,Southwark 031C,E01004073,699,446,195,251,3,3,84,68,16,166,154,12,0
2021,Southwark 031D,E01004074,616,448,250,198,2,2,54,40,14,112,95,17,0
2021,Southwark 031E,E01004075,625,453,239,214,2,2,66,16,50,104,95,9,0
2021,Sutton 011A,E01004076,618,396,166,230,5,5,112,75,37,105,95,10,0
2021,Sutton 011B,E01004077,636,478,221,257,1,1,55,23,32,102,90,12,0
2021,Sutton 011C,E01004078,698,452,151,301,2,2,116,54,62,128,117,11,0
2021,Sutton 011D,E01004079,495,460,218,242,1,1,6,5,1,28,24,4,0
2021,Sutton 011E,E01004080,512,463,241,222,0,0,3,2,1,46,39,7,0
2021,Sutton 011F,E01004081,634,482,158,324,0,0,59,33,26,93,83,10,0
2021,Sutton 011G,E01004082,497,439,189,250,3,3,13,5,8,42,34,8,0
2021,Sutton 019A,E01004083,610,147,50,97,11,11,409,67,342,41,34,7,2
2021,Sutton 024A,E01004084,513,482,262,220,1,1,4,2,2,26,17,9,0
2021,Sutton 024B,E01004085,580,510,259,251,0,0,9,2,7,61,54,7,0
2021,Sutton 019B,E01004086,725,474,185,289,25,25,93,21,72,133,114,19,0
2021,Sutton 017A,E01004087,538,505,272,233,0,0,4,1,3,29,22,7,0
2021,Sutton 019C,E01004088,748,68,16,52,17,17,634,85,549,28,27,1,1
2021,Sutton 019D,E01004089,554,160,51,109,33,33,302,54,248,59,55,4,0
2021,Sutton 021A,E01004090,571,156,50,106,6,6,330,235,95,77,70,7,2
2021,Sutton 022A,E01004091,480,462,260,202,1,1,4,3,1,13,13,0,0
2021,Sutton 022B,E01004092,582,471,247,224,3,3,4,2,2,104,95,9,0
2021,Sutton 025A,E01004093,613,475,230,245,1,1,25,6,19,112,98,14,0
2021,Sutton 025B,E01004094,779,535,217,318,28,28,30,6,24,186,175,11,0
2021,Sutton 025C,E01004095,626,478,242,236,4,4,6,4,2,138,130,8,0
2021,Sutton 021B,E01004096,757,317,102,215,1,1,91,10,81,348,332,16,0
2021,Sutton 015A,E01004097,623,495,250,245,1,1,5,2,3,122,117,5,0
2021,Sutton 015B,E01004098,512,401,183,218,0,0,16,6,10,95,87,8,0
2021,Sutton 015C,E01004099,773,409,161,248,1,1,164,52,112,196,183,13,3
2021,Sutton 015D,E01004100,574,443,212,231,13,13,47,9,38,71,61,10,0
2021,Sutton 013A,E01004101,536,467,241,226,0,0,9,4,5,59,54,5,1
2021,Sutton 015E,E01004102,603,454,215,239,2,2,42,17,25,105,89,16,0
2021,Sutton 013B,E01004103,747,500,198,302,2,2,29,3,26,216,202,14,0
2021,Sutton 020A,E01004104,555,501,269,232,0,0,5,3,2,49,43,6,0
2021,Sutton 022C,E01004105,682,549,264,285,0,0,51,36,15,82,72,10,0
2021,Sutton 022D,E01004106,552,528,276,252,2,2,6,2,4,16,16,0,0
2021,Sutton 020B,E01004107,620,437,174,263,2,2,105,79,26,76,67,9,0
2021,Sutton 024C,E01004108,696,587,229,358,3,3,27,23,4,79,64,15,0
2021,Sutton 024D,E01004109,636,411,176,235,5,5,166,143,23,53,48,5,1
2021,Sutton 016A,E01004110,858,464,259,205,1,1,45,23,22,348,313,35,0
2021,Sutton 016B,E01004111,682,521,238,283,11,11,84,15,69,66,58,8,0
2021,Sutton 016C,E01004112,673,569,343,226,1,1,4,4,0,98,85,13,1
2021,Sutton 025D,E01004114,590,554,309,245,0,0,6,5,1,30,25,5,0
2021,Sutton 009A,E01004115,675,555,240,315,1,1,9,6,3,110,99,11,0
2021,Sutton 008A,E01004116,630,523,304,219,2,2,43,5,38,62,48,14,0
2021,Sutton 006A,E01004117,516,464,203,261,2,2,7,2,5,43,39,4,0
2021,Sutton 009B,E01004118,693,497,254,243,2,2,37,16,21,157,141,16,0
2021,Sutton 009C,E01004119,500,448,211,237,0,0,7,4,3,45,45,0,0
2021,Sutton 016D,E01004120,544,504,275,229,0,0,7,6,1,33,26,7,0
2021,Sutton 006B,E01004121,626,440,208,232,2,2,30,5,25,154,132,22,0
2021,Sutton 008B,E01004122,533,454,228,226,0,0,38,9,29,41,33,8,0
2021,Sutton 002A,E01004123,814,334,95,239,15,15,261,179,82,203,190,13,1
2021,Sutton 002B,E01004124,670,366,135,231,12,12,217,162,55,75,66,9,0
2021,Sutton 001A,E01004125,620,279,73,206,4,4,269,220,49,64,57,7,4
2021,Sutton 002C,E01004126,568,250,78,172,8,8,246,207,39,63,57,6,1
2021,Sutton 005A,E01004127,652,398,133,265,4,4,184,125,59,66,57,9,0
2021,Sutton 002D,E01004128,527,269,98,171,4,4,195,164,31,57,52,5,2
2021,Sutton 002E,E01004129,732,275,99,176,15,15,357,257,100,81,74,7,4
2021,Sutton 003A,E01004130,656,519,258,261,1,1,44,12,32,92,80,12,0
2021,Sutton 003B,E01004131,677,493,222,271,4,4,27,10,17,153,136,17,0
2021,Sutton 009D,E01004132,511,479,195,284,1,1,6,6,0,25,21,4,0
2021,Sutton 009E,E01004133,539,493,223,270,2,2,6,2,4,38,34,4,0
2021,Sutton 003C,E01004134,560,423,207,216,2,2,28,6,22,107,97,10,0
2021,Sutton 003D,E01004135,510,422,228,194,1,1,6,2,4,81,68,13,0
2021,Sutton 003E,E01004136,555,487,229,258,3,3,27,12,15,38,33,5,0
2021,Sutton 012A,E01004137,1160,454,186,268,44,44,76,14,62,586,565,21,0
2021,Sutton 013C,E01004138,751,445,156,289,4,4,92,24,68,208,190,18,2
2021,Sutton 013D,E01004139,634,378,168,210,2,2,37,18,19,217,203,14,0
2021,Sutton 012B,E01004140,788,254,72,182,15,15,289,195,94,226,218,8,4
2021,Sutton 012C,E01004141,751,373,164,209,3,3,209,136,73,163,150,13,3
2021,Sutton 014A,E01004143,628,408,161,247,2,2,70,8,62,147,134,13,1
2021,Sutton 007A,E01004144,652,543,261,282,0,0,9,7,2,100,93,7,0
2021,Sutton 007B,E01004145,808,615,258,357,10,10,62,40,22,119,111,8,2
2021,Sutton 007C,E01004146,731,469,189,280,12,12,52,13,39,198,186,12,0
2021,Sutton 007D,E01004147,594,490,257,233,1,1,54,17,37,49,39,10,0
2021,Sutton 014B,E01004148,678,339,139,200,4,4,232,149,83,101,96,5,2
2021,Sutton 012E,E01004149,787,538,277,261,3,3,55,26,29,190,177,13,1
2021,Sutton 021C,E01004150,1056,307,159,148,3,3,253,48,205,492,466,26,1
2021,Sutton 021D,E01004151,845,370,157,213,0,0,56,12,44,419,400,19,0
2021,Sutton 018A,E01004152,838,348,175,173,3,3,149,52,97,337,316,21,1
2021,Sutton 021E,E01004153,890,409,191,218,4,4,89,9,80,387,362,25,1
2021,Sutton 022E,E01004154,565,467,258,209,2,2,18,13,5,78,73,5,0
2021,Sutton 018B,E01004155,836,423,198,225,0,0,24,14,10,389,374,15,0
2021,Sutton 018C,E01004156,944,354,175,179,1,1,55,6,49,534,515,19,0
2021,Sutton 016E,E01004157,449,417,208,209,1,1,3,2,1,27,26,1,1
2021,Sutton 018D,E01004158,719,444,235,209,6,6,34,16,18,235,224,11,0
2021,Sutton 014C,E01004159,616,499,211,288,2,2,31,19,12,84,80,4,0
2021,Sutton 014D,E01004160,682,425,174,251,5,5,17,3,14,235,221,14,0
2021,Sutton 014E,E01004161,602,474,181,293,2,2,8,5,3,118,110,8,0
2021,Sutton 018E,E01004162,745,365,155,210,2,2,63,31,32,315,300,15,0
2021,Sutton 005B,E01004163,632,536,219,317,3,3,39,16,23,54,49,5,0
2021,Sutton 004A,E01004164,618,477,219,258,6,6,35,22,13,100,96,4,0
2021,Sutton 005C,E01004165,708,444,158,286,8,8,123,47,76,132,116,16,1
2021,Sutton 004B,E01004166,675,493,222,271,0,0,82,59,23,99,92,7,1
2021,Sutton 005D,E01004167,582,260,111,149,3,3,237,116,121,81,70,11,1
2021,Sutton 013E,E01004168,582,507,224,283,4,4,16,1,15,55,52,3,0
2021,Sutton 004C,E01004169,702,355,68,287,79,79,158,41,117,110,102,8,0
2021,Sutton 017B,E01004170,912,532,227,305,19,19,66,24,42,294,271,23,1
2021,Sutton 010A,E01004171,571,451,213,238,11,11,28,8,20,81,73,8,0
2021,Sutton 010B,E01004172,847,356,134,222,2,2,264,138,126,225,196,29,0
2021,Sutton 010C,E01004173,525,392,191,201,1,1,97,49,48,35,33,2,0
2021,Sutton 017C,E01004174,682,439,181,258,0,0,47,14,33,195,182,13,1
2021,Sutton 010D,E01004175,694,501,200,301,4,4,90,46,44,97,91,6,2
2021,Sutton 010E,E01004176,616,386,167,219,16,16,86,28,58,127,118,9,1
2021,Sutton 020C,E01004177,904,431,258,173,0,0,247,35,212,225,205,20,1
2021,Sutton 017D,E01004178,1062,558,214,344,5,5,145,18,127,354,333,21,0
2021,Sutton 017E,E01004179,606,492,229,263,1,1,13,4,9,100,88,12,0
2021,Sutton 020D,E01004180,624,572,321,251,2,2,2,2,0,48,42,6,0
2021,Sutton 020E,E01004181,780,478,256,222,3,3,111,32,79,188,167,21,0
2021,Sutton 019E,E01004182,671,299,112,187,1,1,239,46,193,132,125,7,0
2021,Sutton 001B,E01004183,681,298,83,215,3,3,262,211,51,115,105,10,3
2021,Sutton 001C,E01004184,605,299,83,216,2,2,245,183,62,58,52,6,1
2021,Sutton 001D,E01004185,806,351,74,277,20,20,337,95,242,98,93,5,0
2021,Sutton 004D,E01004186,768,438,131,307,12,12,91,51,40,227,214,13,0
2021,Sutton 005E,E01004187,639,395,138,257,2,2,165,84,81,75,66,9,2
2021,Sutton 001E,E01004189,770,382,123,259,1,1,301,218,83,83,69,14,3
2021,Sutton 008C,E01004190,504,447,229,218,0,0,5,3,2,52,49,3,0
2021,Sutton 008D,E01004191,713,514,224,290,2,2,14,9,5,183,166,17,0
2021,Sutton 006C,E01004192,727,506,185,321,5,5,89,48,41,127,115,12,0
2021,Sutton 006D,E01004193,1057,683,222,461,25,25,134,8,126,215,195,20,0
2021,Sutton 008E,E01004194,693,466,196,270,5,5,68,9,59,154,132,22,0
2021,Sutton 006E,E01004195,685,428,213,215,5,5,38,24,14,214,201,13,0
2021,Sutton 008F,E01004196,605,524,260,264,4,4,7,1,6,70,67,3,0
2021,Tower Hamlets 002B,E01004198,578,83,36,47,4,4,356,197,159,134,124,10,1
2021,Tower Hamlets 002C,E01004199,560,111,25,86,8,8,319,133,186,118,107,11,4
2021,Tower Hamlets 005A,E01004200,575,173,51,122,5,5,120,62,58,277,257,20,0
2021,Tower Hamlets 002D,E01004201,678,142,51,91,8,8,374,205,169,151,145,6,3
2021,Tower Hamlets 005B,E01004202,823,218,71,147,28,28,237,60,177,339,323,16,1
2021,Tower Hamlets 005C,E01004203,678,181,79,102,5,5,219,126,93,271,254,17,2
2021,Tower Hamlets 005D,E01004204,710,146,48,98,6,6,402,159,243,156,149,7,0
2021,Tower Hamlets 013A,E01004205,767,164,27,137,8,8,405,172,233,186,177,9,4
2021,Tower Hamlets 013B,E01004206,547,84,32,52,1,1,310,216,94,148,131,17,4
2021,Tower Hamlets 011A,E01004207,511,83,29,54,2,2,292,93,199,134,109,25,0
2021,Tower Hamlets 013C,E01004208,718,179,80,99,2,2,61,42,19,475,402,73,1
2021,Tower Hamlets 011B,E01004209,454,65,17,48,3,3,278,191,87,104,97,7,4
2021,Tower Hamlets 013D,E01004211,744,155,70,85,22,22,197,38,159,367,355,12,3
2021,Tower Hamlets 011D,E01004212,784,180,58,122,33,33,263,180,83,305,297,8,3
2021,Tower Hamlets 030A,E01004214,636,109,21,88,1,1,427,74,353,95,84,11,4
2021,Tower Hamlets 030B,E01004216,733,222,63,159,11,11,195,40,155,304,288,16,1
2021,Tower Hamlets 030C,E01004217,831,234,89,145,9,9,299,71,228,286,266,20,3
2021,Tower Hamlets 030D,E01004218,788,284,110,174,14,14,170,46,124,320,298,22,0
2021,Tower Hamlets 035B,E01004219,1026,211,40,171,34,34,359,147,212,421,391,30,1
2021,Tower Hamlets 036A,E01004221,818,192,59,133,18,18,248,54,194,360,343,17,0
2021,Tower Hamlets 001A,E01004222,1120,200,62,138,14,14,646,150,496,258,239,19,2
2021,Tower Hamlets 001B,E01004223,939,187,84,103,11,11,615,89,526,125,109,16,1
2021,Tower Hamlets 001D,E01004226,910,232,95,137,46,46,356,245,111,276,255,21,0
2021,Tower Hamlets 003A,E01004228,816,285,106,179,31,31,233,79,154,263,235,28,4
2021,Tower Hamlets 004C,E01004229,538,144,58,86,13,13,215,175,40,163,150,13,3
2021,Tower Hamlets 003B,E01004230,833,235,103,132,6,6,332,69,263,258,246,12,2
2021,Tower Hamlets 004D,E01004231,589,124,40,84,10,10,264,174,90,185,175,10,6
2021,Tower Hamlets 003C,E01004232,632,289,111,178,5,5,107,30,77,226,206,20,5
2021,Tower Hamlets 003D,E01004233,932,194,80,114,4,4,510,72,438,223,206,17,1
2021,Tower Hamlets 003E,E01004234,937,398,150,248,8,8,236,48,188,295,280,15,0
2021,Tower Hamlets 008A,E01004235,482,52,19,33,0,0,328,100,228,100,94,6,2
2021,Tower Hamlets 008B,E01004236,496,91,35,56,13,13,268,98,170,117,112,5,7
2021,Tower Hamlets 008C,E01004237,620,132,46,86,28,28,310,60,250,148,134,14,2
2021,Tower Hamlets 008E,E01004239,539,107,43,64,13,13,293,96,197,124,116,8,2
2021,Tower Hamlets 012A,E01004240,544,114,44,70,5,5,302,142,160,122,111,11,1
2021,Tower Hamlets 012B,E01004241,544,80,33,47,10,10,335,152,183,117,107,10,2
2021,Tower Hamlets 020A,E01004243,459,119,20,99,14,14,197,59,138,128,112,16,1
2021,Tower Hamlets 020B,E01004244,706,120,56,64,7,7,376,95,281,203,196,7,0
2021,Tower Hamlets 018A,E01004245,1067,146,46,100,13,13,421,122,299,482,466,16,5
2021,Tower Hamlets 020C,E01004247,864,122,44,78,23,23,355,133,222,362,348,14,2
2021,Tower Hamlets 018C,E01004248,616,69,28,41,23,23,389,127,262,134,124,10,1
2021,Tower Hamlets 018D,E01004249,775,87,31,56,18,18,518,177,341,150,139,11,2
2021,Tower Hamlets 023A,E01004251,931,187,49,138,11,11,410,355,55,320,304,16,3
2021,Tower Hamlets 023C,E01004255,617,138,31,107,14,14,265,157,108,196,187,9,4
2021,Tower Hamlets 024C,E01004256,599,122,43,79,8,8,302,213,89,161,152,9,6
2021,Tower Hamlets 024D,E01004257,751,115,49,66,1,1,413,304,109,218,200,18,4
2021,Tower Hamlets 023D,E01004258,687,273,122,151,2,2,166,129,37,246,222,24,0
2021,Tower Hamlets 007A,E01004259,782,223,87,136,15,15,230,168,62,314,298,16,0
2021,Tower Hamlets 007B,E01004260,603,138,40,98,12,12,282,228,54,168,155,13,3
2021,Tower Hamlets 007C,E01004263,484,72,17,55,1,1,295,107,188,114,103,11,2
2021,Tower Hamlets 010C,E01004264,443,82,38,44,2,2,221,199,22,135,131,4,3
2021,Tower Hamlets 007D,E01004266,552,150,76,74,5,5,246,88,158,151,138,13,0
2021,Tower Hamlets 012D,E01004267,901,218,79,139,5,5,383,39,344,295,268,27,0
2021,Tower Hamlets 012E,E01004268,729,82,36,46,3,3,427,112,315,216,191,25,1
2021,Tower Hamlets 014B,E01004270,838,246,97,149,5,5,199,49,150,387,358,29,1
2021,Tower Hamlets 014C,E01004271,907,284,53,231,23,23,400,103,297,196,178,18,4
2021,Tower Hamlets 014D,E01004272,872,206,30,176,31,31,413,162,251,222,201,21,0
2021,Tower Hamlets 031A,E01004274,665,130,50,80,2,2,294,47,247,235,224,11,4
2021,Tower Hamlets 031B,E01004275,882,267,106,161,47,47,306,77,229,259,242,17,3
2021,Tower Hamlets 031C,E01004276,958,390,137,253,3,3,32,14,18,531,507,24,2
2021,Tower Hamlets 033A,E01004277,854,255,105,150,5,5,38,10,28,556,514,42,0
2021,Tower Hamlets 032A,E01004280,749,162,55,107,8,8,290,41,249,288,266,22,1
2021,Tower Hamlets 031D,E01004281,812,243,75,168,16,16,95,18,77,458,432,26,0
2021,Tower Hamlets 016A,E01004283,733,137,52,85,4,4,378,119,259,213,197,16,1
2021,Tower Hamlets 019C,E01004286,853,158,57,101,42,42,498,192,306,154,135,19,1
2021,Tower Hamlets 016B,E01004287,879,170,69,101,23,23,449,110,339,236,222,14,1
2021,Tower Hamlets 019D,E01004288,610,74,30,44,13,13,399,267,132,121,111,10,3
2021,Tower Hamlets 016C,E01004289,658,178,69,109,3,3,305,145,160,170,164,6,2
2021,Tower Hamlets 016D,E01004290,775,199,91,108,8,8,254,89,165,312,266,46,2
2021,Tower Hamlets 027A,E01004291,1007,385,169,216,25,25,134,105,29,462,435,27,1
2021,Tower Hamlets 026A,E01004292,767,328,131,197,14,14,41,27,14,383,359,24,1
2021,Tower Hamlets 027B,E01004293,1003,357,169,188,7,7,142,72,70,497,443,54,0
2021,Tower Hamlets 026C,E01004295,667,105,42,63,1,1,339,95,244,220,208,12,2
2021,Tower Hamlets 026D,E01004296,1097,211,75,136,24,24,343,207,136,516,457,59,3
2021,Tower Hamlets 027C,E01004297,883,383,145,238,5,5,107,55,52,387,360,27,1
2021,Tower Hamlets 022A,E01004298,568,65,27,38,14,14,323,104,219,164,152,12,2
2021,Tower Hamlets 022B,E01004300,533,81,39,42,3,3,343,80,263,100,90,10,6
2021,Tower Hamlets 025B,E01004301,474,119,31,88,2,2,185,160,25,160,145,15,8
2021,Tower Hamlets 025C,E01004302,553,122,38,84,31,31,217,121,96,178,170,8,5
2021,Tower Hamlets 025D,E01004303,1007,235,73,162,56,56,431,153,278,282,263,19,3
2021,Tower Hamlets 022C,E01004304,620,78,29,49,21,21,323,138,185,196,186,10,2
2021,Tower Hamlets 022D,E01004305,666,136,50,86,0,0,337,154,183,188,173,15,5
2021,Tower Hamlets 015A,E01004306,687,171,75,96,1,1,220,81,139,295,276,19,0
2021,Tower Hamlets 015B,E01004307,1026,215,98,117,12,12,200,62,138,599,568,31,0
2021,Tower Hamlets 015C,E01004308,504,158,61,97,15,15,160,72,88,169,161,8,2
2021,Tower Hamlets 015D,E01004309,944,158,65,93,22,22,337,161,176,422,390,32,5
2021,Tower Hamlets 015E,E01004310,842,128,57,71,11,11,282,63,219,420,387,33,1
2021,Tower Hamlets 006A,E01004311,757,177,95,82,11,11,375,233,142,191,179,12,3
2021,Tower Hamlets 009A,E01004312,483,92,31,61,3,3,278,243,35,107,105,2,3
2021,Tower Hamlets 009B,E01004313,803,148,58,90,11,11,345,309,36,298,287,11,1
2021,Tower Hamlets 006C,E01004315,663,139,56,83,6,6,310,253,57,203,189,14,5
2021,Tower Hamlets 009C,E01004316,439,96,30,66,0,0,187,140,47,154,148,6,2
2021,Tower Hamlets 021A,E01004319,842,152,62,90,22,22,303,199,104,363,352,11,2
2021,Tower Hamlets 021C,E01004321,842,84,39,45,8,8,331,81,250,416,381,35,3
2021,Tower Hamlets 017A,E01004322,523,83,38,45,2,2,252,187,65,184,179,5,2
2021,Tower Hamlets 017B,E01004323,477,125,64,61,5,5,156,72,84,190,178,12,1
2021,Tower Hamlets 017C,E01004324,522,133,46,87,2,2,216,188,28,169,157,12,2
2021,Tower Hamlets 017D,E01004326,765,131,39,92,14,14,226,180,46,392,386,6,2
2021,Waltham Forest 028A,E01004327,472,213,110,103,2,2,156,116,40,100,92,8,1
2021,Waltham Forest 028B,E01004328,660,306,116,190,2,2,91,51,40,259,245,14,2
2021,Waltham Forest 028C,E01004329,641,297,116,181,6,6,97,44,53,239,220,19,2
2021,Waltham Forest 028D,E01004330,610,362,158,204,5,5,51,23,28,192,178,14,0
2021,Waltham Forest 028E,E01004331,602,288,120,168,1,1,112,41,71,201,180,21,0
2021,Waltham Forest 028F,E01004332,653,214,91,123,3,3,164,101,63,270,258,12,2
2021,Waltham Forest 024A,E01004333,583,203,81,122,4,4,209,157,52,166,145,21,1
2021,Waltham Forest 024B,E01004334,620,114,41,73,3,3,377,334,43,123,64,59,3
2021,Waltham Forest 027A,E01004335,615,78,26,52,30,30,421,242,179,84,76,8,2
2021,Waltham Forest 026A,E01004336,582,229,145,84,2,2,85,29,56,265,255,10,1
2021,Waltham Forest 027B,E01004337,647,213,87,126,4,4,258,237,21,165,152,13,7
2021,Waltham Forest 027C,E01004338,647,262,136,126,2,2,43,18,25,340,323,17,0
2021,Waltham Forest 027D,E01004339,695,316,108,208,2,2,120,53,67,257,249,8,0
2021,Waltham Forest 027E,E01004340,713,176,64,112,3,3,339,161,178,194,185,9,1
2021,Waltham Forest 027F,E01004341,740,143,54,89,6,6,365,70,295,224,211,13,2
2021,Waltham Forest 011A,E01004342,721,381,140,241,4,4,165,120,45,170,158,12,1
2021,Waltham Forest 008A,E01004343,653,491,189,302,3,3,32,15,17,125,111,14,2
2021,Waltham Forest 008B,E01004344,664,320,111,209,4,4,169,91,78,170,153,17,1
2021,Waltham Forest 010A,E01004345,616,389,146,243,1,1,57,22,35,169,165,4,0
2021,Waltham Forest 011B,E01004346,566,377,154,223,9,9,97,8,89,83,70,13,0
2021,Waltham Forest 011C,E01004347,804,473,141,332,9,9,119,33,86,202,188,14,1
2021,Waltham Forest 010B,E01004348,1198,574,153,421,61,61,184,35,149,379,351,28,0
2021,Waltham Forest 001A,E01004349,553,316,147,169,5,5,172,147,25,58,54,4,2
2021,Waltham Forest 001B,E01004350,920,444,253,191,24,24,312,52,260,139,123,16,1
2021,Waltham Forest 001C,E01004351,638,521,279,242,3,3,49,18,31,65,55,10,0
2021,Waltham Forest 002A,E01004352,790,570,335,235,1,1,36,13,23,183,168,15,0
2021,Waltham Forest 002B,E01004353,791,581,323,258,5,5,78,32,46,125,114,11,2
2021,Waltham Forest 002C,E01004354,780,507,238,269,1,1,34,26,8,238,221,17,0
2021,Waltham Forest 004A,E01004355,680,368,184,184,7,7,179,64,115,126,115,11,0
2021,Waltham Forest 001D,E01004356,592,392,188,204,3,3,125,95,30,72,63,9,0
2021,Waltham Forest 001E,E01004357,576,430,227,203,1,1,74,65,9,71,56,15,0
2021,Waltham Forest 002D,E01004358,882,547,254,293,10,10,150,72,78,174,158,16,1
2021,Waltham Forest 002E,E01004359,598,456,230,226,2,2,77,22,55,63,57,6,0
2021,Waltham Forest 004B,E01004360,475,421,223,198,1,1,13,8,5,39,34,5,1
2021,Waltham Forest 005A,E01004361,498,426,206,220,3,3,19,11,8,50,39,11,0
2021,Waltham Forest 021A,E01004362,675,378,128,250,0,0,95,13,82,202,189,13,0
2021,Waltham Forest 019A,E01004363,519,364,172,192,3,3,28,4,24,124,110,14,0
2021,Waltham Forest 019B,E01004364,618,285,128,157,26,26,186,32,154,121,110,11,0
2021,Waltham Forest 020A,E01004365,795,290,123,167,9,9,126,35,91,369,340,29,1
2021,Waltham Forest 019C,E01004366,667,441,241,200,5,5,46,8,38,173,159,14,2
2021,Waltham Forest 019D,E01004367,530,291,127,164,1,1,56,12,44,180,168,12,2
2021,Waltham Forest 019E,E01004368,780,386,213,173,17,17,92,32,60,285,272,13,0
2021,Waltham Forest 023A,E01004369,635,292,79,213,5,5,60,19,41,278,266,12,0
2021,Waltham Forest 023B,E01004370,804,419,115,304,15,15,75,11,64,295,281,14,0
2021,Waltham Forest 025A,E01004371,605,302,135,167,1,1,63,13,50,239,228,11,0
2021,Waltham Forest 023C,E01004372,689,364,113,251,1,1,43,25,18,281,264,17,0
2021,Waltham Forest 025B,E01004373,680,284,118,166,4,4,111,46,65,279,257,22,2
2021,Waltham Forest 025C,E01004374,707,363,143,220,5,5,71,25,46,268,256,12,0
2021,Waltham Forest 025D,E01004375,709,283,112,171,8,8,82,19,63,335,311,24,1
2021,Waltham Forest 025E,E01004376,656,254,147,107,4,4,81,37,44,316,296,20,1
2021,Waltham Forest 010C,E01004377,617,476,209,267,4,4,49,13,36,88,82,6,0
2021,Waltham Forest 010D,E01004378,676,384,175,209,5,5,146,40,106,141,134,7,0
2021,Waltham Forest 007A,E01004379,727,525,202,323,21,21,42,11,31,139,123,16,0
2021,Waltham Forest 007B,E01004380,622,360,139,221,15,15,150,131,19,96,82,14,1
2021,Waltham Forest 007C,E01004381,742,498,185,313,5,5,81,46,35,157,144,13,1
2021,Waltham Forest 008C,E01004382,629,220,63,157,21,21,307,214,93,80,75,5,1
2021,Waltham Forest 007D,E01004383,581,444,180,264,3,3,60,42,18,74,68,6,0
2021,Waltham Forest 003A,E01004384,747,363,138,225,2,2,280,203,77,100,87,13,2
2021,Waltham Forest 003B,E01004385,655,308,139,169,3,3,249,229,20,95,83,12,0
2021,Waltham Forest 003C,E01004386,647,578,298,280,1,1,18,13,5,50,41,9,0
2021,Waltham Forest 007E,E01004387,520,453,242,211,2,2,12,8,4,53,44,9,0
2021,Waltham Forest 007F,E01004388,659,340,153,187,1,1,119,86,33,199,192,7,0
2021,Waltham Forest 003D,E01004389,692,351,158,193,3,3,206,168,38,132,122,10,0
2021,Waltham Forest 003E,E01004390,629,341,150,191,0,0,232,191,41,54,50,4,2
2021,Waltham Forest 014A,E01004391,977,424,134,290,7,7,163,95,68,381,358,23,2
2021,Waltham Forest 017A,E01004392,983,406,149,257,10,10,114,43,71,453,426,27,0
2021,Waltham Forest 014B,E01004393,765,200,74,126,6,6,270,88,182,289,282,7,0
2021,Waltham Forest 017B,E01004394,793,286,121,165,19,19,270,185,85,216,195,21,2
2021,Waltham Forest 018A,E01004395,597,397,159,238,5,5,52,32,20,143,124,19,0
2021,Waltham Forest 012A,E01004396,698,393,171,222,3,3,40,25,15,261,238,23,1
2021,Waltham Forest 017C,E01004397,1129,437,178,259,55,55,147,54,93,489,467,22,1
2021,Waltham Forest 009A,E01004398,663,226,88,138,3,3,330,234,96,104,95,9,0
2021,Waltham Forest 009B,E01004399,598,178,48,130,11,11,328,239,89,78,71,7,3
2021,Waltham Forest 009C,E01004400,654,332,115,217,3,3,120,77,43,197,181,16,2
2021,Waltham Forest 014C,E01004401,886,393,130,263,81,81,179,65,114,233,209,24,0
2021,Waltham Forest 009D,E01004402,654,330,131,199,5,5,165,127,38,154,141,13,0
2021,Waltham Forest 009E,E01004403,898,451,117,334,55,55,262,118,144,125,116,9,5
2021,Waltham Forest 014D,E01004404,1106,288,82,206,100,100,426,123,303,289,273,16,3
2021,Waltham Forest 020B,E01004405,610,301,128,173,6,6,115,77,38,188,161,27,0
2021,Waltham Forest 016A,E01004406,740,289,127,162,2,2,80,57,23,369,354,15,0
2021,Waltham Forest 013A,E01004407,665,116,36,80,6,6,371,301,70,168,122,46,4
2021,Waltham Forest 016B,E01004408,710,379,146,233,7,7,154,66,88,169,158,11,1
2021,Waltham Forest 016C,E01004409,750,287,125,162,11,11,160,82,78,289,276,13,3
2021,Waltham Forest 013B,E01004410,821,252,87,165,20,20,348,218,130,199,169,30,2
2021,Waltham Forest 016D,E01004411,769,280,124,156,6,6,82,32,50,401,378,23,0
2021,Waltham Forest 015A,E01004412,748,363,127,236,2,2,138,77,61,245,230,15,0
2021,Waltham Forest 004C,E01004413,704,320,170,150,16,16,285,123,162,83,71,12,0
2021,Waltham Forest 005B,E01004414,635,441,219,222,1,1,27,8,19,166,151,15,0
2021,Waltham Forest 004D,E01004415,622,372,183,189,2,2,169,42,127,77,67,10,2
2021,Waltham Forest 004E,E01004416,719,514,199,315,6,6,99,82,17,99,93,6,1
2021,Waltham Forest 005C,E01004417,699,404,199,205,4,4,137,72,65,154,138,16,0
2021,Waltham Forest 008D,E01004418,651,431,189,242,20,20,87,51,36,110,98,12,3
2021,Waltham Forest 008E,E01004419,927,423,183,240,107,107,169,28,141,227,212,15,1
2021,Waltham Forest 020C,E01004420,736,282,122,160,10,10,155,113,42,284,261,23,5
2021,Waltham Forest 018B,E01004421,595,367,184,183,2,2,50,39,11,174,156,18,2
2021,Waltham Forest 022A,E01004422,982,521,178,343,77,77,126,33,93,258,212,46,0
2021,Waltham Forest 020D,E01004423,712,252,106,146,1,1,232,134,98,224,209,15,3
2021,Waltham Forest 022B,E01004424,738,279,116,163,6,6,160,46,114,290,266,24,3
2021,Waltham Forest 022C,E01004425,836,349,83,266,24,24,166,79,87,294,265,29,3
2021,Waltham Forest 022D,E01004426,602,370,164,206,4,4,55,20,35,173,143,30,0
2021,Waltham Forest 022E,E01004427,829,348,98,250,3,3,56,31,25,418,392,26,4
2021,Waltham Forest 026B,E01004428,707,124,37,87,14,14,475,77,398,92,81,11,2
2021,Waltham Forest 026C,E01004429,699,234,88,146,20,20,237,36,201,206,166,40,2
2021,Waltham Forest 026D,E01004430,1077,410,150,260,65,65,118,22,96,483,450,33,1
2021,Waltham Forest 023D,E01004432,703,366,157,209,5,5,79,26,53,253,236,17,0
2021,Waltham Forest 026E,E01004434,750,319,158,161,5,5,214,46,168,212,200,12,0
2021,Waltham Forest 023E,E01004435,818,267,101,166,10,10,213,40,173,327,303,24,1
2021,Waltham Forest 021B,E01004436,576,303,144,159,3,3,104,18,86,166,154,12,0
2021,Waltham Forest 021C,E01004437,750,233,99,134,3,3,167,29,138,346,333,13,1
2021,Waltham Forest 024C,E01004438,794,355,155,200,6,6,93,19,74,339,313,26,1
2021,Waltham Forest 021D,E01004439,662,302,138,164,1,1,118,24,94,241,225,16,0
2021,Waltham Forest 024D,E01004440,805,329,120,209,24,24,136,32,104,315,300,15,1
2021,Waltham Forest 024E,E01004441,609,376,190,186,4,4,72,17,55,157,145,12,0
2021,Waltham Forest 021E,E01004442,621,347,168,179,2,2,73,16,57,199,185,14,0
2021,Waltham Forest 016E,E01004443,784,357,152,205,18,18,104,20,84,302,288,14,3
2021,Waltham Forest 017D,E01004444,1150,366,106,260,44,44,335,182,153,402,383,19,3
2021,Waltham Forest 018C,E01004445,681,353,144,209,7,7,111,93,18,210,188,22,0
2021,Waltham Forest 017E,E01004446,798,392,156,236,15,15,98,61,37,292,277,15,1
2021,Waltham Forest 016F,E01004447,654,409,173,236,4,4,48,30,18,193,176,17,0
2021,Waltham Forest 018D,E01004448,763,366,115,251,25,25,165,33,132,207,193,14,0
2021,Waltham Forest 018E,E01004449,638,150,52,98,17,17,381,145,236,86,78,8,4
2021,Waltham Forest 006A,E01004450,606,524,245,279,3,3,7,4,3,72,59,13,0
2021,Waltham Forest 005D,E01004451,630,477,237,240,2,2,86,75,11,65,56,9,0
2021,Waltham Forest 005E,E01004452,766,432,210,222,3,3,130,64,66,200,180,20,1
2021,Waltham Forest 006B,E01004453,660,445,200,245,5,5,35,20,15,175,155,20,0
2021,Waltham Forest 006C,E01004454,690,443,204,239,18,18,94,52,42,133,121,12,2
2021,Waltham Forest 006D,E01004455,603,325,129,196,6,6,119,58,61,152,142,10,1
2021,Waltham Forest 006E,E01004456,562,134,54,80,1,1,377,93,284,49,45,4,1
2021,Waltham Forest 012B,E01004457,755,411,123,288,5,5,140,33,107,199,182,17,0
2021,Waltham Forest 012C,E01004458,758,395,177,218,6,6,113,53,60,244,227,17,0
2021,Waltham Forest 012D,E01004459,523,98,33,65,3,3,383,207,176,38,31,7,1
2021,Waltham Forest 011D,E01004460,702,334,133,201,6,6,144,55,89,218,198,20,0
2021,Waltham Forest 011E,E01004462,833,402,109,293,20,20,141,37,104,270,258,12,0
2021,Waltham Forest 012E,E01004463,893,488,123,365,9,9,152,53,99,243,227,16,1
2021,Waltham Forest 013C,E01004464,681,210,45,165,19,19,335,281,54,113,107,6,4
2021,Waltham Forest 015B,E01004465,568,376,139,237,6,6,84,74,10,101,91,10,1
2021,Waltham Forest 015C,E01004466,672,440,156,284,15,15,78,24,54,138,125,13,1
2021,Waltham Forest 015D,E01004467,913,260,87,173,12,12,345,205,140,294,279,15,2
2021,Waltham Forest 015E,E01004468,666,454,186,268,4,4,40,30,10,168,153,15,0
2021,Waltham Forest 013D,E01004469,645,199,78,121,12,12,317,230,87,115,107,8,2
2021,Waltham Forest 013E,E01004470,598,269,93,176,1,1,163,108,55,163,152,11,2
2021,Waltham Forest 013F,E01004471,653,286,104,182,3,3,203,159,44,160,155,5,1
2021,Wandsworth 021A,E01004472,755,434,201,233,23,23,48,32,16,250,234,16,0
2021,Wandsworth 026A,E01004473,754,393,141,252,4,4,98,36,62,258,240,18,1
2021,Wandsworth 021B,E01004474,982,301,78,223,24,24,121,51,70,536,514,22,0
2021,Wandsworth 026B,E01004475,635,318,118,200,3,3,101,20,81,212,198,14,1
2021,Wandsworth 021C,E01004476,885,289,130,159,6,6,134,91,43,456,433,23,0
2021,Wandsworth 017A,E01004477,609,432,210,222,4,4,59,24,35,114,100,14,0
2021,Wandsworth 017B,E01004478,520,371,160,211,1,1,34,7,27,114,104,10,0
2021,Wandsworth 017C,E01004479,609,356,165,191,3,3,67,24,43,183,169,14,0
2021,Wandsworth 026C,E01004480,671,338,135,203,6,6,32,24,8,295,276,19,0
2021,Wandsworth 029A,E01004481,689,286,117,169,2,2,53,20,33,348,334,14,0
2021,Wandsworth 030A,E01004482,609,280,129,151,2,2,87,41,46,240,224,16,0
2021,Wandsworth 026D,E01004483,962,433,136,297,12,12,67,36,31,448,419,29,2
2021,Wandsworth 026E,E01004484,626,277,112,165,4,4,90,43,47,253,246,7,2
2021,Wandsworth 030B,E01004485,749,314,131,183,4,4,138,47,91,291,276,15,2
2021,Wandsworth 026F,E01004486,737,316,116,200,4,4,134,16,118,282,266,16,1
2021,Wandsworth 030C,E01004487,701,257,91,166,2,2,176,12,164,266,255,11,0
2021,Wandsworth 029B,E01004488,558,306,114,192,2,2,96,11,85,154,144,10,0
2021,Wandsworth 030D,E01004489,598,254,88,166,0,0,161,35,126,183,171,12,0
2021,Wandsworth 031A,E01004490,603,394,113,281,4,4,18,6,12,187,175,12,0
2021,Wandsworth 031B,E01004491,1125,271,103,168,62,62,470,117,353,319,274,45,3
2021,Wandsworth 031C,E01004492,740,370,125,245,4,4,121,101,20,245,233,12,0
2021,Wandsworth 019A,E01004493,845,425,129,296,4,4,110,56,54,305,294,11,1
2021,Wandsworth 018A,E01004494,803,266,68,198,24,24,204,40,164,309,294,15,0
2021,Wandsworth 024A,E01004495,524,140,42,98,10,10,206,192,14,166,159,7,2
2021,Wandsworth 024B,E01004496,934,358,87,271,23,23,95,19,76,455,422,33,3
2021,Wandsworth 024C,E01004497,522,361,131,230,1,1,77,70,7,82,76,6,1
2021,Wandsworth 031D,E01004498,744,417,108,309,3,3,52,12,40,272,262,10,0
2021,Wandsworth 020A,E01004499,704,311,121,190,5,5,95,68,27,291,276,15,2
2021,Wandsworth 014A,E01004500,984,382,177,205,35,35,125,74,51,436,422,14,6
2021,Wandsworth 014B,E01004501,663,254,121,133,7,7,183,142,41,218,207,11,1
2021,Wandsworth 020B,E01004502,683,428,176,252,5,5,23,8,15,227,212,15,0
2021,Wandsworth 014C,E01004503,719,292,118,174,5,5,116,99,17,303,270,33,3
2021,Wandsworth 020C,E01004504,558,317,145,172,4,4,24,13,11,213,146,67,0
2021,Wandsworth 014D,E01004505,780,405,210,195,4,4,31,12,19,340,315,25,0
2021,Wandsworth 011A,E01004506,1104,445,216,229,24,24,70,44,26,559,520,39,6
2021,Wandsworth 014E,E01004507,1233,482,241,241,63,63,98,60,38,588,532,56,2
2021,Wandsworth 012A,E01004508,976,362,128,234,2,2,169,63,106,442,410,32,1
2021,Wandsworth 012B,E01004510,869,382,124,258,26,26,110,16,94,351,326,25,0
2021,Wandsworth 010B,E01004511,653,336,119,217,1,1,44,24,20,272,251,21,0
2021,Wandsworth 019B,E01004512,607,323,116,207,1,1,118,39,79,165,144,21,0
2021,Wandsworth 018B,E01004513,847,337,115,222,14,14,171,147,24,323,298,25,2
2021,Wandsworth 012C,E01004514,800,404,159,245,3,3,91,35,56,302,276,26,0
2021,Wandsworth 012D,E01004515,766,249,107,142,30,30,172,29,143,315,301,14,0
2021,Wandsworth 036A,E01004516,502,375,182,193,0,0,34,18,16,93,86,7,0
2021,Wandsworth 037A,E01004517,886,337,109,228,19,19,82,23,59,448,431,17,0
2021,Wandsworth 036B,E01004518,655,426,188,238,2,2,44,26,18,181,170,11,2
2021,Wandsworth 036C,E01004519,612,336,153,183,4,4,103,72,31,169,152,17,0
2021,Wandsworth 036D,E01004520,439,276,128,148,1,1,51,45,6,110,102,8,1
2021,Wandsworth 037B,E01004521,762,417,138,279,4,4,122,33,89,219,205,14,0
2021,Wandsworth 037C,E01004522,639,335,125,210,5,5,71,14,57,228,215,13,0
2021,Wandsworth 036E,E01004523,712,346,160,186,6,6,205,131,74,153,140,13,2
2021,Wandsworth 037D,E01004524,817,193,79,114,5,5,353,218,135,265,244,21,1
2021,Wandsworth 035A,E01004525,726,226,104,122,3,3,41,26,15,456,433,23,0
2021,Wandsworth 035B,E01004526,751,273,105,168,23,23,104,72,32,349,331,18,2
2021,Wandsworth 035C,E01004527,604,300,139,161,7,7,67,28,39,227,206,21,3
2021,Wandsworth 035D,E01004528,715,217,99,118,17,17,236,38,198,245,231,14,0
2021,Wandsworth 035E,E01004529,888,370,119,251,31,31,113,43,70,374,348,26,0
2021,Wandsworth 035F,E01004530,736,365,133,232,6,6,86,10,76,278,257,21,1
2021,Wandsworth 033A,E01004531,652,305,140,165,0,0,164,149,15,180,165,15,3
2021,Wandsworth 032A,E01004532,621,320,123,197,3,3,133,79,54,165,157,8,0
2021,Wandsworth 033B,E01004533,611,239,96,143,3,3,174,169,5,193,184,9,2
2021,Wandsworth 008A,E01004534,792,407,175,232,4,4,90,64,26,291,269,22,0
2021,Wandsworth 007A,E01004535,710,70,34,36,4,4,516,498,18,113,109,4,7
2021,Wandsworth 008B,E01004536,881,192,108,84,5,5,339,327,12,344,318,26,1
2021,Wandsworth 007B,E01004537,932,183,75,108,27,27,476,404,72,244,223,21,2
2021,Wandsworth 007C,E01004538,1087,304,94,210,53,53,410,341,69,315,296,19,5
2021,Wandsworth 003A,E01004539,782,159,70,89,9,9,472,428,44,138,124,14,4
2021,Wandsworth 003B,E01004540,1046,335,132,203,15,15,364,334,30,330,307,23,2
2021,Wandsworth 007D,E01004541,770,167,80,87,14,14,434,320,114,153,141,12,2
2021,Wandsworth 021D,E01004542,597,396,155,241,1,1,49,21,28,151,147,4,0
2021,Wandsworth 027A,E01004543,713,399,163,236,18,18,35,15,20,261,247,14,0
2021,Wandsworth 021E,E01004544,589,350,134,216,1,1,85,14,71,153,145,8,0
2021,Wandsworth 027B,E01004545,1020,362,154,208,18,18,45,20,25,595,572,23,0
2021,Wandsworth 027C,E01004546,615,327,138,189,8,8,67,19,48,213,202,11,0
2021,Wandsworth 029C,E01004547,556,255,110,145,6,6,144,16,128,151,124,27,0
2021,Wandsworth 029D,E01004548,1022,407,175,232,8,8,110,54,56,497,466,31,0
2021,Wandsworth 027D,E01004549,666,332,139,193,8,8,102,17,85,224,215,9,0
2021,Wandsworth 017D,E01004550,522,259,119,140,0,0,138,62,76,124,115,9,1
2021,Wandsworth 012E,E01004551,787,180,53,127,18,18,216,22,194,371,347,24,2
2021,Wandsworth 008C,E01004552,890,270,95,175,3,3,70,13,57,546,493,53,1
2021,Wandsworth 015A,E01004553,777,350,132,218,3,3,103,36,67,321,296,25,0
2021,Wandsworth 009A,E01004554,621,368,142,226,1,1,28,4,24,224,207,17,0
2021,Wandsworth 017E,E01004555,577,422,179,243,1,1,19,5,14,135,122,13,0
2021,Wandsworth 009B,E01004556,585,385,147,238,0,0,31,5,26,169,152,17,0
2021,Wandsworth 015B,E01004557,662,349,142,207,4,4,59,30,29,250,233,17,0
2021,Wandsworth 015C,E01004558,669,361,136,225,2,2,72,31,41,233,224,9,1
2021,Wandsworth 015D,E01004559,517,313,138,175,3,3,74,35,39,127,118,9,0
2021,Wandsworth 001A,E01004560,883,337,177,160,19,19,130,103,27,396,371,25,1
2021,Wandsworth 039E,E01004563,871,155,82,73,24,24,385,370,15,302,280,22,5
2021,Wandsworth 039D,E01004564,829,266,107,159,5,5,214,47,167,344,329,15,0
2021,Wandsworth 005A,E01004565,777,248,83,165,3,3,232,26,206,294,270,24,0
2021,Wandsworth 001B,E01004566,788,333,175,158,14,14,99,32,67,342,313,29,0
2021,Wandsworth 039A,E01004567,982,172,52,120,32,32,500,434,66,272,255,17,6
2021,Wandsworth 013A,E01004568,459,58,44,14,2,2,316,298,18,80,74,6,3
2021,Wandsworth 023A,E01004569,726,222,115,107,13,13,286,231,55,205,175,30,0
2021,Wandsworth 023B,E01004570,719,100,50,50,3,3,444,366,78,170,157,13,2
2021,Wandsworth 023C,E01004571,688,169,66,103,10,10,283,246,37,224,189,35,2
2021,Wandsworth 016A,E01004572,667,281,146,135,5,5,192,163,29,188,170,18,1
2021,Wandsworth 023D,E01004573,633,296,136,160,3,3,141,125,16,189,174,15,4
2021,Wandsworth 013B,E01004574,703,71,33,38,2,2,463,419,44,160,117,43,7
2021,Wandsworth 013C,E01004575,682,197,105,92,6,6,316,294,22,158,122,36,5
2021,Wandsworth 013D,E01004576,591,194,108,86,4,4,272,218,54,120,110,10,1
2021,Wandsworth 003C,E01004577,821,368,201,167,8,8,150,105,45,295,269,26,0
2021,Wandsworth 004B,E01004579,827,342,143,199,3,3,241,34,207,241,222,19,0
2021,Wandsworth 004C,E01004580,894,365,133,232,5,5,139,109,30,385,359,26,0
2021,Wandsworth 004D,E01004581,837,320,160,160,6,6,165,110,55,346,316,30,0
2021,Wandsworth 001C,E01004582,984,524,352,172,3,3,87,76,11,368,335,33,2
2021,Wandsworth 001D,E01004583,814,368,221,147,21,21,144,116,28,281,229,52,0
2021,Wandsworth 003D,E01004584,716,101,58,43,11,11,490,482,8,111,103,8,3
2021,Wandsworth 008D,E01004585,822,346,164,182,6,6,153,33,120,317,293,24,0
2021,Wandsworth 009C,E01004586,850,372,139,233,1,1,112,14,98,365,332,33,0
2021,Wandsworth 009D,E01004587,697,375,139,236,2,2,68,14,54,252,231,21,0
2021,Wandsworth 008E,E01004588,881,426,205,221,0,0,45,7,38,409,378,31,1
2021,Wandsworth 009E,E01004589,731,347,123,224,3,3,55,15,40,326,307,19,0
2021,Wandsworth 005B,E01004590,815,257,127,130,4,4,355,185,170,198,185,13,1
2021,Wandsworth 005C,E01004591,858,266,103,163,9,9,249,122,127,334,307,27,0
2021,Wandsworth 005D,E01004592,780,216,82,134,0,0,397,33,364,163,152,11,4
2021,Wandsworth 025A,E01004593,837,419,171,248,6,6,56,18,38,355,335,20,1
2021,Wandsworth 020D,E01004594,628,445,211,234,4,4,8,3,5,171,160,11,0
2021,Wandsworth 025B,E01004595,792,425,155,270,3,3,52,40,12,312,300,12,0
2021,Wandsworth 020E,E01004596,643,409,180,229,1,1,17,11,6,216,200,16,0
2021,Wandsworth 025C,E01004597,769,421,159,262,12,12,136,31,105,200,190,10,0
2021,Wandsworth 025D,E01004598,956,485,126,359,45,45,73,32,41,353,340,13,0
2021,Wandsworth 025E,E01004599,567,434,165,269,1,1,22,14,8,110,102,8,0
2021,Wandsworth 018D,E01004601,1093,502,156,346,31,31,166,87,79,393,377,16,1
2021,Wandsworth 010C,E01004602,713,372,189,183,1,1,33,12,21,307,285,22,0
2021,Wandsworth 006A,E01004604,591,451,225,226,1,1,17,10,7,122,113,9,0
2021,Wandsworth 006B,E01004605,804,463,245,218,3,3,142,114,28,194,183,11,2
2021,Wandsworth 006C,E01004606,750,392,148,244,4,4,9,2,7,345,328,17,0
2021,Wandsworth 006D,E01004607,686,421,208,213,1,1,32,19,13,232,220,12,0
2021,Wandsworth 006E,E01004608,784,290,141,149,7,7,164,96,68,320,301,19,3
2021,Wandsworth 010E,E01004609,1013,404,188,216,15,15,58,22,36,536,499,37,0
2021,Wandsworth 033C,E01004610,716,374,206,168,8,8,50,24,26,284,262,22,0
2021,Wandsworth 032B,E01004611,553,312,151,161,5,5,52,35,17,184,177,7,0
2021,Wandsworth 032C,E01004612,542,217,124,93,13,13,59,45,14,252,239,13,1
2021,Wandsworth 033D,E01004613,699,176,87,89,6,6,210,165,45,305,288,17,2
2021,Wandsworth 034A,E01004614,836,322,107,215,18,18,158,45,113,336,316,20,2
2021,Wandsworth 034B,E01004615,706,193,81,112,3,3,301,282,19,205,195,10,4
2021,Wandsworth 034C,E01004616,766,224,94,130,4,4,62,16,46,475,450,25,1
2021,Wandsworth 034D,E01004617,726,197,81,116,5,5,131,75,56,389,368,21,4
2021,Wandsworth 032D,E01004618,530,367,181,186,2,2,14,4,10,147,134,13,0
2021,Wandsworth 015E,E01004619,502,319,132,187,3,3,72,7,65,108,99,9,0
2021,Wandsworth 019C,E01004620,680,356,117,239,2,2,96,15,81,226,214,12,0
2021,Wandsworth 019D,E01004621,693,382,145,237,15,15,83,39,44,213,201,12,0
2021,Wandsworth 024D,E01004622,518,203,77,126,9,9,118,75,43,188,169,19,0
2021,Wandsworth 019E,E01004623,706,413,139,274,5,5,74,29,45,214,201,13,0
2021,Wandsworth 024E,E01004624,609,344,121,223,7,7,101,68,33,157,142,15,0
2021,Wandsworth 027E,E01004625,475,422,206,216,0,0,9,1,8,44,37,7,0
2021,Wandsworth 027F,E01004626,763,507,198,309,4,4,28,10,18,224,196,28,0
2021,Wandsworth 019F,E01004627,608,331,113,218,6,6,110,35,75,160,150,10,1
2021,Wandsworth 022A,E01004628,891,352,147,205,33,33,196,110,86,308,276,32,2
2021,Wandsworth 020F,E01004629,602,377,192,185,7,7,63,54,9,155,141,14,0
2021,Wandsworth 022B,E01004630,659,155,66,89,3,3,352,332,20,149,141,8,0
2021,Wandsworth 022C,E01004631,739,249,99,150,4,4,144,125,19,340,321,19,2
2021,Wandsworth 028A,E01004632,571,307,147,160,2,2,70,58,12,190,178,12,2
2021,Wandsworth 022D,E01004633,601,132,49,83,3,3,290,282,8,174,163,11,2
2021,Wandsworth 028B,E01004634,677,311,135,176,2,2,124,120,4,240,222,18,0
2021,Wandsworth 028C,E01004635,668,304,156,148,8,8,84,77,7,269,262,7,3
2021,Wandsworth 028D,E01004636,619,264,125,139,1,1,107,94,13,246,229,17,1
2021,Wandsworth 028E,E01004637,568,232,105,127,3,3,132,127,5,201,187,14,0
2021,Wandsworth 011B,E01004638,505,397,215,182,0,0,33,25,8,75,64,11,0
2021,Wandsworth 011C,E01004639,766,379,211,168,6,6,63,46,17,317,269,48,1
2021,Wandsworth 011D,E01004640,768,450,209,241,7,7,47,8,39,263,238,25,1
2021,Wandsworth 011E,E01004641,785,418,218,200,3,3,183,156,27,179,168,11,2
2021,Wandsworth 016B,E01004642,828,401,180,221,37,37,195,178,17,190,181,9,5
2021,Wandsworth 016C,E01004643,968,395,157,238,5,5,298,266,32,267,237,30,3
2021,Wandsworth 016D,E01004644,1066,539,239,300,97,97,214,170,44,213,198,15,3
2021,Wandsworth 016E,E01004645,817,237,113,124,8,8,367,346,21,202,192,10,3
2021,Westminster 002A,E01004646,641,316,202,114,2,2,118,78,40,204,186,18,1
2021,Westminster 001A,E01004647,621,217,136,81,1,1,171,124,47,231,206,25,1
2021,Westminster 002B,E01004648,1030,391,201,190,1,1,70,18,52,568,520,48,0
2021,Westminster 001B,E01004649,594,276,198,78,3,3,36,24,12,279,236,43,0
2021,Westminster 002C,E01004650,855,366,221,145,1,1,44,30,14,443,409,34,1
2021,Westminster 003A,E01004651,1012,258,166,92,1,1,62,7,55,688,634,54,3
2021,Westminster 017A,E01004652,850,196,106,90,3,3,88,59,29,558,512,46,5
2021,Westminster 014A,E01004653,797,386,242,144,2,2,121,23,98,288,260,28,0
2021,Westminster 014B,E01004654,1198,395,232,163,2,2,181,59,122,620,572,48,0
2021,Westminster 014D,E01004656,1104,306,171,135,14,14,278,135,143,503,466,37,3
2021,Westminster 012A,E01004657,601,159,105,54,3,3,38,8,30,401,364,37,0
2021,Westminster 012B,E01004658,772,137,84,53,5,5,13,2,11,616,582,34,1
2021,Westminster 008A,E01004659,843,259,169,90,2,2,58,40,18,522,484,38,2
2021,Westminster 008B,E01004660,664,309,195,114,10,10,34,3,31,310,279,31,1
2021,Westminster 012C,E01004661,849,277,152,125,19,19,106,25,81,447,412,35,0
2021,Westminster 012D,E01004662,781,201,136,65,1,1,56,7,49,523,497,26,0
2021,Westminster 012E,E01004663,720,247,150,97,0,0,158,58,100,315,289,26,0
2021,Westminster 024A,E01004665,576,106,75,31,3,3,357,330,27,98,85,13,12
2021,Westminster 023D,E01004668,586,193,114,79,3,3,205,180,25,185,163,22,0
2021,Westminster 024B,E01004669,724,169,98,71,4,4,352,292,60,197,175,22,2
2021,Westminster 009A,E01004670,928,112,67,45,5,5,720,588,132,71,64,7,20
2021,Westminster 005A,E01004674,770,157,69,88,7,7,473,192,281,130,106,24,3
2021,Westminster 005B,E01004675,1073,176,70,106,8,8,550,102,448,336,313,23,3
2021,Westminster 006A,E01004676,713,194,71,123,4,4,182,41,141,332,320,12,1
2021,Westminster 005C,E01004677,801,202,69,133,9,9,300,44,256,288,266,22,2
2021,Westminster 005D,E01004678,835,225,99,126,8,8,349,77,272,252,232,20,1
2021,Westminster 005E,E01004679,918,155,62,93,7,7,487,68,419,264,251,13,5
2021,Westminster 015A,E01004680,568,240,161,79,5,5,19,3,16,304,259,45,0
2021,Westminster 016A,E01004681,918,289,154,135,15,15,108,75,33,504,473,31,2
2021,Westminster 016B,E01004682,671,163,95,68,1,1,61,11,50,446,413,33,0
2021,Westminster 015B,E01004683,623,306,188,118,2,2,39,15,24,276,234,42,0
2021,Westminster 015C,E01004684,472,159,107,52,0,0,26,11,15,286,254,32,1
2021,Westminster 015E,E01004686,748,183,115,68,2,2,63,9,54,500,466,34,0
2021,Westminster 019A,E01004687,674,382,243,139,1,1,19,7,12,272,236,36,0
2021,Westminster 019D,E01004690,435,231,156,75,3,3,19,6,13,182,135,47,0
2021,Westminster 019E,E01004691,476,201,145,56,4,4,11,4,7,259,222,37,1
2021,Westminster 019F,E01004692,447,213,175,38,2,2,17,10,7,215,168,47,0
2021,Westminster 017B,E01004693,589,253,170,83,1,1,36,16,20,299,252,47,0
2021,Westminster 016C,E01004694,772,192,126,66,3,3,23,2,21,553,518,35,1
2021,Westminster 017C,E01004695,547,142,91,51,1,1,42,14,28,362,340,22,0
2021,Westminster 017D,E01004696,693,201,112,89,3,3,291,268,23,190,176,14,8
2021,Westminster 016D,E01004697,668,237,147,90,3,3,75,39,36,348,330,18,5
2021,Westminster 017E,E01004698,634,162,101,61,0,0,51,32,19,420,388,32,1
2021,Westminster 017F,E01004699,899,216,128,88,3,3,55,15,40,625,589,36,0
2021,Westminster 016E,E01004700,773,229,120,109,1,1,84,23,61,458,444,14,1
2021,Westminster 007A,E01004701,771,314,166,148,2,2,44,7,37,409,381,28,2
2021,Westminster 009E,E01004702,1072,164,104,60,4,4,600,443,157,291,279,12,13
2021,Westminster 007B,E01004703,865,429,248,181,1,1,60,34,26,375,331,44,0
2021,Westminster 007D,E01004705,587,254,137,117,0,0,39,9,30,294,268,26,0
2021,Westminster 006B,E01004706,682,276,124,152,1,1,41,21,20,364,347,17,0
2021,Westminster 006C,E01004707,752,355,181,174,0,0,13,4,9,384,356,28,0
2021,Westminster 006D,E01004708,725,222,89,133,8,8,164,59,105,329,307,22,2
2021,Westminster 007E,E01004709,715,219,105,114,4,4,208,60,148,284,261,23,0
2021,Westminster 002D,E01004710,719,169,76,93,2,2,330,273,57,214,197,17,4
2021,Westminster 002E,E01004711,815,113,61,52,4,4,376,186,190,317,308,9,5
2021,Westminster 008C,E01004712,736,265,166,99,2,2,91,42,49,377,341,36,1
2021,Westminster 011A,E01004713,692,231,162,69,3,3,20,3,17,438,393,45,0
2021,Westminster 011B,E01004714,821,211,129,82,6,6,70,17,53,533,463,70,1
2021,Westminster 013A,E01004715,830,163,108,55,7,7,237,143,94,423,399,24,0
2021,Westminster 011C,E01004716,530,245,158,87,1,1,24,7,17,260,218,42,0
2021,Westminster 011D,E01004717,745,185,117,68,5,5,57,7,50,498,476,22,0
2021,Westminster 004A,E01004718,792,180,63,117,9,9,360,185,175,242,223,19,1
2021,Westminster 004B,E01004719,780,208,95,113,8,8,414,286,128,149,137,12,1
2021,Westminster 004C,E01004720,859,250,121,129,10,10,459,350,109,139,125,14,1
2021,Westminster 004D,E01004721,838,138,75,63,8,8,492,396,96,194,180,14,6
2021,Westminster 004E,E01004722,866,115,44,71,9,9,587,356,231,148,136,12,7
2021,Westminster 005F,E01004723,962,167,51,116,8,8,456,127,329,330,311,19,1
2021,Westminster 001C,E01004724,870,233,140,93,3,3,129,104,25,502,474,28,3
2021,Westminster 003B,E01004725,587,135,88,47,6,6,192,25,167,253,231,22,1
2021,Westminster 003C,E01004726,792,307,197,110,1,1,40,28,12,444,399,45,0
2021,Westminster 008D,E01004727,765,301,186,115,8,8,14,6,8,442,385,57,0
2021,Westminster 003D,E01004728,729,224,137,87,3,3,156,141,15,342,295,47,4
2021,Westminster 003E,E01004729,738,172,110,62,2,2,346,205,141,213,196,17,5
2021,Westminster 001D,E01004730,695,347,231,116,5,5,24,10,14,319,286,33,0
2021,Westminster 020A,E01004731,1035,290,184,106,2,2,98,8,90,645,554,91,0
2021,Westminster 020B,E01004732,690,47,30,17,3,3,530,27,503,110,85,25,0
2021,Westminster 020C,E01004733,946,321,196,125,13,13,138,30,108,473,390,83,1
2021,Westminster 018A,E01004734,1004,145,105,40,4,4,326,85,241,528,477,51,1
2021,Westminster 018B,E01004735,1154,231,154,77,5,5,423,112,311,493,426,67,2
2021,Westminster 018C,E01004736,579,191,135,56,3,3,17,2,15,368,281,87,0
2021,Westminster 024C,E01004737,602,134,93,41,1,1,341,23,318,125,88,37,1
2021,Westminster 021A,E01004740,659,161,94,67,3,3,388,345,43,102,79,23,5
2021,Westminster 024F,E01004741,666,164,86,78,2,2,304,119,185,196,182,14,0
2021,Westminster 022A,E01004742,708,222,99,123,9,9,186,15,171,291,256,35,0
2021,Westminster 021B,E01004743,720,181,115,66,1,1,290,262,28,247,202,45,1
2021,Westminster 020D,E01004744,735,147,103,44,7,7,315,38,277,266,161,105,0
2021,Westminster 021D,E01004746,671,109,68,41,1,1,400,336,64,156,137,19,5
2021,Westminster 021E,E01004747,1046,283,171,112,25,25,356,31,325,381,322,59,1
2021,Westminster 020E,E01004748,521,252,164,88,0,0,53,4,49,216,172,44,0
2021,Westminster 022B,E01004749,1053,349,202,147,17,17,163,10,153,524,419,105,0
2021,Westminster 023E,E01004750,839,190,109,81,0,0,344,288,56,302,238,64,3
2021,Westminster 022C,E01004751,768,329,182,147,0,0,99,20,79,340,307,33,0
2021,Westminster 022D,E01004752,708,138,79,59,3,3,357,37,320,210,186,24,0
2021,Westminster 022E,E01004753,921,233,134,99,5,5,335,22,313,347,319,28,1
2021,Westminster 010A,E01004754,679,82,49,33,5,5,452,389,63,137,130,7,3
2021,Westminster 010B,E01004755,991,195,83,112,30,30,433,49,384,330,305,25,3
2021,Westminster 006E,E01004756,752,181,74,107,2,2,226,68,158,340,312,28,3
2021,Westminster 010C,E01004757,622,108,61,47,4,4,346,303,43,161,143,18,3
2021,Westminster 014E,E01004760,697,199,97,102,4,4,293,173,120,201,180,21,0
2021,Westminster 018D,E01004761,698,249,166,83,2,2,54,5,49,392,297,95,1
2021,Westminster 011E,E01004762,760,236,163,73,0,0,213,39,174,311,233,78,0
2021,Westminster 013B,E01004763,1117,214,117,97,29,29,193,39,154,678,606,72,3
2021,Westminster 013D,E01004765,1046,240,156,84,2,2,254,73,181,545,490,55,5
2021,Bolton 005A,E01004766,805,445,239,206,1,1,160,61,99,196,173,23,3
2021,Bolton 005B,E01004767,853,475,259,216,3,3,81,25,56,293,278,15,1
2021,Bolton 001A,E01004768,612,573,299,274,0,0,7,2,5,32,26,6,0
2021,Bolton 003A,E01004769,685,594,319,275,6,6,6,2,4,79,67,12,0
2021,Bolton 003B,E01004770,611,541,346,195,1,1,8,2,6,60,49,11,1
2021,Bolton 003C,E01004771,626,565,305,260,0,0,6,2,4,55,43,12,0
2021,Bolton 005C,E01004772,748,310,142,168,0,0,382,294,88,54,43,11,2
2021,Bolton 003D,E01004773,858,608,305,303,4,4,29,11,18,217,189,28,0
2021,Bolton 005D,E01004774,739,442,211,231,0,0,170,112,58,123,107,16,4
2021,Bolton 014A,E01004775,928,767,325,442,2,2,16,6,10,143,128,15,0
2021,Bolton 031A,E01004776,824,490,203,287,4,4,122,62,60,207,191,16,1
2021,Bolton 004A,E01004777,792,414,186,228,12,12,178,34,144,188,172,16,0
2021,Bolton 009A,E01004778,541,443,273,170,2,2,19,16,3,77,66,11,0
2021,Bolton 007A,E01004779,622,429,193,236,0,0,121,79,42,71,60,11,1
2021,Bolton 009B,E01004780,978,757,365,392,2,2,29,9,20,190,168,22,0
2021,Bolton 007B,E01004781,953,672,290,382,0,0,60,7,53,221,203,18,0
2021,Bolton 009C,E01004782,583,374,158,216,1,1,152,113,39,54,44,10,2
2021,Bolton 009D,E01004783,659,552,317,235,3,3,21,8,13,83,68,15,0
2021,Bolton 006A,E01004784,506,473,302,171,1,1,6,5,1,26,16,10,0
2021,Bolton 006B,E01004785,650,493,272,221,1,1,108,57,51,48,42,6,0
2021,Bolton 006C,E01004786,688,551,301,250,6,6,71,6,65,60,45,15,0
2021,Bolton 013A,E01004787,754,210,93,117,0,0,463,321,142,76,64,12,5
2021,Bolton 002A,E01004788,608,561,377,184,1,1,8,3,5,38,30,8,0
2021,Bolton 006D,E01004789,608,550,336,214,2,2,8,2,6,48,36,12,0
2021,Bolton 002B,E01004790,644,471,271,200,3,3,80,4,76,90,77,13,0
2021,Bolton 006E,E01004791,655,535,318,217,1,1,42,26,16,77,67,10,0
2021,Bolton 006F,E01004792,640,596,396,200,2,2,7,4,3,35,26,9,0
2021,Bolton 013B,E01004793,694,238,124,114,1,1,400,275,125,48,42,6,7
2021,Bolton 013C,E01004794,721,248,133,115,0,0,420,280,140,51,44,7,2
2021,Bolton 013D,E01004795,694,367,215,152,0,0,250,162,88,74,64,10,3
2021,Bolton 019A,E01004796,670,511,283,228,0,0,47,24,23,110,97,13,2
2021,Bolton 013E,E01004797,517,223,108,115,0,0,221,180,41,71,58,13,2
2021,Bolton 019B,E01004798,667,389,197,192,2,2,198,149,49,77,66,11,1
2021,Bolton 019C,E01004799,586,530,353,177,1,1,9,5,4,45,34,11,1
2021,Bolton 019D,E01004800,534,457,253,204,1,1,5,1,4,71,60,11,0
2021,Bolton 019E,E01004801,664,181,79,102,2,2,421,175,246,60,49,11,0
2021,Bolton 010A,E01004802,758,200,89,111,1,1,459,343,116,94,86,8,4
2021,Bolton 001B,E01004803,716,593,332,261,0,0,8,3,5,115,102,13,0
2021,Bolton 001C,E01004804,610,564,321,243,1,1,14,8,6,31,25,6,0
2021,Bolton 002C,E01004805,671,599,369,230,1,1,23,11,12,47,43,4,1
2021,Bolton 002D,E01004806,660,563,345,218,13,13,18,9,9,65,57,8,1
2021,Bolton 001D,E01004807,579,484,223,261,2,2,8,4,4,85,76,9,0
2021,Bolton 001E,E01004808,693,617,347,270,2,2,1,0,1,73,66,7,0
2021,Bolton 003E,E01004809,869,523,241,282,3,3,143,68,75,200,181,19,0
2021,Bolton 002E,E01004810,636,558,298,260,1,1,14,7,7,63,49,14,0
2021,Bolton 022A,E01004811,650,208,127,81,4,4,262,148,114,172,155,17,4
2021,Bolton 022B,E01004812,681,285,137,148,2,2,113,14,99,281,248,33,0
2021,Bolton 022C,E01004813,524,281,145,136,0,0,125,33,92,111,98,13,7
2021,Bolton 027A,E01004814,562,313,133,180,25,25,70,16,54,152,134,18,2
2021,Bolton 022D,E01004815,564,352,189,163,1,1,94,71,23,115,92,23,2
2021,Bolton 029A,E01004816,598,424,157,267,1,1,94,64,30,76,66,10,3
2021,Bolton 022E,E01004817,966,297,169,128,17,17,251,89,162,398,378,20,3
2021,Bolton 017A,E01004818,686,189,121,68,0,0,188,7,181,307,272,35,2
2021,Bolton 017B,E01004819,604,416,234,182,5,5,25,9,16,158,131,27,0
2021,Bolton 011A,E01004820,619,206,127,79,3,3,277,169,108,131,109,22,2
2021,Bolton 016B,E01004822,608,241,154,87,3,3,247,129,118,106,84,22,11
2021,Bolton 016C,E01004823,860,178,96,82,7,7,559,299,260,108,92,16,8
2021,Bolton 005E,E01004824,494,329,248,81,0,0,60,7,53,105,86,19,0
2021,Bolton 011B,E01004825,603,252,174,78,0,0,233,139,94,115,97,18,3
2021,Bolton 011C,E01004826,600,198,114,84,1,1,188,42,146,211,194,17,2
2021,Bolton 021A,E01004827,673,250,139,111,3,3,273,174,99,142,133,9,5
2021,Bolton 023A,E01004828,630,263,175,88,1,1,162,53,109,199,179,20,5
2021,Bolton 023B,E01004829,482,206,144,62,2,2,98,25,73,174,143,31,2
2021,Bolton 026A,E01004830,727,318,160,158,3,3,183,39,144,221,186,35,2
2021,Bolton 026B,E01004831,646,498,271,227,2,2,6,0,6,140,122,18,0
2021,Bolton 023C,E01004832,639,431,211,220,14,14,24,12,12,169,151,18,1
2021,Bolton 026C,E01004833,644,528,316,212,1,1,21,6,15,94,59,35,0
2021,Bolton 018A,E01004834,583,314,178,136,12,12,36,7,29,218,181,37,3
2021,Bolton 020A,E01004835,560,477,321,156,2,2,30,4,26,51,34,17,0
2021,Bolton 020B,E01004836,603,494,300,194,6,6,9,4,5,94,86,8,0
2021,Bolton 020C,E01004837,595,563,364,199,1,1,2,0,2,28,22,6,1
2021,Bolton 018B,E01004838,652,287,171,116,2,2,187,140,47,175,144,31,1
2021,Bolton 026D,E01004839,959,260,100,160,6,6,548,197,351,137,118,19,8
2021,Bolton 012A,E01004840,725,543,312,231,1,1,74,44,30,105,92,13,2
2021,Bolton 012B,E01004841,657,180,99,81,0,0,424,316,108,50,43,7,3
2021,Bolton 012C,E01004842,732,597,372,225,0,0,55,5,50,80,62,18,0
2021,Bolton 018C,E01004843,624,533,301,232,0,0,6,1,5,85,81,4,0
2021,Bolton 020D,E01004844,615,570,349,221,1,1,12,7,5,32,29,3,0
2021,Bolton 018D,E01004845,715,526,290,236,0,0,45,24,21,144,127,17,0
2021,Bolton 025A,E01004846,490,213,116,97,1,1,116,48,68,158,132,26,2
2021,Bolton 025B,E01004847,651,270,140,130,3,3,238,107,131,137,130,7,3
2021,Bolton 016D,E01004848,781,119,76,43,1,1,415,238,177,238,195,43,8
2021,Bolton 021B,E01004849,493,260,210,50,0,0,75,26,49,158,136,22,0
2021,Bolton 021C,E01004850,775,251,177,74,1,1,333,230,103,182,162,20,8
2021,Bolton 021D,E01004851,625,196,159,37,1,1,295,172,123,125,111,14,8
2021,Bolton 025C,E01004852,484,285,238,47,1,1,97,50,47,101,79,22,0
2021,Bolton 021E,E01004853,490,217,151,66,0,0,181,121,60,92,73,19,0
2021,Bolton 023D,E01004854,463,256,204,52,1,1,48,9,39,157,122,35,1
2021,Bolton 027B,E01004855,623,376,195,181,0,0,69,30,39,177,162,15,1
2021,Bolton 027C,E01004856,635,297,154,143,0,0,187,108,79,151,131,20,0
2021,Bolton 027D,E01004857,664,310,161,149,1,1,178,71,107,175,155,20,0
2021,Bolton 032A,E01004858,712,337,173,164,1,1,198,126,72,174,153,21,2
2021,Bolton 032B,E01004859,695,218,125,93,0,0,341,174,167,132,120,12,4
2021,Bolton 032C,E01004860,681,423,224,199,1,1,110,49,61,147,127,20,0
2021,Bolton 033A,E01004861,664,293,88,205,5,5,271,218,53,94,85,9,1
2021,Bolton 033B,E01004862,589,206,90,116,9,9,308,163,145,66,60,6,0
2021,Bolton 033C,E01004863,640,237,120,117,2,2,275,198,77,120,108,12,6
2021,Bolton 008A,E01004864,682,468,242,226,3,3,70,30,40,140,113,27,1
2021,Bolton 011D,E01004865,736,371,201,170,1,1,138,68,70,225,207,18,1
2021,Bolton 011E,E01004866,758,221,116,105,5,5,406,192,214,122,109,13,4
2021,Bolton 008B,E01004867,590,361,200,161,1,1,52,11,41,175,157,18,1
2021,Bolton 015A,E01004868,731,344,184,160,2,2,87,43,44,297,277,20,1
2021,Bolton 015B,E01004869,828,260,161,99,1,1,185,88,97,379,362,17,3
2021,Bolton 015C,E01004870,757,313,206,107,0,0,91,18,73,352,324,28,1
2021,Bolton 015D,E01004871,504,244,150,94,2,2,56,26,30,198,178,20,4
2021,Bolton 029B,E01004872,614,358,144,214,0,0,142,109,33,113,94,19,1
2021,Bolton 029C,E01004873,618,329,133,196,1,1,202,170,32,85,75,10,1
2021,Bolton 033D,E01004874,662,427,194,233,4,4,165,129,36,64,61,3,2
2021,Bolton 029D,E01004875,654,471,262,209,1,1,99,74,25,83,74,9,0
2021,Bolton 033E,E01004876,783,337,142,195,20,20,306,161,145,117,103,14,3
2021,Bolton 025D,E01004877,671,186,105,81,0,0,402,273,129,76,72,4,7
2021,Bolton 023E,E01004878,545,358,190,168,0,0,70,53,17,113,101,12,4
2021,Bolton 025E,E01004879,538,218,91,127,11,11,210,112,98,96,78,18,3
2021,Bolton 029E,E01004880,493,413,201,212,2,2,5,5,0,73,66,7,0
2021,Bolton 004B,E01004881,781,361,201,160,8,8,233,96,137,179,160,19,0
2021,Bolton 007C,E01004882,626,446,264,182,0,0,85,25,60,92,84,8,3
2021,Bolton 007D,E01004883,793,543,253,290,4,4,54,17,37,192,174,18,0
2021,Bolton 007E,E01004884,696,612,417,195,3,3,9,4,5,72,62,10,0
2021,Bolton 014B,E01004885,568,520,314,206,1,1,10,5,5,37,33,4,0
2021,Bolton 014C,E01004886,620,306,146,160,1,1,214,102,112,99,89,10,0
2021,Bolton 014D,E01004887,605,344,198,146,4,4,196,83,113,60,53,7,1
2021,Bolton 004C,E01004888,572,378,222,156,1,1,143,102,41,45,38,7,5
2021,Bolton 004D,E01004889,636,387,199,188,4,4,163,108,55,80,69,11,2
2021,Bolton 004E,E01004890,682,471,247,224,1,1,25,8,17,185,167,18,0
2021,Bolton 028A,E01004891,742,586,358,228,1,1,76,31,45,79,63,16,0
2021,Bolton 030A,E01004892,712,592,364,228,17,17,40,8,32,63,51,12,0
2021,Bolton 028B,E01004893,640,597,390,207,1,1,6,1,5,36,29,7,0
2021,Bolton 028C,E01004894,852,585,292,293,20,20,95,21,74,152,127,25,0
2021,Bolton 031B,E01004895,602,370,201,169,0,0,173,89,84,58,55,3,1
2021,Bolton 030B,E01004896,546,518,350,168,0,0,9,5,4,18,12,6,1
2021,Bolton 020E,E01004897,456,376,210,166,1,1,3,1,2,76,63,13,0
2021,Bolton 030C,E01004899,618,463,225,238,0,0,81,62,19,73,57,16,1
2021,Bolton 030D,E01004900,623,454,198,256,2,2,36,6,30,131,119,12,0
2021,Bolton 028E,E01004901,773,649,372,277,2,2,21,13,8,101,89,12,0
2021,Bolton 032D,E01004902,878,495,237,258,18,18,164,46,118,201,177,24,0
2021,Bolton 034A,E01004903,576,485,249,236,1,1,32,9,23,58,49,9,0
2021,Bolton 034B,E01004904,737,544,253,291,5,5,69,40,29,118,106,12,1
2021,Bolton 034C,E01004905,676,416,197,219,1,1,141,90,51,112,100,12,6
2021,Bolton 032E,E01004906,889,404,200,204,2,2,330,141,189,151,138,13,2
2021,Bolton 034D,E01004907,544,303,141,162,1,1,149,123,26,88,78,10,3
2021,Bolton 034E,E01004908,559,464,293,171,3,3,55,46,9,35,28,7,2
2021,Bolton 034F,E01004909,640,384,208,176,0,0,196,104,92,57,48,9,3
2021,Bolton 034G,E01004910,929,559,272,287,1,1,79,41,38,289,273,16,1
2021,Bolton 024A,E01004911,722,383,210,173,0,0,209,124,85,127,109,18,3
2021,Bolton 024B,E01004912,651,546,353,193,1,1,25,5,20,79,62,17,0
2021,Bolton 024C,E01004913,783,551,211,340,10,10,80,52,28,139,118,21,3
2021,Bolton 024D,E01004914,518,473,328,145,1,1,12,0,12,32,23,9,0
2021,Bolton 024E,E01004915,530,486,317,169,1,1,9,4,5,34,28,6,0
2021,Bolton 024F,E01004916,678,389,207,182,1,1,168,91,77,114,95,19,6
2021,Bolton 019F,E01004917,958,622,270,352,13,13,204,66,138,119,104,15,0
2021,Bolton 024G,E01004918,512,477,278,199,0,0,6,4,2,29,23,6,0
2021,Bolton 012D,E01004919,648,548,301,247,6,6,5,1,4,88,74,14,1
2021,Bolton 012E,E01004920,664,455,260,195,0,0,135,95,40,72,63,9,2
2021,Bolton 008C,E01004921,715,556,298,258,0,0,49,21,28,110,102,8,0
2021,Bolton 015E,E01004922,883,453,187,266,0,0,190,98,92,236,212,24,4
2021,Bolton 018E,E01004923,636,401,214,187,0,0,16,4,12,217,198,19,2
2021,Bolton 008D,E01004924,621,571,287,284,2,2,16,7,9,32,22,10,0
2021,Bolton 008E,E01004925,637,518,276,242,2,2,25,5,20,92,75,17,0
2021,Bolton 010B,E01004926,521,185,87,98,0,0,274,215,59,60,55,5,2
2021,Bolton 010C,E01004927,1051,325,115,210,7,7,428,232,196,288,273,15,3
2021,Bolton 017C,E01004928,686,328,174,154,0,0,69,20,49,287,259,28,2
2021,Bolton 010D,E01004929,1121,608,195,413,3,3,286,176,110,221,201,20,3
2021,Bolton 017D,E01004930,630,523,271,252,1,1,33,25,8,73,60,13,0
2021,Bolton 017E,E01004931,745,366,181,185,1,1,265,136,129,108,95,13,5
2021,Bolton 017F,E01004932,722,404,212,192,2,2,50,12,38,265,248,17,1
2021,Bolton 035A,E01004933,577,491,240,251,0,0,14,6,8,72,67,5,0
2021,Bolton 035B,E01004934,554,381,178,203,12,12,129,12,117,32,28,4,0
2021,Bolton 035C,E01004935,749,620,241,379,2,2,38,19,19,88,69,19,1
2021,Bolton 031C,E01004936,1013,700,345,355,2,2,123,51,72,188,169,19,0
2021,Bolton 035D,E01004937,623,556,264,292,0,0,17,5,12,50,42,8,0
2021,Bolton 031D,E01004938,628,221,96,125,3,3,370,237,133,31,26,5,3
2021,Bolton 031E,E01004939,715,467,250,217,2,2,155,38,117,91,78,13,0
2021,Bolton 035E,E01004940,604,532,298,234,0,0,25,19,6,47,43,4,0
2021,Bury 021A,E01004941,756,426,185,241,0,0,207,30,177,123,108,15,0
2021,Bury 021B,E01004942,640,184,90,94,13,13,349,185,164,93,84,9,1
2021,Bury 021C,E01004943,710,447,168,279,1,1,85,66,19,177,169,8,0
2021,Bury 021D,E01004944,630,548,274,274,0,0,16,11,5,66,59,7,0
2021,Bury 017A,E01004945,658,564,337,227,2,2,40,6,34,52,37,15,0
2021,Bury 021E,E01004946,777,249,139,110,0,0,461,62,399,67,60,7,0
2021,Bury 009A,E01004947,661,379,152,227,0,0,91,60,31,191,171,20,0
2021,Bury 009B,E01004948,841,435,227,208,0,0,212,175,37,188,174,14,6
2021,Bury 010A,E01004949,580,543,330,213,1,1,4,2,2,32,23,9,0
2021,Bury 010B,E01004950,618,542,337,205,0,0,52,39,13,24,15,9,0
2021,Bury 010C,E01004951,649,594,379,215,1,1,5,4,1,49,35,14,0
2021,Bury 010D,E01004952,615,578,433,145,2,2,3,2,1,32,28,4,0
2021,Bury 010E,E01004953,636,512,275,237,1,1,73,7,66,50,40,10,0
2021,Bury 007A,E01004954,646,464,296,168,1,1,87,24,63,93,80,13,1
2021,Bury 007B,E01004955,552,355,161,194,1,1,98,84,14,96,83,13,2
2021,Bury 007C,E01004956,783,393,184,209,12,12,224,140,84,148,119,29,6
2021,Bury 007D,E01004957,791,266,112,154,10,10,430,336,94,80,73,7,5
2021,Bury 008A,E01004958,687,284,157,127,1,1,173,62,111,228,206,22,1
2021,Bury 008B,E01004959,731,354,169,185,5,5,162,71,91,208,180,28,2
2021,Bury 007E,E01004960,652,116,48,68,2,2,459,404,55,68,63,5,7
2021,Bury 005A,E01004961,631,380,189,191,0,0,148,91,57,101,89,12,2
2021,Bury 009C,E01004962,839,602,232,370,5,5,6,6,0,226,200,26,0
2021,Bury 006A,E01004963,692,536,319,217,1,1,74,63,11,79,67,12,2
2021,Bury 009D,E01004964,839,498,224,274,2,2,91,33,58,245,222,23,3
2021,Bury 005B,E01004965,507,462,291,171,0,0,23,15,8,22,18,4,0
2021,Bury 005C,E01004966,723,413,210,203,0,0,191,167,24,115,107,8,4
2021,Bury 005D,E01004967,464,435,263,172,0,0,2,1,1,27,21,6,0
2021,Bury 006B,E01004968,614,559,285,274,1,1,4,3,1,50,40,10,0
2021,Bury 022A,E01004969,712,469,271,198,4,4,46,26,20,189,170,19,4
2021,Bury 022B,E01004970,605,530,277,253,1,1,22,22,0,52,44,8,0
2021,Bury 022C,E01004971,600,546,295,251,1,1,3,3,0,50,42,8,0
2021,Bury 023A,E01004972,568,290,118,172,2,2,202,176,26,72,60,12,2
2021,Bury 023B,E01004973,651,515,252,263,0,0,13,11,2,123,112,11,0
2021,Bury 024A,E01004974,601,503,265,238,2,2,15,6,9,81,72,9,0
2021,Bury 023C,E01004975,769,420,183,237,5,5,133,38,95,211,205,6,0
2021,Bury 004A,E01004976,637,378,196,182,5,5,169,148,21,81,67,14,4
2021,Bury 004B,E01004977,792,512,270,242,20,20,111,66,45,148,128,20,1
2021,Bury 004C,E01004978,660,470,237,233,0,0,60,41,19,130,110,20,0
2021,Bury 008C,E01004979,673,249,115,134,0,0,182,54,128,240,225,15,2
2021,Bury 008D,E01004980,644,321,155,166,1,1,80,19,61,240,213,27,2
2021,Bury 004D,E01004981,622,471,261,210,0,0,69,59,10,81,70,11,1
2021,Bury 004E,E01004982,655,566,342,224,0,0,23,15,8,66,55,11,0
2021,Bury 020A,E01004983,567,383,181,202,1,1,14,3,11,169,159,10,0
2021,Bury 019A,E01004984,572,481,278,203,2,2,13,9,4,76,64,12,0
2021,Bury 019B,E01004985,594,529,316,213,0,0,18,4,14,47,38,9,0
2021,Bury 020B,E01004986,821,485,239,246,4,4,124,93,31,208,191,17,0
2021,Bury 020C,E01004987,659,262,104,158,0,0,341,249,92,55,48,7,1
2021,Bury 020D,E01004988,627,443,222,221,10,10,61,50,11,110,96,14,3
2021,Bury 019C,E01004989,569,479,268,211,3,3,6,1,5,81,67,14,0
2021,Bury 016A,E01004990,665,391,186,205,3,3,130,96,34,140,128,12,1
2021,Bury 015A,E01004991,593,393,186,207,4,4,61,24,37,135,118,17,0
2021,Bury 015B,E01004992,634,390,195,195,0,0,42,13,29,202,173,29,0
2021,Bury 015C,E01004993,779,569,192,377,0,0,132,121,11,76,64,12,2
2021,Bury 015D,E01004994,678,305,138,167,1,1,162,15,147,209,183,26,1
2021,Bury 018A,E01004995,651,578,348,230,1,1,12,8,4,60,42,18,0
2021,Bury 016B,E01004996,758,251,124,127,5,5,276,108,168,226,216,10,0
2021,Bury 014A,E01004997,620,412,204,208,1,1,37,29,8,170,148,22,0
2021,Bury 014B,E01004998,739,602,312,290,0,0,17,8,9,120,97,23,0
2021,Bury 014C,E01004999,599,492,246,246,7,7,35,25,10,64,46,18,1
2021,Bury 012A,E01005000,588,519,272,247,0,0,11,6,5,58,48,10,0
2021,Bury 012B,E01005001,497,432,221,211,1,1,35,2,33,29,26,3,0
2021,Bury 014D,E01005002,645,515,286,229,2,2,72,52,20,55,46,9,1
2021,Bury 014E,E01005003,681,349,172,177,0,0,137,113,24,192,177,15,3
2021,Bury 016C,E01005004,852,220,118,102,5,5,535,406,129,84,73,11,8
2021,Bury 012C,E01005005,622,533,294,239,0,0,21,4,17,68,60,8,0
2021,Bury 012D,E01005006,806,638,279,359,8,8,109,91,18,51,42,9,0
2021,Bury 019D,E01005007,700,542,340,202,2,2,24,13,11,132,112,20,0
2021,Bury 016D,E01005008,949,330,110,220,12,12,365,130,235,236,218,18,6
2021,Bury 016E,E01005009,862,286,141,145,13,13,248,51,197,312,296,16,3
2021,Bury 018B,E01005010,653,523,260,263,1,1,41,31,10,88,73,15,0
2021,Bury 019E,E01005011,595,507,255,252,2,2,14,7,7,72,64,8,0
2021,Bury 018C,E01005012,776,397,174,223,3,3,197,169,28,173,159,14,6
2021,Bury 018D,E01005013,1017,520,178,342,2,2,212,185,27,280,265,15,3
2021,Bury 001A,E01005014,759,456,285,171,1,1,51,8,43,251,229,22,0
2021,Bury 001B,E01005015,687,384,176,208,3,3,205,123,82,94,76,18,1
2021,Bury 001C,E01005016,713,543,250,293,3,3,21,17,4,146,133,13,0
2021,Bury 001D,E01005017,774,601,271,330,2,2,88,13,75,83,72,11,0
2021,Bury 001E,E01005018,723,449,210,239,0,0,118,103,15,155,134,21,1
2021,Bury 002A,E01005019,626,540,317,223,0,0,26,22,4,60,51,9,0
2021,Bury 003A,E01005020,503,480,234,246,0,0,1,0,1,22,17,5,0
2021,Bury 001F,E01005021,420,385,216,169,0,0,0,0,0,35,31,4,0
2021,Bury 003B,E01005022,635,541,249,292,2,2,12,9,3,80,72,8,0
2021,Bury 002B,E01005023,546,424,270,154,1,1,68,60,8,52,41,11,1
2021,Bury 008E,E01005024,1001,291,114,177,3,3,147,39,108,560,510,50,0
2021,Bury 011A,E01005025,719,508,265,243,3,3,65,30,35,142,122,20,1
2021,Bury 008F,E01005026,647,419,177,242,2,2,33,9,24,193,176,17,0
2021,Bury 011B,E01005027,686,398,208,190,0,0,90,3,87,197,174,23,1
2021,Bury 011C,E01005028,834,296,112,184,2,2,432,170,262,102,82,20,2
2021,Bury 011D,E01005029,636,430,228,202,2,2,55,33,22,148,129,19,1
2021,Bury 013A,E01005030,788,259,128,131,15,15,354,146,208,159,148,11,1
2021,Bury 025A,E01005031,635,392,184,208,2,2,158,126,32,83,75,8,0
2021,Bury 025B,E01005032,559,239,95,144,1,1,226,106,120,90,82,8,3
2021,Bury 024B,E01005033,595,429,229,200,0,0,17,4,13,149,143,6,0
2021,Bury 022D,E01005034,714,575,257,318,0,0,27,20,7,111,93,18,1
2021,Bury 025C,E01005035,653,507,226,281,2,2,45,5,40,97,85,12,2
2021,Bury 024C,E01005036,1070,363,182,181,0,0,401,98,303,305,277,28,1
2021,Bury 024D,E01005037,632,517,255,262,4,4,7,3,4,104,90,14,0
2021,Bury 025D,E01005038,523,481,249,232,0,0,1,0,1,41,34,7,0
2021,Bury 023D,E01005039,686,362,181,181,5,5,203,131,72,114,104,10,2
2021,Bury 026A,E01005040,690,487,223,264,1,1,55,40,15,147,133,14,0
2021,Bury 026B,E01005041,526,428,218,210,0,0,1,1,0,97,84,13,0
2021,Bury 026C,E01005042,614,463,230,233,0,0,49,39,10,102,84,18,0
2021,Bury 026D,E01005043,490,366,163,203,2,2,6,2,4,116,108,8,0
2021,Bury 026E,E01005044,475,259,110,149,4,4,32,5,27,180,168,12,0
2021,Bury 023E,E01005045,726,539,287,252,2,2,88,76,12,97,87,10,0
2021,Bury 002C,E01005046,676,628,432,196,2,2,4,2,2,42,35,7,0
2021,Bury 003C,E01005047,590,533,320,213,2,2,7,5,2,48,31,17,0
2021,Bury 002D,E01005048,659,615,381,234,1,1,7,5,2,36,32,4,0
2021,Bury 003D,E01005049,755,619,343,276,1,1,11,4,7,124,101,23,0
2021,Bury 006C,E01005050,853,671,284,387,1,1,31,28,3,150,132,18,0
2021,Bury 003E,E01005051,697,493,228,265,6,6,85,63,22,111,100,11,2
2021,Bury 006D,E01005052,585,529,306,223,1,1,10,7,3,45,35,10,0
2021,Bury 006E,E01005053,635,498,246,252,0,0,51,17,34,86,73,13,0
2021,Bury 013B,E01005054,705,511,249,262,2,2,80,56,24,112,98,14,0
2021,Bury 017B,E01005055,583,514,290,224,1,1,6,5,1,62,56,6,0
2021,Bury 017C,E01005056,596,515,323,192,3,3,9,6,3,69,59,10,0
2021,Bury 017D,E01005057,671,503,272,231,3,3,65,48,17,100,92,8,0
2021,Bury 017E,E01005058,495,459,243,216,1,1,2,1,1,33,27,6,0
2021,Bury 013C,E01005059,722,447,219,228,3,3,144,61,83,127,115,12,1
2021,Bury 013D,E01005060,735,544,289,255,7,7,50,22,28,133,119,14,1
2021,Manchester 018A,E01005061,654,89,21,68,0,0,537,86,451,28,21,7,0
2021,Manchester 018C,E01005063,762,187,63,124,0,0,435,199,236,138,114,24,2
2021,Manchester 018D,E01005065,803,187,67,120,6,6,445,222,223,161,148,13,4
2021,Manchester 018E,E01005066,509,82,36,46,1,1,295,202,93,130,121,9,1
2021,Manchester 020A,E01005067,804,254,76,178,10,10,397,131,266,142,123,19,1
2021,Manchester 051A,E01005068,721,266,116,150,32,32,353,146,207,68,63,5,2
2021,Manchester 047A,E01005069,656,474,233,241,0,0,73,8,65,108,92,16,1
2021,Manchester 051B,E01005070,802,199,98,101,23,23,483,171,312,96,70,26,1
2021,Manchester 048A,E01005071,736,279,105,174,39,39,275,108,167,141,132,9,2
2021,Manchester 048B,E01005072,859,337,107,230,6,6,312,120,192,203,189,14,1
2021,Manchester 048C,E01005073,611,448,220,228,1,1,114,71,43,46,37,9,2
2021,Manchester 051C,E01005074,643,257,119,138,6,6,301,123,178,79,71,8,0
2021,Manchester 051D,E01005075,671,269,108,161,1,1,312,119,193,89,78,11,0
2021,Manchester 039A,E01005076,740,234,72,162,1,1,60,3,57,445,433,12,0
2021,Manchester 042A,E01005077,628,202,75,127,0,0,371,95,276,52,48,4,3
2021,Manchester 042B,E01005078,832,316,135,181,1,1,91,1,90,424,409,15,0
2021,Manchester 042C,E01005079,634,409,184,225,4,4,133,29,104,87,77,10,1
2021,Manchester 039C,E01005081,773,218,87,131,23,23,465,121,344,66,60,6,1
2021,Manchester 037A,E01005082,754,352,111,241,2,2,284,64,220,115,101,14,1
2021,Manchester 039D,E01005083,958,348,113,235,1,1,21,5,16,588,574,14,0
2021,Manchester 042D,E01005084,857,449,179,270,8,8,229,75,154,171,160,11,0
2021,Manchester 049A,E01005085,598,161,65,96,0,0,309,101,208,128,124,4,0
2021,Manchester 049B,E01005086,702,173,72,101,5,5,428,149,279,93,89,4,3
2021,Manchester 050A,E01005087,803,151,64,87,3,3,523,181,342,126,117,9,0
2021,Manchester 050B,E01005088,727,133,69,64,17,17,524,187,337,49,41,8,4
2021,Manchester 049C,E01005089,695,163,67,96,1,1,443,147,296,87,83,4,1
2021,Manchester 050C,E01005090,862,151,72,79,59,59,589,187,402,58,52,6,5
2021,Manchester 050D,E01005091,877,147,58,89,0,0,515,167,348,213,200,13,2
2021,Manchester 015A,E01005092,783,205,112,93,5,5,326,95,231,244,229,15,3
2021,Manchester 012A,E01005093,681,205,111,94,16,16,286,78,208,173,150,23,1
2021,Manchester 012B,E01005094,664,162,86,76,2,2,281,69,212,217,207,10,2
2021,Manchester 012C,E01005097,648,152,78,74,1,1,423,182,241,72,51,21,0
2021,Manchester 001A,E01005098,767,221,107,114,1,1,452,220,232,90,79,11,3
2021,Manchester 001B,E01005099,691,172,80,92,0,0,459,338,121,57,50,7,3
2021,Manchester 001C,E01005100,657,376,200,176,0,0,191,147,44,82,68,14,8
2021,Manchester 002A,E01005101,729,301,121,180,11,11,285,221,64,126,117,9,6
2021,Manchester 001D,E01005102,626,422,223,199,2,2,41,25,16,160,145,15,1
2021,Manchester 001E,E01005103,860,309,169,140,8,8,381,243,138,160,144,16,2
2021,Manchester 004A,E01005104,819,224,102,122,4,4,345,259,86,243,231,12,3
2021,Manchester 015C,E01005105,1130,412,114,298,16,16,319,71,248,382,358,24,1
2021,Manchester 015D,E01005106,900,202,120,82,4,4,357,130,227,335,321,14,2
2021,Manchester 015E,E01005107,744,175,75,100,11,11,462,123,339,96,92,4,0
2021,Manchester 047B,E01005111,608,318,139,179,2,2,222,83,139,63,56,7,3
2021,Manchester 048D,E01005112,676,365,175,190,4,4,225,104,121,81,76,5,1
2021,Manchester 047C,E01005113,812,239,105,134,5,5,470,132,338,98,68,30,0
2021,Manchester 047D,E01005114,815,625,363,262,9,9,71,24,47,110,97,13,0
2021,Manchester 044A,E01005115,782,412,187,225,3,3,264,107,157,103,90,13,0
2021,Manchester 047E,E01005116,990,462,149,313,18,18,299,100,199,207,198,9,4
2021,Manchester 048E,E01005117,972,230,77,153,2,2,611,248,363,128,116,12,1
2021,Manchester 034A,E01005118,475,290,158,132,0,0,106,6,100,79,65,14,0
2021,Manchester 041A,E01005119,670,274,106,168,21,21,291,113,178,79,70,9,5
2021,Manchester 034B,E01005120,664,365,155,210,17,17,162,41,121,120,99,21,0
2021,Manchester 041B,E01005121,602,232,80,152,5,5,293,107,186,72,66,6,0
2021,Manchester 041C,E01005122,647,311,126,185,17,17,240,84,156,79,69,10,0
2021,Manchester 041D,E01005123,611,203,71,132,1,1,343,103,240,64,60,4,0
2021,Manchester 041E,E01005124,671,240,82,158,1,1,348,127,221,80,80,0,2
2021,Manchester 040A,E01005125,614,297,130,167,2,2,215,78,137,98,89,9,2
2021,Manchester 045A,E01005126,804,531,255,276,28,28,44,9,35,201,187,14,0
2021,Manchester 055A,E01005128,694,107,47,60,3,3,43,1,42,541,520,21,0
2021,Manchester 061A,E01005129,834,223,63,160,1,1,471,267,204,134,124,10,5
2021,Manchester 054A,E01005130,735,117,59,58,3,3,452,244,208,158,150,8,5
2021,Manchester 061B,E01005132,841,302,101,201,20,20,396,206,190,122,97,25,1
2021,Manchester 002B,E01005135,658,258,116,142,2,2,293,235,58,102,95,7,3
2021,Manchester 002C,E01005136,615,365,178,187,0,0,135,37,98,114,97,17,1
2021,Manchester 002D,E01005138,995,307,93,214,29,29,569,443,126,78,69,9,12
2021,Manchester 003B,E01005139,767,437,206,231,3,3,148,113,35,179,164,15,0
2021,Manchester 003C,E01005141,795,200,94,106,2,2,501,357,144,86,76,10,6
2021,Manchester 058A,E01005142,703,133,65,68,0,0,452,294,158,113,106,7,5
2021,Manchester 056A,E01005143,790,280,163,117,1,1,222,59,163,283,258,25,4
2021,Manchester 008A,E01005145,773,316,170,146,1,1,62,9,53,394,362,32,0
2021,Manchester 058B,E01005147,898,189,65,124,0,0,493,260,233,210,194,16,6
2021,Manchester 008C,E01005149,506,285,177,108,0,0,30,3,27,191,169,22,0
2021,Manchester 029A,E01005150,843,230,92,138,1,1,91,10,81,519,492,27,2
2021,Manchester 029B,E01005151,704,352,177,175,0,0,151,7,144,201,192,9,0
2021,Manchester 029C,E01005152,590,480,200,280,1,1,6,3,3,103,92,11,0
2021,Manchester 037B,E01005153,782,411,168,243,2,2,142,4,138,227,212,15,0
2021,Manchester 033A,E01005154,655,308,126,182,4,4,42,3,39,301,293,8,0
2021,Manchester 037C,E01005155,670,487,212,275,2,2,10,2,8,171,166,5,0
2021,Manchester 033B,E01005156,624,445,199,246,2,2,22,4,18,155,153,2,0
2021,Manchester 037D,E01005157,599,512,248,264,12,12,6,2,4,69,60,9,0
2021,Manchester 033C,E01005158,696,328,138,190,6,6,195,22,173,166,158,8,1
2021,Manchester 029D,E01005159,684,459,233,226,2,2,26,2,24,197,186,11,0
2021,Manchester 004B,E01005160,705,417,216,201,1,1,63,16,47,224,202,22,0
2021,Manchester 004C,E01005161,659,424,223,201,1,1,15,2,13,219,210,9,0
2021,Manchester 004D,E01005162,656,340,185,155,3,3,117,8,109,196,180,16,0
2021,Manchester 004E,E01005163,654,392,214,178,6,6,38,4,34,216,194,22,2
2021,Manchester 006A,E01005164,784,295,110,185,1,1,173,97,76,313,303,10,2
2021,Manchester 008D,E01005165,886,176,81,95,28,28,269,58,211,411,392,19,2
2021,Manchester 008E,E01005166,704,258,123,135,2,2,140,17,123,303,287,16,1
2021,Manchester 008F,E01005167,630,245,115,130,9,9,169,25,144,207,188,19,0
2021,Manchester 045B,E01005168,523,437,227,210,0,0,30,3,27,56,53,3,0
2021,Manchester 045C,E01005169,596,490,252,238,1,1,15,3,12,90,79,11,0
2021,Manchester 045D,E01005170,579,451,212,239,2,2,4,3,1,122,113,9,0
2021,Manchester 045E,E01005171,702,466,217,249,2,2,57,4,53,177,155,22,0
2021,Manchester 043A,E01005172,796,388,191,197,0,0,120,9,111,287,275,12,1
2021,Manchester 043B,E01005173,723,466,237,229,4,4,53,14,39,200,193,7,0
2021,Manchester 043C,E01005174,619,489,241,248,2,2,13,11,2,115,108,7,0
2021,Manchester 043D,E01005175,683,427,199,228,0,0,105,23,82,149,138,11,2
2021,Manchester 043E,E01005176,896,392,160,232,7,7,90,4,86,407,388,19,0
2021,Manchester 043F,E01005177,620,415,227,188,1,1,82,11,71,122,113,9,0
2021,Manchester 030A,E01005178,745,284,138,146,13,13,245,106,139,201,183,18,2
2021,Manchester 030B,E01005179,916,380,187,193,8,8,141,15,126,376,356,20,11
2021,Manchester 030C,E01005180,763,260,112,148,3,3,369,169,200,122,107,15,9
2021,Manchester 030D,E01005181,687,374,175,199,1,1,70,9,61,242,231,11,0
2021,Manchester 030E,E01005182,471,172,70,102,1,1,233,123,110,56,50,6,9
2021,Manchester 030F,E01005183,649,249,112,137,4,4,332,145,187,62,52,10,2
2021,Manchester 032A,E01005184,777,204,111,93,2,2,59,19,40,511,498,13,1
2021,Manchester 032B,E01005185,511,41,26,15,3,3,45,10,35,416,400,16,6
2021,Manchester 020B,E01005186,1050,392,160,232,3,3,345,155,190,310,286,24,0
2021,Manchester 021A,E01005187,836,231,118,113,24,24,210,38,172,367,343,24,4
2021,Manchester 021B,E01005188,729,413,239,174,18,18,86,22,64,203,180,23,9
2021,Manchester 017D,E01005189,800,151,79,72,14,14,486,198,288,146,117,29,3
2021,Manchester 017E,E01005190,939,352,167,185,1,1,232,71,161,351,329,22,3
2021,Manchester 021C,E01005191,793,235,135,100,11,11,244,72,172,302,286,16,1
2021,Manchester 021D,E01005192,680,386,185,201,2,2,71,26,45,221,208,13,0
2021,Manchester 021E,E01005193,806,362,176,186,8,8,116,32,84,317,296,21,3
2021,Manchester 023A,E01005195,876,228,52,176,27,27,490,105,385,128,120,8,3
2021,Manchester 023C,E01005197,708,197,93,104,22,22,273,73,200,214,190,24,2
2021,Manchester 023D,E01005198,709,175,79,96,9,9,444,179,265,78,70,8,3
2021,Manchester 064C,E01005199,906,420,163,257,2,2,84,24,60,398,368,30,2
2021,Manchester 064A,E01005200,961,478,174,304,17,17,246,85,161,220,203,17,0
2021,Manchester 023E,E01005201,784,141,69,72,5,5,227,61,166,407,390,17,4
2021,Manchester 009A,E01005202,857,163,86,77,1,1,481,256,225,210,198,12,2
2021,Manchester 009B,E01005203,858,125,66,59,2,2,600,395,205,128,119,9,3
2021,Manchester 006B,E01005205,873,187,94,93,2,2,446,317,129,232,212,20,6
2021,Manchester 006C,E01005206,724,364,190,174,11,11,98,23,75,249,235,14,2
2021,Manchester 006D,E01005207,779,299,169,130,12,12,86,53,33,382,360,22,0
2021,Manchester 019A,E01005208,1101,198,70,128,3,3,362,62,300,537,510,27,1
2021,Manchester 019C,E01005210,446,43,27,16,0,0,314,87,227,89,84,5,0
2021,Manchester 057A,E01005212,760,101,47,54,2,2,378,69,309,277,263,14,2
2021,Manchester 059A,E01005213,1167,167,61,106,5,5,703,226,477,290,271,19,2
2021,Manchester 019D,E01005214,987,281,86,195,2,2,193,31,162,510,477,33,1
2021,Manchester 034C,E01005215,724,407,186,221,1,1,78,26,52,237,216,21,1
2021,Manchester 034D,E01005216,605,437,180,257,3,3,33,6,27,132,114,18,0
2021,Manchester 034E,E01005217,697,555,297,258,2,2,15,1,14,125,112,13,0
2021,Manchester 034F,E01005218,629,306,165,141,11,11,130,16,114,181,163,18,1
2021,Manchester 031A,E01005219,926,346,152,194,3,3,106,20,86,471,460,11,0
2021,Manchester 031B,E01005220,745,389,143,246,0,0,66,6,60,290,248,42,0
2021,Manchester 031C,E01005221,870,400,169,231,20,20,109,18,91,341,314,27,0
2021,Manchester 031D,E01005222,911,371,147,224,23,23,237,44,193,279,264,15,1
2021,Manchester 007A,E01005223,607,350,152,198,2,2,116,84,32,138,129,9,1
2021,Manchester 007B,E01005224,760,266,90,176,1,1,146,85,61,342,309,33,5
2021,Manchester 007C,E01005225,857,327,193,134,1,1,270,106,164,256,223,33,3
2021,Manchester 007D,E01005226,701,277,152,125,2,2,77,31,46,343,326,17,2
2021,Manchester 009D,E01005227,741,223,114,109,23,23,195,63,132,296,264,32,4
2021,Manchester 009E,E01005228,893,217,73,144,2,2,530,392,138,141,131,10,3
2021,Manchester 007E,E01005229,606,512,288,224,3,3,13,8,5,77,68,9,1
2021,Manchester 022B,E01005230,762,160,76,84,3,3,224,38,186,375,358,17,0
2021,Manchester 022C,E01005231,699,76,53,23,3,3,46,3,43,574,563,11,0
2021,Manchester 020C,E01005232,706,268,114,154,2,2,197,38,159,236,201,35,3
2021,Manchester 063B,E01005233,787,205,75,130,5,5,221,41,180,354,324,30,2
2021,Manchester 063A,E01005234,651,218,95,123,4,4,200,32,168,226,204,22,3
2021,Manchester 020D,E01005235,715,209,85,124,0,0,346,151,195,158,139,19,2
2021,Manchester 022D,E01005236,698,156,65,91,1,1,178,24,154,360,339,21,3
2021,Manchester 022E,E01005237,524,269,128,141,2,2,72,24,48,180,159,21,1
2021,Manchester 063D,E01005238,582,277,128,149,3,3,79,6,73,222,196,26,1
2021,Manchester 020E,E01005239,625,142,58,84,0,0,409,176,233,68,59,9,6
2021,Manchester 024B,E01005243,1142,172,64,108,5,5,633,238,395,328,306,22,4
2021,Manchester 025C,E01005244,813,142,96,46,3,3,239,36,203,425,403,22,4
2021,Manchester 024C,E01005245,956,120,63,57,2,2,674,183,491,155,139,16,5
2021,Manchester 024D,E01005246,756,126,76,50,9,9,440,87,353,181,162,19,0
2021,Manchester 005A,E01005247,623,476,272,204,1,1,47,11,36,99,89,10,0
2021,Manchester 005B,E01005248,584,482,311,171,1,1,28,18,10,73,59,14,0
2021,Manchester 005C,E01005249,904,509,229,280,6,6,219,108,111,168,146,22,2
2021,Manchester 005D,E01005250,761,342,175,167,5,5,291,211,80,122,115,7,1
2021,Manchester 003D,E01005251,642,273,125,148,0,0,254,204,50,114,102,12,1
2021,Manchester 003E,E01005252,768,354,175,179,1,1,310,215,95,102,93,9,1
2021,Manchester 005E,E01005253,631,287,143,144,0,0,270,219,51,69,60,9,5
2021,Manchester 005F,E01005254,703,517,254,263,4,4,57,15,42,123,108,15,2
2021,Manchester 012D,E01005255,775,147,77,70,4,4,523,325,198,100,95,5,1
2021,Manchester 011A,E01005256,1049,346,134,212,6,6,416,288,128,279,264,15,2
2021,Manchester 011B,E01005257,806,202,100,102,1,1,412,284,128,187,177,10,4
2021,Manchester 011C,E01005258,779,327,154,173,4,4,237,118,119,205,190,15,6
2021,Manchester 011D,E01005259,757,191,103,88,2,2,350,217,133,214,203,11,0
2021,Manchester 011E,E01005260,594,441,231,210,4,4,32,9,23,117,103,14,0
2021,Manchester 012E,E01005261,674,193,79,114,3,3,370,218,152,105,94,11,3
2021,Manchester 044B,E01005262,857,369,135,234,2,2,341,142,199,145,134,11,0
2021,Manchester 046A,E01005263,803,326,148,178,6,6,344,115,229,124,109,15,3
2021,Manchester 044C,E01005264,616,275,112,163,0,0,275,127,148,66,61,5,0
2021,Manchester 044D,E01005265,689,262,111,151,13,13,327,139,188,86,79,7,1
2021,Manchester 044E,E01005266,834,354,147,207,2,2,310,126,184,166,144,22,2
2021,Manchester 046B,E01005267,650,475,234,241,3,3,84,27,57,88,78,10,0
2021,Manchester 046C,E01005268,1075,703,318,385,5,5,67,5,62,299,278,21,1
2021,Manchester 046D,E01005269,615,471,252,219,5,5,71,7,64,68,59,9,0
2021,Manchester 035A,E01005270,686,238,76,162,7,7,329,120,209,110,98,12,2
2021,Manchester 032C,E01005271,620,107,54,53,5,5,62,10,52,446,430,16,0
2021,Manchester 035B,E01005272,815,212,74,138,33,33,483,123,360,83,71,12,4
2021,Manchester 035C,E01005273,593,148,55,93,3,3,111,25,86,331,323,8,0
2021,Manchester 038A,E01005274,697,273,129,144,5,5,213,68,145,203,189,14,3
2021,Manchester 038B,E01005275,803,276,102,174,1,1,47,8,39,479,468,11,0
2021,Manchester 038C,E01005276,616,258,110,148,2,2,56,11,45,300,277,23,0
2021,Manchester 038D,E01005277,783,388,173,215,4,4,14,1,13,377,367,10,0
2021,Manchester 035D,E01005278,535,270,139,131,2,2,61,16,45,199,185,14,3
2021,Manchester 035E,E01005279,818,332,147,185,3,3,294,90,204,189,170,19,0
2021,Manchester 026A,E01005280,538,259,111,148,1,1,192,96,96,86,75,11,0
2021,Manchester 026B,E01005281,529,121,62,59,4,4,127,34,93,277,255,22,0
2021,Manchester 026C,E01005284,654,101,58,43,2,2,76,15,61,475,454,21,0
2021,Manchester 025D,E01005285,509,85,51,34,3,3,245,70,175,175,168,7,1
2021,Manchester 026D,E01005286,766,202,126,76,2,2,69,18,51,492,460,32,1
2021,Manchester 026E,E01005287,657,216,86,130,2,2,265,88,177,171,159,12,3
2021,Manchester 025E,E01005288,676,137,69,68,1,1,143,45,98,394,372,22,1
2021,Manchester 049D,E01005289,780,185,90,95,25,25,519,193,326,45,40,5,6
2021,Manchester 052A,E01005290,685,240,107,133,0,0,372,129,243,73,71,2,0
2021,Manchester 050E,E01005291,681,168,90,78,1,1,457,171,286,52,43,9,3
2021,Manchester 052B,E01005292,670,203,94,109,0,0,408,166,242,58,56,2,1
2021,Manchester 052C,E01005293,513,375,183,192,10,10,45,17,28,83,70,13,0
2021,Manchester 052D,E01005294,638,464,255,209,0,0,108,43,65,66,53,13,0
2021,Manchester 049E,E01005295,1143,576,189,387,5,5,155,42,113,407,381,26,0
2021,Manchester 029E,E01005296,631,424,224,200,1,1,68,6,62,138,131,7,0
2021,Manchester 028A,E01005297,947,449,226,223,11,11,137,27,110,350,330,20,0
2021,Manchester 028B,E01005298,624,354,146,208,0,0,79,8,71,190,176,14,1
2021,Manchester 029F,E01005299,544,417,208,209,1,1,19,1,18,107,89,18,0
2021,Manchester 033D,E01005300,480,387,212,175,0,0,4,1,3,89,74,15,0
2021,Manchester 033E,E01005301,587,410,216,194,1,1,7,3,4,169,152,17,0
2021,Manchester 028C,E01005302,1005,269,108,161,7,7,202,19,183,527,502,25,0
2021,Manchester 040B,E01005304,667,223,91,132,5,5,83,9,74,355,347,8,1
2021,Manchester 036A,E01005305,587,392,198,194,7,7,5,2,3,183,171,12,0
2021,Manchester 040C,E01005306,722,450,222,228,3,3,71,4,67,198,186,12,0
2021,Manchester 040D,E01005307,712,369,182,187,2,2,39,7,32,302,287,15,0
2021,Manchester 040E,E01005308,619,302,126,176,1,1,192,76,116,124,115,9,0
2021,Manchester 036B,E01005309,950,166,96,70,1,1,105,11,94,678,663,15,0
2021,Manchester 036C,E01005310,587,98,37,61,3,3,190,48,142,296,282,14,0
2021,Manchester 036D,E01005311,661,305,137,168,2,2,86,25,61,268,249,19,0
2021,Manchester 036E,E01005312,642,95,58,37,0,0,154,19,135,393,385,8,0
2021,Manchester 053A,E01005313,602,241,116,125,0,0,296,118,178,64,54,10,1
2021,Manchester 053B,E01005314,636,262,134,128,0,0,306,127,179,67,62,5,1
2021,Manchester 053C,E01005315,813,200,98,102,26,26,513,200,313,74,67,7,0
2021,Manchester 053D,E01005316,690,296,115,181,2,2,186,95,91,205,187,18,1
2021,Manchester 052E,E01005317,918,385,169,216,15,15,352,116,236,165,143,22,1
2021,Manchester 053E,E01005318,785,312,125,187,9,9,289,85,204,173,168,5,2
2021,Manchester 051E,E01005319,895,331,141,190,15,15,359,144,215,188,181,7,2
2021,Oldham 024A,E01005320,649,339,184,155,2,2,107,37,70,201,177,24,0
2021,Oldham 022A,E01005321,621,260,137,123,2,2,203,55,148,155,133,22,1
2021,Oldham 029A,E01005322,536,133,69,64,2,2,251,72,179,148,136,12,2
2021,Oldham 029B,E01005323,617,274,127,147,2,2,185,28,157,153,129,24,3
2021,Oldham 029C,E01005324,689,267,95,172,5,5,366,56,310,49,38,11,2
2021,Oldham 029D,E01005325,512,87,34,53,2,2,385,63,322,37,33,4,1
2021,Oldham 022B,E01005326,556,331,219,112,3,3,114,14,100,106,74,32,2
2021,Oldham 017A,E01005327,780,523,254,269,15,15,99,36,63,138,108,30,5
2021,Oldham 017B,E01005328,750,241,122,119,1,1,414,204,210,89,80,9,5
2021,Oldham 015A,E01005329,632,542,288,254,1,1,9,2,7,79,64,15,1
2021,Oldham 015B,E01005330,694,590,290,300,2,2,18,9,9,82,70,12,2
2021,Oldham 017C,E01005331,656,428,231,197,2,2,102,49,53,121,102,19,3
2021,Oldham 028A,E01005332,987,556,265,291,5,5,201,81,120,218,191,27,7
2021,Oldham 015C,E01005333,501,457,273,184,1,1,8,1,7,35,28,7,0
2021,Oldham 017D,E01005334,554,495,222,273,2,2,4,2,2,53,42,11,0
2021,Oldham 010A,E01005335,542,462,261,201,2,2,11,6,5,67,56,11,0
2021,Oldham 015D,E01005336,629,575,345,230,3,3,6,3,3,45,33,12,0
2021,Oldham 010B,E01005337,788,397,149,248,1,1,134,49,85,254,238,16,2
2021,Oldham 017E,E01005338,761,300,129,171,8,8,314,151,163,137,117,20,2
2021,Oldham 010C,E01005339,602,559,313,246,0,0,7,3,4,36,30,6,0
2021,Oldham 010D,E01005340,625,287,141,146,1,1,249,123,126,84,70,14,4
2021,Oldham 028B,E01005341,593,414,182,232,2,2,83,43,40,92,79,13,2
2021,Oldham 027A,E01005342,726,264,142,122,8,8,328,101,227,126,116,10,0
2021,Oldham 027B,E01005343,545,312,142,170,0,0,154,92,62,77,69,8,2
2021,Oldham 027C,E01005344,776,320,150,170,15,15,161,78,83,273,245,28,7
2021,Oldham 028C,E01005345,614,513,281,232,0,0,34,19,15,67,52,15,0
2021,Oldham 028D,E01005346,600,472,266,206,2,2,59,19,40,64,53,11,3
2021,Oldham 028E,E01005347,542,397,183,214,2,2,32,16,16,111,99,12,0
2021,Oldham 014A,E01005348,747,257,105,152,3,3,340,148,192,143,120,23,4
2021,Oldham 016A,E01005349,587,281,133,148,1,1,133,25,108,171,147,24,1
2021,Oldham 014B,E01005350,1064,118,65,53,4,4,823,362,461,106,78,28,13
2021,Oldham 016B,E01005351,473,249,98,151,0,0,95,18,77,129,102,27,0
2021,Oldham 016C,E01005352,466,208,105,103,1,1,147,68,79,108,94,14,2
2021,Oldham 016D,E01005353,408,142,67,75,0,0,184,79,105,82,70,12,0
2021,Oldham 016E,E01005354,572,316,111,205,1,1,113,14,99,142,130,12,0
2021,Oldham 005A,E01005355,623,437,194,243,4,4,40,22,18,141,127,14,1
2021,Oldham 005B,E01005356,501,431,212,219,0,0,13,7,6,57,49,8,0
2021,Oldham 001A,E01005357,615,536,345,191,2,2,24,18,6,53,40,13,0
2021,Oldham 001B,E01005358,716,403,182,221,4,4,165,77,88,144,124,20,0
2021,Oldham 001C,E01005359,759,635,442,193,6,6,22,9,13,95,78,17,1
2021,Oldham 001D,E01005360,639,407,284,123,2,2,180,111,69,50,40,10,0
2021,Oldham 003A,E01005361,738,653,412,241,0,0,20,10,10,65,49,16,0
2021,Oldham 031A,E01005362,597,450,250,200,0,0,55,20,35,91,78,13,1
2021,Oldham 032A,E01005363,842,458,218,240,1,1,156,37,119,225,197,28,2
2021,Oldham 031B,E01005364,692,585,338,247,0,0,12,2,10,95,82,13,0
2021,Oldham 033A,E01005365,612,518,296,222,0,0,13,3,10,81,69,12,0
2021,Oldham 033B,E01005366,753,325,155,170,0,0,350,204,146,76,59,17,2
2021,Oldham 033C,E01005367,569,519,293,226,2,2,10,2,8,37,30,7,1
2021,Oldham 031C,E01005368,757,328,166,162,1,1,133,32,101,294,272,22,1
2021,Oldham 032B,E01005369,828,406,161,245,0,0,179,32,147,242,224,18,1
2021,Oldham 032C,E01005370,794,245,113,132,2,2,368,138,230,176,157,19,3
2021,Oldham 032D,E01005371,603,342,132,210,1,1,78,18,60,182,164,18,0
2021,Oldham 034A,E01005372,534,327,159,168,0,0,110,33,77,97,86,11,0
2021,Oldham 034B,E01005373,509,450,252,198,3,3,19,8,11,37,33,4,0
2021,Oldham 034C,E01005374,618,409,205,204,0,0,121,56,65,88,74,14,0
2021,Oldham 034D,E01005375,644,570,342,228,0,0,17,6,11,57,47,10,0
2021,Oldham 031D,E01005376,572,243,117,126,0,0,209,81,128,118,113,5,2
2021,Oldham 030A,E01005377,633,239,77,162,0,0,347,53,294,45,39,6,2
2021,Oldham 031E,E01005378,663,410,241,169,1,1,34,14,20,216,179,37,2
2021,Oldham 030B,E01005379,483,111,62,49,1,1,322,49,273,49,44,5,0
2021,Oldham 030C,E01005380,523,201,91,110,0,0,301,59,242,21,18,3,0
2021,Oldham 027D,E01005381,759,203,104,99,1,1,339,97,242,213,201,12,3
2021,Oldham 030D,E01005382,653,266,138,128,1,1,254,77,177,127,113,14,5
2021,Oldham 026A,E01005383,708,414,188,226,3,3,192,97,95,98,75,23,1
2021,Oldham 026D,E01005386,646,228,103,125,1,1,355,152,203,61,57,4,1
2021,Oldham 018A,E01005387,640,484,222,262,4,4,33,13,20,119,104,15,0
2021,Oldham 018B,E01005388,585,428,226,202,1,1,72,27,45,84,72,12,0
2021,Oldham 018C,E01005389,781,326,162,164,0,0,273,145,128,178,158,20,4
2021,Oldham 004A,E01005390,609,486,276,210,0,0,43,20,23,80,60,20,0
2021,Oldham 008A,E01005391,656,456,248,208,1,1,136,70,66,63,53,10,0
2021,Oldham 008B,E01005392,808,299,146,153,8,8,369,157,212,130,113,17,2
2021,Oldham 008C,E01005393,532,426,255,171,21,21,41,30,11,44,37,7,0
2021,Oldham 004B,E01005394,642,537,318,219,0,0,52,24,28,52,40,12,1
2021,Oldham 004C,E01005395,623,525,287,238,2,2,5,3,2,91,80,11,0
2021,Oldham 004D,E01005396,577,451,272,179,0,0,83,53,30,43,32,11,0
2021,Oldham 009A,E01005397,612,438,225,213,1,1,84,38,46,89,79,10,0
2021,Oldham 009B,E01005398,674,490,254,236,1,1,10,4,6,173,144,29,0
2021,Oldham 005C,E01005399,711,578,333,245,2,2,19,10,9,112,92,20,0
2021,Oldham 009C,E01005400,796,364,202,162,0,0,347,81,266,84,64,20,1
2021,Oldham 008D,E01005401,681,605,356,249,6,6,16,3,13,54,41,13,0
2021,Oldham 009D,E01005402,662,441,207,234,1,1,54,6,48,166,151,15,0
2021,Oldham 005D,E01005403,692,545,243,302,4,4,57,37,20,84,74,10,2
2021,Oldham 021A,E01005406,585,521,283,238,0,0,20,4,16,44,39,5,0
2021,Oldham 013A,E01005407,751,647,358,289,1,1,13,2,11,90,74,16,0
2021,Oldham 020C,E01005408,890,686,379,307,2,2,87,29,58,115,103,12,0
2021,Oldham 020D,E01005409,660,547,328,219,0,0,10,2,8,103,94,9,0
2021,Oldham 006A,E01005410,624,544,310,234,0,0,17,11,6,62,45,17,1
2021,Oldham 006B,E01005411,736,520,319,201,17,17,96,23,73,103,81,22,0
2021,Oldham 013B,E01005412,793,633,398,235,4,4,23,5,18,133,113,20,0
2021,Oldham 021B,E01005413,642,574,320,254,2,2,7,1,6,59,51,8,0
2021,Oldham 006C,E01005414,560,458,253,205,1,1,21,7,14,80,64,16,0
2021,Oldham 006D,E01005415,512,345,213,132,0,0,115,38,77,52,38,14,0
2021,Oldham 013C,E01005416,672,522,264,258,6,6,11,3,8,133,121,12,0
2021,Oldham 013D,E01005417,643,555,315,240,1,1,14,7,7,73,65,8,0
2021,Oldham 018D,E01005418,598,528,282,246,1,1,11,6,5,58,45,13,0
2021,Oldham 021C,E01005419,654,490,280,210,2,2,46,8,38,116,102,14,0
2021,Oldham 021D,E01005420,746,467,245,222,0,0,163,57,106,116,101,15,0
2021,Oldham 011A,E01005421,771,339,148,191,12,12,176,88,88,243,227,16,1
2021,Oldham 011B,E01005422,523,170,53,117,0,0,305,185,120,47,41,6,1
2021,Oldham 022C,E01005427,509,263,170,93,1,1,136,42,94,108,77,31,1
2021,Oldham 019A,E01005428,528,265,139,126,0,0,30,9,21,225,198,27,8
2021,Oldham 022D,E01005429,462,278,201,77,0,0,88,30,58,95,74,21,1
2021,Oldham 022E,E01005430,718,439,233,206,1,1,78,20,58,200,169,31,0
2021,Oldham 019B,E01005431,696,423,206,217,7,7,58,21,37,206,185,21,2
2021,Oldham 014C,E01005432,692,145,61,84,11,11,421,213,208,113,98,15,2
2021,Oldham 014D,E01005433,935,168,82,86,27,27,492,223,269,246,228,18,2
2021,Oldham 024B,E01005434,792,182,100,82,1,1,350,132,218,237,215,22,22
2021,Oldham 037B,E01005435,496,324,173,151,2,2,26,6,20,142,126,16,2
2021,Oldham 037D,E01005436,516,408,206,202,2,2,6,3,3,100,84,16,0
2021,Oldham 024C,E01005437,544,346,175,171,2,2,48,11,37,147,116,31,1
2021,Oldham 029E,E01005438,1003,577,224,353,7,7,86,26,60,330,296,34,3
2021,Oldham 030E,E01005439,651,495,276,219,3,3,31,4,27,122,109,13,0
2021,Oldham 033D,E01005440,649,372,203,169,9,9,195,96,99,72,60,12,1
2021,Oldham 002A,E01005441,751,351,172,179,1,1,312,67,245,87,71,16,0
2021,Oldham 002B,E01005442,581,520,303,217,1,1,15,4,11,45,36,9,0
2021,Oldham 003B,E01005443,542,499,295,204,1,1,4,2,2,38,29,9,0
2021,Oldham 002C,E01005444,661,412,237,175,15,15,53,30,23,181,162,19,0
2021,Oldham 002D,E01005445,662,304,123,181,5,5,110,41,69,240,224,16,3
2021,Oldham 003C,E01005446,593,404,200,204,1,1,89,46,43,99,85,14,0
2021,Oldham 003D,E01005447,720,305,128,177,2,2,220,112,108,191,170,21,2
2021,Oldham 012A,E01005448,741,183,91,92,0,0,392,162,230,162,154,8,4
2021,Oldham 012B,E01005449,681,271,124,147,28,28,291,150,141,89,75,14,2
2021,Oldham 019C,E01005450,669,281,126,155,2,2,86,34,52,297,265,32,3
2021,Oldham 019D,E01005451,496,400,163,237,1,1,11,2,9,84,67,17,0
2021,Oldham 007C,E01005452,539,479,265,214,0,0,3,0,3,57,47,10,0
2021,Oldham 007D,E01005453,638,538,237,301,0,0,16,9,7,83,66,17,1
2021,Oldham 012C,E01005454,571,465,215,250,0,0,57,27,30,49,43,6,0
2021,Oldham 012D,E01005455,607,486,218,268,1,1,21,12,9,99,83,16,0
2021,Oldham 012E,E01005456,763,295,120,175,2,2,301,142,159,164,147,17,1
2021,Oldham 024D,E01005459,481,140,71,69,3,3,248,86,162,85,65,20,5
2021,Oldham 036C,E01005460,818,451,270,181,2,2,163,43,120,199,172,27,3
2021,Oldham 037A,E01005461,579,343,215,128,0,0,109,17,92,124,101,23,3
2021,Oldham 037C,E01005462,628,414,211,203,0,0,67,12,55,146,122,24,1
2021,Oldham 036D,E01005463,511,191,115,76,6,6,160,42,118,114,93,21,40
2021,Rochdale 016A,E01005464,664,277,108,169,0,0,311,215,96,72,57,15,4
2021,Rochdale 016B,E01005465,795,470,209,261,1,1,120,83,37,202,182,20,2
2021,Rochdale 016C,E01005466,1018,260,104,156,5,5,677,529,148,68,58,10,8
2021,Rochdale 016D,E01005467,831,347,127,220,0,0,378,315,63,101,84,17,5
2021,Rochdale 016E,E01005468,832,737,288,449,3,3,16,8,8,76,58,18,0
2021,Rochdale 012A,E01005469,686,511,265,246,1,1,18,6,12,155,129,26,1
2021,Rochdale 015A,E01005470,511,233,143,90,1,1,102,23,79,171,149,22,4
2021,Rochdale 015B,E01005471,569,329,201,128,1,1,42,22,20,195,172,23,2
2021,Rochdale 010A,E01005472,659,285,129,156,10,10,202,124,78,158,143,15,4
2021,Rochdale 010B,E01005473,507,312,173,139,2,2,55,26,29,135,113,22,3
2021,Rochdale 011A,E01005474,477,373,229,144,1,1,39,28,11,63,57,6,1
2021,Rochdale 015C,E01005475,595,296,157,139,0,0,170,61,109,125,109,16,4
2021,Rochdale 017A,E01005476,777,519,253,266,0,0,116,9,107,142,118,24,0
2021,Rochdale 017B,E01005477,850,310,125,185,3,3,187,16,171,350,320,30,0
2021,Rochdale 017C,E01005478,670,458,281,177,1,1,100,74,26,109,90,19,2
2021,Rochdale 017D,E01005479,785,565,283,282,0,0,90,50,40,130,112,18,0
2021,Rochdale 017E,E01005480,717,459,259,200,1,1,161,135,26,95,75,20,1
2021,Rochdale 017F,E01005481,585,421,204,217,14,14,69,49,20,80,64,16,1
2021,Rochdale 010C,E01005482,893,106,56,50,2,2,592,357,235,188,159,29,5
2021,Rochdale 010D,E01005483,560,169,98,71,4,4,261,147,114,116,100,16,10
2021,Rochdale 010E,E01005484,776,179,120,59,0,0,461,230,231,130,109,21,6
2021,Rochdale 015D,E01005485,673,326,230,96,2,2,150,37,113,193,159,34,2
2021,Rochdale 010F,E01005486,600,247,126,121,2,2,49,17,32,301,278,23,1
2021,Rochdale 010G,E01005487,584,322,182,140,1,1,86,27,59,173,150,23,2
2021,Rochdale 006A,E01005488,584,524,186,338,1,1,8,5,3,50,49,1,1
2021,Rochdale 005A,E01005489,506,406,253,153,0,0,35,11,24,65,58,7,0
2021,Rochdale 005B,E01005490,423,208,78,130,1,1,133,111,22,78,68,10,3
2021,Rochdale 005C,E01005491,681,442,238,204,0,0,131,95,36,107,100,7,1
2021,Rochdale 006B,E01005492,618,560,313,247,0,0,10,4,6,48,39,9,0
2021,Rochdale 005D,E01005493,716,592,313,279,1,1,8,3,5,115,102,13,0
2021,Rochdale 005E,E01005494,713,481,233,248,2,2,72,16,56,154,134,20,4
2021,Rochdale 005F,E01005495,699,438,241,197,0,0,98,60,38,162,143,19,1
2021,Rochdale 009A,E01005496,503,167,76,91,0,0,246,189,57,82,71,11,8
2021,Rochdale 018A,E01005497,748,316,160,156,7,7,307,216,91,113,101,12,5
2021,Rochdale 020A,E01005498,594,339,169,170,0,0,52,12,40,201,183,18,2
2021,Rochdale 006C,E01005499,683,465,266,199,1,1,49,27,22,167,150,17,1
2021,Rochdale 020B,E01005500,644,461,219,242,0,0,67,30,37,115,101,14,1
2021,Rochdale 018B,E01005501,995,246,125,121,5,5,431,194,237,310,288,22,3
2021,Rochdale 018C,E01005502,680,375,207,168,1,1,131,60,71,173,159,14,0
2021,Rochdale 020C,E01005503,528,483,274,209,1,1,10,7,3,34,28,6,0
2021,Rochdale 018D,E01005504,710,375,182,193,0,0,177,72,105,157,144,13,1
2021,Rochdale 018E,E01005505,961,579,234,345,15,15,170,79,91,197,172,25,0
2021,Rochdale 020D,E01005506,652,387,204,183,6,6,179,126,53,79,67,12,1
2021,Rochdale 020E,E01005507,983,628,242,386,2,2,67,20,47,286,257,29,0
2021,Rochdale 020F,E01005508,789,678,362,316,15,15,23,10,13,73,55,18,0
2021,Rochdale 018F,E01005509,721,253,127,126,1,1,292,198,94,172,157,15,3
2021,Rochdale 019A,E01005510,443,408,216,192,1,1,5,3,2,28,24,4,1
2021,Rochdale 019B,E01005511,491,392,214,178,2,2,42,30,12,55,51,4,0
2021,Rochdale 019C,E01005512,663,384,187,197,0,0,149,64,85,130,113,17,0
2021,Rochdale 019D,E01005513,631,223,104,119,0,0,344,125,219,64,58,6,0
2021,Rochdale 019E,E01005514,781,442,169,273,1,1,226,55,171,110,99,11,2
2021,Rochdale 019F,E01005515,684,186,86,100,1,1,427,113,314,67,53,14,3
2021,Rochdale 003A,E01005516,522,451,236,215,0,0,11,7,4,60,46,14,0
2021,Rochdale 003B,E01005517,644,523,334,189,0,0,27,22,5,94,79,15,0
2021,Rochdale 001A,E01005518,672,494,230,264,0,0,82,66,16,96,78,18,0
2021,Rochdale 002A,E01005519,621,518,240,278,0,0,39,28,11,64,52,12,0
2021,Rochdale 001B,E01005520,805,564,316,248,4,4,76,51,25,161,143,18,0
2021,Rochdale 003C,E01005521,673,504,258,246,1,1,43,25,18,125,108,17,0
2021,Rochdale 001C,E01005522,769,396,192,204,1,1,110,42,68,262,232,30,0
2021,Rochdale 001D,E01005523,807,567,284,283,2,2,60,33,27,178,157,21,0
2021,Rochdale 021A,E01005524,618,439,228,211,15,15,67,37,30,97,88,9,0
2021,Rochdale 021B,E01005525,857,284,130,154,14,14,382,274,108,174,164,10,3
2021,Rochdale 021C,E01005526,792,472,185,287,19,19,184,118,66,117,108,9,0
2021,Rochdale 022A,E01005527,824,373,98,275,2,2,363,104,259,83,73,10,3
2021,Rochdale 021D,E01005528,668,386,182,204,5,5,202,111,91,72,61,11,3
2021,Rochdale 022B,E01005529,745,236,126,110,0,0,403,132,271,104,97,7,2
2021,Rochdale 025A,E01005530,634,579,358,221,0,0,12,5,7,43,31,12,0
2021,Rochdale 025B,E01005531,515,365,168,197,11,11,47,35,12,92,80,12,0
2021,Rochdale 025C,E01005532,669,283,138,145,3,3,304,207,97,79,75,4,0
2021,Rochdale 024A,E01005533,802,488,255,233,0,0,130,46,84,183,167,16,1
2021,Rochdale 023A,E01005534,622,399,174,225,0,0,117,52,65,105,96,9,1
2021,Rochdale 023B,E01005535,651,379,194,185,0,0,110,46,64,161,140,21,1
2021,Rochdale 021E,E01005536,681,359,170,189,1,1,120,92,28,201,179,22,0
2021,Rochdale 023C,E01005537,560,494,264,230,0,0,14,7,7,52,43,9,0
2021,Rochdale 023D,E01005538,566,306,117,189,3,3,156,113,43,98,85,13,3
2021,Rochdale 024B,E01005539,667,357,205,152,1,1,155,98,57,152,139,13,2
2021,Rochdale 023E,E01005540,590,418,192,226,1,1,40,13,27,131,112,19,0
2021,Rochdale 023F,E01005541,694,429,180,249,0,0,76,17,59,188,172,16,1
2021,Rochdale 023G,E01005542,700,285,134,151,0,0,247,142,105,163,152,11,5
2021,Rochdale 021F,E01005543,514,412,225,187,1,1,42,30,12,59,51,8,0
2021,Rochdale 025D,E01005544,586,536,279,257,1,1,10,5,5,39,33,6,0
2021,Rochdale 025E,E01005545,482,432,258,174,1,1,6,5,1,43,36,7,0
2021,Rochdale 024C,E01005546,617,374,222,152,2,2,169,112,57,72,61,11,0
2021,Rochdale 024D,E01005547,733,483,212,271,0,0,83,56,27,164,151,13,3
2021,Rochdale 024E,E01005548,623,300,161,139,14,14,216,152,64,89,75,14,4
2021,Rochdale 025F,E01005549,590,554,294,260,0,0,8,4,4,28,22,6,0
2021,Rochdale 025G,E01005550,617,572,348,224,0,0,14,10,4,31,16,15,0
2021,Rochdale 022C,E01005551,828,287,110,177,7,7,428,126,302,106,95,11,0
2021,Rochdale 022D,E01005552,889,244,106,138,2,2,543,201,342,99,89,10,1
2021,Rochdale 022E,E01005553,769,325,171,154,0,0,313,84,229,131,117,14,0
2021,Rochdale 022F,E01005554,876,686,241,445,7,7,73,21,52,109,89,20,1
2021,Rochdale 014A,E01005555,549,453,225,228,1,1,32,25,7,63,53,10,0
2021,Rochdale 013A,E01005556,698,471,266,205,2,2,60,21,39,165,151,14,0
2021,Rochdale 014B,E01005557,497,456,269,187,5,5,7,2,5,29,19,10,0
2021,Rochdale 014C,E01005558,703,421,189,232,0,0,151,93,58,130,115,15,1
2021,Rochdale 013B,E01005559,665,269,129,140,0,0,308,219,89,87,73,14,1
2021,Rochdale 013C,E01005560,691,521,314,207,2,2,16,8,8,152,135,17,0
2021,Rochdale 014D,E01005561,649,448,241,207,1,1,44,23,21,156,148,8,0
2021,Rochdale 014E,E01005562,681,408,199,209,2,2,136,78,58,134,117,17,1
2021,Rochdale 012B,E01005563,707,370,149,221,4,4,122,22,100,210,183,27,1
2021,Rochdale 015E,E01005564,736,258,160,98,5,5,163,35,128,309,287,22,1
2021,Rochdale 012C,E01005565,533,292,120,172,0,0,197,160,37,44,36,8,0
2021,Rochdale 012D,E01005566,828,441,136,305,2,2,195,143,52,189,176,13,1
2021,Rochdale 013D,E01005567,808,555,193,362,1,1,130,57,73,121,112,9,1
2021,Rochdale 012E,E01005568,653,136,89,47,0,0,388,145,243,126,117,9,3
2021,Rochdale 012F,E01005569,641,320,181,139,1,1,231,116,115,87,69,18,2
2021,Rochdale 007A,E01005570,589,460,288,172,2,2,17,8,9,110,92,18,0
2021,Rochdale 006D,E01005571,727,624,347,277,0,0,5,1,4,97,80,17,1
2021,Rochdale 007B,E01005572,627,546,279,267,1,1,9,6,3,71,59,12,0
2021,Rochdale 007C,E01005573,563,499,289,210,0,0,31,21,10,33,28,5,0
2021,Rochdale 007D,E01005574,693,573,348,225,1,1,13,6,7,105,96,9,1
2021,Rochdale 011B,E01005575,760,634,406,228,2,2,8,5,3,113,97,16,3
2021,Rochdale 011C,E01005576,544,504,311,193,0,0,6,2,4,33,29,4,1
2021,Rochdale 011D,E01005577,648,560,338,222,3,3,25,7,18,60,52,8,0
2021,Rochdale 004A,E01005578,515,260,112,148,2,2,148,78,70,103,85,18,2
2021,Rochdale 004B,E01005579,549,207,67,140,1,1,282,238,44,57,53,4,2
2021,Rochdale 008A,E01005580,578,326,150,176,2,2,38,16,22,211,189,22,1
2021,Rochdale 008B,E01005581,720,281,121,160,0,0,202,130,72,234,221,13,3
2021,Rochdale 008D,E01005583,520,211,128,83,1,1,179,57,122,128,118,10,1
2021,Rochdale 008F,E01005585,500,285,135,150,1,1,48,10,38,166,151,15,0
2021,Rochdale 004C,E01005586,632,213,118,95,18,18,303,225,78,97,90,7,1
2021,Rochdale 007E,E01005587,515,446,208,238,1,1,14,7,7,54,45,9,0
2021,Rochdale 007F,E01005588,658,363,239,124,3,3,190,138,52,96,83,13,6
2021,Rochdale 009B,E01005589,719,440,170,270,3,3,52,23,29,222,205,17,2
2021,Rochdale 009C,E01005590,559,343,173,170,2,2,80,33,47,131,112,19,3
2021,Rochdale 009D,E01005591,655,457,252,205,0,0,64,12,52,134,114,20,0
2021,Rochdale 009E,E01005592,611,320,159,161,1,1,196,146,50,92,77,15,2
2021,Rochdale 004D,E01005593,753,461,163,298,14,14,190,139,51,87,73,14,1
2021,Rochdale 002B,E01005594,599,450,234,216,2,2,80,59,21,65,51,14,2
2021,Rochdale 004E,E01005595,747,217,100,117,4,4,392,143,249,133,121,12,1
2021,Rochdale 003D,E01005596,818,659,291,368,9,9,27,19,8,123,100,23,0
2021,Rochdale 002C,E01005597,827,654,276,378,1,1,43,11,32,129,109,20,0
2021,Rochdale 002D,E01005598,688,558,345,213,1,1,18,3,15,111,89,22,0
2021,Salford 026A,E01005599,873,275,134,141,4,4,411,196,215,179,169,10,4
2021,Salford 026B,E01005600,886,477,159,318,4,4,176,71,105,229,212,17,0
2021,Salford 026C,E01005601,678,252,120,132,3,3,282,113,169,139,123,16,2
2021,Salford 026D,E01005602,888,186,68,118,18,18,580,304,276,99,92,7,5
2021,Salford 027A,E01005603,751,317,121,196,3,3,169,49,120,260,235,25,2
2021,Salford 027B,E01005604,727,451,212,239,20,20,154,95,59,102,87,15,0
2021,Salford 027C,E01005605,737,390,169,221,11,11,129,66,63,207,192,15,0
2021,Salford 034C,E01005610,480,102,43,59,3,3,296,172,124,76,74,2,3
2021,Salford 032C,E01005611,1049,233,118,115,9,9,460,78,382,346,321,25,1
2021,Salford 031B,E01005612,1056,126,60,66,3,3,738,285,453,175,163,12,14
2021,Salford 031A,E01005613,1001,154,86,68,5,5,457,171,286,381,347,34,4
2021,Salford 031C,E01005614,618,229,112,117,1,1,175,46,129,212,195,17,1
2021,Salford 032D,E01005615,684,173,86,87,13,13,184,35,149,310,290,20,4
2021,Salford 030A,E01005616,611,328,172,156,1,1,221,143,78,59,47,12,2
2021,Salford 030B,E01005617,604,446,214,232,0,0,72,49,23,83,73,10,3
2021,Salford 030C,E01005618,915,520,144,376,3,3,257,170,87,134,114,20,1
2021,Salford 030D,E01005619,513,337,154,183,0,0,109,75,34,66,58,8,1
2021,Salford 030E,E01005620,1048,699,271,428,1,1,126,61,65,220,185,35,2
2021,Salford 030F,E01005621,784,363,169,194,5,5,202,97,105,212,192,20,2
2021,Salford 018A,E01005622,667,365,148,217,6,6,81,8,73,215,198,17,0
2021,Salford 018B,E01005623,492,400,195,205,0,0,11,3,8,81,75,6,0
2021,Salford 017A,E01005624,728,278,110,168,30,30,333,185,148,84,74,10,3
2021,Salford 015A,E01005625,606,451,230,221,3,3,41,3,38,111,97,14,0
2021,Salford 018C,E01005626,517,459,252,207,0,0,4,1,3,53,37,16,1
2021,Salford 015B,E01005627,472,392,197,195,2,2,15,5,10,62,52,10,1
2021,Salford 018D,E01005628,661,403,222,181,0,0,48,10,38,209,200,9,1
2021,Salford 021A,E01005629,670,450,199,251,0,0,122,27,95,96,89,7,2
2021,Salford 021B,E01005630,647,442,192,250,3,3,64,31,33,138,119,19,0
2021,Salford 020A,E01005631,1043,158,70,88,0,0,678,356,322,200,182,18,7
2021,Salford 020B,E01005632,1116,630,246,384,3,3,122,31,91,359,333,26,2
2021,Salford 020C,E01005633,604,336,145,191,1,1,185,109,76,70,57,13,12
2021,Salford 020D,E01005634,666,586,278,308,2,2,16,6,10,62,55,7,0
2021,Salford 020E,E01005635,680,397,191,206,3,3,74,23,51,206,199,7,0
2021,Salford 020F,E01005636,704,474,259,215,3,3,83,17,66,144,129,15,0
2021,Salford 020G,E01005637,658,394,156,238,14,14,106,58,48,143,115,28,1
2021,Salford 027D,E01005638,974,306,127,179,3,3,274,121,153,387,351,36,4
2021,Salford 029A,E01005639,568,135,50,85,0,0,365,212,153,66,56,10,2
2021,Salford 029B,E01005640,530,259,113,146,1,1,198,100,98,70,62,8,2
2021,Salford 029C,E01005641,618,330,152,178,0,0,188,79,109,99,85,14,1
2021,Salford 029D,E01005642,507,416,192,224,1,1,5,2,3,85,74,11,0
2021,Salford 029E,E01005643,665,513,324,189,0,0,60,20,40,92,78,14,0
2021,Salford 029F,E01005644,608,498,196,302,1,1,19,11,8,90,77,13,0
2021,Salford 029G,E01005645,591,519,325,194,1,1,31,11,20,40,33,7,0
2021,Salford 010A,E01005646,553,278,115,163,1,1,85,7,78,189,178,11,0
2021,Salford 011A,E01005647,624,319,184,135,1,1,73,10,63,231,211,20,0
2021,Salford 011B,E01005648,1024,592,266,326,1,1,63,25,38,368,341,27,0
2021,Salford 010B,E01005649,647,342,222,120,2,2,38,14,24,265,241,24,0
2021,Salford 010C,E01005650,632,193,88,105,7,7,203,66,137,225,206,19,4
2021,Salford 010D,E01005651,554,252,121,131,0,0,169,51,118,132,120,12,1
2021,Salford 011C,E01005652,569,303,129,174,5,5,165,120,45,96,88,8,0
2021,Salford 011D,E01005653,593,164,96,68,8,8,244,157,87,174,159,15,3
2021,Salford 023A,E01005654,922,363,127,236,19,19,161,31,130,378,349,29,1
2021,Salford 023B,E01005656,716,266,148,118,4,4,118,23,95,328,307,21,0
2021,Salford 023C,E01005657,749,294,178,116,6,6,204,35,169,243,232,11,2
2021,Salford 001A,E01005659,629,314,152,162,0,0,202,127,75,112,103,9,1
2021,Salford 001B,E01005660,732,187,90,97,4,4,444,274,170,88,82,6,9
2021,Salford 004A,E01005661,758,364,136,228,5,5,241,148,93,145,133,12,3
2021,Salford 004B,E01005662,636,151,88,63,3,3,385,229,156,94,87,7,3
2021,Salford 001C,E01005663,670,314,154,160,7,7,165,85,80,180,167,13,4
2021,Salford 001D,E01005664,620,172,74,98,1,1,366,240,126,79,69,10,2
2021,Salford 001E,E01005665,816,136,64,72,22,22,590,291,299,61,57,4,7
2021,Salford 035C,E01005667,1032,207,69,138,1,1,545,324,221,273,248,25,6
2021,Salford 005A,E01005670,818,321,145,176,1,1,310,119,191,183,171,12,3
2021,Salford 012A,E01005671,757,358,183,175,1,1,203,83,120,192,170,22,3
2021,Salford 005B,E01005672,611,356,181,175,6,6,58,19,39,191,180,11,0
2021,Salford 008A,E01005673,659,403,173,230,3,3,115,62,53,137,124,13,1
2021,Salford 012B,E01005674,622,390,170,220,6,6,126,57,69,98,80,18,2
2021,Salford 005C,E01005676,553,482,312,170,0,0,13,6,7,58,47,11,0
2021,Salford 005D,E01005677,681,478,263,215,1,1,84,59,25,118,106,12,0
2021,Salford 008C,E01005678,649,279,121,158,3,3,292,156,136,69,62,7,6
2021,Salford 008D,E01005679,662,226,102,124,0,0,343,192,151,88,73,15,5
2021,Salford 017B,E01005680,793,162,84,78,2,2,347,68,279,281,271,10,1
2021,Salford 024C,E01005681,550,54,38,16,1,1,375,212,163,116,96,20,4
2021,Salford 024D,E01005682,993,44,26,18,2,2,876,336,540,60,54,6,11
2021,Salford 017C,E01005683,887,214,69,145,15,15,553,351,202,99,92,7,6
2021,Salford 006A,E01005686,634,385,210,175,0,0,79,38,41,168,156,12,2
2021,Salford 009A,E01005687,812,502,219,283,1,1,97,51,46,212,175,37,0
2021,Salford 006B,E01005688,652,456,253,203,2,2,111,68,43,81,69,12,2
2021,Salford 009B,E01005689,528,183,78,105,0,0,288,173,115,54,47,7,3
2021,Salford 009C,E01005690,692,490,234,256,0,0,94,49,45,107,96,11,1
2021,Salford 006C,E01005691,673,521,353,168,3,3,60,38,22,88,75,13,1
2021,Salford 006D,E01005692,730,230,108,122,2,2,302,149,153,194,186,8,2
2021,Salford 009D,E01005693,630,485,238,247,0,0,15,7,8,129,120,9,1
2021,Salford 012C,E01005694,689,536,240,296,2,2,36,18,18,112,100,12,3
2021,Salford 014A,E01005695,626,557,288,269,2,2,12,6,6,55,48,7,0
2021,Salford 012D,E01005696,711,530,221,309,5,5,116,61,55,59,54,5,1
2021,Salford 014B,E01005697,653,543,279,264,1,1,34,16,18,73,56,17,2
2021,Salford 012E,E01005698,776,245,123,122,2,2,403,212,191,112,101,11,14
2021,Salford 015C,E01005699,761,647,313,334,12,12,24,6,18,78,66,12,0
2021,Salford 012F,E01005700,655,420,231,189,1,1,92,51,41,141,136,5,1
2021,Salford 015D,E01005701,716,587,297,290,3,3,39,11,28,87,75,12,0
2021,Salford 003A,E01005702,1143,605,252,353,37,37,236,111,125,264,243,21,1
2021,Salford 002A,E01005703,754,238,109,129,0,0,403,265,138,111,102,9,2
2021,Salford 002B,E01005704,589,383,202,181,1,1,91,62,29,113,96,17,1
2021,Salford 002C,E01005706,657,314,145,169,0,0,216,124,92,124,103,21,3
2021,Salford 003C,E01005707,767,267,127,140,21,21,338,141,197,140,126,14,1
2021,Salford 002D,E01005708,724,321,180,141,1,1,198,103,95,199,184,15,5
2021,Salford 004C,E01005709,630,209,104,105,0,0,362,230,132,56,49,7,3
2021,Salford 004D,E01005710,841,664,284,380,8,8,110,65,45,57,50,7,2
2021,Salford 007A,E01005711,628,494,255,239,4,4,34,16,18,96,87,9,0
2021,Salford 007B,E01005712,843,401,176,225,3,3,131,50,81,308,291,17,0
2021,Salford 007C,E01005713,700,614,342,272,2,2,18,12,6,66,53,13,0
2021,Salford 007D,E01005714,699,418,157,261,3,3,204,124,80,74,60,14,0
2021,Salford 007E,E01005715,757,605,306,299,8,8,44,14,30,99,85,14,1
2021,Salford 013A,E01005716,674,584,334,250,2,2,18,10,8,70,59,11,0
2021,Salford 013B,E01005717,560,506,212,294,0,0,7,3,4,47,42,5,0
2021,Salford 007F,E01005718,795,491,252,239,1,1,132,55,77,168,150,18,3
2021,Salford 021C,E01005719,1011,293,130,163,1,1,325,135,190,389,369,20,3
2021,Salford 023D,E01005721,784,358,216,142,6,6,211,72,139,206,195,11,3
2021,Salford 021E,E01005722,795,316,126,190,11,11,223,119,104,242,190,52,3
2021,Salford 021F,E01005723,652,204,83,121,0,0,304,146,158,141,128,13,3
2021,Salford 021G,E01005724,636,479,273,206,0,0,79,22,57,78,65,13,0
2021,Salford 019A,E01005725,557,184,75,109,1,1,299,160,139,69,67,2,4
2021,Salford 019B,E01005726,615,367,159,208,0,0,132,72,60,116,104,12,0
2021,Salford 019C,E01005727,648,357,138,219,1,1,95,54,41,193,180,13,2
2021,Salford 019D,E01005728,761,605,265,340,16,16,51,24,27,89,71,18,0
2021,Salford 025A,E01005729,776,112,60,52,3,3,525,251,274,128,125,3,8
2021,Salford 025B,E01005730,730,496,233,263,5,5,62,31,31,166,135,31,1
2021,Salford 025C,E01005731,581,240,103,137,2,2,279,149,130,57,49,8,3
2021,Salford 025D,E01005732,546,238,108,130,2,2,251,125,126,52,49,3,3
2021,Salford 019E,E01005733,495,236,108,128,2,2,214,115,99,42,36,6,1
2021,Salford 013C,E01005734,625,431,209,222,1,1,92,55,37,101,86,15,0
2021,Salford 013D,E01005735,597,539,319,220,0,0,9,7,2,49,46,3,0
2021,Salford 013E,E01005736,625,522,295,227,1,1,10,4,6,90,79,11,2
2021,Salford 013F,E01005737,591,550,296,254,0,0,8,7,1,33,28,5,0
2021,Salford 014C,E01005738,823,690,363,327,2,2,14,8,6,117,101,16,0
2021,Salford 013G,E01005739,783,674,279,395,14,14,28,5,23,67,52,15,0
2021,Salford 014D,E01005740,702,555,303,252,1,1,50,24,26,96,85,11,0
2021,Salford 014E,E01005741,684,578,306,272,3,3,51,12,39,52,45,7,0
2021,Salford 014F,E01005742,664,541,258,283,2,2,29,5,24,92,75,17,0
2021,Stockport 009A,E01005743,565,501,288,213,0,0,3,3,0,61,49,12,0
2021,Stockport 009B,E01005744,658,424,222,202,30,30,110,74,36,94,82,12,0
2021,Stockport 005A,E01005745,598,479,248,231,1,1,52,30,22,66,54,12,0
2021,Stockport 005B,E01005746,785,299,162,137,20,20,406,243,163,56,50,6,4
2021,Stockport 005C,E01005747,588,523,267,256,2,2,6,4,2,57,50,7,0
2021,Stockport 005D,E01005748,662,605,369,236,13,13,10,8,2,34,25,9,0
2021,Stockport 009C,E01005749,729,588,311,277,17,17,17,3,14,107,97,10,0
2021,Stockport 009D,E01005750,699,582,253,329,2,2,4,2,2,111,100,11,0
2021,Stockport 009E,E01005751,615,458,221,237,14,14,19,6,13,124,111,13,0
2021,Stockport 012A,E01005752,631,351,173,178,16,16,208,105,103,55,49,6,1
2021,Stockport 004A,E01005753,691,264,120,144,32,32,322,291,31,72,69,3,1
2021,Stockport 004B,E01005754,1036,210,89,121,4,4,752,598,154,67,58,9,3
2021,Stockport 004C,E01005755,719,295,128,167,13,13,339,289,50,72,66,6,0
2021,Stockport 004D,E01005756,1040,403,90,313,12,12,555,471,84,68,59,9,2
2021,Stockport 014A,E01005757,727,404,173,231,13,13,74,31,43,235,219,16,1
2021,Stockport 023A,E01005759,727,486,205,281,23,23,82,53,29,133,115,18,3
2021,Stockport 023B,E01005760,881,435,178,257,39,39,105,35,70,300,281,19,2
2021,Stockport 026A,E01005761,545,339,116,223,2,2,120,105,15,82,73,9,2
2021,Stockport 026B,E01005762,800,365,108,257,7,7,376,201,175,52,49,3,0
2021,Stockport 026C,E01005763,638,340,135,205,2,2,233,136,97,63,51,12,0
2021,Stockport 016A,E01005764,777,429,161,268,3,3,135,63,72,208,191,17,2
2021,Stockport 018A,E01005765,566,498,221,277,2,2,9,0,9,57,49,8,0
2021,Stockport 014C,E01005766,801,268,136,132,43,43,185,68,117,304,291,13,1
2021,Stockport 028A,E01005767,603,549,366,183,1,1,3,0,3,50,41,9,0
2021,Stockport 025A,E01005768,759,689,307,382,1,1,4,2,2,65,51,14,0
2021,Stockport 022A,E01005769,787,531,251,280,1,1,35,24,11,220,202,18,0
2021,Stockport 025B,E01005770,636,482,276,206,5,5,49,5,44,100,86,14,0
2021,Stockport 025C,E01005771,562,436,195,241,1,1,53,18,35,72,64,8,0
2021,Stockport 028B,E01005772,571,475,267,208,4,4,30,24,6,62,51,11,0
2021,Stockport 028C,E01005773,650,504,268,236,1,1,49,27,22,96,82,14,0
2021,Stockport 028D,E01005774,730,328,139,189,7,7,320,274,46,71,58,13,4
2021,Stockport 025D,E01005775,645,592,289,303,0,0,10,4,6,43,35,8,0
2021,Stockport 028E,E01005776,619,546,301,245,5,5,6,5,1,62,54,8,0
2021,Stockport 034A,E01005777,708,479,261,218,13,13,144,48,96,71,59,12,1
2021,Stockport 022B,E01005778,603,499,231,268,0,0,26,5,21,78,68,10,0
2021,Stockport 022C,E01005779,587,500,232,268,0,0,17,11,6,70,64,6,0
2021,Stockport 022D,E01005780,565,446,175,271,5,5,42,20,22,72,64,8,0
2021,Stockport 022E,E01005781,905,342,165,177,2,2,454,179,275,105,91,14,2
2021,Stockport 030A,E01005782,581,499,290,209,1,1,18,11,7,63,55,8,0
2021,Stockport 030B,E01005783,730,613,394,219,2,2,69,56,13,43,37,6,3
2021,Stockport 030C,E01005784,546,507,283,224,1,1,4,4,0,34,29,5,0
2021,Stockport 030D,E01005785,659,541,275,266,3,3,37,28,9,78,70,8,0
2021,Stockport 030E,E01005786,807,546,259,287,13,13,20,13,7,228,219,9,0
2021,Stockport 034B,E01005787,480,457,247,210,1,1,2,0,2,20,17,3,0
2021,Stockport 034C,E01005788,621,529,262,267,1,1,23,3,20,68,62,6,0
2021,Stockport 039A,E01005789,732,615,350,265,11,11,22,18,4,84,65,19,0
2021,Stockport 034D,E01005790,509,343,175,168,4,4,118,88,30,44,39,5,0
2021,Stockport 039B,E01005791,642,498,248,250,1,1,83,66,17,60,52,8,0
2021,Stockport 041A,E01005792,591,546,306,240,0,0,4,3,1,41,33,8,0
2021,Stockport 039C,E01005793,627,499,271,228,3,3,27,16,11,97,87,10,1
2021,Stockport 041B,E01005794,501,463,268,195,0,0,8,5,3,30,23,7,0
2021,Stockport 039D,E01005795,529,485,261,224,1,1,3,2,1,40,34,6,0
2021,Stockport 039E,E01005796,497,443,239,204,0,0,4,2,2,50,45,5,0
2021,Stockport 023C,E01005797,681,378,148,230,1,1,101,67,34,200,190,10,1
2021,Stockport 027A,E01005798,806,442,229,213,20,20,165,20,145,179,165,14,0
2021,Stockport 026D,E01005799,699,279,89,190,20,20,311,276,35,86,81,5,3
2021,Stockport 023D,E01005800,688,588,314,274,3,3,23,20,3,74,62,12,0
2021,Stockport 027B,E01005801,895,646,245,401,37,37,38,6,32,174,149,25,0
2021,Stockport 027C,E01005802,600,519,240,279,3,3,22,15,7,56,50,6,0
2021,Stockport 027D,E01005803,593,538,289,249,19,19,6,3,3,29,28,1,1
2021,Stockport 023E,E01005804,465,279,106,173,4,4,105,81,24,76,67,9,1
2021,Stockport 035A,E01005805,588,523,268,255,1,1,30,3,27,34,30,4,0
2021,Stockport 033A,E01005806,498,450,262,188,2,2,5,3,2,41,34,7,0
2021,Stockport 035B,E01005807,626,605,346,259,0,0,4,4,0,17,12,5,0
2021,Stockport 037A,E01005808,528,488,280,208,0,0,3,2,1,37,31,6,0
2021,Stockport 037B,E01005809,500,446,249,197,2,2,5,3,2,47,43,4,0
2021,Stockport 037C,E01005810,662,511,313,198,3,3,27,6,21,121,109,12,0
2021,Stockport 037D,E01005811,629,511,292,219,26,26,9,4,5,83,73,10,0
2021,Stockport 037E,E01005812,479,454,269,185,2,2,5,4,1,18,17,1,0
2021,Stockport 033B,E01005813,600,511,309,202,0,0,5,4,1,84,70,14,0
2021,Stockport 033C,E01005814,542,525,323,202,1,1,3,1,2,13,12,1,0
2021,Stockport 033D,E01005815,583,542,298,244,1,1,2,0,2,38,34,4,0
2021,Stockport 016B,E01005816,707,406,150,256,5,5,35,16,19,261,238,23,0
2021,Stockport 016C,E01005817,662,410,168,242,3,3,48,11,37,201,186,15,0
2021,Stockport 018B,E01005818,550,347,133,214,3,3,114,104,10,86,82,4,0
2021,Stockport 018C,E01005819,651,570,266,304,2,2,10,5,5,69,58,11,0
2021,Stockport 018D,E01005820,642,448,187,261,1,1,63,14,49,128,114,14,2
2021,Stockport 018E,E01005821,666,444,193,251,16,16,85,43,42,121,105,16,0
2021,Stockport 016D,E01005822,1038,229,97,132,30,30,417,309,108,360,347,13,2
2021,Stockport 018F,E01005823,706,426,173,253,17,17,138,98,40,123,120,3,2
2021,Stockport 024A,E01005824,613,461,209,252,24,24,54,32,22,74,65,9,0
2021,Stockport 019A,E01005825,758,480,227,253,11,11,149,53,96,118,101,17,0
2021,Stockport 024B,E01005826,633,250,113,137,19,19,285,215,70,78,60,18,1
2021,Stockport 024C,E01005827,736,633,350,283,25,25,37,31,6,41,34,7,0
2021,Stockport 024D,E01005828,568,140,58,82,1,1,365,162,203,56,51,5,6
2021,Stockport 024E,E01005829,495,287,145,142,0,0,164,142,22,43,36,7,1
2021,Stockport 027E,E01005830,703,477,242,235,45,45,47,10,37,134,122,12,0
2021,Stockport 027F,E01005831,680,499,221,278,15,15,20,8,12,146,138,8,0
2021,Stockport 021A,E01005832,636,481,277,204,5,5,86,32,54,64,56,8,0
2021,Stockport 021B,E01005833,462,297,152,145,0,0,135,26,109,30,26,4,0
2021,Stockport 031A,E01005834,632,398,191,207,3,3,170,137,33,60,55,5,1
2021,Stockport 021C,E01005835,578,528,304,224,3,3,2,0,2,45,38,7,0
2021,Stockport 031B,E01005836,846,644,365,279,26,26,45,25,20,131,108,23,0
2021,Stockport 021D,E01005837,665,566,285,281,1,1,16,15,1,82,72,10,0
2021,Stockport 031C,E01005838,892,546,285,261,12,12,19,12,7,315,282,33,0
2021,Stockport 035C,E01005839,547,525,330,195,2,2,4,1,3,16,14,2,0
2021,Stockport 031D,E01005840,767,501,260,241,9,9,80,48,32,177,159,18,0
2021,Stockport 035D,E01005841,629,520,307,213,12,12,25,25,0,72,63,9,0
2021,Stockport 038A,E01005842,656,596,351,245,0,0,9,5,4,51,40,11,0
2021,Stockport 021E,E01005843,596,550,298,252,1,1,8,1,7,37,31,6,0
2021,Stockport 036A,E01005844,546,480,272,208,0,0,7,3,4,59,51,8,0
2021,Stockport 036B,E01005845,613,537,288,249,0,0,8,7,1,68,54,14,0
2021,Stockport 040A,E01005846,618,520,273,247,1,1,30,27,3,65,49,16,2
2021,Stockport 040B,E01005847,626,510,243,267,1,1,15,7,8,100,81,19,0
2021,Stockport 040C,E01005848,799,697,362,335,22,22,14,4,10,65,61,4,1
2021,Stockport 036C,E01005849,655,567,320,247,13,13,39,4,35,36,26,10,0
2021,Stockport 040D,E01005850,742,503,265,238,5,5,128,55,73,104,83,21,2
2021,Stockport 036D,E01005851,603,542,292,250,1,1,6,4,2,54,40,14,0
2021,Stockport 013A,E01005852,684,470,233,237,3,3,59,6,53,152,135,17,0
2021,Stockport 011A,E01005853,669,406,193,213,1,1,190,168,22,70,52,18,2
2021,Stockport 013B,E01005854,722,625,304,321,3,3,9,8,1,85,78,7,0
2021,Stockport 013C,E01005855,584,504,269,235,17,17,4,1,3,58,53,5,1
2021,Stockport 011B,E01005856,656,528,270,258,5,5,32,24,8,91,76,15,0
2021,Stockport 013D,E01005857,619,518,273,245,4,4,15,6,9,82,67,15,0
2021,Stockport 013E,E01005858,792,592,339,253,2,2,16,7,9,182,169,13,0
2021,Stockport 008A,E01005859,628,382,180,202,24,24,41,15,26,181,174,7,0
2021,Stockport 011C,E01005860,588,526,255,271,2,2,14,14,0,46,37,9,0
2021,Stockport 011D,E01005861,711,505,261,244,3,3,110,20,90,93,80,13,0
2021,Stockport 003A,E01005862,591,521,262,259,2,2,39,4,35,29,24,5,0
2021,Stockport 006A,E01005863,771,575,307,268,3,3,55,16,39,138,124,14,0
2021,Stockport 006B,E01005864,643,439,193,246,4,4,21,5,16,179,166,13,0
2021,Stockport 008B,E01005865,771,610,308,302,30,30,36,3,33,95,89,6,0
2021,Stockport 006C,E01005866,795,420,181,239,1,1,101,21,80,273,258,15,0
2021,Stockport 008C,E01005867,646,506,283,223,2,2,41,6,35,97,92,5,0
2021,Stockport 008D,E01005868,610,542,300,242,0,0,7,2,5,61,49,12,0
2021,Stockport 006D,E01005869,653,544,293,251,2,2,53,46,7,54,45,9,0
2021,Stockport 015A,E01005870,607,415,180,235,7,7,47,8,39,138,116,22,0
2021,Stockport 015B,E01005871,620,427,175,252,9,9,35,17,18,149,132,17,0
2021,Stockport 019B,E01005872,797,519,223,296,2,2,94,15,79,182,164,18,0
2021,Stockport 015C,E01005873,587,494,218,276,1,1,34,27,7,56,38,18,2
2021,Stockport 019C,E01005874,1037,298,147,151,68,68,463,206,257,205,187,18,3
2021,Stockport 015D,E01005875,650,534,253,281,7,7,13,12,1,96,85,11,0
2021,Stockport 019D,E01005876,606,494,238,256,1,1,20,16,4,91,80,11,0
2021,Stockport 019E,E01005877,770,408,188,220,42,42,164,54,110,155,142,13,1
2021,Stockport 020A,E01005878,735,458,180,278,8,8,203,86,117,65,57,8,1
2021,Stockport 020B,E01005879,587,424,209,215,1,1,94,86,8,68,59,9,0
2021,Stockport 017A,E01005880,656,535,290,245,3,3,33,24,9,85,78,7,0
2021,Stockport 017B,E01005881,496,476,298,178,0,0,5,2,3,15,12,3,0
2021,Stockport 020C,E01005882,498,475,301,174,2,2,5,3,2,16,12,4,0
2021,Stockport 017C,E01005883,664,602,406,196,1,1,12,7,5,49,44,5,0
2021,Stockport 020D,E01005884,592,560,351,209,1,1,8,5,3,23,16,7,0
2021,Stockport 020E,E01005885,692,511,297,214,24,24,27,15,12,130,122,8,0
2021,Stockport 001A,E01005886,683,400,162,238,1,1,129,61,68,153,136,17,0
2021,Stockport 002A,E01005887,661,334,124,210,32,32,209,134,75,85,74,11,1
2021,Stockport 001B,E01005888,587,427,198,229,0,0,81,65,16,79,70,9,0
2021,Stockport 001C,E01005889,673,392,196,196,1,1,129,21,108,151,141,10,0
2021,Stockport 002B,E01005890,586,399,163,236,2,2,104,85,19,81,71,10,0
2021,Stockport 001D,E01005891,570,504,324,180,0,0,11,8,3,55,52,3,0
2021,Stockport 003B,E01005892,553,355,175,180,3,3,60,48,12,135,119,16,0
2021,Stockport 002C,E01005893,1095,457,198,259,17,17,142,94,48,479,468,11,0
2021,Stockport 001E,E01005894,570,447,211,236,0,0,25,17,8,98,89,9,0
2021,Stockport 003C,E01005895,484,324,161,163,0,0,91,66,25,69,57,12,0
2021,Stockport 002D,E01005896,787,451,209,242,5,5,50,11,39,281,266,15,0
2021,Stockport 010A,E01005897,595,409,189,220,0,0,122,100,22,64,58,6,0
2021,Stockport 010B,E01005898,736,559,324,235,5,5,102,86,16,70,60,10,0
2021,Stockport 012B,E01005899,750,591,376,215,17,17,56,15,41,86,72,14,0
2021,Stockport 010C,E01005900,791,486,284,202,7,7,187,94,93,111,94,17,0
2021,Stockport 012C,E01005901,626,546,357,189,1,1,29,12,17,50,45,5,0
2021,Stockport 012D,E01005902,739,365,179,186,3,3,305,109,196,63,57,6,3
2021,Stockport 010D,E01005903,631,591,389,202,1,1,5,4,1,34,25,9,0
2021,Stockport 010E,E01005904,665,574,349,225,3,3,19,8,11,68,57,11,1
2021,Stockport 012E,E01005905,603,266,117,149,5,5,240,69,171,91,75,16,1
2021,Stockport 038B,E01005906,634,595,422,173,0,0,7,4,3,32,25,7,0
2021,Stockport 038C,E01005907,619,559,384,175,0,0,6,2,4,54,48,6,0
2021,Stockport 017D,E01005908,638,597,324,273,0,0,10,7,3,31,22,9,0
2021,Stockport 029A,E01005909,656,583,367,216,0,0,29,8,21,44,36,8,0
2021,Stockport 029B,E01005910,763,466,255,211,23,23,173,108,65,98,83,15,3
2021,Stockport 029C,E01005911,545,482,294,188,14,14,29,23,6,20,15,5,0
2021,Stockport 029D,E01005912,661,580,302,278,1,1,5,3,2,75,60,15,0
2021,Stockport 038D,E01005913,636,551,337,214,3,3,45,37,8,37,31,6,0
2021,Stockport 007A,E01005914,673,477,223,254,2,2,88,70,18,106,93,13,0
2021,Stockport 007B,E01005915,718,399,164,235,2,2,167,128,39,150,137,13,0
2021,Stockport 007C,E01005916,724,468,205,263,3,3,73,43,30,180,167,13,0
2021,Stockport 007D,E01005917,899,356,162,194,5,5,216,62,154,321,304,17,1
2021,Stockport 014D,E01005918,834,117,60,57,2,2,655,452,203,57,48,9,3
2021,Stockport 002E,E01005919,702,312,112,200,25,25,286,168,118,77,65,12,2
2021,Stockport 003D,E01005920,631,557,265,292,2,2,14,10,4,58,46,12,0
2021,Stockport 003E,E01005921,717,377,203,174,2,2,113,48,65,224,205,19,1
2021,Stockport 003F,E01005922,619,484,240,244,23,23,24,3,21,88,71,17,0
2021,Stockport 041C,E01005923,605,585,334,251,1,1,4,2,2,15,14,1,0
2021,Stockport 042A,E01005924,525,476,293,183,0,0,7,7,0,42,34,8,0
2021,Stockport 042B,E01005925,609,499,319,180,1,1,62,52,10,46,41,5,1
2021,Stockport 042C,E01005926,857,764,329,435,12,12,20,6,14,60,39,21,1
2021,Stockport 032A,E01005927,491,473,236,237,3,3,2,1,1,13,11,2,0
2021,Stockport 032B,E01005928,666,429,179,250,7,7,145,17,128,84,77,7,1
2021,Stockport 032C,E01005929,601,540,348,192,0,0,10,7,3,51,45,6,0
2021,Stockport 032D,E01005930,600,559,332,227,0,0,8,5,3,33,27,6,0
2021,Stockport 041D,E01005931,637,557,351,206,1,1,34,12,22,44,41,3,1
2021,Stockport 042D,E01005932,526,494,293,201,0,0,4,2,2,28,25,3,0
2021,Tameside 006A,E01005933,552,209,85,124,4,4,274,103,171,64,57,7,1
2021,Tameside 006B,E01005934,626,450,248,202,1,1,108,36,72,67,60,7,0
2021,Tameside 006C,E01005935,636,207,105,102,1,1,315,126,189,111,108,3,2
2021,Tameside 004A,E01005936,645,516,313,203,1,1,54,22,32,73,55,18,1
2021,Tameside 004B,E01005937,712,394,205,189,1,1,206,64,142,111,103,8,0
2021,Tameside 002A,E01005938,648,417,254,163,0,0,134,37,97,96,80,16,1
2021,Tameside 002B,E01005939,480,417,279,138,0,0,5,4,1,58,49,9,0
2021,Tameside 002C,E01005940,594,461,301,160,0,0,73,22,51,60,54,6,0
2021,Tameside 007A,E01005941,777,304,177,127,1,1,185,53,132,287,265,22,0
2021,Tameside 007B,E01005942,708,541,265,276,1,1,50,18,32,116,98,18,0
2021,Tameside 007C,E01005943,848,504,254,250,1,1,46,6,40,297,274,23,0
2021,Tameside 007D,E01005944,723,581,239,342,3,3,16,3,13,123,112,11,0
2021,Tameside 004C,E01005945,750,317,132,185,6,6,304,110,194,123,116,7,0
2021,Tameside 004D,E01005946,692,389,197,192,1,1,91,33,58,204,186,18,7
2021,Tameside 004E,E01005947,813,285,154,131,4,4,192,57,135,330,307,23,2
2021,Tameside 013A,E01005948,1172,177,90,87,4,4,575,145,430,416,390,26,0
2021,Tameside 006D,E01005949,708,380,204,176,0,0,107,35,72,221,207,14,0
2021,Tameside 013B,E01005950,641,319,136,183,0,0,110,18,92,212,186,26,0
2021,Tameside 013C,E01005951,755,349,168,181,0,0,126,32,94,279,259,20,1
2021,Tameside 013E,E01005953,876,307,164,143,1,1,346,53,293,221,194,27,1
2021,Tameside 005A,E01005954,761,364,198,166,3,3,294,108,186,99,84,15,1
2021,Tameside 002D,E01005955,624,549,294,255,0,0,5,2,3,70,56,14,0
2021,Tameside 005B,E01005956,588,469,294,175,14,14,58,9,49,47,34,13,0
2021,Tameside 005C,E01005957,620,464,251,213,0,0,42,12,30,114,99,15,0
2021,Tameside 005D,E01005958,679,301,125,176,0,0,280,77,203,98,85,13,0
2021,Tameside 005E,E01005959,729,368,178,190,2,2,287,87,200,70,57,13,2
2021,Tameside 006E,E01005960,739,297,140,157,3,3,241,49,192,198,181,17,0
2021,Tameside 014A,E01005961,1109,927,310,617,0,0,33,5,28,149,122,27,0
2021,Tameside 014B,E01005962,597,481,277,204,0,0,50,7,43,66,61,5,0
2021,Tameside 019A,E01005963,489,399,202,197,0,0,31,6,25,59,50,9,0
2021,Tameside 019B,E01005964,655,490,241,249,1,1,44,9,35,120,99,21,0
2021,Tameside 019C,E01005965,798,441,165,276,6,6,253,69,184,98,88,10,0
2021,Tameside 019D,E01005966,622,348,150,198,3,3,168,39,129,103,89,14,0
2021,Tameside 019E,E01005967,710,246,124,122,9,9,373,89,284,81,70,11,1
2021,Tameside 014C,E01005968,616,519,299,220,0,0,11,2,9,86,77,9,0
2021,Tameside 014D,E01005969,569,468,290,178,2,2,13,2,11,86,75,11,0
2021,Tameside 021A,E01005970,648,559,354,205,1,1,13,2,11,75,62,13,0
2021,Tameside 025A,E01005971,635,425,231,194,1,1,47,11,36,160,131,29,2
2021,Tameside 021B,E01005972,761,404,187,217,0,0,148,30,118,207,186,21,2
2021,Tameside 026A,E01005973,597,500,305,195,0,0,15,9,6,82,75,7,0
2021,Tameside 021C,E01005974,820,415,210,205,11,11,91,25,66,300,281,19,3
2021,Tameside 021D,E01005975,694,358,171,187,1,1,152,42,110,182,169,13,1
2021,Tameside 026B,E01005976,627,308,136,172,0,0,260,100,160,58,45,13,1
2021,Tameside 026C,E01005977,664,536,305,231,1,1,34,13,21,93,81,12,0
2021,Tameside 026D,E01005978,603,300,154,146,1,1,238,42,196,64,58,6,0
2021,Tameside 029A,E01005979,773,503,292,211,0,0,186,53,133,84,74,10,0
2021,Tameside 029B,E01005980,637,340,143,197,2,2,222,31,191,73,63,10,0
2021,Tameside 029C,E01005981,800,349,171,178,3,3,371,75,296,72,60,12,5
2021,Tameside 029D,E01005982,568,342,195,147,1,1,172,53,119,52,44,8,1
2021,Tameside 029E,E01005983,694,599,365,234,3,3,21,6,15,71,56,15,0
2021,Tameside 029F,E01005984,810,200,109,91,25,25,507,72,435,78,72,6,0
2021,Tameside 024A,E01005985,694,600,353,247,2,2,31,3,28,61,49,12,0
2021,Tameside 025B,E01005986,535,372,180,192,0,0,85,26,59,76,61,15,2
2021,Tameside 024B,E01005987,699,627,361,266,0,0,9,2,7,63,54,9,0
2021,Tameside 024C,E01005988,639,538,283,255,3,3,7,1,6,91,79,12,0
2021,Tameside 025C,E01005989,506,452,252,200,0,0,4,1,3,50,43,7,0
2021,Tameside 024D,E01005990,625,521,280,241,0,0,31,4,27,71,60,11,2
2021,Tameside 024E,E01005991,622,480,226,254,1,1,53,2,51,88,72,16,0
2021,Tameside 025D,E01005992,586,349,189,160,2,2,102,19,83,133,117,16,0
2021,Tameside 010A,E01005993,605,472,273,199,1,1,64,20,44,68,57,11,0
2021,Tameside 011A,E01005994,609,397,182,215,0,0,75,19,56,137,125,12,0
2021,Tameside 010B,E01005995,516,479,265,214,1,1,7,1,6,29,22,7,0
2021,Tameside 010C,E01005996,802,508,231,277,3,3,112,31,81,179,158,21,0
2021,Tameside 010D,E01005997,682,447,235,212,5,5,90,29,61,140,112,28,0
2021,Tameside 012A,E01005998,756,507,245,262,5,5,37,10,27,207,180,27,0
2021,Tameside 011B,E01005999,931,442,189,253,0,0,211,45,166,272,243,29,6
2021,Tameside 010E,E01006000,935,350,169,181,12,12,365,76,289,207,196,11,1
2021,Tameside 012B,E01006001,645,467,235,232,1,1,52,5,47,125,114,11,0
2021,Tameside 011C,E01006002,563,401,204,197,2,2,72,13,59,88,81,7,0
2021,Tameside 012C,E01006003,633,445,233,212,6,6,34,1,33,148,134,14,0
2021,Tameside 011D,E01006004,613,511,277,234,1,1,7,2,5,94,85,9,0
2021,Tameside 011E,E01006005,628,234,121,113,2,2,246,87,159,144,137,7,2
2021,Tameside 012D,E01006006,600,505,276,229,0,0,9,2,7,86,78,8,0
2021,Tameside 011F,E01006007,646,419,199,220,1,1,58,20,38,168,156,12,0
2021,Tameside 017A,E01006008,612,407,178,229,0,0,54,12,42,151,133,18,0
2021,Tameside 016A,E01006009,585,417,225,192,3,3,61,28,33,104,92,12,0
2021,Tameside 017B,E01006010,656,252,111,141,0,0,248,42,206,155,140,15,1
2021,Tameside 018A,E01006011,695,276,105,171,1,1,350,90,260,65,50,15,3
2021,Tameside 017C,E01006012,798,511,263,248,2,2,100,32,68,180,164,16,5
2021,Tameside 018B,E01006013,569,398,232,166,3,3,86,34,52,82,66,16,0
2021,Tameside 018C,E01006014,480,286,130,156,0,0,144,55,89,50,44,6,0
2021,Tameside 017D,E01006015,521,464,221,243,1,1,21,5,16,35,33,2,0
2021,Tameside 017E,E01006016,1038,256,133,123,0,0,560,163,397,220,204,16,2
2021,Tameside 016B,E01006017,549,509,286,223,0,0,7,3,4,33,25,8,0
2021,Tameside 016C,E01006018,562,518,315,203,1,1,8,4,4,35,27,8,0
2021,Tameside 018D,E01006019,813,281,143,138,0,0,458,149,309,72,63,9,2
2021,Tameside 018E,E01006020,628,418,200,218,2,2,147,51,96,61,52,9,0
2021,Tameside 016D,E01006021,605,440,274,166,0,0,36,9,27,128,113,15,1
2021,Tameside 015A,E01006022,1040,444,228,216,17,17,205,23,182,373,329,44,1
2021,Tameside 015B,E01006023,802,285,133,152,4,4,365,128,237,146,126,20,2
2021,Tameside 022A,E01006024,688,635,321,314,11,11,8,4,4,34,23,11,0
2021,Tameside 027A,E01006025,781,394,131,263,0,0,312,91,221,73,68,5,2
2021,Tameside 022B,E01006026,736,451,203,248,0,0,118,19,99,167,148,19,0
2021,Tameside 027B,E01006027,1005,510,144,366,0,0,402,87,315,89,77,12,4
2021,Tameside 028A,E01006028,897,304,142,162,0,0,425,90,335,168,143,25,0
2021,Tameside 028B,E01006029,715,396,155,241,3,3,108,20,88,208,188,20,0
2021,Tameside 028C,E01006030,779,434,176,258,7,7,245,67,178,93,82,11,0
2021,Tameside 020A,E01006031,938,493,138,355,0,0,308,104,204,134,123,11,3
2021,Tameside 020B,E01006032,600,306,138,168,2,2,182,63,119,109,98,11,1
2021,Tameside 020C,E01006033,789,483,183,300,3,3,159,55,104,144,133,11,0
2021,Tameside 020D,E01006034,928,489,171,318,2,2,271,78,193,163,143,20,3
2021,Tameside 020E,E01006035,1012,562,218,344,4,4,256,77,179,189,167,22,1
2021,Tameside 020F,E01006036,947,442,172,270,3,3,300,75,225,202,183,19,0
2021,Tameside 022C,E01006037,651,603,305,298,2,2,6,3,3,40,33,7,0
2021,Tameside 022D,E01006038,663,536,302,234,2,2,58,27,31,67,65,2,0
2021,Tameside 028D,E01006039,453,261,133,128,1,1,68,7,61,123,108,15,0
2021,Tameside 028E,E01006040,631,294,126,168,8,8,87,11,76,241,223,18,1
2021,Tameside 028F,E01006041,700,447,221,226,2,2,42,9,33,209,192,17,0
2021,Tameside 030A,E01006042,812,589,295,294,2,2,62,9,53,159,137,22,0
2021,Tameside 030B,E01006043,606,428,213,215,4,4,82,26,56,92,79,13,0
2021,Tameside 030C,E01006044,654,524,293,231,0,0,78,18,60,52,44,8,0
2021,Tameside 030D,E01006045,533,498,314,184,2,2,10,4,6,23,19,4,0
2021,Tameside 030E,E01006046,627,547,292,255,1,1,9,3,6,70,62,8,0
2021,Tameside 023A,E01006047,592,434,213,221,0,0,74,20,54,84,75,9,0
2021,Tameside 023B,E01006048,758,559,313,246,3,3,73,16,57,123,97,26,0
2021,Tameside 023C,E01006049,764,501,268,233,17,17,92,30,62,154,144,10,0
2021,Tameside 027C,E01006050,785,235,109,126,1,1,438,95,343,111,101,10,0
2021,Tameside 023D,E01006051,724,543,310,233,0,0,91,28,63,90,74,16,0
2021,Tameside 027D,E01006052,658,290,131,159,1,1,298,79,219,67,58,9,2
2021,Tameside 001A,E01006053,848,687,352,335,0,0,29,1,28,132,115,17,0
2021,Tameside 001B,E01006054,808,464,226,238,2,2,257,81,176,83,71,12,2
2021,Tameside 001C,E01006055,690,504,227,277,4,4,45,8,37,137,119,18,0
2021,Tameside 003A,E01006056,503,155,66,89,0,0,302,108,194,45,41,4,1
2021,Tameside 001D,E01006057,675,543,232,311,2,2,19,6,13,111,97,14,0
2021,Tameside 001E,E01006058,1020,569,272,297,0,0,70,13,57,380,349,31,1
2021,Tameside 001F,E01006059,632,484,222,262,2,2,27,8,19,119,108,11,0
2021,Tameside 008A,E01006060,711,274,128,146,2,2,231,71,160,201,171,30,3
2021,Tameside 003B,E01006061,981,535,212,323,1,1,364,100,264,79,66,13,2
2021,Tameside 003C,E01006062,811,710,370,340,0,0,11,2,9,90,68,22,0
2021,Tameside 003D,E01006063,568,498,253,245,3,3,23,6,17,44,32,12,0
2021,Tameside 008B,E01006064,799,273,128,145,9,9,436,171,265,77,66,11,4
2021,Tameside 008C,E01006065,512,217,109,108,1,1,255,75,180,36,30,6,3
2021,Tameside 008D,E01006066,602,347,180,167,4,4,67,25,42,183,155,28,1
2021,Tameside 009A,E01006067,739,637,281,356,0,0,11,4,7,91,77,14,0
2021,Tameside 009B,E01006068,827,350,142,208,3,3,188,27,161,285,268,17,1
2021,Tameside 009C,E01006069,705,365,166,199,0,0,287,92,195,49,40,9,4
2021,Tameside 015C,E01006070,618,476,233,243,0,0,13,3,10,129,114,15,0
2021,Tameside 015D,E01006071,697,634,400,234,0,0,21,1,20,42,33,9,0
2021,Tameside 015E,E01006072,671,622,383,239,1,1,7,1,6,41,34,7,0
2021,Tameside 009D,E01006073,818,407,127,280,3,3,224,92,132,184,173,11,0
2021,Trafford 025A,E01006074,627,365,153,212,9,9,198,90,108,55,46,9,0
2021,Trafford 025B,E01006075,1038,638,340,298,4,4,39,5,34,356,324,32,1
2021,Trafford 025C,E01006076,811,617,401,216,1,1,44,14,30,149,137,12,0
2021,Trafford 027A,E01006077,803,459,235,224,1,1,120,46,74,222,198,24,1
2021,Trafford 024A,E01006078,989,560,204,356,0,0,100,23,77,329,310,19,0
2021,Trafford 025D,E01006079,1051,776,337,439,6,6,51,14,37,218,206,12,0
2021,Trafford 024B,E01006080,826,637,303,334,2,2,40,16,24,146,134,12,1
2021,Trafford 027B,E01006081,503,475,260,215,0,0,9,5,4,19,15,4,0
2021,Trafford 027C,E01006082,673,547,340,207,0,0,12,5,7,114,98,16,0
2021,Trafford 026A,E01006083,482,438,242,196,1,1,2,0,2,41,32,9,0
2021,Trafford 026B,E01006084,636,553,264,289,1,1,9,0,9,73,65,8,0
2021,Trafford 027D,E01006085,626,507,258,249,10,10,20,5,15,89,70,19,0
2021,Trafford 027E,E01006086,652,470,261,209,3,3,127,34,93,51,44,7,1
2021,Trafford 025E,E01006087,564,403,220,183,6,6,72,12,60,83,57,26,0
2021,Trafford 026C,E01006088,662,492,211,281,6,6,34,8,26,130,119,11,0
2021,Trafford 024C,E01006089,807,560,217,343,2,2,63,25,38,182,165,17,0
2021,Trafford 020A,E01006090,991,636,293,343,31,31,125,10,115,199,187,12,0
2021,Trafford 019A,E01006091,1157,840,299,541,24,24,60,21,39,233,208,25,0
2021,Trafford 019B,E01006092,502,208,72,136,2,2,249,91,158,43,43,0,0
2021,Trafford 023A,E01006093,619,513,237,276,17,17,23,5,18,66,61,5,0
2021,Trafford 020B,E01006094,594,537,296,241,0,0,10,1,9,47,40,7,0
2021,Trafford 019C,E01006095,684,606,293,313,7,7,4,1,3,67,57,10,0
2021,Trafford 020C,E01006096,574,488,226,262,1,1,5,1,4,80,71,9,0
2021,Trafford 015A,E01006097,822,547,329,218,1,1,28,12,16,246,228,18,0
2021,Trafford 014A,E01006098,511,466,259,207,1,1,6,1,5,38,34,4,0
2021,Trafford 014B,E01006099,549,441,207,234,0,0,22,5,17,85,76,9,1
2021,Trafford 020D,E01006100,601,462,237,225,1,1,67,19,48,71,61,10,0
2021,Trafford 021A,E01006101,547,520,284,236,0,0,2,0,2,25,24,1,0
2021,Trafford 018A,E01006102,572,426,204,222,0,0,96,40,56,49,39,10,1
2021,Trafford 020E,E01006103,602,549,267,282,0,0,2,1,1,51,43,8,0
2021,Trafford 017A,E01006104,747,550,297,253,25,25,65,14,51,106,94,12,1
2021,Trafford 017B,E01006105,675,243,120,123,1,1,362,47,315,68,60,8,1
2021,Trafford 017C,E01006106,599,389,201,188,2,2,134,19,115,74,68,6,0
2021,Trafford 017D,E01006107,699,380,175,205,10,10,217,66,151,90,76,14,2
2021,Trafford 017E,E01006108,624,143,74,69,1,1,438,51,387,42,39,3,0
2021,Trafford 001A,E01006109,533,70,39,31,8,8,390,118,272,61,53,8,4
2021,Trafford 001B,E01006110,656,398,202,196,2,2,123,10,113,131,124,7,2
2021,Trafford 001C,E01006111,555,173,102,71,2,2,270,43,227,108,94,14,2
2021,Trafford 001D,E01006112,700,245,134,111,7,7,322,101,221,121,107,14,5
2021,Trafford 004A,E01006113,472,380,209,171,1,1,12,7,5,79,62,17,0
2021,Trafford 004B,E01006114,568,317,164,153,7,7,175,41,134,69,61,8,0
2021,Trafford 004C,E01006115,591,367,186,181,4,4,138,17,121,82,74,8,0
2021,Trafford 002A,E01006116,537,466,211,255,1,1,12,1,11,58,52,6,0
2021,Trafford 002B,E01006117,639,580,304,276,1,1,31,18,13,27,22,5,0
2021,Trafford 002C,E01006118,669,405,196,209,24,24,178,76,102,59,52,7,3
2021,Trafford 002D,E01006119,630,560,292,268,1,1,24,13,11,45,42,3,0
2021,Trafford 010A,E01006120,559,507,274,233,1,1,5,2,3,46,36,10,0
2021,Trafford 002E,E01006121,597,478,259,219,2,2,28,18,10,89,70,19,0
2021,Trafford 005A,E01006122,743,652,353,299,2,2,41,12,29,48,43,5,0
2021,Trafford 005B,E01006123,650,547,290,257,1,1,32,17,15,70,51,19,0
2021,Trafford 005C,E01006124,613,570,337,233,1,1,17,3,14,25,20,5,0
2021,Trafford 007A,E01006125,606,496,264,232,7,7,71,34,37,32,28,4,0
2021,Trafford 007B,E01006126,747,419,174,245,21,21,244,111,133,60,46,14,3
2021,Trafford 007C,E01006127,619,528,276,252,6,6,42,21,21,43,35,8,0
2021,Trafford 005D,E01006128,785,641,330,311,14,14,46,10,36,84,73,11,0
2021,Trafford 010B,E01006129,637,402,210,192,1,1,182,63,119,52,43,9,0
2021,Trafford 007D,E01006130,739,604,293,311,14,14,68,32,36,53,50,3,0
2021,Trafford 005E,E01006131,623,522,275,247,0,0,41,16,25,60,51,9,0
2021,Trafford 007E,E01006132,672,500,232,268,0,0,107,24,83,65,56,9,0
2021,Trafford 010C,E01006133,650,604,383,221,3,3,7,1,6,36,24,12,0
2021,Trafford 028A,E01006134,527,489,270,219,0,0,2,0,2,35,27,8,1
2021,Trafford 028B,E01006135,651,561,347,214,1,1,26,9,17,63,53,10,0
2021,Trafford 028C,E01006136,619,544,288,256,0,0,11,1,10,64,57,7,0
2021,Trafford 028D,E01006137,481,420,232,188,2,2,7,2,5,52,43,9,0
2021,Trafford 028E,E01006138,782,543,288,255,0,0,156,51,105,81,66,15,2
2021,Trafford 026D,E01006139,719,571,273,298,1,1,16,5,11,131,116,15,0
2021,Trafford 026E,E01006140,628,500,232,268,1,1,54,18,36,73,66,7,0
2021,Trafford 003A,E01006141,647,450,176,274,8,8,108,42,66,81,67,14,0
2021,Trafford 011A,E01006142,752,505,284,221,3,3,163,56,107,80,70,10,1
2021,Trafford 011B,E01006143,696,502,265,237,6,6,52,8,44,136,130,6,0
2021,Trafford 011C,E01006144,692,246,104,142,2,2,310,97,213,133,128,5,1
2021,Trafford 004D,E01006145,806,318,148,170,1,1,312,123,189,172,153,19,3
2021,Trafford 004E,E01006146,645,519,268,251,4,4,35,12,23,87,75,12,0
2021,Trafford 012A,E01006147,528,481,235,246,1,1,5,1,4,41,35,6,0
2021,Trafford 016A,E01006148,684,518,290,228,0,0,28,2,26,138,130,8,0
2021,Trafford 012B,E01006149,687,441,196,245,24,24,132,48,84,88,81,7,2
2021,Trafford 012C,E01006150,865,530,297,233,5,5,75,8,67,255,246,9,0
2021,Trafford 016B,E01006151,566,515,274,241,2,2,9,2,7,40,37,3,0
2021,Trafford 016C,E01006152,619,577,350,227,1,1,6,0,6,35,32,3,0
2021,Trafford 016D,E01006153,627,551,335,216,3,3,31,15,16,41,35,6,1
2021,Trafford 012D,E01006154,659,509,198,311,0,0,20,7,13,130,110,20,0
2021,Trafford 006A,E01006155,717,575,248,327,6,6,14,8,6,122,109,13,0
2021,Trafford 008A,E01006156,694,432,234,198,18,18,176,29,147,68,59,9,0
2021,Trafford 006B,E01006157,656,490,220,270,26,26,71,6,65,69,59,10,0
2021,Trafford 008B,E01006158,789,414,171,243,5,5,282,118,164,87,71,16,1
2021,Trafford 006C,E01006159,706,386,155,231,0,0,258,103,155,62,48,14,0
2021,Trafford 015B,E01006160,1088,454,230,224,9,9,219,65,154,405,382,23,1
2021,Trafford 015C,E01006161,944,583,284,299,17,17,34,6,28,310,289,21,0
2021,Trafford 015D,E01006162,675,514,252,262,1,1,7,2,5,153,144,9,0
2021,Trafford 015E,E01006163,815,530,200,330,2,2,10,1,9,273,258,15,0
2021,Trafford 014C,E01006164,726,572,295,277,2,2,82,10,72,70,61,9,0
2021,Trafford 012E,E01006165,914,528,209,319,1,1,119,38,81,266,244,22,0
2021,Trafford 013A,E01006166,681,446,212,234,5,5,153,35,118,75,69,6,2
2021,Trafford 019D,E01006167,722,216,93,123,13,13,456,46,410,37,26,11,0
2021,Trafford 019E,E01006168,734,181,82,99,14,14,457,53,404,82,69,13,0
2021,Trafford 013B,E01006169,667,550,305,245,1,1,50,23,27,66,55,11,0
2021,Trafford 013C,E01006170,677,519,260,259,1,1,107,39,68,50,44,6,0
2021,Trafford 013D,E01006171,766,376,165,211,4,4,288,42,246,97,85,12,1
2021,Trafford 016E,E01006172,648,539,329,210,0,0,77,34,43,31,24,7,1
2021,Trafford 018B,E01006173,607,537,259,278,0,0,17,4,13,53,48,5,0
2021,Trafford 014D,E01006174,814,576,301,275,0,0,39,11,28,199,184,15,0
2021,Trafford 018C,E01006175,744,314,118,196,1,1,368,175,193,59,49,10,2
2021,Trafford 018D,E01006176,724,555,286,269,3,3,63,27,36,103,93,10,0
2021,Trafford 018E,E01006177,601,303,124,179,6,6,245,124,121,45,36,9,2
2021,Trafford 014E,E01006178,769,605,287,318,1,1,46,16,30,117,108,9,0
2021,Trafford 008C,E01006179,849,422,195,227,0,0,311,102,209,115,108,7,1
2021,Trafford 011D,E01006180,784,494,187,307,2,2,72,18,54,216,201,15,0
2021,Trafford 011E,E01006181,653,458,196,262,3,3,104,28,76,87,72,15,1
2021,Trafford 006D,E01006182,586,521,249,272,2,2,10,3,7,53,47,6,0
2021,Trafford 006E,E01006183,635,531,258,273,1,1,32,10,22,71,59,12,0
2021,Trafford 008D,E01006184,754,460,247,213,14,14,207,39,168,73,68,5,0
2021,Trafford 003B,E01006186,947,435,178,257,3,3,141,44,97,368,344,24,0
2021,Trafford 003C,E01006187,1140,630,234,396,1,1,167,54,113,341,319,22,1
2021,Trafford 001F,E01006188,784,320,171,149,3,3,101,12,89,360,340,20,0
2021,Trafford 003D,E01006189,931,602,250,352,2,2,154,49,105,173,155,18,0
2021,Trafford 021B,E01006190,642,592,328,264,0,0,5,2,3,45,38,7,0
2021,Trafford 023B,E01006191,643,574,312,262,1,1,13,2,11,55,45,10,0
2021,Trafford 023C,E01006192,623,566,321,245,0,0,13,5,8,44,37,7,0
2021,Trafford 024D,E01006193,619,537,289,248,1,1,15,5,10,66,59,7,0
2021,Trafford 024E,E01006194,980,597,243,354,4,4,115,44,71,264,247,17,0
2021,Trafford 021C,E01006195,665,613,316,297,0,0,3,0,3,49,39,10,0
2021,Trafford 021D,E01006196,680,626,282,344,1,1,5,1,4,48,46,2,0
2021,Trafford 010D,E01006197,596,474,226,248,23,23,32,10,22,66,63,3,1
2021,Trafford 009A,E01006198,701,441,233,208,1,1,129,26,103,130,117,13,0
2021,Trafford 009B,E01006199,745,410,172,238,6,6,177,47,130,152,134,18,0
2021,Trafford 009C,E01006200,683,426,224,202,0,0,174,52,122,81,70,11,2
2021,Trafford 009D,E01006201,653,431,159,272,18,18,78,18,60,125,115,10,1
2021,Trafford 009E,E01006202,607,393,216,177,3,3,45,3,42,166,158,8,0
2021,Trafford 010E,E01006203,518,471,242,229,4,4,9,0,9,34,28,6,0
2021,Trafford 022A,E01006204,704,566,359,207,0,0,61,9,52,77,60,17,0
2021,Trafford 023D,E01006205,549,489,285,204,0,0,26,1,25,34,30,4,0
2021,Trafford 022B,E01006206,752,477,235,242,10,10,196,65,131,69,58,11,0
2021,Trafford 022C,E01006207,779,257,117,140,13,13,414,108,306,92,80,12,3
2021,Trafford 022D,E01006208,624,416,228,188,2,2,161,33,128,42,38,4,3
2021,Trafford 023E,E01006209,636,593,350,243,1,1,12,6,6,30,27,3,0
2021,Trafford 021E,E01006210,633,506,253,253,0,0,74,11,63,53,45,8,0
2021,Trafford 022E,E01006211,656,400,181,219,0,0,196,70,126,60,45,15,0
2021,Wigan 026A,E01006212,582,475,280,195,0,0,48,29,19,58,39,19,1
2021,Wigan 024A,E01006213,704,269,130,139,1,1,229,163,66,202,179,23,3
2021,Wigan 026B,E01006214,609,359,182,177,1,1,80,75,5,169,153,16,0
2021,Wigan 024B,E01006215,759,324,160,164,3,3,262,219,43,166,144,22,4
2021,Wigan 026C,E01006216,873,664,293,371,3,3,70,60,10,135,119,16,1
2021,Wigan 024C,E01006217,931,573,220,353,0,0,216,150,66,141,129,12,1
2021,Wigan 024D,E01006218,998,560,213,347,1,1,102,52,50,332,312,20,3
2021,Wigan 024E,E01006219,524,430,267,163,2,2,2,1,1,90,83,7,0
2021,Wigan 035A,E01006220,763,412,201,211,1,1,240,230,10,107,86,21,3
2021,Wigan 035B,E01006221,692,535,310,225,1,1,5,0,5,151,134,17,0
2021,Wigan 035C,E01006222,634,578,325,253,3,3,2,2,0,51,42,9,0
2021,Wigan 036A,E01006223,759,521,268,253,1,1,15,5,10,221,202,19,1
2021,Wigan 035D,E01006224,499,451,182,269,4,4,2,2,0,41,32,9,1
2021,Wigan 036B,E01006225,639,537,312,225,0,0,38,36,2,63,51,12,1
2021,Wigan 035E,E01006226,755,599,338,261,2,2,33,30,3,121,105,16,0
2021,Wigan 038A,E01006227,632,517,268,249,2,2,39,38,1,73,66,7,1
2021,Wigan 038B,E01006228,745,465,234,231,1,1,54,29,25,225,206,19,0
2021,Wigan 002A,E01006229,649,530,357,173,0,0,5,4,1,114,95,19,0
2021,Wigan 002B,E01006230,860,754,344,410,0,0,56,43,13,50,42,8,0
2021,Wigan 004A,E01006231,640,553,344,209,0,0,27,26,1,60,42,18,0
2021,Wigan 004B,E01006232,811,672,340,332,1,1,16,9,7,121,113,8,1
2021,Wigan 002C,E01006233,564,540,313,227,1,1,1,0,1,22,17,5,0
2021,Wigan 004C,E01006234,533,411,285,126,1,1,78,77,1,43,35,8,0
2021,Wigan 004D,E01006235,706,321,158,163,0,0,315,276,39,62,50,12,8
2021,Wigan 007A,E01006236,695,622,392,230,1,1,10,3,7,62,53,9,0
2021,Wigan 002D,E01006237,798,708,319,389,10,10,22,18,4,58,45,13,0
2021,Wigan 002E,E01006238,746,345,175,170,1,1,264,237,27,130,120,10,6
2021,Wigan 017A,E01006239,1002,341,159,182,3,3,525,500,25,121,111,10,12
2021,Wigan 017B,E01006240,604,196,95,101,0,0,349,342,7,57,55,2,2
2021,Wigan 017C,E01006241,979,571,171,400,5,5,255,241,14,141,127,14,7
2021,Wigan 023A,E01006242,870,601,317,284,3,3,69,49,20,197,176,21,0
2021,Wigan 023B,E01006243,909,720,327,393,0,0,18,13,5,171,145,26,0
2021,Wigan 023C,E01006244,890,442,244,198,5,5,165,92,73,275,246,29,3
2021,Wigan 023D,E01006245,1161,811,330,481,7,7,101,96,5,241,228,13,1
2021,Wigan 034A,E01006246,716,467,272,195,7,7,163,153,10,75,62,13,4
2021,Wigan 034B,E01006247,552,466,278,188,0,0,31,29,2,55,33,22,0
2021,Wigan 031A,E01006248,1022,465,109,356,0,0,509,481,28,44,40,4,4
2021,Wigan 031B,E01006249,664,367,191,176,1,1,229,218,11,65,55,10,2
2021,Wigan 029A,E01006250,913,775,359,416,34,34,11,4,7,93,82,11,0
2021,Wigan 029B,E01006251,654,567,278,289,3,3,9,5,4,75,69,6,0
2021,Wigan 034C,E01006252,625,533,313,220,0,0,7,1,6,85,73,12,0
2021,Wigan 005A,E01006253,674,387,231,156,2,2,189,167,22,87,69,18,9
2021,Wigan 005B,E01006254,612,218,96,122,2,2,336,324,12,47,37,10,9
2021,Wigan 005C,E01006255,664,567,330,237,1,1,6,1,5,89,77,12,1
2021,Wigan 005D,E01006256,745,440,217,223,0,0,61,28,33,241,220,21,3
2021,Wigan 008A,E01006257,534,390,220,170,1,1,4,2,2,139,119,20,0
2021,Wigan 008B,E01006258,710,504,291,213,0,0,57,14,43,149,123,26,0
2021,Wigan 003A,E01006259,554,436,246,190,1,1,47,45,2,70,64,6,0
2021,Wigan 005E,E01006260,637,332,175,157,0,0,240,218,22,61,52,9,4
2021,Wigan 036C,E01006261,650,439,243,196,3,3,128,125,3,79,66,13,1
2021,Wigan 032A,E01006262,702,365,144,221,1,1,239,235,4,93,76,17,4
2021,Wigan 032B,E01006263,641,596,401,195,4,4,9,4,5,32,23,9,0
2021,Wigan 036D,E01006264,514,490,313,177,0,0,2,2,0,21,16,5,1
2021,Wigan 036E,E01006265,622,462,278,184,1,1,37,25,12,122,112,10,0
2021,Wigan 032C,E01006266,626,565,388,177,0,0,7,3,4,54,37,17,0
2021,Wigan 032D,E01006267,728,257,125,132,1,1,403,395,8,57,51,6,10
2021,Wigan 032E,E01006268,700,480,245,235,0,0,77,70,7,140,130,10,3
2021,Wigan 013A,E01006269,818,473,267,206,3,3,218,199,19,121,100,21,3
2021,Wigan 016A,E01006270,634,303,180,123,1,1,278,268,10,48,42,6,4
2021,Wigan 013B,E01006271,747,588,315,273,2,2,35,17,18,122,100,22,0
2021,Wigan 013C,E01006272,763,450,191,259,3,3,92,73,19,218,199,19,0
2021,Wigan 013D,E01006273,656,391,225,166,0,0,165,154,11,98,85,13,2
2021,Wigan 016B,E01006274,671,312,139,173,0,0,217,147,70,141,126,15,1
2021,Wigan 016C,E01006275,682,250,118,132,0,0,342,292,50,85,76,9,5
2021,Wigan 013E,E01006276,893,711,314,397,1,1,26,17,9,155,135,20,0
2021,Wigan 016D,E01006277,676,590,251,339,0,0,50,47,3,36,35,1,0
2021,Wigan 019A,E01006278,743,544,329,215,1,1,98,93,5,100,81,19,0
2021,Wigan 019B,E01006279,639,564,271,293,2,2,5,3,2,68,59,9,0
2021,Wigan 019C,E01006280,639,458,277,181,4,4,104,97,7,73,63,10,0
2021,Wigan 019D,E01006281,794,690,334,356,0,0,7,5,2,97,89,8,0
2021,Wigan 027A,E01006282,749,504,251,253,2,2,134,129,5,109,100,9,0
2021,Wigan 027B,E01006283,719,355,162,193,1,1,215,203,12,143,128,15,5
2021,Wigan 027C,E01006284,673,375,184,191,0,0,193,189,4,103,86,17,2
2021,Wigan 019E,E01006285,825,758,412,346,1,1,21,4,17,45,39,6,0
2021,Wigan 016E,E01006286,701,543,364,179,3,3,105,72,33,47,32,15,3
2021,Wigan 017D,E01006287,482,447,285,162,1,1,3,2,1,31,24,7,0
2021,Wigan 025A,E01006288,759,275,147,128,10,10,392,379,13,79,65,14,3
2021,Wigan 017E,E01006289,807,272,131,141,1,1,434,421,13,90,81,9,10
2021,Wigan 022A,E01006290,625,536,320,216,1,1,5,4,1,81,65,16,2
2021,Wigan 022B,E01006291,687,425,200,225,2,2,105,77,28,149,129,20,6
2021,Wigan 022C,E01006292,649,518,328,190,5,5,32,30,2,94,89,5,0
2021,Wigan 022D,E01006293,753,425,204,221,9,9,192,180,12,122,110,12,5
2021,Wigan 025B,E01006294,911,495,216,279,0,0,53,38,15,363,322,41,0
2021,Wigan 025C,E01006295,800,422,194,228,2,2,155,120,35,217,193,24,4
2021,Wigan 037A,E01006296,686,259,111,148,0,0,306,279,27,112,99,13,9
2021,Wigan 034D,E01006297,739,277,142,135,11,11,292,279,13,157,143,14,2
2021,Wigan 037B,E01006298,681,256,109,147,15,15,288,163,125,122,102,20,0
2021,Wigan 037C,E01006299,873,684,331,353,3,3,13,10,3,173,157,16,0
2021,Wigan 037D,E01006300,607,558,359,199,0,0,19,19,0,30,24,6,0
2021,Wigan 037E,E01006301,588,540,304,236,0,0,7,6,1,41,32,9,0
2021,Wigan 040A,E01006302,777,640,278,362,1,1,29,3,26,107,90,17,0
2021,Wigan 040B,E01006303,705,618,324,294,0,0,10,4,6,77,70,7,0
2021,Wigan 040C,E01006304,658,503,285,218,4,4,73,68,5,77,61,16,1
2021,Wigan 012A,E01006305,676,253,146,107,1,1,356,338,18,59,50,9,7
2021,Wigan 009A,E01006306,828,208,114,94,0,0,401,355,46,210,192,18,9
2021,Wigan 009B,E01006307,612,310,164,146,2,2,189,126,63,111,88,23,0
2021,Wigan 012B,E01006308,700,318,160,158,1,1,173,133,40,207,182,25,1
2021,Wigan 012C,E01006309,645,308,157,151,1,1,197,120,77,137,126,11,2
2021,Wigan 012D,E01006310,711,307,136,171,3,3,229,189,40,171,155,16,1
2021,Wigan 012E,E01006311,634,345,174,171,1,1,210,197,13,75,64,11,3
2021,Wigan 003B,E01006312,623,559,351,208,0,0,3,3,0,61,48,13,0
2021,Wigan 003C,E01006313,590,348,130,218,0,0,167,131,36,71,62,9,4
2021,Wigan 003D,E01006314,794,679,428,251,2,2,10,10,0,103,85,18,0
2021,Wigan 001A,E01006315,649,556,279,277,26,26,12,9,3,55,48,7,0
2021,Wigan 001B,E01006316,842,745,335,410,9,9,16,12,4,71,58,13,1
2021,Wigan 001C,E01006317,727,533,294,239,11,11,109,60,49,74,61,13,0
2021,Wigan 003E,E01006318,634,586,407,179,1,1,3,2,1,44,39,5,0
2021,Wigan 001D,E01006319,584,483,181,302,0,0,28,18,10,73,66,7,0
2021,Wigan 003F,E01006320,563,520,311,209,0,0,2,2,0,41,35,6,0
2021,Wigan 003G,E01006321,688,625,344,281,1,1,5,4,1,56,45,11,1
2021,Wigan 026D,E01006322,875,455,189,266,31,31,150,111,39,237,223,14,2
2021,Wigan 033A,E01006323,640,346,179,167,1,1,72,15,57,220,205,15,1
2021,Wigan 033B,E01006324,630,347,197,150,3,3,156,67,89,123,114,9,1
2021,Wigan 033C,E01006325,634,487,274,213,0,0,33,22,11,114,104,10,0
2021,Wigan 033D,E01006326,696,376,210,166,5,5,59,16,43,255,220,35,1
2021,Wigan 033E,E01006327,1055,543,146,397,31,31,350,295,55,128,115,13,3
2021,Wigan 030A,E01006328,705,313,162,151,5,5,48,29,19,339,313,26,0
2021,Wigan 026E,E01006329,487,276,150,126,0,0,109,101,8,100,89,11,2
2021,Wigan 031C,E01006330,670,577,355,222,16,16,10,6,4,67,58,9,0
2021,Wigan 031D,E01006331,641,603,338,265,2,2,6,2,4,30,26,4,0
2021,Wigan 031E,E01006332,909,582,225,357,2,2,54,9,45,271,249,22,0
2021,Wigan 030B,E01006333,1014,440,219,221,6,6,109,19,90,457,424,33,2
2021,Wigan 030C,E01006334,994,393,227,166,3,3,66,7,59,531,492,39,1
2021,Wigan 034E,E01006335,767,409,216,193,3,3,76,38,38,278,258,20,1
2021,Wigan 027D,E01006336,700,159,83,76,0,0,465,396,69,73,63,10,3
2021,Wigan 027E,E01006337,668,482,264,218,0,0,105,63,42,81,68,13,0
2021,Wigan 030D,E01006338,785,441,225,216,3,3,112,100,12,227,206,21,2
2021,Wigan 039A,E01006339,579,525,337,188,1,1,15,14,1,38,31,7,0
2021,Wigan 039B,E01006340,823,507,177,330,27,27,183,148,35,103,89,14,3
2021,Wigan 040D,E01006341,756,358,152,206,14,14,252,184,68,126,111,15,6
2021,Wigan 038C,E01006342,709,372,190,182,0,0,219,205,14,116,101,15,2
2021,Wigan 039C,E01006343,643,563,275,288,9,9,2,0,2,69,63,6,0
2021,Wigan 038D,E01006344,574,267,137,130,3,3,247,239,8,54,45,9,3
2021,Wigan 039D,E01006345,675,591,331,260,0,0,16,13,3,68,59,9,0
2021,Wigan 038E,E01006346,944,574,279,295,4,4,113,50,63,252,223,29,1
2021,Wigan 040E,E01006347,646,594,370,224,4,4,4,3,1,44,36,8,0
2021,Wigan 039E,E01006348,1121,947,394,553,26,26,69,31,38,77,56,21,2
2021,Wigan 015A,E01006349,1013,524,220,304,5,5,91,27,64,392,370,22,1
2021,Wigan 010A,E01006350,739,237,91,146,0,0,422,411,11,75,72,3,5
2021,Wigan 010B,E01006351,870,171,68,103,1,1,554,543,11,133,126,7,11
2021,Wigan 015B,E01006352,868,506,209,297,1,1,110,69,41,250,232,18,1
2021,Wigan 014A,E01006353,663,491,272,219,2,2,36,27,9,134,123,11,0
2021,Wigan 014B,E01006354,629,332,176,156,3,3,169,114,55,123,108,15,2
2021,Wigan 014C,E01006355,695,491,276,215,4,4,12,1,11,187,168,19,1
2021,Wigan 011A,E01006356,573,298,143,155,1,1,217,210,7,54,47,7,3
2021,Wigan 010C,E01006357,643,162,72,90,0,0,415,385,30,59,48,11,7
2021,Wigan 014D,E01006358,923,535,249,286,8,8,177,150,27,202,177,25,1
2021,Wigan 014E,E01006359,595,364,185,179,0,0,134,103,31,92,77,15,5
2021,Wigan 010D,E01006360,691,192,94,98,0,0,431,418,13,61,54,7,7
2021,Wigan 010E,E01006361,661,225,110,115,0,0,331,313,18,100,85,15,5
2021,Wigan 018A,E01006362,731,637,374,263,0,0,8,4,4,86,69,17,0
2021,Wigan 018B,E01006363,712,663,432,231,2,2,7,3,4,40,30,10,0
2021,Wigan 018C,E01006364,827,530,244,286,1,1,204,198,6,90,79,11,2
2021,Wigan 018D,E01006365,871,750,344,406,1,1,15,13,2,104,91,13,1
2021,Wigan 018E,E01006366,868,602,315,287,8,8,169,160,9,88,74,14,1
2021,Wigan 018F,E01006367,772,698,366,332,1,1,11,10,1,62,51,11,0
2021,Wigan 018G,E01006368,823,665,355,310,2,2,47,43,4,109,86,23,0
2021,Wigan 008C,E01006369,1042,363,180,183,2,2,274,70,204,397,377,20,6
2021,Wigan 006A,E01006370,948,385,198,187,4,4,102,38,64,457,426,31,0
2021,Wigan 008D,E01006371,651,504,254,250,0,0,4,2,2,140,119,21,3
2021,Wigan 006B,E01006372,660,602,381,221,1,1,1,1,0,56,49,7,0
2021,Wigan 006C,E01006373,633,539,305,234,1,1,9,5,4,84,71,13,0
2021,Wigan 006D,E01006374,676,601,343,258,1,1,10,8,2,64,43,21,0
2021,Wigan 008E,E01006375,742,497,259,238,2,2,19,4,15,224,210,14,0
2021,Wigan 028A,E01006376,730,369,170,199,1,1,258,236,22,97,86,11,5
2021,Wigan 025D,E01006377,659,594,351,243,3,3,9,7,2,53,47,6,0
2021,Wigan 025E,E01006378,592,542,338,204,2,2,4,1,3,44,30,14,0
2021,Wigan 029C,E01006379,688,581,308,273,2,2,12,11,1,93,80,13,0
2021,Wigan 029D,E01006380,1152,699,171,528,61,61,294,283,11,94,69,25,4
2021,Wigan 028B,E01006381,772,657,260,397,5,5,8,7,1,102,91,11,0
2021,Wigan 028C,E01006382,512,489,278,211,1,1,2,0,2,20,18,2,0
2021,Wigan 028D,E01006383,624,499,236,263,4,4,73,71,2,46,36,10,2
2021,Wigan 028E,E01006384,586,489,266,223,2,2,9,2,7,86,77,9,0
2021,Wigan 029E,E01006385,602,549,329,220,2,2,3,3,0,48,39,9,0
2021,Wigan 009C,E01006386,932,114,71,43,3,3,696,574,122,99,92,7,20
2021,Wigan 009D,E01006387,573,361,192,169,1,1,70,46,24,141,130,11,0
2021,Wigan 007B,E01006388,808,496,213,283,0,0,218,213,5,92,83,9,2
2021,Wigan 007C,E01006389,507,387,191,196,3,3,62,9,53,54,48,6,1
2021,Wigan 006E,E01006390,771,469,295,174,2,2,189,117,72,109,89,20,2
2021,Wigan 007D,E01006391,665,570,382,188,3,3,38,10,28,54,41,13,0
2021,Wigan 009E,E01006392,599,183,81,102,3,3,314,282,32,95,85,10,4
2021,Wigan 021A,E01006393,606,528,280,248,0,0,9,2,7,69,56,13,0
2021,Wigan 021B,E01006394,645,601,363,238,1,1,4,3,1,39,28,11,0
2021,Wigan 021C,E01006395,927,877,312,565,3,3,3,1,2,44,39,5,0
2021,Wigan 011B,E01006396,600,497,265,232,1,1,27,25,2,75,64,11,0
2021,Wigan 011C,E01006397,567,261,148,113,1,1,237,174,63,64,55,9,4
2021,Wigan 011D,E01006398,488,258,125,133,0,0,138,135,3,86,74,12,6
2021,Wigan 011E,E01006399,700,436,202,234,0,0,106,53,53,155,136,19,3
2021,Wigan 021D,E01006400,729,659,248,411,0,0,24,19,5,46,37,9,0
2021,Wigan 021E,E01006401,560,525,271,254,0,0,3,0,3,32,24,8,0
2021,Wigan 021F,E01006402,471,452,268,184,1,1,2,2,0,16,12,4,0
2021,Wigan 021G,E01006403,676,621,363,258,3,3,4,2,2,48,37,11,0
2021,Wigan 015C,E01006404,733,390,151,239,0,0,192,166,26,151,130,21,0
2021,Wigan 015D,E01006405,790,432,199,233,6,6,236,133,103,112,100,12,4
2021,Wigan 020A,E01006406,619,520,326,194,2,2,35,31,4,62,50,12,0
2021,Wigan 020B,E01006407,594,538,288,250,1,1,2,1,1,53,43,10,0
2021,Wigan 020C,E01006408,704,392,166,226,2,2,224,189,35,80,70,10,6
2021,Wigan 020D,E01006409,575,523,341,182,3,3,4,3,1,45,26,19,0
2021,Wigan 020E,E01006410,533,488,316,172,2,2,13,2,11,30,23,7,0
2021,Wigan 015E,E01006411,670,169,76,93,1,1,396,264,132,101,94,7,3
2021,Knowsley 006A,E01006412,621,187,113,74,0,0,362,50,312,72,61,11,0
2021,Knowsley 006B,E01006413,814,100,63,37,2,2,651,96,555,61,54,7,0
2021,Knowsley 006C,E01006414,618,235,146,89,1,1,307,39,268,75,72,3,0
2021,Knowsley 003A,E01006415,778,468,204,264,1,1,189,87,102,120,103,17,0
2021,Knowsley 005A,E01006416,680,274,146,128,2,2,267,124,143,132,113,19,5
2021,Knowsley 003B,E01006417,566,233,110,123,3,3,257,94,163,73,69,4,0
2021,Knowsley 005B,E01006418,567,266,139,127,2,2,227,75,152,71,63,8,1
2021,Knowsley 019A,E01006419,622,524,266,258,5,5,14,5,9,79,68,11,0
2021,Knowsley 017A,E01006420,908,782,317,465,12,12,17,7,10,97,82,15,0
2021,Knowsley 018A,E01006421,438,385,191,194,5,5,9,0,9,39,32,7,0
2021,Knowsley 019B,E01006422,558,469,278,191,0,0,50,10,40,39,31,8,0
2021,Knowsley 019C,E01006423,529,456,222,234,4,4,11,4,7,58,49,9,0
2021,Knowsley 017B,E01006424,796,711,374,337,0,0,9,4,5,76,63,13,0
2021,Knowsley 018B,E01006425,554,395,203,192,3,3,98,40,58,58,51,7,0
2021,Knowsley 020A,E01006426,625,251,107,144,4,4,312,116,196,58,50,8,0
2021,Knowsley 019D,E01006427,627,501,289,212,43,43,38,11,27,45,35,10,0
2021,Knowsley 020B,E01006428,642,367,162,205,1,1,192,97,95,81,72,9,1
2021,Knowsley 020C,E01006429,480,207,111,96,0,0,224,98,126,49,34,15,0
2021,Knowsley 018C,E01006430,692,238,106,132,27,27,367,118,249,60,56,4,0
2021,Knowsley 020D,E01006431,842,547,260,287,12,12,149,79,70,131,117,14,3
2021,Knowsley 020E,E01006432,670,334,170,164,0,0,251,117,134,84,81,3,1
2021,Knowsley 018D,E01006433,702,427,238,189,9,9,161,70,91,105,97,8,0
2021,Knowsley 005C,E01006434,651,299,131,168,0,0,217,115,102,134,125,9,1
2021,Knowsley 005D,E01006435,665,354,213,141,6,6,233,80,153,72,56,16,0
2021,Knowsley 003C,E01006436,647,235,144,91,2,2,302,134,168,106,98,8,2
2021,Knowsley 003D,E01006437,685,258,136,122,3,3,317,103,214,107,103,4,0
2021,Knowsley 005E,E01006438,490,389,232,157,1,1,42,22,20,57,47,10,1
2021,Knowsley 005F,E01006439,694,438,201,237,0,0,131,62,69,123,88,35,2
2021,Knowsley 010A,E01006440,595,238,116,122,17,17,217,119,98,122,117,5,1
2021,Knowsley 010B,E01006442,715,215,86,129,19,19,429,231,198,51,45,6,1
2021,Knowsley 010C,E01006443,707,242,130,112,4,4,363,155,208,95,87,8,3
2021,Knowsley 010D,E01006444,495,172,79,93,0,0,263,142,121,59,57,2,1
2021,Knowsley 010E,E01006445,530,200,100,100,0,0,249,136,113,81,74,7,0
2021,Knowsley 005G,E01006446,593,294,164,130,0,0,202,86,116,96,87,9,1
2021,Knowsley 003E,E01006447,666,207,103,104,1,1,249,135,114,205,193,12,4
2021,Knowsley 001A,E01006448,854,275,131,144,9,9,385,182,203,183,166,17,2
2021,Knowsley 012A,E01006449,664,413,205,208,21,21,124,62,62,103,87,16,3
2021,Knowsley 012B,E01006450,759,434,144,290,18,18,214,94,120,91,84,7,2
2021,Knowsley 012C,E01006451,599,358,191,167,0,0,142,43,99,99,92,7,0
2021,Knowsley 012D,E01006452,621,406,201,205,1,1,34,11,23,180,162,18,0
2021,Knowsley 008A,E01006453,517,178,90,88,0,0,285,144,141,53,46,7,1
2021,Knowsley 002A,E01006454,662,548,269,279,23,23,54,4,50,37,29,8,0
2021,Knowsley 004A,E01006455,755,305,167,138,1,1,249,139,110,196,186,10,4
2021,Knowsley 002B,E01006456,686,469,233,236,11,11,145,61,84,61,51,10,0
2021,Knowsley 002C,E01006457,553,462,301,161,38,38,18,6,12,35,24,11,0
2021,Knowsley 002D,E01006458,660,415,207,208,6,6,125,54,71,113,103,10,1
2021,Knowsley 009A,E01006459,703,462,233,229,1,1,45,19,26,195,171,24,0
2021,Knowsley 007A,E01006460,640,209,106,103,2,2,337,168,169,92,87,5,0
2021,Knowsley 007B,E01006461,590,277,131,146,2,2,226,124,102,84,71,13,1
2021,Knowsley 009B,E01006462,717,551,254,297,8,8,43,14,29,115,103,12,0
2021,Knowsley 007D,E01006464,1185,778,277,501,1,1,220,95,125,186,173,13,0
2021,Knowsley 011A,E01006465,632,545,269,276,1,1,43,7,36,42,37,5,1
2021,Knowsley 007E,E01006466,744,435,215,220,6,6,131,53,78,169,152,17,3
2021,Knowsley 008B,E01006467,561,165,89,76,1,1,334,175,159,58,51,7,3
2021,Knowsley 008E,E01006470,619,255,123,132,1,1,291,129,162,69,59,10,3
2021,Knowsley 016A,E01006471,613,555,309,246,0,0,4,0,4,54,47,7,0
2021,Knowsley 014A,E01006472,615,543,301,242,1,1,21,8,13,49,38,11,1
2021,Knowsley 016B,E01006473,633,579,253,326,9,9,8,5,3,37,28,9,0
2021,Knowsley 016C,E01006474,820,721,325,396,15,15,19,5,14,65,57,8,0
2021,Knowsley 016D,E01006475,547,467,283,184,2,2,31,8,23,47,41,6,0
2021,Knowsley 016E,E01006476,584,539,316,223,3,3,11,1,10,31,23,8,0
2021,Knowsley 015A,E01006477,660,378,180,198,1,1,158,89,69,123,104,19,0
2021,Knowsley 015B,E01006478,797,361,182,179,15,15,282,128,154,138,115,23,1
2021,Knowsley 015C,E01006479,606,404,200,204,0,0,103,48,55,99,78,21,0
2021,Knowsley 015D,E01006480,641,237,122,115,8,8,299,159,140,93,82,11,4
2021,Knowsley 015E,E01006481,652,306,158,148,2,2,258,100,158,86,74,12,0
2021,Knowsley 011B,E01006482,581,352,192,160,4,4,126,45,81,97,81,16,2
2021,Knowsley 011C,E01006483,650,375,181,194,1,1,178,98,80,93,79,14,3
2021,Knowsley 011D,E01006484,547,308,163,145,10,10,154,58,96,75,60,15,0
2021,Knowsley 014B,E01006485,746,646,268,378,2,2,28,13,15,69,61,8,1
2021,Knowsley 014C,E01006486,488,418,224,194,2,2,6,3,3,62,56,6,0
2021,Knowsley 014D,E01006487,623,526,295,231,0,0,12,5,7,85,77,8,0
2021,Knowsley 014E,E01006488,965,856,359,497,2,2,31,8,23,75,60,15,1
2021,Knowsley 014F,E01006489,574,457,213,244,1,1,38,18,20,78,68,10,0
2021,Knowsley 002E,E01006490,1059,819,257,562,1,1,17,8,9,222,204,18,0
2021,Knowsley 002F,E01006491,801,648,192,456,0,0,16,3,13,137,125,12,0
2021,Knowsley 001B,E01006492,512,339,188,151,0,0,110,62,48,63,54,9,0
2021,Knowsley 001C,E01006493,721,227,63,164,13,13,321,170,151,155,149,6,5
2021,Knowsley 001D,E01006494,685,203,98,105,1,1,349,161,188,130,123,7,2
2021,Knowsley 001E,E01006495,858,445,120,325,5,5,306,150,156,95,89,6,7
2021,Knowsley 009C,E01006496,609,393,194,199,1,1,141,72,69,74,65,9,0
2021,Knowsley 013A,E01006497,500,359,198,161,2,2,77,35,42,59,48,11,3
2021,Knowsley 009D,E01006498,586,537,245,292,0,0,19,9,10,30,26,4,0
2021,Knowsley 009E,E01006499,837,584,248,336,11,11,85,32,53,156,141,15,1
2021,Knowsley 013B,E01006500,465,240,134,106,1,1,197,92,105,27,21,6,0
2021,Knowsley 013C,E01006501,547,393,154,239,10,10,47,21,26,97,88,9,0
2021,Knowsley 017C,E01006502,763,636,398,238,1,1,14,5,9,112,85,27,0
2021,Knowsley 017D,E01006503,554,478,301,177,1,1,25,8,17,49,33,16,1
2021,Knowsley 013D,E01006504,492,241,113,128,4,4,182,92,90,62,57,5,3
2021,Knowsley 013E,E01006505,683,308,162,146,1,1,287,154,133,87,73,14,0
2021,Knowsley 004B,E01006506,596,372,190,182,1,1,36,19,17,187,180,7,0
2021,Knowsley 004C,E01006507,668,290,141,149,1,1,245,127,118,132,116,16,0
2021,Knowsley 004D,E01006508,603,370,155,215,0,0,104,38,66,129,111,18,0
2021,Knowsley 004E,E01006509,781,319,139,180,8,8,334,110,224,120,111,9,0
2021,Knowsley 004F,E01006510,570,412,228,184,1,1,61,16,45,96,84,12,0
2021,Liverpool 031A,E01006512,544,124,73,51,2,2,119,17,102,298,279,19,1
2021,Liverpool 037A,E01006514,767,119,50,69,5,5,390,31,359,252,216,36,1
2021,Liverpool 044A,E01006518,814,191,112,79,6,6,442,70,372,175,162,13,0
2021,Liverpool 056A,E01006519,522,466,268,198,3,3,15,9,6,38,27,11,0
2021,Liverpool 043A,E01006520,1059,218,82,136,10,10,272,10,262,559,538,21,0
2021,Liverpool 052A,E01006521,897,378,252,126,1,1,217,9,208,301,288,13,0
2021,Liverpool 048A,E01006522,1020,225,70,155,1,1,302,27,275,492,464,28,0
2021,Liverpool 052B,E01006523,808,290,140,150,14,14,266,15,251,238,224,14,0
2021,Liverpool 048B,E01006524,639,427,264,163,0,0,12,2,10,200,180,20,0
2021,Liverpool 049A,E01006525,474,410,222,188,0,0,6,1,5,58,47,11,0
2021,Liverpool 048C,E01006526,640,489,232,257,2,2,46,4,42,103,88,15,0
2021,Liverpool 053A,E01006527,650,379,200,179,1,1,179,5,174,91,79,12,0
2021,Liverpool 052C,E01006528,569,382,165,217,0,0,47,11,36,140,129,11,0
2021,Liverpool 048D,E01006529,540,428,205,223,2,2,21,6,15,89,80,9,0
2021,Liverpool 055A,E01006530,605,534,314,220,10,10,10,3,7,51,42,9,0
2021,Liverpool 055B,E01006531,657,542,325,217,1,1,75,5,70,39,28,11,0
2021,Liverpool 047A,E01006532,617,553,324,229,1,1,28,2,26,35,21,14,0
2021,Liverpool 055C,E01006533,598,452,264,188,2,2,100,16,84,44,37,7,0
2021,Liverpool 054A,E01006534,746,538,256,282,2,2,143,37,106,63,55,8,0
2021,Liverpool 054B,E01006535,654,463,230,233,0,0,134,26,108,57,47,10,0
2021,Liverpool 054C,E01006536,802,497,243,254,1,1,205,35,170,97,84,13,2
2021,Liverpool 055D,E01006537,1093,725,309,416,1,1,73,12,61,294,278,16,0
2021,Liverpool 055E,E01006538,511,429,244,185,1,1,30,8,22,51,44,7,0
2021,Liverpool 047B,E01006539,588,504,318,186,0,0,12,4,8,72,63,9,0
2021,Liverpool 024A,E01006540,808,171,91,80,0,0,318,30,288,317,295,22,2
2021,Liverpool 015A,E01006541,766,376,221,155,0,0,216,32,184,172,154,18,2
2021,Liverpool 018A,E01006542,588,241,123,118,3,3,127,19,108,217,204,13,0
2021,Liverpool 015B,E01006543,502,406,235,171,4,4,25,1,24,67,59,8,0
2021,Liverpool 015C,E01006544,715,196,115,81,2,2,342,54,288,174,161,13,1
2021,Liverpool 019A,E01006545,596,328,191,137,2,2,31,17,14,234,215,19,1
2021,Liverpool 019B,E01006546,588,269,170,99,2,2,43,4,39,274,264,10,0
2021,Liverpool 019C,E01006547,749,211,134,77,1,1,96,8,88,440,416,24,1
2021,Liverpool 019D,E01006548,759,268,152,116,4,4,127,10,117,351,331,20,9
2021,Liverpool 043B,E01006549,775,137,67,70,4,4,193,20,173,439,426,13,2
2021,Liverpool 038A,E01006550,500,184,91,93,4,4,36,6,30,276,270,6,0
2021,Liverpool 048E,E01006551,792,133,99,34,0,0,471,9,462,188,177,11,0
2021,Liverpool 039A,E01006552,763,137,67,70,10,10,347,32,315,269,247,22,0
2021,Liverpool 042A,E01006553,541,278,106,172,2,2,47,5,42,214,199,15,0
2021,Liverpool 048F,E01006554,627,206,118,88,1,1,114,0,114,305,287,18,1
2021,Liverpool 039B,E01006556,835,107,63,44,4,4,350,28,322,359,329,30,15
2021,Liverpool 038B,E01006557,582,182,96,86,0,0,29,2,27,371,353,18,0
2021,Liverpool 018B,E01006558,611,144,104,40,2,2,261,26,235,204,198,6,0
2021,Liverpool 023A,E01006560,949,141,93,48,6,6,748,148,600,53,47,6,1
2021,Liverpool 018E,E01006562,694,194,141,53,1,1,303,39,264,193,179,14,3
2021,Liverpool 024B,E01006563,880,117,73,44,3,3,539,91,448,220,213,7,1
2021,Liverpool 023B,E01006564,775,418,261,157,3,3,237,59,178,115,94,21,2
2021,Liverpool 029A,E01006565,622,392,200,192,2,2,149,34,115,78,67,11,1
2021,Liverpool 032A,E01006566,591,427,224,203,0,0,78,5,73,86,74,12,0
2021,Liverpool 026A,E01006567,877,324,173,151,3,3,417,51,366,132,125,7,1
2021,Liverpool 026B,E01006568,616,428,204,224,2,2,86,15,71,100,89,11,0
2021,Liverpool 029B,E01006569,604,342,189,153,0,0,188,51,137,74,49,25,0
2021,Liverpool 026C,E01006570,603,478,263,215,0,0,24,4,20,101,90,11,0
2021,Liverpool 026D,E01006571,610,333,180,153,11,11,205,48,157,60,47,13,1
2021,Liverpool 025A,E01006572,538,188,93,95,3,3,267,66,201,80,73,7,0
2021,Liverpool 029C,E01006573,746,273,150,123,2,2,209,18,191,261,232,29,1
2021,Liverpool 025B,E01006574,631,297,148,149,3,3,230,49,181,101,95,6,0
2021,Liverpool 034A,E01006575,557,380,190,190,3,3,81,19,62,93,83,10,0
2021,Liverpool 034B,E01006576,730,610,291,319,4,4,11,5,6,105,96,9,0
2021,Liverpool 034C,E01006577,589,542,283,259,0,0,3,0,3,44,37,7,0
2021,Liverpool 036A,E01006578,536,464,212,252,0,0,12,6,6,60,51,9,0
2021,Liverpool 034D,E01006579,598,552,309,243,2,2,5,2,3,38,30,8,1
2021,Liverpool 036B,E01006580,504,475,260,215,0,0,7,3,4,21,17,4,1
2021,Liverpool 036C,E01006581,596,534,299,235,0,0,1,1,0,61,48,13,0
2021,Liverpool 041A,E01006582,611,548,309,239,0,0,4,4,0,59,49,10,0
2021,Liverpool 047C,E01006583,464,438,264,174,0,0,6,1,5,20,14,6,0
2021,Liverpool 034E,E01006584,626,499,252,247,9,9,39,4,35,79,69,10,0
2021,Liverpool 032B,E01006585,618,269,142,127,1,1,294,60,234,54,42,12,0
2021,Liverpool 032C,E01006586,850,415,197,218,12,12,223,21,202,199,177,22,1
2021,Liverpool 032D,E01006587,676,410,204,206,12,12,127,16,111,127,115,12,0
2021,Liverpool 042C,E01006588,692,427,208,219,3,3,44,13,31,218,206,12,0
2021,Liverpool 041B,E01006589,581,522,291,231,1,1,16,8,8,42,33,9,0
2021,Liverpool 042D,E01006590,656,423,192,231,1,1,36,2,34,196,185,11,0
2021,Liverpool 041C,E01006591,627,484,229,255,0,0,6,2,4,136,124,12,1
2021,Liverpool 041D,E01006592,601,518,316,202,1,1,9,1,8,73,66,7,0
2021,Liverpool 042E,E01006593,591,377,129,248,2,2,26,5,21,185,174,11,1
2021,Liverpool 047D,E01006594,558,493,315,178,1,1,7,2,5,57,49,8,0
2021,Liverpool 049B,E01006595,797,603,293,310,6,6,41,3,38,146,137,9,1
2021,Liverpool 049C,E01006596,575,482,279,203,1,1,7,2,5,85,76,9,0
2021,Liverpool 041E,E01006597,695,602,352,250,3,3,10,2,8,80,65,15,0
2021,Liverpool 010A,E01006598,701,148,80,68,3,3,442,98,344,107,99,8,1
2021,Liverpool 010B,E01006599,715,205,55,150,0,0,396,78,318,113,104,9,1
2021,Liverpool 011A,E01006600,581,338,180,158,2,2,172,57,115,69,52,17,0
2021,Liverpool 011B,E01006603,603,341,170,171,0,0,193,41,152,68,52,16,1
2021,Liverpool 016A,E01006604,609,339,160,179,3,3,185,47,138,82,69,13,0
2021,Liverpool 016B,E01006605,682,318,169,149,4,4,274,59,215,84,75,9,2
2021,Liverpool 020A,E01006606,684,391,190,201,2,2,133,36,97,157,144,13,1
2021,Liverpool 008A,E01006607,639,341,190,151,0,0,227,58,169,70,57,13,1
2021,Liverpool 009A,E01006608,518,276,148,128,6,6,122,7,115,114,107,7,0
2021,Liverpool 009B,E01006609,531,267,140,127,0,0,92,7,85,172,162,10,0
2021,Liverpool 009C,E01006610,687,229,142,87,0,0,246,26,220,210,196,14,2
2021,Liverpool 012A,E01006611,684,166,95,71,0,0,138,26,112,380,341,39,0
2021,Liverpool 008B,E01006612,715,257,134,123,3,3,394,99,295,60,48,12,1
2021,Liverpool 009D,E01006613,607,326,192,134,0,0,203,33,170,76,61,15,2
2021,Liverpool 012B,E01006614,557,249,143,106,3,3,83,9,74,220,208,12,2
2021,Liverpool 012C,E01006615,691,212,128,84,3,3,162,18,144,313,298,15,1
2021,Liverpool 015D,E01006616,604,355,200,155,11,11,166,47,119,71,48,23,1
2021,Liverpool 021A,E01006617,693,492,254,238,3,3,67,8,59,131,119,12,0
2021,Liverpool 016C,E01006618,693,442,257,185,3,3,188,47,141,59,45,14,1
2021,Liverpool 021B,E01006619,778,548,272,276,3,3,50,8,42,176,157,19,1
2021,Liverpool 021C,E01006620,623,450,278,172,0,0,100,15,85,73,61,12,0
2021,Liverpool 021D,E01006621,654,557,304,253,0,0,27,6,21,70,59,11,0
2021,Liverpool 021E,E01006622,585,511,257,254,2,2,9,5,4,63,56,7,0
2021,Liverpool 013A,E01006623,520,501,319,182,0,0,7,3,4,12,7,5,0
2021,Liverpool 013B,E01006624,714,412,212,200,3,3,156,13,143,143,124,19,0
2021,Liverpool 016D,E01006625,610,484,290,194,1,1,46,5,41,79,59,20,0
2021,Liverpool 016E,E01006626,588,466,271,195,1,1,66,11,55,55,41,14,0
2021,Liverpool 013C,E01006627,590,433,241,192,1,1,70,13,57,86,69,17,0
2021,Liverpool 052D,E01006628,652,445,215,230,11,11,55,1,54,141,129,12,0
2021,Liverpool 052E,E01006629,599,416,225,191,0,0,108,6,102,75,61,14,0
2021,Liverpool 044B,E01006630,959,222,61,161,3,3,436,98,338,296,286,10,2
2021,Liverpool 044C,E01006632,853,230,127,103,13,13,422,51,371,185,163,22,3
2021,Liverpool 050B,E01006633,683,150,77,73,4,4,426,78,348,102,92,10,1
2021,Liverpool 017A,E01006637,651,217,100,117,1,1,279,91,188,150,142,8,4
2021,Liverpool 017B,E01006638,560,157,84,73,1,1,297,69,228,104,101,3,1
2021,Liverpool 017C,E01006639,656,421,192,229,3,3,101,26,75,131,120,11,0
2021,Liverpool 021F,E01006640,760,566,286,280,2,2,88,14,74,104,88,16,0
2021,Liverpool 025C,E01006641,634,449,130,319,2,2,31,9,22,152,127,25,0
2021,Liverpool 025D,E01006642,616,204,96,108,0,0,341,90,251,71,62,9,0
2021,Liverpool 025E,E01006643,759,295,133,162,1,1,299,76,223,162,156,6,2
2021,Liverpool 017D,E01006644,919,421,206,215,4,4,263,61,202,231,211,20,0
2021,Liverpool 017E,E01006645,692,236,123,113,5,5,354,74,280,97,82,15,0
2021,Liverpool 023C,E01006646,935,188,83,105,7,7,456,72,384,282,266,16,2
2021,Liverpool 024C,E01006647,856,190,80,110,32,32,572,99,473,60,51,9,2
2021,Liverpool 023D,E01006648,1072,233,128,105,9,9,457,74,383,371,351,20,2
2021,Liverpool 001A,E01006651,630,527,215,312,15,15,39,0,39,49,44,5,0
2021,Liverpool 002A,E01006652,623,441,235,206,0,0,13,4,9,169,151,18,0
2021,Liverpool 001B,E01006653,782,404,175,229,11,11,239,54,185,126,114,12,2
2021,Liverpool 005A,E01006654,627,354,173,181,3,3,104,8,96,166,152,14,0
2021,Liverpool 001C,E01006655,731,435,231,204,1,1,136,26,110,159,105,54,0
2021,Liverpool 002B,E01006656,647,434,209,225,1,1,32,4,28,180,162,18,0
2021,Liverpool 002C,E01006657,572,313,160,153,1,1,75,9,66,183,169,14,0
2021,Liverpool 001D,E01006658,647,217,117,100,3,3,284,71,213,139,128,11,4
2021,Liverpool 005B,E01006659,539,198,94,104,3,3,218,69,149,120,110,10,0
2021,Liverpool 001E,E01006660,622,295,158,137,1,1,241,53,188,85,68,17,0
2021,Liverpool 004A,E01006661,725,292,147,145,1,1,348,85,263,81,76,5,3
2021,Liverpool 004B,E01006662,803,249,114,135,5,5,431,77,354,116,104,12,2
2021,Liverpool 004C,E01006663,481,258,95,163,3,3,142,39,103,78,73,5,0
2021,Liverpool 004D,E01006664,826,272,129,143,8,8,350,62,288,194,177,17,2
2021,Liverpool 007A,E01006665,624,520,262,258,6,6,17,4,13,80,73,7,1
2021,Liverpool 007B,E01006666,508,441,211,230,11,11,6,1,5,50,38,12,0
2021,Liverpool 007C,E01006667,630,376,216,160,6,6,159,32,127,89,79,10,0
2021,Liverpool 007D,E01006668,580,488,185,303,11,11,10,3,7,71,61,10,0
2021,Liverpool 004E,E01006669,547,401,160,241,8,8,62,14,48,76,63,13,0
2021,Liverpool 007E,E01006670,610,499,249,250,0,0,23,2,21,88,81,7,0
2021,Liverpool 013D,E01006671,505,339,179,160,0,0,121,35,86,45,36,9,0
2021,Liverpool 010E,E01006672,775,309,160,149,2,2,369,79,290,94,82,12,1
2021,Liverpool 037D,E01006673,943,83,33,50,4,4,547,87,460,307,297,10,2
2021,Liverpool 039C,E01006674,885,113,69,44,21,21,612,109,503,136,123,13,3
2021,Liverpool 043C,E01006675,1111,231,115,116,7,7,443,35,408,430,412,18,0
2021,Liverpool 044D,E01006676,793,131,75,56,1,1,484,99,385,175,134,41,2
2021,Liverpool 043D,E01006677,657,77,43,34,1,1,353,50,303,224,211,13,2
2021,Liverpool 044E,E01006678,947,182,99,83,30,30,548,63,485,187,175,12,0
2021,Liverpool 039D,E01006679,950,171,89,82,17,17,541,104,437,217,193,24,4
2021,Liverpool 053B,E01006680,582,536,292,244,1,1,16,2,14,29,19,10,0
2021,Liverpool 054D,E01006681,693,446,261,185,16,16,162,26,136,68,63,5,1
2021,Liverpool 053C,E01006682,492,467,255,212,1,1,3,1,2,21,15,6,0
2021,Liverpool 053D,E01006683,584,543,276,267,1,1,9,6,3,31,28,3,0
2021,Liverpool 056B,E01006684,979,707,383,324,3,3,39,3,36,230,210,20,0
2021,Liverpool 056C,E01006685,597,475,287,188,1,1,26,4,22,95,90,5,0
2021,Liverpool 053E,E01006686,527,484,296,188,0,0,3,0,3,40,33,7,0
2021,Liverpool 056D,E01006687,1039,687,296,391,21,21,192,19,173,139,128,11,0
2021,Liverpool 056E,E01006688,723,454,233,221,0,0,62,5,57,207,197,10,0
2021,Liverpool 049D,E01006689,673,552,304,248,7,7,40,6,34,74,60,14,0
2021,Liverpool 028A,E01006690,839,139,79,60,2,2,277,36,241,420,390,30,1
2021,Liverpool 030A,E01006691,660,150,113,37,6,6,137,16,121,364,351,13,3
2021,Liverpool 028B,E01006692,1081,402,185,217,10,10,259,26,233,409,377,32,1
2021,Liverpool 024D,E01006693,789,222,147,75,0,0,411,61,350,156,143,13,0
2021,Liverpool 030B,E01006694,823,167,126,41,4,4,151,27,124,499,450,49,2
2021,Liverpool 028C,E01006695,937,174,94,80,4,4,351,50,301,403,376,27,5
2021,Liverpool 030C,E01006696,816,241,142,99,5,5,249,46,203,317,296,21,4
2021,Liverpool 030D,E01006697,749,160,105,55,4,4,125,14,111,457,422,35,3
2021,Liverpool 012D,E01006698,677,360,208,152,3,3,95,17,78,218,204,14,1
2021,Liverpool 014A,E01006699,759,143,90,53,0,0,455,76,379,160,151,9,1
2021,Liverpool 012E,E01006700,667,252,157,95,1,1,191,16,175,222,210,12,1
2021,Liverpool 014B,E01006701,743,369,227,142,5,5,218,58,160,150,143,7,1
2021,Liverpool 014C,E01006702,750,268,184,84,3,3,261,50,211,218,203,15,0
2021,Liverpool 014D,E01006703,799,199,120,79,5,5,422,104,318,172,167,5,1
2021,Liverpool 009E,E01006705,617,252,166,86,1,1,77,12,65,287,267,20,0
2021,Liverpool 045A,E01006706,560,188,116,72,2,2,331,77,254,39,33,6,0
2021,Liverpool 045B,E01006707,579,266,128,138,11,11,257,49,208,45,36,9,0
2021,Liverpool 045C,E01006708,746,352,160,192,28,28,280,32,248,84,76,8,2
2021,Liverpool 040A,E01006709,671,305,145,160,19,19,276,33,243,70,61,9,1
2021,Liverpool 045D,E01006710,634,413,246,167,6,6,85,12,73,130,118,12,0
2021,Liverpool 027A,E01006711,675,303,163,140,1,1,106,9,97,264,250,14,1
2021,Liverpool 029D,E01006712,528,327,171,156,2,2,33,6,27,166,157,9,0
2021,Liverpool 029E,E01006713,576,348,187,161,1,1,18,6,12,209,195,14,0
2021,Liverpool 032E,E01006716,662,263,138,125,3,3,160,28,132,234,222,12,2
2021,Liverpool 027D,E01006717,572,446,259,187,0,0,18,5,13,108,97,11,0
2021,Liverpool 027E,E01006718,666,419,225,194,11,11,87,8,79,147,130,17,2
2021,Liverpool 027F,E01006719,591,408,220,188,1,1,39,12,27,143,124,19,0
2021,Liverpool 038C,E01006721,815,156,74,82,6,6,335,31,304,317,293,24,1
2021,Liverpool 038D,E01006722,561,162,83,79,6,6,49,6,43,344,340,4,0
2021,Liverpool 038E,E01006723,694,215,116,99,4,4,110,12,98,365,357,8,0
2021,Liverpool 038F,E01006724,506,237,115,122,5,5,42,6,36,222,214,8,0
2021,Liverpool 035B,E01006725,723,283,155,128,1,1,170,18,152,269,253,16,0
2021,Liverpool 035C,E01006726,629,201,111,90,0,0,112,14,98,314,291,23,2
2021,Liverpool 035D,E01006727,596,372,178,194,2,2,22,3,19,200,175,25,0
2021,Liverpool 035E,E01006728,803,174,116,58,1,1,268,52,216,358,343,15,2
2021,Liverpool 008C,E01006729,520,146,76,70,0,0,329,76,253,45,37,8,0
2021,Liverpool 011C,E01006730,538,245,140,105,2,2,233,47,186,56,42,14,2
2021,Liverpool 011D,E01006731,473,236,128,108,0,0,172,50,122,64,61,3,1
2021,Liverpool 011E,E01006732,625,52,32,20,1,1,535,137,398,37,34,3,0
2021,Liverpool 005C,E01006734,623,152,75,77,3,3,382,84,298,86,84,2,0
2021,Liverpool 005D,E01006735,609,219,121,98,0,0,323,94,229,65,54,11,2
2021,Liverpool 005E,E01006736,572,261,146,115,1,1,230,51,179,80,71,9,0
2021,Liverpool 005F,E01006737,553,248,121,127,0,0,243,53,190,62,56,6,0
2021,Liverpool 058A,E01006738,645,271,157,114,5,5,252,56,196,117,98,19,0
2021,Liverpool 058B,E01006739,1008,463,137,326,0,0,459,75,384,85,75,10,1
2021,Liverpool 057A,E01006740,682,219,71,148,1,1,394,63,331,67,59,8,1
2021,Liverpool 058C,E01006741,822,419,180,239,2,2,282,70,212,119,106,13,0
2021,Liverpool 057B,E01006742,654,436,193,243,6,6,139,17,122,72,62,10,1
2021,Liverpool 058D,E01006743,946,477,192,285,4,4,217,37,180,247,223,24,1
2021,Liverpool 057C,E01006744,733,424,171,253,26,26,102,15,87,181,164,17,0
2021,Liverpool 057D,E01006745,852,301,161,140,3,3,157,24,133,389,367,22,2
2021,Liverpool 030E,E01006746,666,157,103,54,1,1,315,86,229,192,183,9,1
2021,Liverpool 031B,E01006747,730,124,73,51,3,3,230,30,200,372,350,22,1
2021,Liverpool 031C,E01006748,709,140,113,27,1,1,127,8,119,441,431,10,0
2021,Liverpool 031F,E01006751,790,151,90,61,3,3,437,73,364,198,191,7,1
2021,Liverpool 059A,E01006753,792,326,111,215,26,26,348,75,273,91,83,8,1
2021,Liverpool 059B,E01006754,837,224,109,115,5,5,446,78,368,161,145,16,1
2021,Liverpool 059C,E01006755,660,152,57,95,1,1,410,97,313,97,90,7,0
2021,Liverpool 059D,E01006756,728,199,100,99,0,0,417,81,336,112,107,5,0
2021,Liverpool 059E,E01006757,602,221,113,108,8,8,284,56,228,89,80,9,0
2021,Liverpool 059F,E01006758,627,250,132,118,0,0,297,77,220,80,68,12,0
2021,Liverpool 028D,E01006759,427,226,108,118,3,3,39,6,33,158,143,15,1
2021,Liverpool 028E,E01006760,681,168,96,72,0,0,157,9,148,356,342,14,0
2021,Liverpool 020B,E01006761,703,304,172,132,2,2,190,22,168,206,187,19,1
2021,Liverpool 015E,E01006762,729,305,179,126,2,2,277,26,251,143,133,10,2
2021,Liverpool 020C,E01006763,645,327,179,148,3,3,38,7,31,274,249,25,3
2021,Liverpool 020D,E01006764,684,288,185,103,2,2,97,16,81,292,269,23,5
2021,Liverpool 020E,E01006765,653,310,168,142,5,5,122,23,99,214,201,13,2
2021,Liverpool 019E,E01006766,582,145,90,55,6,6,116,7,109,315,300,15,0
2021,Liverpool 019F,E01006767,810,295,142,153,5,5,158,20,138,351,338,13,1
2021,Liverpool 020F,E01006768,588,318,171,147,0,0,72,11,61,195,181,14,3
2021,Liverpool 040B,E01006769,658,188,97,91,36,36,392,50,342,42,39,3,0
2021,Liverpool 040C,E01006770,502,227,111,116,25,25,184,38,146,66,46,20,0
2021,Liverpool 040D,E01006771,809,258,144,114,16,16,475,47,428,57,40,17,3
2021,Liverpool 040E,E01006772,492,343,190,153,21,21,86,19,67,42,34,8,0
2021,Liverpool 036D,E01006773,555,485,245,240,2,2,22,6,16,45,35,10,1
2021,Liverpool 036E,E01006774,534,462,233,229,0,0,36,8,28,35,29,6,1
2021,Liverpool 040F,E01006775,665,283,131,152,32,32,313,50,263,37,27,10,0
2021,Liverpool 022B,E01006776,903,248,110,138,23,23,444,35,409,188,174,14,0
2021,Liverpool 014E,E01006778,1073,221,137,84,0,0,491,124,367,357,323,34,4
2021,Liverpool 022D,E01006779,920,208,104,104,2,2,576,149,427,132,126,6,2
2021,Liverpool 002D,E01006780,568,428,216,212,1,1,31,4,27,108,95,13,0
2021,Liverpool 003A,E01006781,573,478,260,218,2,2,29,6,23,64,58,6,0
2021,Liverpool 003B,E01006782,636,396,191,205,0,0,46,6,40,194,180,14,0
2021,Liverpool 002E,E01006783,582,405,207,198,2,2,25,3,22,150,139,11,0
2021,Liverpool 003C,E01006784,532,367,165,202,1,1,10,2,8,153,142,11,1
2021,Liverpool 003D,E01006785,771,452,241,211,0,0,46,13,33,273,252,21,0
2021,Liverpool 003E,E01006786,739,553,283,270,1,1,68,8,60,117,102,15,0
2021,Liverpool 006A,E01006787,553,276,136,140,9,9,69,8,61,198,189,9,1
2021,Liverpool 006B,E01006788,684,455,218,237,2,2,65,9,56,162,154,8,0
2021,Liverpool 006C,E01006790,867,153,89,64,43,43,434,53,381,231,218,13,6
2021,Liverpool 006D,E01006791,833,237,130,107,16,16,383,84,299,197,184,13,0
2021,Liverpool 046A,E01006792,567,477,277,200,13,13,35,4,31,42,31,11,0
2021,Liverpool 051A,E01006793,724,401,247,154,2,2,145,16,129,176,166,10,0
2021,Liverpool 046B,E01006794,716,525,296,229,6,6,70,10,60,115,97,18,0
2021,Liverpool 051B,E01006795,644,518,287,231,1,1,18,10,8,106,92,14,1
2021,Liverpool 047E,E01006796,621,551,322,229,0,0,7,3,4,63,46,17,0
2021,Liverpool 051C,E01006797,626,372,183,189,4,4,194,51,143,56,48,8,0
2021,Liverpool 051D,E01006798,575,490,286,204,3,3,26,4,22,56,50,6,0
2021,Liverpool 051E,E01006799,1045,427,261,166,2,2,444,25,419,172,157,15,0
2021,Liverpool 046C,E01006800,680,602,403,199,2,2,7,5,2,69,57,12,0
2021,Liverpool 046D,E01006801,836,764,375,389,1,1,15,3,12,55,45,10,1
2021,St. Helens 002A,E01006802,727,517,306,211,1,1,142,42,100,67,59,8,0
2021,St. Helens 003A,E01006803,611,559,324,235,1,1,4,2,2,47,35,12,0
2021,St. Helens 002B,E01006804,660,539,342,197,2,2,75,24,51,44,37,7,0
2021,St. Helens 003B,E01006805,628,418,235,183,10,10,144,66,78,53,45,8,3
2021,St. Helens 002C,E01006806,616,571,382,189,2,2,14,3,11,29,25,4,0
2021,St. Helens 002D,E01006807,585,547,369,178,3,3,8,3,5,27,16,11,0
2021,St. Helens 003C,E01006808,535,480,287,193,0,0,7,2,5,48,35,13,0
2021,St. Helens 003D,E01006809,599,532,333,199,0,0,10,5,5,57,46,11,0
2021,St. Helens 008A,E01006810,495,477,303,174,2,2,4,1,3,12,8,4,0
2021,St. Helens 008B,E01006811,610,445,297,148,1,1,114,51,63,50,42,8,0
2021,St. Helens 008C,E01006812,595,246,129,117,1,1,280,116,164,67,58,9,1
2021,St. Helens 008D,E01006813,671,374,198,176,1,1,148,43,105,148,127,21,0
2021,St. Helens 008E,E01006814,600,545,310,235,5,5,12,2,10,38,34,4,0
2021,St. Helens 008F,E01006815,551,358,193,165,4,4,106,36,70,83,61,22,0
2021,St. Helens 017A,E01006816,729,217,114,103,10,10,372,163,209,125,118,7,5
2021,St. Helens 017B,E01006817,649,187,96,91,3,3,364,167,197,92,85,7,3
2021,St. Helens 008G,E01006818,524,455,281,174,1,1,33,9,24,35,29,6,0
2021,St. Helens 011A,E01006819,724,487,210,277,0,0,120,48,72,117,96,21,0
2021,St. Helens 011B,E01006820,619,241,142,99,5,5,217,74,143,155,142,13,1
2021,St. Helens 011C,E01006821,677,240,139,101,2,2,297,118,179,138,130,8,0
2021,St. Helens 009A,E01006822,636,549,322,227,0,0,51,6,45,36,26,10,0
2021,St. Helens 009B,E01006823,582,545,357,188,0,0,9,5,4,28,22,6,0
2021,St. Helens 009C,E01006824,515,479,286,193,1,1,6,1,5,29,25,4,0
2021,St. Helens 009D,E01006825,630,557,359,198,5,5,5,1,4,63,47,16,0
2021,St. Helens 018A,E01006826,590,326,209,117,1,1,217,68,149,45,33,12,1
2021,St. Helens 018B,E01006827,621,539,293,246,2,2,13,4,9,66,61,5,1
2021,St. Helens 018C,E01006828,903,807,474,333,0,0,25,11,14,71,54,17,0
2021,St. Helens 018D,E01006829,717,629,305,324,0,0,24,3,21,64,55,9,0
2021,St. Helens 025A,E01006830,656,180,71,109,0,0,322,124,198,151,143,8,3
2021,St. Helens 016A,E01006831,684,379,195,184,4,4,78,25,53,222,202,20,1
2021,St. Helens 012A,E01006832,813,381,131,250,4,4,224,42,182,203,192,11,1
2021,St. Helens 016B,E01006833,997,638,279,359,57,57,52,12,40,250,221,29,0
2021,St. Helens 012B,E01006834,640,283,145,138,0,0,125,19,106,231,211,20,1
2021,St. Helens 016C,E01006835,618,449,270,179,1,1,57,7,50,111,95,16,0
2021,St. Helens 005A,E01006836,632,411,256,155,1,1,138,57,81,77,63,14,5
2021,St. Helens 006A,E01006837,621,446,241,205,1,1,85,38,47,89,78,11,0
2021,St. Helens 006B,E01006838,738,371,197,174,39,39,141,35,106,186,169,17,1
2021,St. Helens 005B,E01006839,567,407,229,178,1,1,108,33,75,50,38,12,1
2021,St. Helens 005C,E01006840,660,499,302,197,0,0,47,18,29,114,103,11,0
2021,St. Helens 006C,E01006841,658,572,319,253,1,1,49,15,34,36,32,4,0
2021,St. Helens 005D,E01006842,672,286,108,178,1,1,288,108,180,94,82,12,3
2021,St. Helens 006D,E01006843,554,364,236,128,0,0,122,45,77,66,58,8,2
2021,St. Helens 020A,E01006844,806,328,174,154,3,3,203,66,137,271,251,20,1
2021,St. Helens 014A,E01006845,845,484,227,257,46,46,87,22,65,227,212,15,1
2021,St. Helens 020B,E01006846,616,527,309,218,1,1,28,7,21,60,43,17,0
2021,St. Helens 020C,E01006847,777,285,115,170,1,1,423,129,294,67,64,3,1
2021,St. Helens 020D,E01006848,622,475,285,190,3,3,76,4,72,68,58,10,0
2021,St. Helens 004A,E01006849,647,230,116,114,0,0,355,85,270,59,46,13,3
2021,St. Helens 004B,E01006850,770,337,159,178,9,9,334,106,228,86,72,14,4
2021,St. Helens 004C,E01006851,595,446,245,201,8,8,86,20,66,55,46,9,0
2021,St. Helens 004D,E01006852,529,487,292,195,0,0,5,0,5,37,25,12,0
2021,St. Helens 004E,E01006853,740,601,297,304,2,2,75,12,63,62,52,10,0
2021,St. Helens 004F,E01006854,640,455,235,220,1,1,92,29,63,92,75,17,0
2021,St. Helens 004G,E01006855,655,445,283,162,2,2,147,53,94,61,52,9,0
2021,St. Helens 015A,E01006856,708,527,216,311,8,8,26,4,22,147,129,18,0
2021,St. Helens 015B,E01006857,634,537,300,237,1,1,35,10,25,61,41,20,0
2021,St. Helens 015C,E01006858,626,309,150,159,4,4,216,82,134,97,88,9,0
2021,St. Helens 015D,E01006859,741,604,318,286,27,27,18,3,15,92,79,13,0
2021,St. Helens 015E,E01006860,672,408,189,219,4,4,162,51,111,98,85,13,0
2021,St. Helens 015F,E01006861,776,261,53,208,5,5,450,120,330,58,52,6,2
2021,St. Helens 015G,E01006862,993,638,179,459,0,0,260,79,181,93,74,19,2
2021,St. Helens 013A,E01006863,890,302,158,144,34,34,314,61,253,238,220,18,2
2021,St. Helens 013B,E01006864,900,658,310,348,2,2,46,9,37,194,176,18,0
2021,St. Helens 010A,E01006866,691,323,147,176,27,27,288,91,197,52,47,5,1
2021,St. Helens 010B,E01006867,813,656,272,384,5,5,45,16,29,107,98,9,0
2021,St. Helens 010C,E01006868,660,314,141,173,6,6,262,80,182,78,71,7,0
2021,St. Helens 010D,E01006869,747,442,193,249,0,0,179,59,120,126,108,18,0
2021,St. Helens 014B,E01006870,697,336,201,135,5,5,52,7,45,303,286,17,1
2021,St. Helens 011D,E01006871,745,243,108,135,3,3,355,122,233,140,126,14,4
2021,St. Helens 014C,E01006872,867,209,136,73,3,3,249,61,188,403,377,26,3
2021,St. Helens 014D,E01006873,625,125,70,55,12,12,408,155,253,80,71,9,0
2021,St. Helens 014E,E01006874,638,159,87,72,0,0,273,79,194,204,194,10,2
2021,St. Helens 017C,E01006875,543,263,125,138,0,0,153,51,102,126,120,6,1
2021,St. Helens 016D,E01006876,657,421,241,180,2,2,24,2,22,210,186,24,0
2021,St. Helens 012C,E01006877,885,358,212,146,7,7,299,71,228,220,199,21,1
2021,St. Helens 016E,E01006878,645,418,225,193,2,2,67,16,51,158,137,21,0
2021,St. Helens 016F,E01006879,610,365,179,186,0,0,181,62,119,64,52,12,0
2021,St. Helens 012D,E01006880,757,218,120,98,3,3,292,66,226,243,223,20,1
2021,St. Helens 012E,E01006881,756,251,123,128,13,13,280,64,216,212,189,23,0
2021,St. Helens 001A,E01006882,503,468,306,162,0,0,23,6,17,12,10,2,0
2021,St. Helens 001B,E01006883,627,511,328,183,1,1,34,10,24,81,73,8,0
2021,St. Helens 001C,E01006884,627,514,319,195,0,0,55,15,40,58,50,8,0
2021,St. Helens 001D,E01006885,576,507,330,177,1,1,18,7,11,50,40,10,0
2021,St. Helens 001E,E01006886,573,511,341,170,0,0,12,5,7,50,37,13,0
2021,St. Helens 001F,E01006887,597,414,253,161,13,13,94,26,68,76,63,13,0
2021,St. Helens 023A,E01006888,506,469,294,175,1,1,5,2,3,31,24,7,0
2021,St. Helens 023B,E01006889,580,510,302,208,2,2,10,4,6,58,46,12,0
2021,St. Helens 021A,E01006890,614,453,232,221,2,2,51,17,34,106,96,10,2
2021,St. Helens 023C,E01006891,645,528,272,256,4,4,55,18,37,58,51,7,0
2021,St. Helens 021B,E01006892,567,425,265,160,32,32,71,20,51,39,32,7,0
2021,St. Helens 021C,E01006893,604,422,240,182,2,2,46,8,38,132,118,14,2
2021,St. Helens 021D,E01006894,634,479,329,150,12,12,100,18,82,43,38,5,0
2021,St. Helens 023D,E01006895,645,582,424,158,0,0,11,1,10,52,41,11,0
2021,St. Helens 020E,E01006896,656,575,387,188,0,0,9,2,7,72,57,15,0
2021,St. Helens 020F,E01006897,660,509,290,219,0,0,71,11,60,80,67,13,0
2021,St. Helens 022A,E01006898,786,491,303,188,1,1,187,49,138,105,91,14,2
2021,St. Helens 017D,E01006899,870,567,240,327,1,1,123,39,84,179,159,20,0
2021,St. Helens 020G,E01006901,632,506,254,252,8,8,7,1,6,111,101,10,0
2021,St. Helens 024A,E01006903,738,306,168,138,1,1,294,96,198,137,128,9,0
2021,St. Helens 016G,E01006904,672,440,252,188,1,1,160,77,83,71,62,9,0
2021,St. Helens 024B,E01006905,615,265,181,84,1,1,309,127,182,39,32,7,1
2021,St. Helens 025B,E01006906,698,435,221,214,2,2,60,11,49,201,177,24,0
2021,St. Helens 024C,E01006907,672,429,229,200,3,3,107,31,76,133,117,16,0
2021,St. Helens 022C,E01006908,622,257,136,121,0,0,279,103,176,85,75,10,1
2021,St. Helens 022D,E01006909,494,104,52,52,0,0,346,139,207,44,39,5,0
2021,St. Helens 022E,E01006910,821,375,180,195,21,21,283,53,230,142,126,16,0
2021,St. Helens 022F,E01006911,621,566,373,193,1,1,11,2,9,43,34,9,0
2021,St. Helens 024E,E01006912,685,308,127,181,1,1,246,77,169,130,116,14,0
2021,St. Helens 024D,E01006913,570,278,149,129,0,0,250,100,150,40,35,5,2
2021,St. Helens 007A,E01006914,534,508,309,199,2,2,5,2,3,19,19,0,0
2021,St. Helens 007B,E01006915,664,399,219,180,0,0,188,45,143,76,65,11,1
2021,St. Helens 007C,E01006916,663,467,242,225,1,1,78,21,57,117,93,24,0
2021,St. Helens 007D,E01006917,705,638,339,299,1,1,19,5,14,47,35,12,0
2021,St. Helens 007E,E01006918,517,412,199,213,1,1,23,3,20,81,70,11,0
2021,St. Helens 007F,E01006919,747,326,121,205,5,5,282,98,184,131,110,21,3
2021,Sefton 011A,E01006920,717,523,299,224,16,16,62,20,42,116,104,12,0
2021,Sefton 012A,E01006921,589,534,380,154,1,1,13,4,9,41,35,6,0
2021,Sefton 012B,E01006922,598,569,387,182,0,0,6,0,6,23,12,11,0
2021,Sefton 012C,E01006923,708,656,456,200,0,0,6,2,4,46,31,15,0
2021,Sefton 011B,E01006924,665,323,166,157,2,2,243,63,180,97,80,17,0
2021,Sefton 011C,E01006925,701,456,238,218,11,11,162,59,103,72,61,11,0
2021,Sefton 012D,E01006926,739,674,455,219,16,16,6,1,5,43,39,4,0
2021,Sefton 011D,E01006927,797,583,354,229,5,5,91,21,70,118,107,11,0
2021,Sefton 009A,E01006928,593,477,264,213,7,7,51,2,49,57,51,6,1
2021,Sefton 010A,E01006929,618,483,244,239,1,1,20,11,9,114,101,13,0
2021,Sefton 010B,E01006930,627,453,230,223,0,0,69,23,46,105,94,11,0
2021,Sefton 010C,E01006931,653,547,312,235,0,0,34,8,26,72,65,7,0
2021,Sefton 010D,E01006932,588,526,323,203,0,0,4,1,3,58,47,11,0
2021,Sefton 010E,E01006933,585,427,209,218,2,2,48,15,33,108,97,11,0
2021,Sefton 007A,E01006934,663,459,256,203,2,2,27,1,26,175,155,20,0
2021,Sefton 009B,E01006935,699,523,275,248,2,2,4,0,4,170,153,17,0
2021,Sefton 022A,E01006936,754,585,420,165,3,3,16,5,11,150,132,18,0
2021,Sefton 022B,E01006937,501,463,240,223,1,1,4,1,3,33,24,9,0
2021,Sefton 022C,E01006938,581,472,315,157,0,0,47,3,44,62,50,12,0
2021,Sefton 022D,E01006939,700,523,278,245,0,0,50,12,38,127,108,19,0
2021,Sefton 022E,E01006940,638,473,286,187,2,2,22,2,20,141,128,13,0
2021,Sefton 028A,E01006941,690,521,325,196,3,3,26,3,23,140,119,21,0
2021,Sefton 028B,E01006942,640,474,246,228,0,0,46,4,42,120,104,16,0
2021,Sefton 022F,E01006943,486,458,250,208,0,0,5,3,2,23,12,11,0
2021,Sefton 003A,E01006944,938,527,417,110,19,19,99,6,93,292,276,16,1
2021,Sefton 004A,E01006945,933,466,322,144,3,3,35,5,30,429,383,46,0
2021,Sefton 001A,E01006946,721,622,434,188,3,3,19,3,16,77,61,16,0
2021,Sefton 002A,E01006947,624,566,369,197,2,2,9,1,8,47,41,6,0
2021,Sefton 003B,E01006948,667,332,201,131,1,1,244,60,184,88,71,17,2
2021,Sefton 003C,E01006949,764,535,386,149,1,1,125,6,119,103,94,9,0
2021,Sefton 004B,E01006950,937,220,141,79,31,31,120,9,111,566,543,23,0
2021,Sefton 003D,E01006951,786,541,411,130,1,1,67,2,65,177,160,17,0
2021,Sefton 032A,E01006952,607,207,86,121,1,1,287,91,196,112,101,11,0
2021,Sefton 032B,E01006953,703,291,138,153,0,0,225,64,161,186,177,9,1
2021,Sefton 028C,E01006954,683,407,219,188,4,4,120,7,113,152,133,19,0
2021,Sefton 030A,E01006955,634,487,225,262,0,0,31,6,25,116,99,17,0
2021,Sefton 030B,E01006956,789,402,183,219,1,1,47,4,43,339,319,20,0
2021,Sefton 032C,E01006957,844,280,150,130,17,17,211,34,177,336,318,18,0
2021,Sefton 030C,E01006958,803,340,184,156,1,1,162,19,143,300,282,18,0
2021,Sefton 032D,E01006959,682,470,246,224,13,13,52,12,40,147,135,12,0
2021,Sefton 038A,E01006960,448,386,214,172,1,1,23,8,15,38,33,5,0
2021,Sefton 038B,E01006961,689,304,149,155,6,6,135,20,115,244,228,16,0
2021,Sefton 038C,E01006962,645,332,181,151,0,0,162,21,141,151,116,35,0
2021,Sefton 038D,E01006963,697,177,105,72,2,2,217,27,190,301,287,14,0
2021,Sefton 036A,E01006964,708,284,166,118,0,0,158,9,149,266,230,36,0
2021,Sefton 038E,E01006965,589,302,149,153,0,0,219,86,133,67,52,15,1
2021,Sefton 038F,E01006966,713,361,176,185,2,2,178,32,146,171,157,14,1
2021,Sefton 037A,E01006967,885,279,144,135,9,9,346,37,309,250,228,22,1
2021,Sefton 004D,E01006969,714,310,168,142,23,23,27,3,24,354,335,19,0
2021,Sefton 007B,E01006970,949,341,204,137,32,32,40,2,38,536,505,31,0
2021,Sefton 009C,E01006971,794,539,388,151,0,0,20,3,17,235,222,13,0
2021,Sefton 009D,E01006972,875,565,445,120,2,2,139,4,135,169,141,28,0
2021,Sefton 009E,E01006973,678,523,390,133,9,9,14,2,12,132,124,8,0
2021,Sefton 009F,E01006974,664,576,382,194,2,2,11,2,9,75,65,10,0
2021,Sefton 033A,E01006976,603,417,207,210,3,3,85,34,51,98,91,7,0
2021,Sefton 032E,E01006977,984,389,214,175,10,10,470,47,423,114,101,13,1
2021,Sefton 031A,E01006978,565,473,253,220,1,1,21,7,14,70,57,13,0
2021,Sefton 024A,E01006979,599,187,104,83,0,0,291,108,183,121,110,11,0
2021,Sefton 024B,E01006980,619,218,112,106,1,1,327,128,199,73,62,11,0
2021,Sefton 031B,E01006981,592,239,131,108,0,0,274,90,184,77,67,10,2
2021,Sefton 031C,E01006982,541,392,208,184,1,1,60,23,37,88,85,3,0
2021,Sefton 031D,E01006983,678,493,206,287,2,2,55,23,32,128,115,13,0
2021,Sefton 031E,E01006984,499,193,103,90,1,1,240,99,141,65,56,9,0
2021,Sefton 013A,E01006985,593,540,349,191,4,4,23,4,19,26,21,5,0
2021,Sefton 013B,E01006986,532,491,325,166,2,2,4,0,4,35,23,12,0
2021,Sefton 013C,E01006987,522,478,322,156,0,0,2,1,1,42,33,9,0
2021,Sefton 014A,E01006988,664,456,272,184,0,0,116,25,91,91,77,14,1
2021,Sefton 013D,E01006989,539,510,372,138,0,0,1,0,1,28,25,3,0
2021,Sefton 013E,E01006990,475,453,307,146,0,0,0,0,0,22,16,6,0
2021,Sefton 015A,E01006991,596,566,368,198,0,0,5,1,4,25,20,5,0
2021,Sefton 015B,E01006992,509,389,212,177,4,4,70,13,57,46,40,6,0
2021,Sefton 015C,E01006993,587,548,350,198,3,3,6,2,4,30,20,10,0
2021,Sefton 007C,E01006994,742,371,183,188,2,2,58,8,50,311,292,19,0
2021,Sefton 008A,E01006995,514,429,241,188,11,11,10,2,8,64,52,12,0
2021,Sefton 007D,E01006996,770,394,190,204,31,31,62,7,55,283,263,20,0
2021,Sefton 008B,E01006997,635,451,205,246,3,3,11,0,11,170,152,18,0
2021,Sefton 007E,E01006998,686,400,206,194,1,1,19,2,17,266,236,30,0
2021,Sefton 008C,E01006999,712,487,291,196,9,9,66,8,58,150,127,23,0
2021,Sefton 008D,E01007000,604,325,165,160,35,35,152,8,144,92,80,12,0
2021,Sefton 008E,E01007001,713,438,230,208,0,0,75,6,69,200,179,21,0
2021,Sefton 008F,E01007002,906,715,359,356,40,40,42,3,39,108,84,24,1
2021,Sefton 036B,E01007003,580,163,87,76,3,3,212,44,168,202,186,16,0
2021,Sefton 034A,E01007004,659,213,117,96,2,2,272,40,232,172,157,15,0
2021,Sefton 034B,E01007005,678,190,89,101,1,1,324,63,261,163,156,7,0
2021,Sefton 036C,E01007006,618,211,134,77,6,6,245,38,207,156,146,10,0
2021,Sefton 037B,E01007007,685,142,74,68,9,9,438,99,339,92,80,12,4
2021,Sefton 037C,E01007008,647,179,103,76,5,5,296,63,233,165,153,12,2
2021,Sefton 037D,E01007009,927,221,116,105,5,5,356,97,259,341,319,22,4
2021,Sefton 037E,E01007010,690,214,92,122,5,5,294,61,233,177,166,11,0
2021,Sefton 034C,E01007011,692,155,79,76,1,1,369,49,320,166,146,20,1
2021,Sefton 036D,E01007012,636,337,151,186,17,17,110,19,91,172,160,12,0
2021,Sefton 036E,E01007013,690,217,112,105,6,6,184,32,152,283,264,19,0
2021,Sefton 033B,E01007014,632,521,280,241,2,2,50,8,42,59,47,12,0
2021,Sefton 034D,E01007016,772,327,161,166,14,14,235,20,215,196,186,10,0
2021,Sefton 034E,E01007017,756,256,119,137,17,17,281,53,228,202,193,9,0
2021,Sefton 035A,E01007019,615,173,53,120,1,1,387,132,255,54,52,2,0
2021,Sefton 021A,E01007020,575,350,157,193,1,1,162,66,96,60,43,17,2
2021,Sefton 025A,E01007021,534,476,290,186,0,0,10,3,7,48,38,10,0
2021,Sefton 021B,E01007022,590,334,176,158,0,0,153,47,106,102,95,7,1
2021,Sefton 021C,E01007023,533,489,280,209,0,0,6,2,4,38,30,8,0
2021,Sefton 024C,E01007024,506,190,100,90,6,6,276,89,187,34,26,8,0
2021,Sefton 025B,E01007025,532,503,310,193,1,1,2,0,2,26,16,10,0
2021,Sefton 024D,E01007026,534,289,149,140,3,3,192,82,110,50,46,4,0
2021,Sefton 021D,E01007027,901,828,529,299,2,2,9,1,8,62,51,11,0
2021,Sefton 001B,E01007028,604,503,254,249,1,1,19,6,13,81,67,14,0
2021,Sefton 001C,E01007029,605,535,401,134,0,0,15,6,9,55,38,17,0
2021,Sefton 001D,E01007030,638,468,219,249,5,5,53,12,41,112,99,13,0
2021,Sefton 002B,E01007031,577,493,272,221,2,2,34,6,28,48,41,7,0
2021,Sefton 002C,E01007032,575,498,296,202,1,1,7,2,5,69,59,10,0
2021,Sefton 002D,E01007033,601,521,329,192,1,1,7,1,6,72,60,12,0
2021,Sefton 003E,E01007034,558,495,297,198,0,0,16,4,12,47,40,7,0
2021,Sefton 002E,E01007035,600,488,295,193,1,1,15,4,11,96,89,7,0
2021,Sefton 001E,E01007036,530,471,320,151,2,2,6,1,5,51,41,10,0
2021,Sefton 021E,E01007037,713,638,359,279,0,0,32,8,24,43,34,9,0
2021,Sefton 021F,E01007038,657,487,265,222,6,6,120,34,86,43,39,4,1
2021,Sefton 026A,E01007039,518,445,198,247,0,0,29,7,22,44,42,2,0
2021,Sefton 026B,E01007040,838,661,303,358,5,5,54,11,43,118,100,18,0
2021,Sefton 027A,E01007041,578,433,243,190,1,1,81,6,75,63,39,24,0
2021,Sefton 026C,E01007042,552,430,215,215,3,3,57,18,39,62,52,10,0
2021,Sefton 027B,E01007043,605,540,328,212,2,2,16,5,11,47,32,15,0
2021,Sefton 026D,E01007044,623,538,342,196,3,3,34,13,21,47,26,21,1
2021,Sefton 026E,E01007045,477,435,251,184,0,0,10,7,3,32,19,13,0
2021,Sefton 027C,E01007046,729,593,255,338,1,1,38,3,35,97,82,15,0
2021,Sefton 033E,E01007047,720,429,237,192,17,17,210,74,136,64,54,10,0
2021,Sefton 029A,E01007048,620,211,83,128,13,13,323,98,225,73,64,9,0
2021,Sefton 035B,E01007049,895,565,215,350,5,5,210,59,151,114,101,13,1
2021,Sefton 035C,E01007050,475,385,183,202,0,0,46,16,30,44,39,5,0
2021,Sefton 035D,E01007051,518,211,109,102,0,0,237,80,157,69,59,10,1
2021,Sefton 035E,E01007052,547,283,142,141,0,0,199,88,111,64,55,9,1
2021,Sefton 027D,E01007053,561,451,222,229,0,0,49,17,32,61,47,14,0
2021,Sefton 029B,E01007054,599,353,209,144,9,9,161,44,117,75,67,8,1
2021,Sefton 005A,E01007055,573,254,119,135,4,4,204,36,168,111,102,9,0
2021,Sefton 005B,E01007056,674,470,222,248,3,3,10,3,7,191,174,17,0
2021,Sefton 005C,E01007057,654,458,227,231,0,0,16,4,12,180,161,19,0
2021,Sefton 006A,E01007058,665,399,186,213,3,3,30,6,24,233,217,16,0
2021,Sefton 006B,E01007059,628,516,232,284,2,2,7,1,6,103,86,17,0
2021,Sefton 006C,E01007060,594,355,172,183,5,5,117,7,110,117,105,12,0
2021,Sefton 006D,E01007061,589,449,195,254,4,4,17,4,13,119,104,15,0
2021,Sefton 005D,E01007062,612,485,258,227,9,9,13,3,10,105,91,14,0
2021,Sefton 005E,E01007063,622,467,223,244,2,2,36,2,34,117,98,19,0
2021,Sefton 006E,E01007064,475,394,213,181,0,0,20,1,19,61,53,8,0
2021,Sefton 020A,E01007065,495,424,210,214,0,0,8,1,7,63,57,6,0
2021,Sefton 020B,E01007066,593,509,248,261,2,2,15,3,12,67,59,8,0
2021,Sefton 017A,E01007067,607,526,326,200,1,1,6,3,3,74,58,16,0
2021,Sefton 017B,E01007068,478,441,248,193,1,1,7,0,7,29,23,6,0
2021,Sefton 017C,E01007069,667,508,270,238,3,3,78,28,50,78,67,11,0
2021,Sefton 017D,E01007070,595,567,363,204,2,2,3,2,1,23,16,7,0
2021,Sefton 020C,E01007071,588,501,275,226,4,4,32,7,25,51,43,8,0
2021,Sefton 020D,E01007072,679,584,404,180,3,3,41,8,33,51,45,6,0
2021,Sefton 020E,E01007073,488,459,252,207,1,1,2,0,2,26,20,6,0
2021,Sefton 019A,E01007074,617,441,235,206,10,10,99,26,73,67,58,9,0
2021,Sefton 016A,E01007075,602,507,333,174,2,2,4,2,2,89,75,14,0
2021,Sefton 016B,E01007076,626,534,295,239,4,4,26,8,18,62,52,10,0
2021,Sefton 016C,E01007077,590,491,283,208,0,0,24,7,17,75,63,12,0
2021,Sefton 015D,E01007078,633,560,367,193,0,0,7,0,7,66,59,7,0
2021,Sefton 014B,E01007079,649,546,380,166,5,5,21,1,20,77,63,14,0
2021,Sefton 014C,E01007080,628,509,301,208,12,12,25,7,18,82,69,13,0
2021,Sefton 014D,E01007081,763,621,434,187,2,2,17,2,15,123,106,17,0
2021,Sefton 016D,E01007082,600,522,313,209,0,0,4,1,3,74,61,13,0
2021,Sefton 023A,E01007083,469,353,190,163,1,1,72,28,44,43,35,8,0
2021,Sefton 027E,E01007084,528,479,255,224,1,1,5,1,4,43,36,7,0
2021,Sefton 023B,E01007085,557,247,127,120,0,0,207,99,108,102,92,10,1
2021,Sefton 023C,E01007086,496,207,110,97,1,1,219,71,148,68,59,9,1
2021,Sefton 029C,E01007087,617,239,107,132,11,11,300,83,217,64,59,5,3
2021,Sefton 029D,E01007088,595,353,195,158,10,10,155,50,105,77,66,11,0
2021,Sefton 024E,E01007089,665,304,136,168,1,1,273,98,175,87,75,12,0
2021,Sefton 029E,E01007090,562,229,101,128,21,21,257,88,169,54,49,5,1
2021,Sefton 023D,E01007091,595,359,222,137,17,17,140,38,102,78,72,6,1
2021,Sefton 023E,E01007092,489,223,114,109,3,3,183,61,122,80,69,11,0
2021,Sefton 018C,E01007095,700,622,371,251,0,0,6,1,5,72,61,11,0
2021,Sefton 018D,E01007096,563,503,317,186,2,2,7,2,5,51,42,9,0
2021,Sefton 019B,E01007097,645,546,322,224,2,2,13,3,10,84,73,11,0
2021,Sefton 019C,E01007098,719,610,339,271,6,6,32,4,28,71,62,9,0
2021,Sefton 019D,E01007099,689,530,340,190,23,23,58,8,50,78,68,10,0
2021,Sefton 018E,E01007100,586,497,291,206,1,1,39,5,34,49,42,7,0
2021,Sefton 017E,E01007101,600,539,316,223,2,2,10,3,7,49,46,3,0
2021,Sefton 030D,E01007102,596,452,195,257,0,0,11,5,6,132,119,13,1
2021,Sefton 030E,E01007103,614,526,262,264,0,0,3,1,2,85,72,13,0
2021,Sefton 028D,E01007104,563,462,239,223,0,0,7,1,6,94,87,7,0
2021,Sefton 025C,E01007105,733,519,265,254,0,0,91,5,86,123,113,10,0
2021,Sefton 025D,E01007106,737,561,247,314,6,6,110,15,95,60,46,14,0
2021,Sefton 025E,E01007107,484,440,221,219,0,0,3,1,2,41,31,10,0
2021,Sefton 025F,E01007108,600,513,264,249,0,0,30,9,21,56,46,10,1
2021,Sefton 028E,E01007109,662,448,215,233,0,0,66,9,57,148,122,26,0
2021,Wirral 035A,E01007110,728,603,351,252,3,3,25,8,17,97,81,16,0
2021,Wirral 032A,E01007111,581,535,293,242,2,2,7,2,5,37,27,10,0
2021,Wirral 032B,E01007112,655,502,268,234,15,15,51,11,40,86,66,20,1
2021,Wirral 032C,E01007113,577,467,280,187,0,0,32,3,29,78,71,7,0
2021,Wirral 032D,E01007114,572,342,164,178,4,4,141,48,93,85,69,16,0
2021,Wirral 031A,E01007115,660,434,220,214,14,14,121,23,98,91,75,16,0
2021,Wirral 032E,E01007116,658,520,269,251,0,0,20,2,18,118,103,15,0
2021,Wirral 035B,E01007117,628,538,243,295,1,1,11,0,11,78,70,8,0
2021,Wirral 035C,E01007118,628,374,187,187,2,2,184,53,131,68,61,7,0
2021,Wirral 019A,E01007119,722,261,116,145,19,19,322,77,245,120,111,9,0
2021,Wirral 011A,E01007120,537,271,121,150,3,3,194,54,140,68,57,11,1
2021,Wirral 011B,E01007121,677,176,80,96,0,0,412,187,225,89,87,2,0
2021,Wirral 011C,E01007122,750,172,73,99,0,0,437,210,227,140,133,7,1
2021,Wirral 011D,E01007123,669,204,84,120,1,1,295,135,160,169,162,7,0
2021,Wirral 011E,E01007124,688,149,73,76,0,0,474,126,348,61,54,7,4
2021,Wirral 015A,E01007125,763,394,209,185,0,0,121,53,68,248,232,16,0
2021,Wirral 016B,E01007127,715,173,104,69,6,6,303,88,215,233,217,16,0
2021,Wirral 016C,E01007128,917,173,110,63,2,2,535,81,454,206,189,17,1
2021,Wirral 016D,E01007129,719,227,117,110,4,4,230,32,198,258,244,14,0
2021,Wirral 021A,E01007130,718,288,125,163,4,4,78,9,69,348,322,26,0
2021,Wirral 021B,E01007131,769,308,145,163,11,11,176,25,151,274,255,19,0
2021,Wirral 016E,E01007133,700,98,59,39,11,11,482,101,381,107,104,3,2
2021,Wirral 039A,E01007135,667,564,317,247,2,2,24,5,19,77,61,16,0
2021,Wirral 039B,E01007136,696,377,167,210,0,0,210,86,124,108,96,12,1
2021,Wirral 039C,E01007137,782,458,237,221,1,1,182,54,128,141,119,22,0
2021,Wirral 031B,E01007138,808,346,161,185,4,4,261,51,210,197,178,19,0
2021,Wirral 031C,E01007139,709,393,193,200,0,0,96,22,74,219,186,33,1
2021,Wirral 031D,E01007141,864,390,241,149,2,2,252,19,233,220,181,39,0
2021,Wirral 036B,E01007142,863,610,338,272,1,1,135,8,127,117,101,16,0
2021,Wirral 036C,E01007143,802,528,199,329,22,22,91,9,82,161,149,12,0
2021,Wirral 038A,E01007144,547,399,265,134,0,0,4,0,4,144,124,20,0
2021,Wirral 038B,E01007145,533,499,335,164,9,9,6,1,5,19,14,5,0
2021,Wirral 038C,E01007146,677,576,373,203,0,0,8,2,6,93,84,9,0
2021,Wirral 038D,E01007147,614,558,350,208,4,4,8,2,6,44,38,6,0
2021,Wirral 038E,E01007148,655,623,401,222,1,1,2,2,0,29,25,4,0
2021,Wirral 041A,E01007149,624,588,357,231,0,0,2,0,2,34,26,8,0
2021,Wirral 041B,E01007150,569,529,300,229,1,1,7,3,4,32,31,1,0
2021,Wirral 035D,E01007151,644,596,365,231,3,3,3,1,2,42,35,7,0
2021,Wirral 036D,E01007152,779,477,265,212,3,3,151,16,135,148,126,22,0
2021,Wirral 036E,E01007153,622,352,189,163,4,4,202,43,159,62,53,9,2
2021,Wirral 035E,E01007154,613,541,306,235,0,0,24,6,18,48,37,11,0
2021,Wirral 020A,E01007155,991,328,180,148,8,8,251,19,232,403,384,19,1
2021,Wirral 015B,E01007156,670,455,249,206,5,5,61,13,48,149,140,9,0
2021,Wirral 015C,E01007157,600,475,234,241,0,0,11,2,9,114,101,13,0
2021,Wirral 015D,E01007158,693,535,310,225,0,0,18,0,18,140,125,15,0
2021,Wirral 015E,E01007159,791,646,308,338,2,2,50,9,41,93,77,16,0
2021,Wirral 020B,E01007160,819,475,262,213,0,0,135,10,125,209,192,17,0
2021,Wirral 019B,E01007161,638,536,312,224,0,0,34,13,21,68,62,6,0
2021,Wirral 019C,E01007162,540,212,98,114,0,0,277,152,125,48,38,10,3
2021,Wirral 024A,E01007163,916,733,349,384,0,0,67,23,44,115,103,12,1
2021,Wirral 042A,E01007164,757,614,278,336,3,3,36,9,27,104,85,19,0
2021,Wirral 041C,E01007165,546,494,310,184,3,3,6,1,5,43,36,7,0
2021,Wirral 042B,E01007166,625,560,345,215,1,1,6,2,4,58,47,11,0
2021,Wirral 042C,E01007167,635,442,214,228,0,0,106,33,73,87,73,14,0
2021,Wirral 042D,E01007168,736,431,221,210,1,1,192,82,110,112,99,13,0
2021,Wirral 042E,E01007169,746,533,264,269,16,16,96,31,65,99,87,12,2
2021,Wirral 039D,E01007170,720,594,323,271,11,11,51,5,46,64,54,10,0
2021,Wirral 041D,E01007171,615,555,307,248,3,3,1,0,1,56,47,9,0
2021,Wirral 041E,E01007172,642,534,360,174,2,2,72,5,67,34,26,8,0
2021,Wirral 029A,E01007173,592,474,260,214,17,17,25,7,18,72,59,13,4
2021,Wirral 029B,E01007174,726,546,248,298,4,4,76,18,58,100,89,11,0
2021,Wirral 027A,E01007175,909,309,143,166,1,1,317,101,216,282,248,34,0
2021,Wirral 029C,E01007176,761,378,185,193,15,15,100,20,80,268,248,20,0
2021,Wirral 029D,E01007177,672,414,201,213,13,13,156,61,95,87,77,10,2
2021,Wirral 029E,E01007178,710,415,229,186,19,19,112,32,80,164,155,9,0
2021,Wirral 021C,E01007179,652,244,112,132,1,1,134,17,117,270,226,44,3
2021,Wirral 022A,E01007180,685,409,218,191,2,2,78,16,62,186,170,16,10
2021,Wirral 022B,E01007181,694,407,199,208,0,0,47,23,24,239,228,11,1
2021,Wirral 037A,E01007182,719,535,338,197,2,2,57,5,52,125,103,22,0
2021,Wirral 034A,E01007183,521,469,255,214,0,0,6,2,4,46,34,12,0
2021,Wirral 037B,E01007184,668,531,304,227,2,2,60,3,57,75,61,14,0
2021,Wirral 037C,E01007185,718,491,257,234,12,12,63,20,43,152,143,9,0
2021,Wirral 040A,E01007186,644,599,378,221,0,0,7,4,3,38,34,4,0
2021,Wirral 040B,E01007187,647,622,400,222,0,0,1,0,1,24,19,5,0
2021,Wirral 040C,E01007188,625,584,345,239,0,0,7,2,5,34,27,7,0
2021,Wirral 040D,E01007189,707,641,454,187,1,1,13,3,10,52,43,9,0
2021,Wirral 040E,E01007190,641,612,405,207,1,1,4,2,2,24,21,3,0
2021,Wirral 040F,E01007191,540,524,318,206,0,0,5,2,3,10,8,2,1
2021,Wirral 037D,E01007192,652,450,287,163,1,1,172,35,137,29,27,2,0
2021,Wirral 014A,E01007193,740,577,376,201,1,1,15,2,13,147,132,15,0
2021,Wirral 014B,E01007194,665,468,263,205,1,1,36,7,29,160,150,10,0
2021,Wirral 013A,E01007195,661,606,344,262,2,2,13,6,7,40,35,5,0
2021,Wirral 026A,E01007196,781,556,383,173,0,0,67,3,64,158,143,15,0
2021,Wirral 026B,E01007197,664,580,347,233,1,1,15,0,15,68,61,7,0
2021,Wirral 026C,E01007198,801,521,313,208,3,3,48,9,39,229,202,27,0
2021,Wirral 013B,E01007199,608,564,346,218,1,1,6,2,4,37,30,7,0
2021,Wirral 014C,E01007200,654,595,335,260,0,0,24,4,20,35,29,6,0
2021,Wirral 014D,E01007201,622,504,280,224,0,0,6,1,5,112,101,11,0
2021,Wirral 014E,E01007202,679,398,228,170,1,1,121,20,101,159,145,14,0
2021,Wirral 006A,E01007203,845,678,334,344,3,3,31,3,28,133,121,12,0
2021,Wirral 009A,E01007204,668,145,69,76,1,1,435,116,319,86,74,12,1
2021,Wirral 006B,E01007205,618,367,153,214,0,0,171,32,139,80,66,14,0
2021,Wirral 009B,E01007206,750,536,239,297,0,0,74,24,50,139,126,13,1
2021,Wirral 009C,E01007207,681,244,120,124,0,0,335,125,210,99,95,4,3
2021,Wirral 012A,E01007208,754,505,318,187,2,2,117,42,75,129,111,18,1
2021,Wirral 009D,E01007209,716,311,184,127,0,0,317,119,198,86,77,9,2
2021,Wirral 006C,E01007210,868,441,242,199,1,1,284,68,216,142,128,14,0
2021,Wirral 004A,E01007211,503,407,209,198,0,0,19,7,12,77,65,12,0
2021,Wirral 007A,E01007212,613,498,271,227,1,1,25,8,17,89,77,12,0
2021,Wirral 007B,E01007213,650,502,300,202,2,2,8,1,7,138,126,12,0
2021,Wirral 007C,E01007214,690,389,190,199,0,0,128,27,101,173,160,13,0
2021,Wirral 005A,E01007215,745,256,121,135,1,1,190,9,181,298,279,19,0
2021,Wirral 005B,E01007216,705,405,203,202,0,0,88,12,76,211,194,17,1
2021,Wirral 007D,E01007217,847,451,221,230,3,3,42,2,40,351,326,25,0
2021,Wirral 002A,E01007218,681,354,157,197,1,1,48,5,43,277,263,14,1
2021,Wirral 005C,E01007219,602,384,189,195,2,2,14,3,11,202,187,15,0
2021,Wirral 005D,E01007220,593,201,91,110,0,0,163,32,131,229,213,16,0
2021,Wirral 012B,E01007221,646,507,285,222,5,5,21,11,10,113,98,15,0
2021,Wirral 013C,E01007222,700,592,313,279,0,0,14,3,11,94,79,15,0
2021,Wirral 013D,E01007223,625,474,223,251,3,3,56,18,38,92,77,15,0
2021,Wirral 017A,E01007224,620,553,337,216,0,0,4,1,3,63,53,10,0
2021,Wirral 012C,E01007225,884,790,445,345,19,19,6,3,3,69,54,15,0
2021,Wirral 017B,E01007226,749,653,419,234,4,4,4,2,2,87,70,17,1
2021,Wirral 012D,E01007227,676,353,161,192,1,1,216,71,145,105,86,19,1
2021,Wirral 012E,E01007228,675,386,233,153,3,3,222,83,139,64,52,12,0
2021,Wirral 001A,E01007229,729,473,223,250,13,13,18,5,13,225,211,14,0
2021,Wirral 001B,E01007230,566,442,258,184,2,2,19,1,18,103,92,11,0
2021,Wirral 001C,E01007231,728,502,268,234,3,3,15,1,14,208,187,21,0
2021,Wirral 002B,E01007232,634,416,219,197,1,1,26,1,25,191,177,14,0
2021,Wirral 002C,E01007233,756,449,207,242,4,4,92,11,81,211,197,14,0
2021,Wirral 002D,E01007234,704,471,234,237,11,11,50,23,27,172,148,24,0
2021,Wirral 004B,E01007235,592,474,260,214,1,1,6,1,5,111,103,8,0
2021,Wirral 002E,E01007236,583,385,191,194,0,0,45,5,40,153,143,10,0
2021,Wirral 001D,E01007237,931,493,320,173,4,4,171,15,156,263,225,38,0
2021,Wirral 001E,E01007238,931,336,179,157,4,4,213,14,199,378,353,25,0
2021,Wirral 022C,E01007239,803,346,156,190,14,14,141,22,119,301,287,14,1
2021,Wirral 020C,E01007240,896,356,192,164,16,16,148,14,134,376,345,31,0
2021,Wirral 020D,E01007241,707,550,386,164,11,11,54,2,52,92,80,12,0
2021,Wirral 020E,E01007242,871,644,402,242,3,3,30,3,27,192,163,29,2
2021,Wirral 022D,E01007243,816,579,350,229,1,1,99,30,69,137,117,20,0
2021,Wirral 022E,E01007244,940,475,203,272,3,3,47,4,43,414,395,19,1
2021,Wirral 024B,E01007245,630,546,313,233,6,6,8,2,6,70,57,13,0
2021,Wirral 024C,E01007246,586,524,308,216,0,0,6,0,6,56,50,6,0
2021,Wirral 024D,E01007247,661,563,314,249,2,2,9,0,9,87,77,10,0
2021,Wirral 030A,E01007248,596,503,293,210,1,1,13,5,8,79,73,6,0
2021,Wirral 025A,E01007249,587,280,129,151,1,1,186,87,99,120,99,21,0
2021,Wirral 030B,E01007250,555,495,270,225,0,0,29,11,18,31,25,6,0
2021,Wirral 025B,E01007251,511,384,225,159,1,1,47,5,42,79,67,12,0
2021,Wirral 024E,E01007252,644,564,294,270,1,1,5,2,3,73,62,11,1
2021,Wirral 030C,E01007253,740,425,201,224,2,2,231,64,167,82,71,11,0
2021,Wirral 030D,E01007254,638,569,315,254,6,6,5,2,3,58,54,4,0
2021,Wirral 034B,E01007255,685,541,290,251,1,1,78,18,60,65,55,10,0
2021,Wirral 034C,E01007256,756,688,465,223,2,2,7,2,5,59,48,11,0
2021,Wirral 025C,E01007257,593,190,100,90,5,5,257,96,161,140,132,8,1
2021,Wirral 028A,E01007258,630,566,336,230,0,0,12,2,10,51,40,11,1
2021,Wirral 023A,E01007259,491,463,273,190,1,1,4,2,2,23,16,7,0
2021,Wirral 028B,E01007260,639,579,355,224,2,2,22,3,19,36,30,6,0
2021,Wirral 023B,E01007261,602,547,375,172,2,2,13,4,9,40,28,12,0
2021,Wirral 028C,E01007262,655,599,363,236,2,2,7,0,7,47,43,4,0
2021,Wirral 026D,E01007263,633,361,191,170,13,13,175,53,122,84,74,10,0
2021,Wirral 023C,E01007264,650,587,381,206,2,2,2,0,2,59,46,13,0
2021,Wirral 017C,E01007265,528,463,222,241,1,1,31,14,17,33,30,3,0
2021,Wirral 023D,E01007266,612,549,302,247,1,1,31,9,22,31,26,5,0
2021,Wirral 023E,E01007267,633,496,289,207,3,3,68,6,62,66,55,11,0
2021,Wirral 023F,E01007268,651,533,381,152,13,13,31,7,24,74,62,12,0
2021,Wirral 010C,E01007269,782,258,112,146,5,5,295,103,192,221,208,13,3
2021,Wirral 010D,E01007270,820,308,161,147,1,1,264,54,210,246,228,18,1
2021,Wirral 010E,E01007271,759,369,165,204,31,31,56,4,52,303,291,12,0
2021,Wirral 008A,E01007272,592,250,124,126,7,7,101,24,77,234,223,11,0
2021,Wirral 008B,E01007273,624,180,99,81,1,1,215,45,170,228,218,10,0
2021,Wirral 008C,E01007274,663,133,55,78,2,2,412,86,326,116,108,8,0
2021,Wirral 005E,E01007275,643,326,173,153,19,19,29,9,20,269,258,11,0
2021,Wirral 007E,E01007276,594,425,201,224,6,6,15,4,11,148,141,7,0
2021,Wirral 008D,E01007277,603,244,140,104,2,2,135,11,124,222,213,9,0
2021,Wirral 008E,E01007278,619,245,116,129,3,3,124,28,96,247,241,6,0
2021,Wirral 034D,E01007279,660,562,282,280,3,3,41,6,35,54,47,7,0
2021,Wirral 033A,E01007280,724,612,338,274,12,12,16,5,11,84,69,15,0
2021,Wirral 028D,E01007281,592,492,309,183,2,2,32,3,29,66,60,6,0
2021,Wirral 026E,E01007282,645,457,266,191,6,6,13,4,9,169,143,26,0
2021,Wirral 028E,E01007283,478,453,288,165,0,0,9,4,5,16,14,2,0
2021,Wirral 033B,E01007284,684,634,405,229,0,0,9,2,7,41,32,9,0
2021,Wirral 033C,E01007285,625,544,342,202,0,0,18,3,15,63,50,13,0
2021,Wirral 034E,E01007286,632,495,280,215,1,1,70,19,51,66,52,14,0
2021,Wirral 033D,E01007287,852,720,454,266,1,1,55,15,40,76,55,21,0
2021,Wirral 037E,E01007288,764,524,308,216,10,10,130,34,96,100,88,12,0
2021,Wirral 031E,E01007289,649,134,79,55,4,4,410,159,251,100,83,17,1
2021,Wirral 027B,E01007290,936,212,103,109,14,14,356,55,301,354,332,22,0
2021,Wirral 021D,E01007291,854,266,127,139,44,44,233,30,203,311,290,21,0
2021,Wirral 021E,E01007292,723,217,102,115,12,12,278,36,242,216,206,10,0
2021,Wirral 027C,E01007293,759,102,51,51,4,4,476,155,321,175,169,6,2
2021,Wirral 021F,E01007294,679,323,150,173,1,1,76,20,56,279,266,13,0
2021,Wirral 027D,E01007295,724,268,105,163,24,24,160,27,133,271,263,8,1
2021,Wirral 027E,E01007296,843,310,138,172,9,9,162,29,133,361,351,10,1
2021,Wirral 018A,E01007297,644,368,200,168,4,4,181,70,111,88,80,8,3
2021,Wirral 018B,E01007298,616,569,354,215,1,1,6,0,6,40,29,11,0
2021,Wirral 017D,E01007299,587,469,239,230,1,1,59,11,48,58,46,12,0
2021,Wirral 019D,E01007300,929,399,178,221,1,1,379,135,244,149,124,25,1
2021,Wirral 018C,E01007301,708,553,310,243,4,4,88,16,72,63,49,14,0
2021,Wirral 018D,E01007302,901,593,250,343,9,9,124,30,94,174,156,18,1
2021,Wirral 025D,E01007303,708,257,147,110,12,12,325,147,178,112,101,11,2
2021,Wirral 025E,E01007304,634,257,126,131,0,0,263,108,155,110,95,15,4
2021,Wirral 018E,E01007305,737,614,341,273,9,9,8,0,8,106,86,20,0
2021,Wirral 017E,E01007306,728,601,331,270,9,9,4,3,1,114,100,14,0
2021,Wirral 003A,E01007307,713,576,327,249,2,2,13,3,10,122,110,12,0
2021,Wirral 003B,E01007308,723,572,383,189,4,4,17,2,15,129,121,8,1
2021,Wirral 006D,E01007309,601,532,343,189,10,10,4,0,4,55,43,12,0
2021,Wirral 004C,E01007310,530,453,245,208,0,0,10,2,8,67,59,8,0
2021,Wirral 004D,E01007311,599,512,299,213,1,1,14,4,10,72,61,11,0
2021,Wirral 003C,E01007312,656,484,244,240,9,9,87,17,70,75,59,16,1
2021,Wirral 003D,E01007313,790,449,276,173,2,2,138,23,115,200,183,17,1
2021,Wirral 004E,E01007314,589,438,229,209,1,1,18,5,13,132,121,11,0
2021,Wirral 003E,E01007315,612,518,283,235,1,1,6,4,2,87,76,11,0
2021,Wirral 004F,E01007316,596,525,301,224,1,1,6,1,5,64,54,10,0
2021,Barnsley 018A,E01007317,660,308,188,120,1,1,295,276,19,51,46,5,5
2021,Barnsley 018B,E01007318,654,282,104,178,5,5,241,175,66,123,112,11,3
2021,Barnsley 015A,E01007319,626,555,338,217,1,1,17,13,4,53,46,7,0
2021,Barnsley 018C,E01007320,728,314,165,149,7,7,277,205,72,129,115,14,1
2021,Barnsley 015B,E01007321,688,575,396,179,6,6,35,32,3,72,60,12,0
2021,Barnsley 015C,E01007322,922,528,225,303,4,4,85,64,21,305,290,15,0
2021,Barnsley 007A,E01007323,664,340,143,197,19,19,222,177,45,82,76,6,1
2021,Barnsley 007B,E01007324,720,382,221,161,2,2,243,227,16,88,78,10,5
2021,Barnsley 007C,E01007325,596,211,99,112,3,3,346,337,9,33,27,6,3
2021,Barnsley 007D,E01007326,721,364,205,159,3,3,296,196,100,53,39,14,5
2021,Barnsley 007E,E01007327,790,362,201,161,1,1,357,332,25,66,57,9,4
2021,Barnsley 006A,E01007328,854,438,175,263,9,9,316,258,58,84,69,15,7
2021,Barnsley 003A,E01007329,637,433,216,217,0,0,138,127,11,60,47,13,6
2021,Barnsley 006B,E01007330,769,555,251,304,2,2,120,102,18,91,77,14,1
2021,Barnsley 003B,E01007331,828,615,348,267,0,0,61,45,16,150,130,20,2
2021,Barnsley 006C,E01007332,983,479,215,264,2,2,221,145,76,278,243,35,3
2021,Barnsley 006D,E01007333,585,348,190,158,1,1,81,11,70,155,144,11,0
2021,Barnsley 009A,E01007334,558,454,277,177,1,1,10,4,6,93,81,12,0
2021,Barnsley 009B,E01007335,607,506,304,202,3,3,53,6,47,45,39,6,0
2021,Barnsley 013A,E01007336,748,331,187,144,5,5,87,60,27,325,312,13,0
2021,Barnsley 015D,E01007337,883,409,199,210,3,3,62,37,25,408,375,33,1
2021,Barnsley 017A,E01007338,971,225,152,73,3,3,450,318,132,275,261,14,18
2021,Barnsley 017B,E01007339,700,237,144,93,2,2,111,51,60,348,325,23,2
2021,Barnsley 013B,E01007340,869,358,163,195,3,3,48,28,20,457,432,25,3
2021,Barnsley 008A,E01007341,510,172,81,91,1,1,289,280,9,48,41,7,0
2021,Barnsley 003C,E01007342,568,444,282,162,0,0,28,24,4,96,81,15,0
2021,Barnsley 003D,E01007343,683,354,184,170,0,0,201,171,30,122,117,5,6
2021,Barnsley 011A,E01007344,1052,732,297,435,5,5,100,67,33,212,187,25,3
2021,Barnsley 008B,E01007345,665,421,252,169,0,0,31,31,0,211,189,22,2
2021,Barnsley 008C,E01007346,675,449,195,254,0,0,89,68,21,135,116,19,2
2021,Barnsley 008D,E01007347,781,630,272,358,2,2,49,42,7,99,80,19,1
2021,Barnsley 020A,E01007348,630,349,223,126,3,3,207,175,32,68,53,15,3
2021,Barnsley 020B,E01007349,714,411,213,198,2,2,158,125,33,143,130,13,0
2021,Barnsley 020C,E01007350,514,435,318,117,7,7,37,32,5,35,26,9,0
2021,Barnsley 020D,E01007351,737,430,248,182,12,12,163,95,68,131,116,15,1
2021,Barnsley 020E,E01007352,639,276,141,135,1,1,272,234,38,85,79,6,5
2021,Barnsley 020F,E01007353,715,447,243,204,2,2,96,43,53,170,140,30,0
2021,Barnsley 020G,E01007354,723,508,286,222,2,2,63,49,14,149,132,17,1
2021,Barnsley 005A,E01007355,605,525,267,258,0,0,25,25,0,54,48,6,1
2021,Barnsley 004A,E01007356,618,542,334,208,1,1,20,13,7,55,41,14,0
2021,Barnsley 004B,E01007357,622,359,189,170,0,0,171,132,39,92,82,10,0
2021,Barnsley 005B,E01007358,636,475,248,227,1,1,28,24,4,132,120,12,0
2021,Barnsley 005C,E01007359,653,406,218,188,0,0,129,110,19,116,104,12,2
2021,Barnsley 005D,E01007360,652,472,300,172,1,1,128,124,4,49,43,6,2
2021,Barnsley 004C,E01007361,837,636,272,364,0,0,39,28,11,162,137,25,0
2021,Barnsley 004D,E01007362,908,797,393,404,4,4,34,12,22,73,56,17,0
2021,Barnsley 004E,E01007363,794,395,202,193,0,0,320,301,19,74,67,7,5
2021,Barnsley 025A,E01007364,596,321,163,158,3,3,197,192,5,70,58,12,5
2021,Barnsley 025B,E01007365,512,241,110,131,1,1,182,174,8,85,73,12,3
2021,Barnsley 025C,E01007366,972,791,344,447,0,0,34,31,3,146,123,23,1
2021,Barnsley 025D,E01007367,466,313,181,132,0,0,11,9,2,142,132,10,0
2021,Barnsley 025E,E01007368,734,468,234,234,2,2,72,38,34,190,174,16,2
2021,Barnsley 022A,E01007369,909,492,189,303,4,4,87,65,22,326,300,26,0
2021,Barnsley 022B,E01007370,768,452,205,247,0,0,162,150,12,152,130,22,2
2021,Barnsley 022C,E01007371,808,507,252,255,1,1,141,129,12,156,140,16,3
2021,Barnsley 014A,E01007372,746,331,129,202,0,0,273,191,82,141,133,8,1
2021,Barnsley 014B,E01007373,734,273,163,110,19,19,248,36,212,194,179,15,0
2021,Barnsley 014C,E01007374,650,511,331,180,1,1,40,33,7,97,82,15,1
2021,Barnsley 014D,E01007375,739,505,297,208,0,0,117,59,58,116,102,14,1
2021,Barnsley 022D,E01007376,693,317,179,138,1,1,172,76,96,201,186,15,2
2021,Barnsley 014E,E01007377,564,264,147,117,5,5,156,37,119,139,127,12,0
2021,Barnsley 014F,E01007378,750,264,127,137,1,1,366,341,25,112,103,9,7
2021,Barnsley 012A,E01007379,691,573,373,200,3,3,42,35,7,73,56,17,0
2021,Barnsley 012B,E01007380,772,636,351,285,1,1,33,30,3,102,93,9,0
2021,Barnsley 012C,E01007381,899,701,323,378,28,28,96,31,65,70,60,10,4
2021,Barnsley 019A,E01007382,736,480,232,248,0,0,138,123,15,115,96,19,3
2021,Barnsley 019B,E01007383,517,438,224,214,1,1,31,27,4,47,42,5,0
2021,Barnsley 019C,E01007384,745,629,365,264,0,0,49,43,6,67,59,8,0
2021,Barnsley 019D,E01007385,672,347,208,139,1,1,235,218,17,81,71,10,8
2021,Barnsley 005E,E01007386,841,746,442,304,2,2,8,2,6,85,63,22,0
2021,Barnsley 012D,E01007387,616,426,238,188,4,4,93,85,8,89,71,18,4
2021,Barnsley 029A,E01007388,778,535,274,261,7,7,100,62,38,135,116,19,1
2021,Barnsley 030A,E01007389,664,545,396,149,2,2,51,22,29,65,54,11,1
2021,Barnsley 030B,E01007390,666,507,302,205,6,6,74,68,6,79,62,17,0
2021,Barnsley 030C,E01007391,699,310,146,164,5,5,276,247,29,102,93,9,6
2021,Barnsley 030D,E01007392,615,298,128,170,1,1,231,225,6,85,67,18,0
2021,Barnsley 029B,E01007393,868,469,221,248,11,11,201,115,86,187,167,20,0
2021,Barnsley 029C,E01007394,584,304,146,158,0,0,179,168,11,101,92,9,0
2021,Barnsley 030E,E01007395,838,447,202,245,2,2,289,277,12,93,82,11,7
2021,Barnsley 028A,E01007396,754,474,245,229,1,1,99,94,5,178,150,28,2
2021,Barnsley 028B,E01007397,696,391,217,174,1,1,221,208,13,78,63,15,5
2021,Barnsley 028C,E01007398,772,606,406,200,4,4,100,86,14,61,48,13,1
2021,Barnsley 028D,E01007399,930,640,296,344,25,25,83,53,30,181,167,14,1
2021,Barnsley 009C,E01007400,959,746,360,386,0,0,121,91,30,91,76,15,1
2021,Barnsley 011B,E01007402,771,311,117,194,1,1,366,300,66,92,79,13,1
2021,Barnsley 011C,E01007403,607,258,132,126,2,2,284,203,81,59,41,18,4
2021,Barnsley 009D,E01007404,628,509,356,153,0,0,59,29,30,59,33,26,1
2021,Barnsley 011D,E01007405,784,589,351,238,0,0,117,102,15,76,58,18,2
2021,Barnsley 009E,E01007406,819,351,170,181,3,3,361,328,33,95,79,16,9
2021,Barnsley 010C,E01007408,654,448,232,216,1,1,76,62,14,128,109,19,1
2021,Barnsley 010D,E01007409,655,481,272,209,4,4,41,16,25,128,113,15,1
2021,Barnsley 010E,E01007410,916,413,224,189,7,7,345,287,58,144,126,18,7
2021,Barnsley 007F,E01007411,593,162,63,99,0,0,370,280,90,56,42,14,5
2021,Barnsley 017C,E01007413,640,267,130,137,12,12,263,197,66,90,78,12,8
2021,Barnsley 017D,E01007414,916,511,196,315,10,10,207,87,120,186,175,11,2
2021,Barnsley 013C,E01007415,677,447,244,203,1,1,115,105,10,111,102,9,3
2021,Barnsley 018D,E01007416,588,269,123,146,0,0,255,231,24,60,53,7,4
2021,Barnsley 013D,E01007417,840,395,182,213,11,11,68,23,45,363,335,28,3
2021,Barnsley 016A,E01007418,599,429,293,136,13,13,49,36,13,108,94,14,0
2021,Barnsley 016B,E01007419,705,589,361,228,1,1,33,19,14,82,66,16,0
2021,Barnsley 016C,E01007420,623,500,311,189,3,3,84,78,6,35,31,4,1
2021,Barnsley 027A,E01007421,597,443,287,156,0,0,25,17,8,128,100,28,1
2021,Barnsley 027B,E01007422,647,530,303,227,0,0,58,52,6,59,47,12,0
2021,Barnsley 027C,E01007423,714,507,279,228,3,3,135,119,16,66,54,12,3
2021,Barnsley 028E,E01007424,823,594,275,319,6,6,142,114,28,77,64,13,4
2021,Barnsley 016D,E01007425,764,676,380,296,2,2,25,16,9,61,42,19,0
2021,Barnsley 027D,E01007426,813,629,337,292,2,2,93,59,34,88,60,28,1
2021,Barnsley 024A,E01007427,731,549,285,264,2,2,87,74,13,93,82,11,0
2021,Barnsley 024B,E01007428,689,548,336,212,0,0,43,26,17,98,73,25,0
2021,Barnsley 024C,E01007429,712,343,217,126,17,17,270,157,113,78,61,17,4
2021,Barnsley 024D,E01007430,1137,944,363,581,7,7,16,12,4,170,154,16,0
2021,Barnsley 024E,E01007431,578,467,276,191,4,4,64,58,6,43,37,6,0
2021,Barnsley 024F,E01007432,697,530,271,259,3,3,92,81,11,72,61,11,0
2021,Barnsley 002A,E01007433,697,481,245,236,3,3,143,96,47,69,54,15,1
2021,Barnsley 001A,E01007434,1038,693,261,432,28,28,134,110,24,181,159,22,2
2021,Barnsley 001B,E01007435,734,327,161,166,12,12,310,253,57,79,70,9,6
2021,Barnsley 002B,E01007436,612,469,281,188,0,0,77,69,8,66,58,8,0
2021,Barnsley 002C,E01007437,633,379,192,187,5,5,138,124,14,108,91,17,3
2021,Barnsley 001C,E01007438,621,477,279,198,0,0,95,83,12,45,34,11,4
2021,Barnsley 001D,E01007439,623,528,295,233,5,5,47,34,13,43,31,12,0
2021,Barnsley 002D,E01007440,669,364,205,159,11,11,116,84,32,177,155,22,1
2021,Barnsley 013E,E01007441,741,435,201,234,0,0,62,49,13,240,209,31,4
2021,Barnsley 012E,E01007442,662,588,428,160,0,0,29,26,3,44,36,8,1
2021,Barnsley 013F,E01007443,1177,314,148,166,2,2,180,141,39,678,640,38,3
2021,Barnsley 012F,E01007444,976,688,319,369,3,3,164,123,41,115,97,18,6
2021,Barnsley 013G,E01007445,758,372,194,178,14,14,118,70,48,253,236,17,1
2021,Barnsley 012G,E01007446,627,399,250,149,5,5,80,68,12,142,123,19,1
2021,Barnsley 023A,E01007447,751,370,177,193,0,0,299,215,84,78,60,18,4
2021,Barnsley 023B,E01007448,1064,575,232,343,2,2,124,49,75,362,334,28,1
2021,Barnsley 023C,E01007449,823,521,324,197,0,0,26,15,11,276,255,21,0
2021,Barnsley 023D,E01007450,910,456,222,234,0,0,362,245,117,91,79,12,1
2021,Barnsley 026A,E01007451,821,447,192,255,5,5,180,172,8,186,160,26,3
2021,Barnsley 026B,E01007452,697,533,219,314,1,1,31,28,3,130,108,22,2
2021,Barnsley 026C,E01007453,715,267,133,134,7,7,381,344,37,55,46,9,5
2021,Barnsley 026E,E01007455,637,532,328,204,6,6,67,58,9,31,26,5,1
2021,Barnsley 029D,E01007456,781,601,332,269,1,1,43,39,4,135,116,19,1
2021,Barnsley 029E,E01007457,755,437,179,258,1,1,192,178,14,121,111,10,4
2021,Barnsley 021A,E01007458,665,432,230,202,4,4,97,89,8,131,109,22,1
2021,Barnsley 021B,E01007459,744,593,413,180,6,6,81,77,4,64,50,14,0
2021,Barnsley 021C,E01007460,625,457,305,152,2,2,107,95,12,58,39,19,1
2021,Barnsley 021D,E01007461,806,400,180,220,1,1,302,260,42,102,88,14,1
2021,Barnsley 021E,E01007462,655,295,152,143,1,1,288,278,10,67,58,9,4
2021,Barnsley 021F,E01007463,770,267,140,127,0,0,427,384,43,70,56,14,6
2021,Doncaster 009A,E01007464,605,330,172,158,0,0,197,111,86,77,65,12,1
2021,Doncaster 009B,E01007465,754,484,207,277,16,16,169,165,4,84,66,18,1
2021,Doncaster 009C,E01007466,774,416,152,264,0,0,214,162,52,139,122,17,5
2021,Doncaster 009D,E01007467,651,382,175,207,3,3,168,121,47,97,83,14,1
2021,Doncaster 005A,E01007468,592,527,378,149,3,3,8,7,1,54,38,16,0
2021,Doncaster 005B,E01007469,525,380,214,166,0,0,47,45,2,98,85,13,0
2021,Doncaster 005C,E01007470,536,348,154,194,0,0,85,80,5,102,88,14,1
2021,Doncaster 009E,E01007471,601,464,226,238,1,1,62,58,4,74,67,7,0
2021,Doncaster 005D,E01007472,602,280,147,133,1,1,242,233,9,72,58,14,7
2021,Doncaster 005E,E01007473,594,352,184,168,0,0,74,65,9,168,152,16,0
2021,Doncaster 005F,E01007474,611,197,99,98,0,0,319,255,64,84,70,14,11
2021,Doncaster 011A,E01007475,631,521,295,226,1,1,11,7,4,98,90,8,0
2021,Doncaster 011B,E01007476,753,511,236,275,5,5,149,121,28,83,70,13,5
2021,Doncaster 011C,E01007477,621,509,312,197,2,2,36,32,4,74,62,12,0
2021,Doncaster 011D,E01007478,697,477,258,219,0,0,94,61,33,126,114,12,0
2021,Doncaster 014A,E01007479,683,413,216,197,0,0,138,80,58,130,119,11,2
2021,Doncaster 014B,E01007480,555,338,146,192,3,3,86,82,4,125,119,6,3
2021,Doncaster 014D,E01007482,666,333,169,164,0,0,214,181,33,112,98,14,7
2021,Doncaster 017A,E01007483,606,491,305,186,1,1,31,23,8,83,70,13,0
2021,Doncaster 017B,E01007484,624,430,257,173,0,0,95,91,4,99,83,16,0
2021,Doncaster 017C,E01007485,608,539,275,264,4,4,11,7,4,54,44,10,0
2021,Doncaster 017D,E01007486,626,517,389,128,2,2,32,21,11,73,57,16,2
2021,Doncaster 002A,E01007487,694,429,220,209,0,0,194,184,10,65,53,12,6
2021,Doncaster 002B,E01007488,692,567,357,210,2,2,22,12,10,101,83,18,0
2021,Doncaster 002C,E01007489,930,638,304,334,13,13,56,44,12,222,202,20,1
2021,Doncaster 002D,E01007490,704,511,290,221,7,7,96,69,27,90,71,19,0
2021,Doncaster 002E,E01007491,662,350,183,167,3,3,66,59,7,242,227,15,1
2021,Doncaster 002F,E01007492,728,272,141,131,8,8,329,262,67,114,102,12,5
2021,Doncaster 002G,E01007493,719,584,324,260,0,0,32,24,8,103,79,24,0
2021,Doncaster 023A,E01007494,696,427,202,225,11,11,41,29,12,213,194,19,4
2021,Doncaster 028A,E01007495,747,308,172,136,1,1,190,163,27,238,219,19,10
2021,Doncaster 029A,E01007496,613,192,75,117,3,3,305,225,80,109,88,21,4
2021,Doncaster 029B,E01007497,535,316,149,167,1,1,139,99,40,72,64,8,7
2021,Doncaster 029C,E01007498,665,361,205,156,3,3,102,77,25,198,181,17,1
2021,Doncaster 029D,E01007499,618,194,98,96,2,2,342,324,18,78,64,14,2
2021,Doncaster 028B,E01007500,553,248,106,142,0,0,232,221,11,68,63,5,5
2021,Doncaster 029E,E01007501,619,539,367,172,0,0,16,14,2,63,50,13,1
2021,Doncaster 029F,E01007503,679,566,312,254,3,3,18,7,11,92,75,17,0
2021,Doncaster 009F,E01007504,607,381,204,177,2,2,111,99,12,108,89,19,5
2021,Doncaster 013A,E01007505,700,525,340,185,5,5,77,60,17,92,82,10,1
2021,Doncaster 010A,E01007506,712,393,132,261,1,1,191,161,30,124,105,19,3
2021,Doncaster 009G,E01007507,480,237,119,118,1,1,153,145,8,88,78,10,1
2021,Doncaster 010B,E01007508,687,292,151,141,4,4,185,168,17,201,186,15,5
2021,Doncaster 010C,E01007509,801,296,157,139,22,22,233,121,112,246,227,19,4
2021,Doncaster 010D,E01007510,755,379,191,188,3,3,148,54,94,224,207,17,1
2021,Doncaster 010E,E01007511,608,261,141,120,14,14,224,172,52,107,94,13,2
2021,Doncaster 012A,E01007512,870,668,252,416,22,22,80,71,9,100,82,18,0
2021,Doncaster 012B,E01007513,685,441,239,202,1,1,145,116,29,93,78,15,5
2021,Doncaster 013B,E01007514,701,366,174,192,0,0,13,10,3,322,289,33,0
2021,Doncaster 012C,E01007515,636,378,186,192,0,0,182,176,6,74,57,17,2
2021,Doncaster 013C,E01007516,641,482,237,245,5,5,65,61,4,89,77,12,0
2021,Doncaster 013D,E01007517,710,320,166,154,1,1,61,53,8,327,299,28,1
2021,Doncaster 012D,E01007518,619,496,249,247,1,1,81,77,4,38,32,6,3
2021,Doncaster 012E,E01007519,555,378,172,206,3,3,62,55,7,112,99,13,0
2021,Doncaster 027A,E01007520,593,532,384,148,3,3,6,4,2,50,35,15,2
2021,Doncaster 025A,E01007521,591,487,292,195,0,0,58,10,48,46,33,13,0
2021,Doncaster 024A,E01007522,740,301,146,155,1,1,320,254,66,110,96,14,8
2021,Doncaster 025B,E01007523,667,522,334,188,0,0,10,3,7,135,115,20,0
2021,Doncaster 025C,E01007524,711,581,345,236,3,3,35,31,4,92,78,14,0
2021,Doncaster 024B,E01007525,671,357,150,207,1,1,198,176,22,111,94,17,4
2021,Doncaster 025D,E01007526,865,722,382,340,4,4,28,25,3,111,102,9,0
2021,Doncaster 024C,E01007528,626,320,149,171,1,1,207,203,4,94,87,7,4
2021,Doncaster 022A,E01007529,651,190,123,67,3,3,93,58,35,365,340,25,0
2021,Doncaster 022B,E01007530,662,258,110,148,1,1,87,48,39,316,289,27,0
2021,Doncaster 022C,E01007531,769,306,170,136,1,1,207,156,51,251,232,19,4
2021,Doncaster 023B,E01007532,935,59,37,22,0,0,732,683,49,134,105,29,10
2021,Doncaster 023C,E01007533,659,286,155,131,2,2,169,47,122,202,183,19,0
2021,Doncaster 028D,E01007534,944,232,129,103,5,5,102,25,77,601,574,27,4
2021,Doncaster 023D,E01007535,629,274,157,117,3,3,60,29,31,291,276,15,1
2021,Doncaster 032A,E01007536,870,591,302,289,0,0,31,15,16,247,212,35,1
2021,Doncaster 035A,E01007537,694,507,276,231,0,0,91,89,2,95,69,26,1
2021,Doncaster 035B,E01007538,596,412,219,193,1,1,117,100,17,62,55,7,4
2021,Doncaster 035C,E01007539,557,295,135,160,1,1,116,97,19,144,129,15,1
2021,Doncaster 035D,E01007540,654,464,260,204,1,1,83,73,10,105,86,19,1
2021,Doncaster 035E,E01007541,682,404,230,174,1,1,189,183,6,82,66,16,6
2021,Doncaster 032B,E01007542,947,434,194,240,2,2,357,292,65,144,126,18,10
2021,Doncaster 032C,E01007543,669,251,133,118,0,0,360,317,43,55,46,9,3
2021,Doncaster 032D,E01007544,752,154,71,83,3,3,532,483,49,48,41,7,15
2021,Doncaster 034A,E01007545,604,385,170,215,5,5,61,24,37,153,137,16,0
2021,Doncaster 033A,E01007546,609,323,188,135,0,0,76,71,5,209,196,13,1
2021,Doncaster 034B,E01007547,642,381,190,191,2,2,68,57,11,191,184,7,0
2021,Doncaster 034C,E01007548,756,422,155,267,1,1,146,91,55,186,176,10,1
2021,Doncaster 034D,E01007549,706,305,150,155,6,6,307,244,63,83,70,13,5
2021,Doncaster 034E,E01007550,690,429,218,211,4,4,193,164,29,59,48,11,5
2021,Doncaster 033B,E01007551,711,585,322,263,1,1,45,43,2,79,67,12,1
2021,Doncaster 033C,E01007552,603,479,269,210,1,1,39,36,3,82,65,17,2
2021,Doncaster 008A,E01007553,737,589,345,244,3,3,44,27,17,101,75,26,0
2021,Doncaster 006A,E01007554,684,526,263,263,2,2,29,23,6,126,112,14,1
2021,Doncaster 006B,E01007555,618,278,135,143,1,1,272,264,8,62,49,13,5
2021,Doncaster 006C,E01007556,535,301,137,164,0,0,141,135,6,93,81,12,0
2021,Doncaster 008B,E01007557,457,365,240,125,1,1,6,5,1,85,71,14,0
2021,Doncaster 008C,E01007558,618,481,264,217,0,0,65,59,6,71,56,15,1
2021,Doncaster 008D,E01007559,434,365,235,130,1,1,17,13,4,51,39,12,0
2021,Doncaster 008E,E01007560,726,613,367,246,11,11,23,15,8,79,67,12,0
2021,Doncaster 006D,E01007561,560,513,294,219,3,3,4,2,2,40,35,5,0
2021,Doncaster 006E,E01007562,608,471,269,202,0,0,39,37,2,98,82,16,0
2021,Doncaster 006F,E01007563,553,285,119,166,0,0,156,142,14,111,93,18,1
2021,Doncaster 018A,E01007564,612,285,111,174,1,1,211,204,7,109,95,14,6
2021,Doncaster 018B,E01007565,642,525,302,223,2,2,10,7,3,104,87,17,1
2021,Doncaster 018C,E01007566,776,286,140,146,1,1,372,332,40,110,76,34,7
2021,Doncaster 018D,E01007567,531,359,185,174,2,2,52,44,8,118,100,18,0
2021,Doncaster 018E,E01007568,586,260,95,165,0,0,243,222,21,82,74,8,1
2021,Doncaster 018F,E01007569,616,323,140,183,0,0,191,183,8,96,83,13,6
2021,Doncaster 015A,E01007570,641,515,302,213,0,0,56,49,7,70,56,14,0
2021,Doncaster 031A,E01007571,760,427,201,226,5,5,103,50,53,225,204,21,0
2021,Doncaster 031B,E01007572,578,420,276,144,0,0,110,102,8,47,36,11,1
2021,Doncaster 031C,E01007573,642,197,86,111,1,1,373,352,21,63,56,7,8
2021,Doncaster 031D,E01007574,625,262,139,123,5,5,171,124,47,187,170,17,0
2021,Doncaster 030A,E01007575,590,127,61,66,0,0,412,399,13,44,40,4,7
2021,Doncaster 031E,E01007576,651,414,228,186,2,2,87,68,19,148,135,13,0
2021,Doncaster 031F,E01007577,693,277,132,145,1,1,146,61,85,269,253,16,0
2021,Doncaster 030B,E01007578,692,362,170,192,0,0,169,158,11,160,147,13,1
2021,Doncaster 030C,E01007579,1196,688,246,442,0,0,217,160,57,289,252,37,2
2021,Doncaster 030D,E01007580,606,463,310,153,6,6,85,80,5,50,43,7,2
2021,Doncaster 016A,E01007581,619,544,322,222,18,18,6,6,0,51,45,6,0
2021,Doncaster 016B,E01007582,616,496,251,245,0,0,8,5,3,111,101,10,1
2021,Doncaster 020A,E01007583,618,493,321,172,2,2,25,19,6,98,81,17,0
2021,Doncaster 021A,E01007584,692,494,272,222,1,1,15,9,6,182,152,30,0
2021,Doncaster 021B,E01007585,649,505,246,259,0,0,27,23,4,117,96,21,0
2021,Doncaster 020B,E01007586,660,558,365,193,1,1,46,37,9,53,44,9,2
2021,Doncaster 020C,E01007587,779,369,231,138,16,16,265,198,67,126,110,16,3
2021,Doncaster 016C,E01007588,692,500,259,241,1,1,80,74,6,110,98,12,1
2021,Doncaster 016D,E01007589,732,592,337,255,1,1,77,63,14,62,50,12,0
2021,Doncaster 037A,E01007590,488,308,149,159,0,0,83,78,5,96,78,18,1
2021,Doncaster 036A,E01007591,612,424,241,183,1,1,68,65,3,119,97,22,0
2021,Doncaster 037B,E01007592,663,285,117,168,0,0,169,154,15,208,194,14,1
2021,Doncaster 037C,E01007593,807,565,187,378,0,0,83,77,6,158,146,12,1
2021,Doncaster 036B,E01007594,838,666,286,380,10,10,16,8,8,146,126,20,0
2021,Doncaster 037D,E01007595,625,362,160,202,2,2,155,147,8,103,86,17,3
2021,Doncaster 036C,E01007596,510,471,296,175,1,1,3,1,2,35,27,8,0
2021,Doncaster 037E,E01007597,680,230,105,125,1,1,361,340,21,80,69,11,8
2021,Doncaster 036D,E01007598,688,568,352,216,2,2,22,22,0,96,76,20,0
2021,Doncaster 026A,E01007599,736,645,364,281,2,2,29,29,0,60,48,12,0
2021,Doncaster 026B,E01007600,605,548,378,170,0,0,3,3,0,54,40,14,0
2021,Doncaster 026C,E01007601,702,612,384,228,1,1,44,27,17,45,33,12,0
2021,Doncaster 026D,E01007602,812,690,334,356,3,3,34,24,10,84,56,28,1
2021,Doncaster 026E,E01007603,682,558,308,250,3,3,7,7,0,114,89,25,0
2021,Doncaster 024D,E01007604,573,515,320,195,1,1,6,5,1,50,44,6,1
2021,Doncaster 027C,E01007605,650,520,317,203,25,25,48,45,3,57,43,14,0
2021,Doncaster 027D,E01007606,881,800,370,430,0,0,16,10,6,64,55,9,1
2021,Doncaster 025E,E01007607,637,365,202,163,1,1,173,165,8,96,86,10,2
2021,Doncaster 038B,E01007609,1018,691,375,316,6,6,162,111,51,159,138,21,0
2021,Doncaster 038C,E01007610,852,718,470,248,2,2,13,10,3,116,106,10,3
2021,Doncaster 039A,E01007611,581,423,269,154,0,0,85,59,26,71,57,14,2
2021,Doncaster 039B,E01007612,632,507,336,171,0,0,30,28,2,95,81,14,0
2021,Doncaster 033D,E01007613,692,571,346,225,2,2,48,41,7,68,57,11,3
2021,Doncaster 039C,E01007614,564,499,303,196,5,5,14,8,6,46,41,5,0
2021,Doncaster 039D,E01007615,626,444,308,136,2,2,96,85,11,84,69,15,0
2021,Doncaster 039E,E01007616,580,469,334,135,2,2,36,32,4,73,56,17,0
2021,Doncaster 021C,E01007617,643,580,373,207,1,1,5,4,1,57,41,16,0
2021,Doncaster 021D,E01007618,505,426,259,167,2,2,8,6,2,69,57,12,0
2021,Doncaster 021E,E01007619,743,683,405,278,0,0,5,4,1,55,46,9,0
2021,Doncaster 020D,E01007620,716,643,402,241,0,0,13,12,1,60,47,13,0
2021,Doncaster 007A,E01007621,568,490,238,252,0,0,7,6,1,70,60,10,1
2021,Doncaster 007B,E01007622,660,558,338,220,17,17,7,1,6,78,70,8,0
2021,Doncaster 007C,E01007623,632,377,217,160,13,13,151,115,36,89,79,10,2
2021,Doncaster 007D,E01007624,837,706,349,357,1,1,13,3,10,115,101,14,2
2021,Doncaster 004A,E01007625,605,517,318,199,2,2,24,17,7,61,52,9,1
2021,Doncaster 004B,E01007626,679,388,199,189,1,1,137,104,33,150,126,24,3
2021,Doncaster 004C,E01007627,684,329,166,163,1,1,235,230,5,112,105,7,7
2021,Doncaster 004D,E01007628,535,218,119,99,1,1,205,193,12,108,98,10,3
2021,Doncaster 004E,E01007629,640,203,111,92,2,2,320,264,56,111,101,10,4
2021,Doncaster 007E,E01007630,649,513,365,148,0,0,65,60,5,71,54,17,0
2021,Doncaster 007F,E01007631,538,501,361,140,2,2,8,8,0,27,24,3,0
2021,Doncaster 001A,E01007632,623,431,231,200,0,0,74,64,10,117,102,15,1
2021,Doncaster 001B,E01007633,530,326,186,140,1,1,79,76,3,121,110,11,3
2021,Doncaster 001C,E01007634,684,298,160,138,4,4,215,177,38,163,147,16,4
2021,Doncaster 001D,E01007635,849,506,292,214,3,3,256,153,103,81,68,13,3
2021,Doncaster 003A,E01007636,658,329,164,165,1,1,184,166,18,143,134,9,1
2021,Doncaster 003B,E01007637,663,477,316,161,0,0,51,36,15,134,119,15,1
2021,Doncaster 003C,E01007638,719,346,198,148,2,2,226,192,34,137,121,16,8
2021,Doncaster 003D,E01007639,1049,544,278,266,33,33,209,99,110,263,229,34,0
2021,Doncaster 003E,E01007640,748,639,416,223,9,9,14,13,1,86,66,20,0
2021,Doncaster 003F,E01007641,594,450,234,216,7,7,49,43,6,86,73,13,2
2021,Doncaster 003G,E01007642,639,352,162,190,2,2,174,172,2,108,99,9,3
2021,Doncaster 022D,E01007643,628,260,123,137,1,1,236,196,40,128,108,20,3
2021,Doncaster 019A,E01007644,708,523,239,284,3,3,11,6,5,169,147,22,2
2021,Doncaster 019B,E01007646,735,403,240,163,1,1,26,7,19,305,290,15,0
2021,Doncaster 019C,E01007647,752,443,231,212,1,1,70,15,55,237,209,28,1
2021,Doncaster 019E,E01007649,614,443,228,215,0,0,9,7,2,162,147,15,0
2021,Doncaster 015B,E01007650,841,512,287,225,1,1,206,146,60,119,100,19,3
2021,Doncaster 015C,E01007651,696,350,141,209,2,2,200,184,16,143,130,13,1
2021,Doncaster 015D,E01007652,834,388,153,235,0,0,350,305,45,91,66,25,5
2021,Doncaster 015E,E01007653,642,438,222,216,1,1,18,13,5,184,168,16,1
2021,Doncaster 019F,E01007654,627,321,178,143,1,1,35,13,22,270,251,19,0
2021,Doncaster 022F,E01007655,1026,211,132,79,3,3,170,62,108,639,607,32,3
2021,Doncaster 015F,E01007656,672,405,198,207,2,2,173,165,8,86,77,9,6
2021,Rotherham 029A,E01007657,586,506,307,199,1,1,19,17,2,60,45,15,0
2021,Rotherham 032A,E01007658,610,508,255,253,1,1,24,22,2,77,64,13,0
2021,Rotherham 029B,E01007659,479,414,235,179,0,0,6,5,1,59,51,8,0
2021,Rotherham 032B,E01007660,507,435,266,169,1,1,39,22,17,30,21,9,2
2021,Rotherham 032C,E01007661,609,507,300,207,1,1,43,42,1,56,45,11,2
2021,Rotherham 032D,E01007662,486,224,122,102,1,1,221,219,2,37,31,6,3
2021,Rotherham 032E,E01007663,670,603,398,205,0,0,2,2,0,65,54,11,0
2021,Rotherham 032F,E01007664,838,709,483,226,1,1,43,38,5,82,71,11,3
2021,Rotherham 026A,E01007666,577,468,311,157,0,0,36,35,1,73,60,13,0
2021,Rotherham 030A,E01007667,636,445,174,271,0,0,119,110,9,72,62,10,0
2021,Rotherham 030B,E01007668,679,206,104,102,0,0,372,308,64,93,87,6,8
2021,Rotherham 030C,E01007669,643,545,348,197,0,0,46,37,9,52,40,12,0
2021,Rotherham 030D,E01007670,612,542,343,199,0,0,13,12,1,57,42,15,0
2021,Rotherham 031A,E01007671,831,685,308,377,1,1,26,12,14,119,97,22,0
2021,Rotherham 030E,E01007672,583,522,304,218,0,0,11,8,3,50,38,12,0
2021,Rotherham 030F,E01007673,674,366,181,185,5,5,217,216,1,83,73,10,3
2021,Rotherham 031B,E01007674,888,779,371,408,1,1,26,19,7,82,71,11,0
2021,Rotherham 023A,E01007675,684,490,261,229,0,0,86,65,21,106,89,17,2
2021,Rotherham 025A,E01007676,743,379,224,155,9,9,256,179,77,98,83,15,1
2021,Rotherham 017A,E01007677,697,167,85,82,0,0,398,318,80,128,109,19,4
2021,Rotherham 023B,E01007678,614,508,357,151,0,0,13,7,6,92,55,37,1
2021,Rotherham 023C,E01007679,761,442,243,199,1,1,194,150,44,112,104,8,12
2021,Rotherham 023D,E01007680,706,392,241,151,0,0,81,39,42,225,186,39,8
2021,Rotherham 012A,E01007681,567,480,335,145,3,3,39,36,3,45,36,9,0
2021,Rotherham 019A,E01007682,553,408,214,194,2,2,71,66,5,72,58,14,0
2021,Rotherham 019B,E01007683,588,483,285,198,0,0,50,47,3,53,43,10,2
2021,Rotherham 034A,E01007684,764,577,245,332,7,7,34,21,13,138,116,22,8
2021,Rotherham 018A,E01007685,600,488,289,199,1,1,12,11,1,99,73,26,0
2021,Rotherham 019C,E01007686,741,587,436,151,2,2,55,14,41,95,72,23,2
2021,Rotherham 034C,E01007687,704,540,314,226,3,3,107,103,4,53,41,12,1
2021,Rotherham 019D,E01007688,656,325,197,128,0,0,35,5,30,296,290,6,0
2021,Rotherham 034B,E01007689,662,480,247,233,13,13,114,70,44,55,44,11,0
2021,Rotherham 034E,E01007690,754,662,425,237,6,6,15,9,6,71,58,13,0
2021,Rotherham 012B,E01007691,888,734,417,317,12,12,65,55,10,77,55,22,0
2021,Rotherham 012C,E01007692,715,548,305,243,1,1,83,79,4,81,67,14,2
2021,Rotherham 001B,E01007694,771,431,186,245,2,2,230,225,5,105,84,21,3
2021,Rotherham 001C,E01007695,1110,857,336,521,1,1,135,115,20,115,102,13,2
2021,Rotherham 007A,E01007696,662,357,214,143,0,0,110,59,51,195,168,27,0
2021,Rotherham 001D,E01007697,699,327,162,165,0,0,299,277,22,67,55,12,6
2021,Rotherham 001E,E01007698,644,495,293,202,1,1,25,21,4,123,106,17,0
2021,Rotherham 027B,E01007699,1102,767,225,542,7,7,198,179,19,123,113,10,7
2021,Rotherham 027C,E01007700,800,605,220,385,2,2,74,41,33,118,105,13,1
2021,Rotherham 027D,E01007701,712,328,159,169,0,0,225,218,7,153,132,21,6
2021,Rotherham 025B,E01007702,697,409,184,225,6,6,79,62,17,203,186,17,0
2021,Rotherham 025C,E01007703,494,417,244,173,1,1,32,31,1,43,35,8,1
2021,Rotherham 025D,E01007704,729,499,255,244,1,1,148,132,16,79,70,9,2
2021,Rotherham 025E,E01007705,612,544,309,235,0,0,7,6,1,61,44,17,0
2021,Rotherham 027E,E01007706,560,449,250,199,1,1,21,19,2,89,77,12,0
2021,Rotherham 025F,E01007707,659,548,351,197,1,1,49,46,3,61,43,18,0
2021,Rotherham 021A,E01007708,745,304,123,181,7,7,344,250,94,83,57,26,7
2021,Rotherham 021B,E01007709,607,556,308,248,1,1,15,13,2,35,22,13,0
2021,Rotherham 021C,E01007710,648,588,351,237,2,2,7,6,1,50,42,8,1
2021,Rotherham 021D,E01007711,672,613,348,265,0,0,8,7,1,51,36,15,0
2021,Rotherham 023E,E01007712,748,611,321,290,1,1,32,9,23,104,91,13,0
2021,Rotherham 023F,E01007713,631,576,359,217,0,0,8,8,0,47,41,6,0
2021,Rotherham 017B,E01007714,1145,213,126,87,8,8,414,267,147,501,455,46,9
2021,Rotherham 016A,E01007715,644,195,123,72,0,0,167,67,100,280,256,24,2
2021,Rotherham 016B,E01007716,768,226,139,87,1,1,299,234,65,235,209,26,7
2021,Rotherham 016C,E01007717,835,422,215,207,20,20,197,100,97,193,171,22,3
2021,Rotherham 016D,E01007718,697,245,115,130,10,10,255,94,161,183,163,20,4
2021,Rotherham 010A,E01007719,530,191,96,95,0,0,269,222,47,66,56,10,4
2021,Rotherham 010B,E01007720,667,470,236,234,0,0,131,127,4,63,53,10,3
2021,Rotherham 010C,E01007721,749,333,145,188,2,2,308,220,88,104,95,9,2
2021,Rotherham 013A,E01007723,595,300,146,154,3,3,239,230,9,50,47,3,3
2021,Rotherham 021E,E01007724,590,398,224,174,2,2,25,7,18,165,154,11,0
2021,Rotherham 019E,E01007725,494,396,203,193,0,0,31,29,2,67,59,8,0
2021,Rotherham 019F,E01007726,724,267,150,117,0,0,348,275,73,101,92,9,8
2021,Rotherham 010D,E01007727,679,290,158,132,3,3,300,294,6,79,65,14,7
2021,Rotherham 009A,E01007728,498,373,220,153,2,2,76,73,3,45,39,6,2
2021,Rotherham 009B,E01007729,842,247,139,108,3,3,515,416,99,72,68,4,5
2021,Rotherham 009C,E01007730,706,265,135,130,0,0,332,321,11,105,92,13,4
2021,Rotherham 009D,E01007731,571,349,205,144,0,0,103,75,28,119,101,18,0
2021,Rotherham 009E,E01007732,727,311,178,133,0,0,359,347,12,53,46,7,4
2021,Rotherham 009F,E01007733,608,294,157,137,2,2,254,249,5,55,49,6,3
2021,Rotherham 021F,E01007734,767,282,115,167,5,5,397,350,47,78,67,11,5
2021,Rotherham 013B,E01007735,577,186,77,109,4,4,320,308,12,64,61,3,3
2021,Rotherham 014A,E01007736,683,192,113,79,14,14,327,188,139,148,133,15,2
2021,Rotherham 013C,E01007737,618,187,72,115,3,3,355,341,14,64,59,5,9
2021,Rotherham 013D,E01007738,580,202,107,95,2,2,238,181,57,138,130,8,0
2021,Rotherham 013E,E01007739,611,228,109,119,0,0,329,310,19,48,40,8,6
2021,Rotherham 011A,E01007740,608,309,153,156,0,0,229,219,10,67,62,5,3
2021,Rotherham 015A,E01007741,694,592,397,195,2,2,16,9,7,84,71,13,0
2021,Rotherham 015B,E01007742,609,421,227,194,4,4,129,127,2,55,43,12,0
2021,Rotherham 015C,E01007743,494,433,252,181,1,1,37,8,29,22,17,5,1
2021,Rotherham 015D,E01007744,703,424,225,199,17,17,136,117,19,125,111,14,1
2021,Rotherham 015E,E01007745,706,369,186,183,0,0,228,220,8,105,82,23,4
2021,Rotherham 015F,E01007746,579,437,230,207,0,0,91,88,3,49,40,9,2
2021,Rotherham 031C,E01007747,552,302,130,172,1,1,168,165,3,78,63,15,3
2021,Rotherham 033A,E01007748,652,495,310,185,2,2,111,109,2,44,34,10,0
2021,Rotherham 033B,E01007749,782,633,342,291,2,2,20,16,4,127,115,12,0
2021,Rotherham 031D,E01007750,679,549,331,218,1,1,34,32,2,95,73,22,0
2021,Rotherham 033C,E01007751,976,591,201,390,7,7,184,89,95,190,159,31,4
2021,Rotherham 033D,E01007752,641,534,302,232,3,3,11,10,1,93,75,18,0
2021,Rotherham 033E,E01007753,684,484,280,204,0,0,129,123,6,69,44,25,2
2021,Rotherham 018B,E01007754,524,443,201,242,2,2,28,25,3,51,47,4,0
2021,Rotherham 018C,E01007755,583,500,264,236,1,1,5,3,2,77,60,17,0
2021,Rotherham 018D,E01007756,597,524,300,224,2,2,25,24,1,45,37,8,1
2021,Rotherham 020A,E01007757,679,552,326,226,1,1,45,22,23,80,67,13,1
2021,Rotherham 020B,E01007758,624,388,167,221,0,0,90,55,35,144,134,10,2
2021,Rotherham 020C,E01007759,672,386,226,160,1,1,183,156,27,99,86,13,3
2021,Rotherham 020D,E01007760,738,318,188,130,3,3,150,51,99,265,248,17,2
2021,Rotherham 018E,E01007761,697,441,221,220,0,0,152,135,17,99,77,22,5
2021,Rotherham 018F,E01007762,594,441,238,203,0,0,88,86,2,65,50,15,0
2021,Rotherham 020E,E01007763,697,358,208,150,1,1,125,89,36,212,190,22,1
2021,Rotherham 020F,E01007764,718,190,113,77,0,0,386,193,193,140,127,13,2
2021,Rotherham 014B,E01007765,636,386,223,163,0,0,41,17,24,208,187,21,1
2021,Rotherham 014C,E01007766,508,261,119,142,0,0,184,177,7,60,53,7,3
2021,Rotherham 017C,E01007767,627,333,182,151,1,1,76,16,60,217,197,20,0
2021,Rotherham 014D,E01007768,821,284,192,92,1,1,304,166,138,227,188,39,5
2021,Rotherham 017D,E01007769,603,145,103,42,3,3,109,61,48,340,288,52,6
2021,Rotherham 014E,E01007770,618,356,181,175,1,1,170,150,20,87,76,11,4
2021,Rotherham 006A,E01007771,604,469,289,180,8,8,27,12,15,100,89,11,0
2021,Rotherham 006B,E01007772,569,325,145,180,2,2,130,120,10,107,90,17,5
2021,Rotherham 006C,E01007773,610,340,166,174,0,0,106,97,9,160,141,19,4
2021,Rotherham 006D,E01007774,610,370,168,202,7,7,132,101,31,99,87,12,2
2021,Rotherham 008A,E01007775,547,166,74,92,0,0,305,270,35,73,65,8,3
2021,Rotherham 008B,E01007776,696,361,180,181,0,0,226,204,22,106,93,13,3
2021,Rotherham 004A,E01007777,888,616,211,405,2,2,191,170,21,76,62,14,3
2021,Rotherham 005A,E01007778,592,499,287,212,0,0,70,66,4,23,18,5,0
2021,Rotherham 005B,E01007779,851,490,165,325,8,8,255,233,22,95,84,11,3
2021,Rotherham 005C,E01007780,611,442,264,178,1,1,121,119,2,45,38,7,2
2021,Rotherham 005D,E01007781,656,373,199,174,1,1,228,225,3,51,45,6,3
2021,Rotherham 005E,E01007782,598,307,167,140,6,6,195,165,30,85,70,15,5
2021,Rotherham 008C,E01007783,892,352,183,169,21,21,387,322,65,120,111,9,12
2021,Rotherham 008D,E01007784,786,396,162,234,5,5,160,76,84,223,205,18,2
2021,Rotherham 029C,E01007785,548,430,230,200,1,1,64,59,5,53,42,11,0
2021,Rotherham 029D,E01007786,490,411,254,157,0,0,24,23,1,55,40,15,0
2021,Rotherham 028B,E01007788,698,496,289,207,2,2,79,59,20,120,95,25,1
2021,Rotherham 028C,E01007789,752,396,216,180,1,1,208,158,50,145,125,20,2
2021,Rotherham 029E,E01007790,767,242,136,106,3,3,259,149,110,260,239,21,3
2021,Rotherham 029F,E01007791,558,327,159,168,2,2,109,92,17,120,111,9,0
2021,Rotherham 028D,E01007792,489,444,230,214,1,1,6,4,2,38,31,7,0
2021,Rotherham 004B,E01007793,645,387,219,168,0,0,201,196,5,55,40,15,2
2021,Rotherham 004C,E01007794,544,264,147,117,1,1,225,224,1,52,44,8,2
2021,Rotherham 004D,E01007795,635,573,385,188,0,0,13,11,2,49,40,9,0
2021,Rotherham 003A,E01007796,557,228,105,123,3,3,255,222,33,68,62,6,3
2021,Rotherham 003B,E01007797,570,394,234,160,0,0,118,106,12,57,48,9,1
2021,Rotherham 003C,E01007798,700,640,354,286,0,0,24,18,6,36,29,7,0
2021,Rotherham 003D,E01007799,644,371,218,153,2,2,214,145,69,55,47,8,2
2021,Rotherham 003E,E01007800,740,393,222,171,10,10,118,75,43,216,198,18,3
2021,Rotherham 007B,E01007801,619,519,296,223,0,0,24,14,10,76,62,14,0
2021,Rotherham 007C,E01007802,568,459,261,198,0,0,46,14,32,62,49,13,1
2021,Rotherham 007D,E01007803,547,392,212,180,0,0,90,85,5,63,49,14,2
2021,Rotherham 011B,E01007804,652,286,149,137,3,3,295,291,4,62,51,11,6
2021,Rotherham 011C,E01007805,660,276,124,152,1,1,316,304,12,60,54,6,7
2021,Rotherham 011D,E01007806,530,265,104,161,0,0,211,210,1,51,43,8,3
2021,Rotherham 011E,E01007807,599,405,214,191,1,1,121,117,4,71,57,14,1
2021,Rotherham 007E,E01007808,585,546,347,199,1,1,6,5,1,32,27,5,0
2021,Rotherham 026B,E01007809,749,333,181,152,0,0,286,237,49,120,106,14,10
2021,Rotherham 026C,E01007810,1189,855,339,516,15,15,218,170,48,100,75,25,1
2021,Rotherham 034D,E01007811,579,499,290,209,4,4,7,7,0,69,54,15,0
2021,Rotherham 034F,E01007812,532,275,156,119,0,0,203,185,18,52,44,8,2
2021,Rotherham 026D,E01007815,688,372,190,182,0,0,90,82,8,224,201,23,2
2021,Rotherham 002A,E01007816,723,402,228,174,18,18,189,144,45,112,105,7,2
2021,Rotherham 002B,E01007817,643,394,208,186,3,3,185,179,6,57,45,12,4
2021,Rotherham 003F,E01007818,671,582,343,239,2,2,29,22,7,58,49,9,0
2021,Rotherham 002C,E01007819,628,508,307,201,0,0,79,74,5,41,28,13,0
2021,Rotherham 002D,E01007820,761,446,202,244,4,4,76,44,32,234,217,17,1
2021,Rotherham 002E,E01007821,681,428,232,196,1,1,200,112,88,52,41,11,0
2021,Rotherham 002F,E01007822,840,318,184,134,7,7,400,288,112,108,90,18,7
2021,Sheffield 069A,E01007823,808,558,314,244,2,2,168,139,29,80,60,20,0
2021,Sheffield 066A,E01007824,563,540,296,244,0,0,5,1,4,18,18,0,0
2021,Sheffield 066B,E01007825,618,563,343,220,3,3,25,7,18,27,22,5,0
2021,Sheffield 066C,E01007826,598,574,319,255,0,0,2,1,1,22,17,5,0
2021,Sheffield 064A,E01007827,851,710,381,329,0,0,60,5,55,81,61,20,0
2021,Sheffield 059A,E01007828,751,526,251,275,2,2,123,117,6,100,91,9,0
2021,Sheffield 059B,E01007829,747,516,245,271,2,2,33,19,14,196,176,20,0
2021,Sheffield 064B,E01007830,651,479,297,182,0,0,116,90,26,56,42,14,0
2021,Sheffield 059C,E01007831,701,496,232,264,0,0,8,2,6,197,172,25,0
2021,Sheffield 059D,E01007832,695,529,255,274,1,1,39,24,15,126,115,11,0
2021,Sheffield 064C,E01007833,776,580,355,225,3,3,161,135,26,32,23,9,0
2021,Sheffield 066D,E01007834,752,546,311,235,4,4,133,128,5,69,57,12,0
2021,Sheffield 062A,E01007835,590,468,233,235,0,0,82,48,34,40,32,8,0
2021,Sheffield 062B,E01007836,697,561,337,224,1,1,63,58,5,72,63,9,0
2021,Sheffield 076A,E01007838,642,494,225,269,8,8,73,60,13,67,58,9,0
2021,Sheffield 076B,E01007839,669,581,272,309,2,2,11,9,2,75,64,11,0
2021,Sheffield 076C,E01007841,622,541,285,256,1,1,20,14,6,60,51,9,0
2021,Sheffield 076D,E01007842,682,447,216,231,0,0,148,142,6,87,71,16,0
2021,Sheffield 062C,E01007843,763,364,172,192,0,0,302,295,7,97,84,13,0
2021,Sheffield 062D,E01007846,652,545,298,247,2,2,25,20,5,80,65,15,0
2021,Sheffield 014A,E01007847,653,335,195,140,4,4,227,189,38,86,73,13,1
2021,Sheffield 013A,E01007848,704,262,133,129,0,0,359,290,69,81,63,18,2
2021,Sheffield 010A,E01007849,872,387,184,203,15,15,254,142,112,214,197,17,2
2021,Sheffield 014B,E01007850,619,488,293,195,0,0,48,14,34,83,74,9,0
2021,Sheffield 013B,E01007851,534,265,157,108,0,0,172,47,125,97,81,16,0
2021,Sheffield 014C,E01007852,652,417,230,187,1,1,60,21,39,174,154,20,0
2021,Sheffield 014D,E01007853,809,586,272,314,13,13,80,14,66,128,110,18,2
2021,Sheffield 014E,E01007854,580,298,147,151,2,2,189,88,101,88,76,12,3
2021,Sheffield 014F,E01007855,777,422,194,228,0,0,103,27,76,251,235,16,1
2021,Sheffield 007A,E01007856,543,253,102,151,0,0,212,49,163,78,67,11,0
2021,Sheffield 010B,E01007857,684,286,140,146,1,1,334,61,273,62,53,9,1
2021,Sheffield 038A,E01007858,653,445,244,201,6,6,37,4,33,165,149,16,0
2021,Sheffield 038B,E01007861,708,603,363,240,1,1,21,12,9,83,76,7,0
2021,Sheffield 038C,E01007862,443,311,207,104,0,0,9,4,5,123,100,23,0
2021,Sheffield 036C,E01007863,610,377,212,165,0,0,38,2,36,195,183,12,0
2021,Sheffield 036D,E01007864,493,109,61,48,1,1,25,4,21,358,339,19,0
2021,Sheffield 038D,E01007865,769,554,294,260,0,0,49,3,46,166,148,18,0
2021,Sheffield 030A,E01007866,607,234,134,100,10,10,51,2,49,312,299,13,0
2021,Sheffield 030B,E01007867,645,156,74,82,2,2,64,1,63,423,413,10,0
2021,Sheffield 030C,E01007868,555,299,179,120,1,1,33,7,26,222,208,14,0
2021,Sheffield 020A,E01007869,521,277,182,95,2,2,97,17,80,145,129,16,0
2021,Sheffield 019A,E01007870,724,333,192,141,3,3,165,92,73,210,178,32,13
2021,Sheffield 019B,E01007871,819,334,185,149,1,1,398,374,24,81,71,10,5
2021,Sheffield 020B,E01007872,626,391,247,144,2,2,66,48,18,166,144,22,1
2021,Sheffield 020C,E01007873,705,292,149,143,2,2,281,238,43,128,111,17,2
2021,Sheffield 022A,E01007874,694,199,145,54,11,11,405,315,90,77,69,8,2
2021,Sheffield 022B,E01007875,559,168,106,62,9,9,249,110,139,126,106,20,7
2021,Sheffield 075A,E01007878,555,182,96,86,0,0,316,104,212,57,45,12,0
2021,Sheffield 075B,E01007879,674,294,164,130,0,0,118,7,111,248,223,25,14
2021,Sheffield 075C,E01007881,695,345,186,159,14,14,199,55,144,136,114,22,1
2021,Sheffield 075D,E01007882,600,401,226,175,2,2,6,4,2,188,172,16,3
2021,Sheffield 027A,E01007883,578,159,92,67,2,2,307,126,181,106,94,12,4
2021,Sheffield 075E,E01007885,819,134,64,70,1,1,604,37,567,80,67,13,0
2021,Sheffield 075F,E01007886,657,193,105,88,0,0,397,70,327,65,61,4,2
2021,Sheffield 004A,E01007887,609,413,206,207,0,0,137,131,6,59,54,5,0
2021,Sheffield 003A,E01007888,564,519,259,260,2,2,10,7,3,33,26,7,0
2021,Sheffield 004B,E01007889,1092,929,414,515,1,1,36,32,4,126,113,13,0
2021,Sheffield 004C,E01007890,584,522,301,221,1,1,14,11,3,47,35,12,0
2021,Sheffield 004D,E01007891,662,610,401,209,1,1,6,3,3,45,32,13,0
2021,Sheffield 003B,E01007892,664,256,138,118,0,0,342,284,58,66,57,9,0
2021,Sheffield 003C,E01007893,628,563,337,226,2,2,16,15,1,47,37,10,0
2021,Sheffield 004E,E01007894,638,481,260,221,2,2,18,16,2,137,118,19,0
2021,Sheffield 004F,E01007895,646,370,203,167,0,0,202,174,28,74,62,12,0
2021,Sheffield 004G,E01007896,552,500,320,180,3,3,8,3,5,41,36,5,0
2021,Sheffield 005A,E01007897,624,569,390,179,0,0,7,6,1,48,36,12,0
2021,Sheffield 003D,E01007898,628,541,272,269,1,1,3,1,2,83,74,9,0
2021,Sheffield 003E,E01007899,628,586,385,201,1,1,11,10,1,29,26,3,1
2021,Sheffield 003F,E01007900,772,461,230,231,2,2,195,188,7,114,98,16,0
2021,Sheffield 003G,E01007901,645,281,143,138,0,0,312,301,11,52,42,10,0
2021,Sheffield 027B,E01007902,689,193,122,71,1,1,402,342,60,90,80,10,3
2021,Sheffield 018A,E01007903,577,374,207,167,1,1,114,100,14,88,75,13,0
2021,Sheffield 018B,E01007904,631,180,100,80,1,1,391,338,53,58,45,13,1
2021,Sheffield 027C,E01007905,582,218,69,149,3,3,210,17,193,150,133,17,1
2021,Sheffield 027D,E01007906,831,420,202,218,4,4,141,89,52,266,237,29,0
2021,Sheffield 032A,E01007907,581,443,231,212,2,2,17,12,5,119,106,13,0
2021,Sheffield 032B,E01007908,639,514,247,267,1,1,7,5,2,117,103,14,0
2021,Sheffield 032C,E01007909,1121,757,315,442,2,2,90,72,18,272,246,26,0
2021,Sheffield 037A,E01007910,773,363,187,176,3,3,309,39,270,98,83,15,0
2021,Sheffield 032D,E01007911,590,540,304,236,0,0,10,5,5,40,34,6,0
2021,Sheffield 037B,E01007912,685,495,299,196,1,1,121,48,73,67,56,11,1
2021,Sheffield 018C,E01007913,478,239,174,65,4,4,53,15,38,181,158,23,1
2021,Sheffield 018D,E01007914,455,218,130,88,0,0,56,7,49,181,155,26,0
2021,Sheffield 071A,E01007915,610,581,314,267,1,1,3,1,2,25,20,5,0
2021,Sheffield 069B,E01007916,709,206,104,102,1,1,408,398,10,90,83,7,4
2021,Sheffield 071B,E01007917,677,501,323,178,1,1,109,90,19,65,55,10,1
2021,Sheffield 071C,E01007918,768,572,330,242,0,0,95,15,80,101,93,8,0
2021,Sheffield 069C,E01007919,755,223,101,122,0,0,426,417,9,105,95,10,1
2021,Sheffield 068A,E01007920,721,646,409,237,4,4,8,3,5,63,60,3,0
2021,Sheffield 068B,E01007921,792,644,408,236,0,0,75,60,15,73,61,12,0
2021,Sheffield 071D,E01007922,586,556,316,240,0,0,6,2,4,24,24,0,0
2021,Sheffield 068C,E01007923,813,678,393,285,1,1,50,48,2,84,70,14,0
2021,Sheffield 071E,E01007924,711,499,246,253,1,1,154,148,6,57,45,12,0
2021,Sheffield 068D,E01007925,780,625,342,283,0,0,85,82,3,70,61,9,0
2021,Sheffield 068E,E01007926,719,639,398,241,2,2,28,21,7,50,39,11,0
2021,Sheffield 055A,E01007927,646,602,393,209,2,2,7,4,3,35,23,12,0
2021,Sheffield 055B,E01007928,700,649,412,237,0,0,16,3,13,35,30,5,0
2021,Sheffield 055C,E01007929,807,699,373,326,1,1,16,1,15,91,75,16,0
2021,Sheffield 055D,E01007930,540,515,281,234,0,0,4,2,2,21,15,6,0
2021,Sheffield 047A,E01007931,617,592,337,255,1,1,4,0,4,20,16,4,0
2021,Sheffield 055E,E01007932,628,557,316,241,0,0,32,6,26,39,29,10,0
2021,Sheffield 068F,E01007933,646,600,356,244,0,0,15,2,13,31,24,7,0
2021,Sheffield 047B,E01007934,599,499,250,249,0,0,41,8,33,59,51,8,0
2021,Sheffield 047C,E01007935,560,410,170,240,1,1,10,3,7,139,129,10,0
2021,Sheffield 047D,E01007936,677,450,163,287,4,4,9,2,7,214,204,10,0
2021,Sheffield 047E,E01007937,605,539,285,254,2,2,5,0,5,59,47,12,0
2021,Sheffield 047F,E01007938,589,562,298,264,1,1,3,2,1,23,20,3,0
2021,Sheffield 055F,E01007939,676,587,361,226,0,0,33,28,5,56,45,11,0
2021,Sheffield 022E,E01007940,597,190,117,73,6,6,228,171,57,173,151,22,0
2021,Sheffield 015A,E01007941,678,331,207,124,1,1,284,214,70,62,43,19,0
2021,Sheffield 020D,E01007942,520,264,181,83,0,0,86,30,56,170,135,35,0
2021,Sheffield 019C,E01007943,777,215,110,105,12,12,468,427,41,81,66,15,1
2021,Sheffield 015B,E01007945,737,296,152,144,0,0,341,243,98,99,79,20,1
2021,Sheffield 015C,E01007946,625,209,99,110,1,1,337,275,62,76,66,10,2
2021,Sheffield 013C,E01007947,793,128,81,47,0,0,573,545,28,88,82,6,4
2021,Sheffield 013D,E01007948,600,196,108,88,2,2,277,265,12,123,114,9,2
2021,Sheffield 020E,E01007949,488,255,160,95,2,2,41,18,23,189,170,19,1
2021,Sheffield 015D,E01007950,628,279,147,132,0,0,272,257,15,77,65,12,0
2021,Sheffield 029A,E01007951,690,492,257,235,2,2,46,39,7,150,134,16,0
2021,Sheffield 033A,E01007952,649,584,355,229,1,1,10,4,6,54,50,4,0
2021,Sheffield 033B,E01007953,794,456,314,142,2,2,255,175,80,80,72,8,1
2021,Sheffield 033C,E01007954,645,578,335,243,0,0,3,0,3,64,58,6,0
2021,Sheffield 041A,E01007955,547,498,289,209,2,2,29,27,2,18,16,2,0
2021,Sheffield 041B,E01007956,896,791,470,321,0,0,21,20,1,84,66,18,0
2021,Sheffield 041C,E01007957,635,579,334,245,1,1,4,3,1,51,46,5,0
2021,Sheffield 041D,E01007958,620,541,363,178,0,0,5,5,0,74,61,13,0
2021,Sheffield 041E,E01007959,592,552,322,230,1,1,10,2,8,28,22,6,1
2021,Sheffield 029B,E01007960,682,459,239,220,0,0,30,11,19,193,172,21,0
2021,Sheffield 033D,E01007961,588,522,282,240,0,0,18,14,4,48,43,5,0
2021,Sheffield 029C,E01007962,583,244,107,137,2,2,119,116,3,218,203,15,0
2021,Sheffield 045A,E01007963,713,484,252,232,2,2,175,166,9,52,48,4,0
2021,Sheffield 049A,E01007964,730,469,226,243,2,2,153,110,43,106,93,13,0
2021,Sheffield 044A,E01007965,779,335,186,149,28,28,364,189,175,51,44,7,1
2021,Sheffield 049B,E01007966,650,422,207,215,1,1,143,133,10,84,73,11,0
2021,Sheffield 045B,E01007967,761,403,151,252,3,3,286,277,9,69,57,12,0
2021,Sheffield 049C,E01007968,628,298,193,105,1,1,240,203,37,87,76,11,2
2021,Sheffield 044B,E01007969,698,501,242,259,1,1,128,77,51,68,59,9,0
2021,Sheffield 049D,E01007970,872,172,104,68,3,3,628,593,35,67,62,5,2
2021,Sheffield 037C,E01007971,617,423,200,223,0,0,131,127,4,61,50,11,2
2021,Sheffield 044C,E01007972,607,551,337,214,1,1,5,3,2,50,44,6,0
2021,Sheffield 037D,E01007973,639,556,313,243,10,10,19,17,2,54,47,7,0
2021,Sheffield 044D,E01007974,553,454,215,239,3,3,43,26,17,52,43,9,1
2021,Sheffield 051A,E01007975,772,351,177,174,0,0,273,230,43,147,133,14,1
2021,Sheffield 051B,E01007976,637,382,197,185,1,1,177,162,15,75,54,21,2
2021,Sheffield 051C,E01007977,804,230,136,94,3,3,519,468,51,51,44,7,1
2021,Sheffield 053A,E01007978,743,405,183,222,2,2,36,8,28,300,283,17,0
2021,Sheffield 051D,E01007979,672,156,89,67,2,2,447,370,77,66,60,6,1
2021,Sheffield 053B,E01007980,647,446,188,258,0,0,42,6,36,159,138,21,0
2021,Sheffield 053C,E01007981,596,418,192,226,2,2,16,8,8,160,148,12,0
2021,Sheffield 054A,E01007982,794,376,207,169,1,1,326,305,21,88,81,7,3
2021,Sheffield 053D,E01007983,641,492,194,298,4,4,14,2,12,131,115,16,0
2021,Sheffield 064D,E01007984,582,543,290,253,0,0,5,2,3,34,28,6,0
2021,Sheffield 053E,E01007985,657,543,272,271,3,3,6,3,3,105,90,15,0
2021,Sheffield 059E,E01007986,646,420,179,241,2,2,4,0,4,219,201,18,1
2021,Sheffield 016A,E01007987,597,491,261,230,0,0,13,2,11,93,83,10,0
2021,Sheffield 016B,E01007988,641,532,294,238,0,0,56,10,46,53,47,6,0
2021,Sheffield 016C,E01007989,626,471,242,229,0,0,9,3,6,146,135,11,0
2021,Sheffield 021A,E01007990,656,455,253,202,2,2,154,19,135,45,32,13,0
2021,Sheffield 016D,E01007991,678,304,180,124,0,0,314,15,299,60,52,8,0
2021,Sheffield 021B,E01007992,697,492,238,254,2,2,54,39,15,148,127,21,1
2021,Sheffield 021C,E01007993,694,424,201,223,1,1,201,26,175,67,57,10,1
2021,Sheffield 021D,E01007994,606,473,216,257,1,1,19,8,11,113,95,18,0
2021,Sheffield 017A,E01007995,750,428,183,245,5,5,11,2,9,306,286,20,0
2021,Sheffield 021E,E01007996,751,506,242,264,0,0,76,10,66,168,137,31,1
2021,Sheffield 025A,E01007997,672,585,330,255,1,1,48,45,3,38,25,13,0
2021,Sheffield 025B,E01007998,820,344,189,155,2,2,440,422,18,34,28,6,0
2021,Sheffield 045C,E01007999,551,444,257,187,0,0,62,58,4,45,37,8,0
2021,Sheffield 052A,E01008000,682,445,238,207,2,2,101,74,27,134,124,10,0
2021,Sheffield 052B,E01008001,652,431,218,213,1,1,125,115,10,94,78,16,1
2021,Sheffield 054B,E01008002,702,594,332,262,1,1,30,28,2,77,67,10,0
2021,Sheffield 054C,E01008003,619,484,264,220,1,1,80,60,20,54,41,13,0
2021,Sheffield 052C,E01008004,721,464,243,221,1,1,170,92,78,86,76,10,0
2021,Sheffield 052D,E01008005,725,565,340,225,0,0,63,57,6,97,81,16,0
2021,Sheffield 054D,E01008006,690,562,351,211,0,0,43,38,5,85,80,5,0
2021,Sheffield 060A,E01008007,794,302,155,147,0,0,406,275,131,86,74,12,0
2021,Sheffield 045D,E01008008,726,316,152,164,0,0,321,236,85,89,81,8,0
2021,Sheffield 045E,E01008009,597,174,65,109,1,1,358,93,265,64,57,7,0
2021,Sheffield 052E,E01008010,583,333,156,177,1,1,187,29,158,62,48,14,0
2021,Sheffield 039A,E01008011,762,223,61,162,12,12,475,64,411,52,45,7,0
2021,Sheffield 039B,E01008012,1023,278,91,187,7,7,485,232,253,252,236,16,1
2021,Sheffield 039C,E01008013,811,259,62,197,0,0,288,177,111,264,251,13,0
2021,Sheffield 032E,E01008014,691,347,176,171,2,2,195,172,23,147,131,16,0
2021,Sheffield 039D,E01008015,745,284,134,150,11,11,377,85,292,73,61,12,0
2021,Sheffield 032F,E01008016,622,392,198,194,0,0,145,143,2,85,73,12,0
2021,Sheffield 039E,E01008017,698,178,90,88,1,1,460,139,321,58,46,12,1
2021,Sheffield 039F,E01008018,653,286,109,177,0,0,312,51,261,54,47,7,1
2021,Sheffield 065A,E01008019,716,458,219,239,2,2,182,177,5,73,65,8,1
2021,Sheffield 065B,E01008020,587,491,300,191,0,0,31,22,9,65,54,11,0
2021,Sheffield 072A,E01008021,552,513,292,221,0,0,2,2,0,37,28,9,0
2021,Sheffield 065C,E01008022,728,186,95,91,0,0,481,456,25,61,47,14,0
2021,Sheffield 072B,E01008023,1026,828,334,494,3,3,28,14,14,164,146,18,3
2021,Sheffield 072C,E01008024,899,675,252,423,15,15,113,100,13,96,79,17,0
2021,Sheffield 072D,E01008025,894,646,335,311,3,3,112,103,9,133,114,19,0
2021,Sheffield 065D,E01008027,671,377,181,196,0,0,239,224,15,53,41,12,2
2021,Sheffield 056A,E01008028,637,414,181,233,3,3,124,114,10,96,86,10,0
2021,Sheffield 056B,E01008029,591,321,130,191,2,2,207,188,19,60,49,11,1
2021,Sheffield 063A,E01008030,564,442,217,225,2,2,41,19,22,78,61,17,1
2021,Sheffield 061A,E01008031,619,382,198,184,0,0,166,142,24,71,62,9,0
2021,Sheffield 056C,E01008032,627,366,181,185,3,3,158,125,33,99,83,16,1
2021,Sheffield 061B,E01008033,587,456,304,152,10,10,73,71,2,48,34,14,0
2021,Sheffield 056D,E01008034,683,429,219,210,1,1,184,120,64,68,52,16,1
2021,Sheffield 063B,E01008035,471,434,238,196,1,1,0,0,0,36,32,4,0
2021,Sheffield 063C,E01008036,588,501,269,232,6,6,2,1,1,79,70,9,0
2021,Sheffield 065E,E01008037,712,399,285,114,2,2,247,160,87,64,36,28,0
2021,Sheffield 061C,E01008038,735,659,484,175,0,0,7,2,5,69,51,18,0
2021,Sheffield 065F,E01008039,604,501,343,158,0,0,39,12,27,64,56,8,0
2021,Sheffield 061D,E01008040,680,513,264,249,2,2,112,33,79,53,43,10,0
2021,Sheffield 063D,E01008041,533,480,247,233,0,0,6,1,5,47,42,5,0
2021,Sheffield 050A,E01008042,707,409,241,168,15,15,14,5,9,269,246,23,0
2021,Sheffield 046A,E01008043,674,587,335,252,1,1,7,1,6,79,71,8,0
2021,Sheffield 046B,E01008044,622,574,306,268,2,2,6,1,5,40,31,9,0
2021,Sheffield 050B,E01008045,520,382,196,186,0,0,42,9,33,95,86,9,1
2021,Sheffield 050C,E01008046,685,411,169,242,9,9,16,4,12,248,233,15,1
2021,Sheffield 046C,E01008047,584,277,138,139,0,0,12,2,10,294,272,22,1
2021,Sheffield 046D,E01008048,588,335,166,169,3,3,22,2,20,228,216,12,0
2021,Sheffield 050D,E01008049,779,453,272,181,2,2,142,31,111,181,151,30,1
2021,Sheffield 046E,E01008050,620,371,148,223,2,2,13,5,8,234,215,19,0
2021,Sheffield 050E,E01008051,629,407,180,227,1,1,31,8,23,189,181,8,1
2021,Sheffield 050F,E01008052,790,518,260,258,4,4,27,3,24,241,203,38,0
2021,Sheffield 006A,E01008053,569,276,132,144,0,0,244,231,13,49,30,19,0
2021,Sheffield 007B,E01008054,551,221,106,115,0,0,269,42,227,61,58,3,0
2021,Sheffield 007C,E01008055,625,213,94,119,0,0,314,50,264,97,93,4,1
2021,Sheffield 006B,E01008056,594,376,180,196,0,0,163,143,20,55,51,4,0
2021,Sheffield 007D,E01008057,611,241,111,130,0,0,297,63,234,73,59,14,0
2021,Sheffield 006C,E01008058,744,581,282,299,0,0,102,94,8,61,45,16,0
2021,Sheffield 010C,E01008059,651,288,134,154,1,1,293,51,242,69,58,11,0
2021,Sheffield 010D,E01008060,632,226,116,110,1,1,337,51,286,68,56,12,0
2021,Sheffield 011A,E01008061,651,269,123,146,0,0,274,196,78,108,97,11,0
2021,Sheffield 013E,E01008062,596,200,107,93,3,3,341,287,54,50,45,5,2
2021,Sheffield 011B,E01008063,688,425,256,169,1,1,196,186,10,66,41,25,0
2021,Sheffield 028A,E01008064,627,324,157,167,1,1,7,3,4,295,282,13,0
2021,Sheffield 026A,E01008065,980,87,57,30,0,0,630,569,61,254,244,10,9
2021,Sheffield 028B,E01008066,451,120,58,62,1,1,29,19,10,300,287,13,1
2021,Sheffield 030D,E01008067,524,77,42,35,1,1,71,31,40,375,370,5,0
2021,Sheffield 026B,E01008068,689,97,68,29,1,1,394,346,48,192,178,14,5
2021,Sheffield 028C,E01008069,536,227,103,124,1,1,40,29,11,268,260,8,0
2021,Sheffield 026C,E01008072,734,214,116,98,4,4,264,164,100,250,236,14,2
2021,Sheffield 030E,E01008073,684,283,144,139,9,9,215,116,99,175,167,8,2
2021,Sheffield 028D,E01008074,537,330,144,186,2,2,26,17,9,179,163,16,0
2021,Sheffield 060B,E01008075,591,177,100,77,0,0,347,318,29,65,57,8,2
2021,Sheffield 060C,E01008076,598,225,113,112,0,0,289,255,34,84,76,8,0
2021,Sheffield 060D,E01008077,707,369,201,168,2,2,251,235,16,85,67,18,0
2021,Sheffield 064E,E01008078,697,501,302,199,0,0,107,34,73,88,69,19,1
2021,Sheffield 064F,E01008079,485,441,258,183,0,0,5,4,1,39,31,8,0
2021,Sheffield 069D,E01008080,663,451,252,199,1,1,135,130,5,75,65,10,1
2021,Sheffield 070A,E01008081,773,288,142,146,0,0,397,368,29,88,58,30,0
2021,Sheffield 070B,E01008082,813,265,157,108,9,9,472,398,74,63,54,9,4
2021,Sheffield 070C,E01008083,704,240,117,123,1,1,360,344,16,102,94,8,1
2021,Sheffield 070D,E01008084,763,173,100,73,1,1,498,491,7,89,83,6,2
2021,Sheffield 009A,E01008085,586,265,123,142,0,0,255,244,11,66,57,9,0
2021,Sheffield 009B,E01008086,590,273,139,134,0,0,241,232,9,75,63,12,1
2021,Sheffield 012A,E01008087,687,551,320,231,2,2,28,19,9,106,95,11,0
2021,Sheffield 012B,E01008088,656,464,260,204,0,0,88,55,33,104,97,7,0
2021,Sheffield 017B,E01008089,703,294,168,126,0,0,262,245,17,146,125,21,1
2021,Sheffield 012C,E01008090,692,263,134,129,2,2,355,343,12,72,63,9,0
2021,Sheffield 017C,E01008091,639,446,204,242,0,0,11,4,7,182,170,12,0
2021,Sheffield 012D,E01008092,712,200,104,96,1,1,446,337,109,63,53,10,2
2021,Sheffield 017D,E01008093,780,429,246,183,0,0,68,32,36,283,263,20,0
2021,Sheffield 019D,E01008094,500,227,110,117,0,0,203,188,15,69,63,6,1
2021,Sheffield 043A,E01008095,770,275,95,180,20,20,209,114,95,265,248,17,1
2021,Sheffield 043B,E01008096,1037,349,154,195,8,8,461,235,226,218,191,27,1
2021,Sheffield 043C,E01008097,640,269,102,167,6,6,294,194,100,71,60,11,0
2021,Sheffield 048A,E01008098,624,210,101,109,1,1,333,325,8,80,73,7,0
2021,Sheffield 051E,E01008099,643,434,168,266,4,4,57,37,20,148,132,16,0
2021,Sheffield 048B,E01008100,540,158,73,85,0,0,335,312,23,46,42,4,1
2021,Sheffield 043D,E01008101,816,330,137,193,1,1,363,348,15,122,115,7,0
2021,Sheffield 048C,E01008102,620,153,75,78,2,2,404,251,153,57,47,10,4
2021,Sheffield 048D,E01008103,459,158,80,78,0,0,259,234,25,42,40,2,0
2021,Sheffield 036E,E01008104,483,217,126,91,0,0,88,65,23,175,166,9,3
2021,Sheffield 040A,E01008105,655,224,116,108,5,5,77,44,33,348,323,25,1
2021,Sheffield 040C,E01008107,597,171,76,95,0,0,251,149,102,174,163,11,1
2021,Sheffield 042A,E01008108,713,200,80,120,4,4,76,32,44,432,416,16,1
2021,Sheffield 042B,E01008109,755,219,116,103,4,4,190,107,83,339,319,20,3
2021,Sheffield 040D,E01008111,591,190,96,94,1,1,33,8,25,367,357,10,0
2021,Sheffield 042D,E01008112,599,244,111,133,7,7,65,49,16,282,254,28,1
2021,Sheffield 042E,E01008113,651,405,188,217,1,1,39,31,8,206,187,19,0
2021,Sheffield 074A,E01008114,829,74,46,28,5,5,350,159,191,395,380,15,5
2021,Sheffield 074B,E01008115,488,78,41,37,2,2,115,22,93,293,288,5,0
2021,Sheffield 009C,E01008116,538,211,112,99,2,2,282,275,7,41,32,9,2
2021,Sheffield 009D,E01008117,771,423,136,287,1,1,285,268,17,62,47,15,0
2021,Sheffield 009E,E01008118,612,273,136,137,0,0,278,266,12,61,44,17,0
2021,Sheffield 009F,E01008119,512,239,108,131,0,0,227,221,6,44,30,14,2
2021,Sheffield 012E,E01008122,638,230,91,139,0,0,346,312,34,60,50,10,2
2021,Sheffield 015E,E01008123,541,240,110,130,1,1,249,224,25,51,43,8,0
2021,Sheffield 012F,E01008124,619,154,60,94,0,0,386,371,15,79,75,4,0
2021,Sheffield 009G,E01008125,615,396,199,197,1,1,170,163,7,47,39,8,1
2021,Sheffield 008A,E01008126,659,591,335,256,3,3,33,29,4,32,18,14,0
2021,Sheffield 008C,E01008128,739,573,331,242,2,2,34,13,21,130,100,30,0
2021,Sheffield 023A,E01008129,659,559,306,253,3,3,35,34,1,62,48,14,0
2021,Sheffield 023B,E01008130,669,534,307,227,0,0,90,18,72,45,31,14,0
2021,Sheffield 023C,E01008131,670,568,311,257,3,3,67,63,4,32,28,4,0
2021,Sheffield 023D,E01008132,562,532,339,193,1,1,5,4,1,23,15,8,1
2021,Sheffield 023E,E01008133,746,535,335,200,0,0,166,160,6,43,34,9,2
2021,Sheffield 005B,E01008134,599,458,300,158,0,0,78,74,4,63,54,9,0
2021,Sheffield 005C,E01008135,760,605,343,262,7,7,24,7,17,124,100,24,0
2021,Sheffield 008D,E01008136,585,403,238,165,2,2,128,125,3,52,34,18,0
2021,Sheffield 005D,E01008137,628,594,367,227,1,1,7,4,3,26,21,5,0
2021,Sheffield 006D,E01008138,626,310,173,137,0,0,268,248,20,47,45,2,1
2021,Sheffield 006E,E01008139,697,471,263,208,1,1,102,78,24,123,112,11,0
2021,Sheffield 008E,E01008140,848,584,267,317,4,4,160,150,10,100,82,18,0
2021,Sheffield 005E,E01008141,666,581,365,216,0,0,25,21,4,60,53,7,0
2021,Sheffield 002A,E01008142,619,422,212,210,0,0,105,104,1,92,82,10,0
2021,Sheffield 002B,E01008143,765,570,288,282,1,1,94,86,8,100,86,14,0
2021,Sheffield 001A,E01008144,855,657,332,325,4,4,32,23,9,161,144,17,1
2021,Sheffield 001B,E01008145,647,357,219,138,3,3,226,205,21,60,52,8,1
2021,Sheffield 002C,E01008146,521,493,288,205,3,3,0,0,0,25,18,7,0
2021,Sheffield 002D,E01008147,626,523,330,193,0,0,47,47,0,56,45,11,0
2021,Sheffield 001C,E01008148,637,460,280,180,4,4,111,106,5,62,51,11,0
2021,Sheffield 001D,E01008149,641,570,328,242,0,0,4,2,2,66,58,8,1
2021,Sheffield 001E,E01008150,668,411,196,215,1,1,160,104,56,96,68,28,0
2021,Sheffield 024A,E01008151,715,429,188,241,3,3,14,9,5,269,246,23,0
2021,Sheffield 025C,E01008152,661,512,291,221,0,0,91,81,10,58,49,9,0
2021,Sheffield 024B,E01008153,832,490,197,293,1,1,98,82,16,243,223,20,0
2021,Sheffield 024C,E01008154,822,516,266,250,4,4,123,78,45,179,161,18,0
2021,Sheffield 024D,E01008155,714,414,181,233,0,0,99,74,25,201,183,18,0
2021,Sheffield 024E,E01008156,689,599,310,289,1,1,12,2,10,77,72,5,0
2021,Sheffield 026D,E01008157,867,292,162,130,3,3,425,389,36,142,126,16,5
2021,Sheffield 025D,E01008158,717,386,232,154,3,3,254,245,9,74,61,13,0
2021,Sheffield 029D,E01008159,763,498,263,235,5,5,17,1,16,243,224,19,0
2021,Sheffield 024F,E01008160,648,468,230,238,2,2,83,11,72,95,79,16,0
2021,Sheffield 026E,E01008161,816,504,248,256,1,1,28,8,20,281,243,38,2
2021,Gateshead 027A,E01008162,1176,529,186,343,2,2,232,208,24,409,379,30,4
2021,Gateshead 028A,E01008163,758,280,130,150,0,0,176,150,26,300,285,15,2
2021,Gateshead 027B,E01008164,688,253,100,153,0,0,130,87,43,303,275,28,2
2021,Gateshead 011A,E01008165,612,205,121,84,4,4,346,153,193,56,50,6,1
2021,Gateshead 027C,E01008166,622,89,37,52,0,0,302,282,20,226,214,12,5
2021,Gateshead 008A,E01008167,670,278,166,112,6,6,135,74,61,249,233,16,2
2021,Gateshead 008C,E01008170,898,242,109,133,3,3,374,178,196,278,262,16,1
2021,Gateshead 026A,E01008172,828,586,337,249,1,1,170,165,5,71,62,9,0
2021,Gateshead 026B,E01008173,606,274,105,169,0,0,257,226,31,74,71,3,1
2021,Gateshead 026C,E01008174,948,505,226,279,35,35,296,214,82,112,97,15,0
2021,Gateshead 026D,E01008175,666,368,204,164,1,1,60,9,51,237,214,23,0
2021,Gateshead 026E,E01008176,636,506,294,212,0,0,68,61,7,62,51,11,0
2021,Gateshead 005A,E01008177,590,404,219,185,3,3,40,5,35,143,130,13,0
2021,Gateshead 004A,E01008178,694,445,108,337,13,13,82,39,43,154,136,18,0
2021,Gateshead 005B,E01008179,523,367,172,195,1,1,86,84,2,69,63,6,0
2021,Gateshead 004B,E01008180,617,165,74,91,1,1,400,380,20,51,38,13,0
2021,Gateshead 005C,E01008181,651,489,267,222,0,0,103,86,17,59,49,10,0
2021,Gateshead 004C,E01008182,789,351,107,244,2,2,315,265,50,121,107,14,0
2021,Gateshead 029B,E01008183,653,400,225,175,1,1,163,157,6,89,82,7,0
2021,Gateshead 022A,E01008184,644,551,354,197,7,7,50,38,12,36,28,8,0
2021,Gateshead 022B,E01008185,589,260,126,134,7,7,271,243,28,51,41,10,0
2021,Gateshead 029C,E01008186,928,503,305,198,2,2,80,62,18,343,316,27,0
2021,Gateshead 022C,E01008188,603,458,277,181,0,0,101,99,2,43,32,11,1
2021,Gateshead 023A,E01008189,588,206,106,100,0,0,297,269,28,83,78,5,2
2021,Gateshead 023B,E01008190,604,470,291,179,1,1,90,77,13,42,33,9,1
2021,Gateshead 023C,E01008191,725,240,108,132,0,0,396,369,27,84,71,13,5
2021,Gateshead 023D,E01008192,660,345,173,172,0,0,258,244,14,55,49,6,2
2021,Gateshead 020A,E01008193,489,434,240,194,0,0,37,13,24,18,11,7,0
2021,Gateshead 020B,E01008194,603,513,306,207,0,0,34,9,25,56,48,8,0
2021,Gateshead 002A,E01008195,885,627,332,295,5,5,138,124,14,114,93,21,1
2021,Gateshead 029A,E01008196,927,670,368,302,1,1,121,106,15,135,108,27,0
2021,Gateshead 002B,E01008197,800,625,301,324,11,11,14,9,5,150,136,14,0
2021,Gateshead 002C,E01008198,717,451,194,257,5,5,180,144,36,81,73,8,0
2021,Gateshead 002D,E01008199,656,497,290,207,2,2,12,8,4,145,125,20,0
2021,Gateshead 002E,E01008200,596,540,323,217,1,1,1,0,1,54,44,10,0
2021,Gateshead 011B,E01008201,620,190,101,89,0,0,376,317,59,49,44,5,5
2021,Gateshead 011C,E01008202,770,385,175,210,7,7,224,169,55,151,144,7,3
2021,Gateshead 028B,E01008203,813,264,137,127,2,2,203,88,115,343,320,23,1
2021,Gateshead 011D,E01008204,706,178,98,80,0,0,428,116,312,100,91,9,0
2021,Gateshead 028C,E01008205,676,529,311,218,1,1,41,8,33,104,95,9,1
2021,Gateshead 013A,E01008206,727,556,284,272,3,3,91,84,7,77,65,12,0
2021,Gateshead 013B,E01008207,587,519,302,217,0,0,29,25,4,39,30,9,0
2021,Gateshead 013C,E01008208,722,386,179,207,2,2,212,175,37,122,106,16,0
2021,Gateshead 007A,E01008209,962,440,201,239,12,12,197,171,26,312,278,34,1
2021,Gateshead 007B,E01008210,678,278,127,151,8,8,255,72,183,137,128,9,0
2021,Gateshead 013D,E01008211,751,491,271,220,1,1,106,61,45,152,129,23,1
2021,Gateshead 012A,E01008212,642,200,98,102,2,2,318,287,31,117,106,11,5
2021,Gateshead 012B,E01008213,674,397,219,178,1,1,235,188,47,41,31,10,0
2021,Gateshead 003A,E01008214,735,131,57,74,4,4,518,409,109,81,76,5,1
2021,Gateshead 003B,E01008215,735,176,79,97,0,0,400,224,176,158,139,19,1
2021,Gateshead 012C,E01008216,698,259,138,121,0,0,367,216,151,70,61,9,2
2021,Gateshead 023E,E01008217,719,399,221,178,3,3,214,202,12,103,87,16,0
2021,Gateshead 021A,E01008218,737,243,133,110,3,3,430,396,34,60,47,13,1
2021,Gateshead 016A,E01008219,706,400,196,204,2,2,208,196,12,96,86,10,0
2021,Gateshead 021B,E01008220,567,125,67,58,0,0,374,313,61,58,49,9,10
2021,Gateshead 021C,E01008221,765,358,163,195,1,1,329,309,20,76,60,16,1
2021,Gateshead 025A,E01008222,700,423,179,244,2,2,211,203,8,64,52,12,0
2021,Gateshead 025B,E01008223,805,214,107,107,1,1,490,444,46,100,87,13,0
2021,Gateshead 025C,E01008224,1099,860,353,507,10,10,186,125,61,43,29,14,0
2021,Gateshead 021D,E01008225,775,525,318,207,1,1,189,70,119,58,50,8,2
2021,Gateshead 025D,E01008226,768,462,241,221,9,9,211,181,30,84,70,14,2
2021,Gateshead 021E,E01008227,633,121,54,67,0,0,465,431,34,47,39,8,0
2021,Gateshead 012D,E01008228,537,233,122,111,1,1,229,198,31,74,61,13,0
2021,Gateshead 018A,E01008229,630,448,300,148,1,1,132,122,10,49,36,13,0
2021,Gateshead 018B,E01008230,611,333,159,174,8,8,176,122,54,94,85,9,0
2021,Gateshead 015A,E01008231,664,252,128,124,1,1,326,312,14,84,78,6,1
2021,Gateshead 018C,E01008232,582,226,105,121,1,1,283,237,46,69,65,4,3
2021,Gateshead 018D,E01008233,587,480,297,183,2,2,36,34,2,69,56,13,0
2021,Gateshead 020C,E01008234,984,785,451,334,12,12,30,14,16,157,133,24,0
2021,Gateshead 016B,E01008235,626,554,317,237,1,1,34,23,11,37,26,11,0
2021,Gateshead 016C,E01008236,751,426,213,213,15,15,146,100,46,164,152,12,0
2021,Gateshead 016D,E01008237,591,554,268,286,1,1,5,2,3,31,25,6,0
2021,Gateshead 016E,E01008238,659,518,263,255,10,10,16,7,9,115,107,8,0
2021,Gateshead 020D,E01008239,658,552,296,256,0,0,32,13,19,74,65,9,0
2021,Gateshead 015B,E01008240,631,402,186,216,0,0,177,175,2,50,35,15,2
2021,Gateshead 015C,E01008241,691,427,235,192,1,1,218,188,30,45,36,9,0
2021,Gateshead 015D,E01008242,681,319,131,188,1,1,303,284,19,58,50,8,0
2021,Gateshead 003C,E01008243,729,524,314,210,1,1,73,69,4,130,113,17,1
2021,Gateshead 003D,E01008244,948,461,204,257,5,5,174,154,20,308,281,27,0
2021,Gateshead 002F,E01008245,626,509,304,205,1,1,69,67,2,47,37,10,0
2021,Gateshead 001A,E01008246,623,346,155,191,5,5,207,187,20,65,57,8,0
2021,Gateshead 001B,E01008247,730,371,229,142,1,1,300,141,159,57,49,8,1
2021,Gateshead 001C,E01008248,1110,948,355,593,3,3,34,10,24,125,103,22,0
2021,Gateshead 001D,E01008249,728,602,431,171,0,0,55,45,10,71,56,15,0
2021,Gateshead 001E,E01008250,599,400,202,198,0,0,145,132,13,54,49,5,0
2021,Gateshead 010A,E01008251,850,353,154,199,2,2,63,40,23,430,411,19,2
2021,Gateshead 010B,E01008252,674,261,123,138,1,1,118,72,46,292,266,26,2
2021,Gateshead 010C,E01008253,679,237,101,136,2,2,54,15,39,380,350,30,6
2021,Gateshead 010D,E01008254,696,266,111,155,21,21,117,26,91,287,273,14,5
2021,Gateshead 010E,E01008255,909,573,271,302,0,0,233,166,67,103,86,17,0
2021,Gateshead 019A,E01008256,745,574,301,273,0,0,85,71,14,86,77,9,0
2021,Gateshead 008E,E01008257,638,221,132,89,1,1,315,226,89,101,86,15,0
2021,Gateshead 007C,E01008258,1151,480,136,344,8,8,330,268,62,331,310,21,2
2021,Gateshead 007D,E01008259,1011,346,129,217,0,0,558,480,78,102,85,17,5
2021,Gateshead 019B,E01008260,628,561,269,292,5,5,16,15,1,45,39,6,1
2021,Gateshead 019C,E01008261,621,292,160,132,1,1,277,265,12,49,39,10,2
2021,Gateshead 009A,E01008262,757,367,166,201,1,1,104,62,42,283,273,10,2
2021,Gateshead 009B,E01008263,635,284,121,163,0,0,262,240,22,89,82,7,0
2021,Gateshead 009C,E01008264,598,553,314,239,2,2,9,8,1,34,28,6,0
2021,Gateshead 009D,E01008265,613,406,212,194,3,3,140,134,6,63,53,10,1
2021,Gateshead 009E,E01008266,613,443,291,152,3,3,83,11,72,84,68,16,0
2021,Gateshead 017A,E01008267,710,516,362,154,0,0,135,108,27,58,45,13,1
2021,Gateshead 019D,E01008268,617,477,259,218,0,0,85,74,11,55,46,9,0
2021,Gateshead 017B,E01008269,643,590,377,213,2,2,9,4,5,42,35,7,0
2021,Gateshead 017C,E01008270,600,556,405,151,0,0,9,6,3,35,21,14,0
2021,Gateshead 017D,E01008271,595,526,324,202,1,1,9,5,4,59,58,1,0
2021,Gateshead 019E,E01008272,699,593,355,238,5,5,38,6,32,61,50,11,2
2021,Gateshead 019F,E01008273,635,490,241,249,0,0,55,23,32,90,78,12,0
2021,Gateshead 019G,E01008274,602,358,180,178,1,1,157,150,7,86,66,20,0
2021,Gateshead 017E,E01008275,643,578,367,211,0,0,4,3,1,60,53,7,1
2021,Gateshead 005D,E01008276,725,462,234,228,0,0,170,160,10,92,84,8,1
2021,Gateshead 004D,E01008277,657,425,253,172,1,1,169,159,10,62,42,20,0
2021,Gateshead 022D,E01008278,657,609,379,230,1,1,17,13,4,30,23,7,0
2021,Gateshead 005E,E01008279,665,572,398,174,0,0,12,5,7,81,71,10,0
2021,Gateshead 004E,E01008280,910,384,181,203,8,8,352,257,95,164,136,28,2
2021,Gateshead 015E,E01008281,667,342,176,166,0,0,255,222,33,69,53,16,1
2021,Gateshead 015F,E01008282,622,257,126,131,1,1,299,94,205,65,56,9,0
2021,Gateshead 014A,E01008283,582,526,336,190,2,2,2,1,1,52,40,12,0
2021,Gateshead 014B,E01008284,605,436,262,174,1,1,106,92,14,62,50,12,0
2021,Gateshead 018E,E01008285,629,228,111,117,0,0,327,265,62,74,62,12,0
2021,Gateshead 014C,E01008286,661,400,251,149,0,0,202,193,9,59,50,9,0
2021,Gateshead 014D,E01008287,797,603,243,360,1,1,128,55,73,64,50,14,1
2021,Newcastle upon Tyne 027A,E01008288,632,346,189,157,3,3,135,76,59,147,138,9,1
2021,Newcastle upon Tyne 027B,E01008289,645,192,104,88,0,0,380,313,67,67,52,15,6
2021,Newcastle upon Tyne 027C,E01008290,700,299,135,164,10,10,211,54,157,178,145,33,2
2021,Newcastle upon Tyne 027D,E01008291,884,79,40,39,1,1,567,324,243,231,208,23,6
2021,Newcastle upon Tyne 027E,E01008292,552,476,263,213,1,1,8,3,5,67,55,12,0
2021,Newcastle upon Tyne 004A,E01008293,642,460,274,186,5,5,40,28,12,137,119,18,0
2021,Newcastle upon Tyne 033D,E01008294,607,464,292,172,2,2,8,3,5,133,115,18,0
2021,Newcastle upon Tyne 008A,E01008295,647,223,99,124,0,0,365,339,26,56,47,9,3
2021,Newcastle upon Tyne 011A,E01008296,702,383,229,154,0,0,209,171,38,108,86,22,2
2021,Newcastle upon Tyne 011B,E01008297,880,341,106,235,9,9,426,368,58,104,93,11,0
2021,Newcastle upon Tyne 011C,E01008298,822,476,178,298,78,78,141,78,63,127,101,26,0
2021,Newcastle upon Tyne 011D,E01008299,560,236,104,132,22,22,238,202,36,61,44,17,3
2021,Newcastle upon Tyne 016A,E01008300,824,395,130,265,0,0,313,270,43,115,105,10,1
2021,Newcastle upon Tyne 040D,E01008301,882,364,163,201,2,2,161,104,57,352,329,23,3
2021,Newcastle upon Tyne 035D,E01008302,741,212,120,92,1,1,379,298,81,143,134,9,6
2021,Newcastle upon Tyne 018A,E01008303,993,144,82,62,0,0,657,416,241,184,167,17,8
2021,Newcastle upon Tyne 040C,E01008305,944,115,66,49,1,1,690,352,338,134,113,21,4
2021,Newcastle upon Tyne 032A,E01008306,1062,771,351,420,3,3,211,175,36,77,63,14,0
2021,Newcastle upon Tyne 032B,E01008307,646,360,121,239,1,1,203,142,61,81,70,11,1
2021,Newcastle upon Tyne 002A,E01008309,729,682,412,270,0,0,11,7,4,36,30,6,0
2021,Newcastle upon Tyne 033A,E01008311,873,723,343,380,0,0,8,4,4,142,131,11,0
2021,Newcastle upon Tyne 033B,E01008312,494,388,221,167,1,1,16,12,4,88,73,15,1
2021,Newcastle upon Tyne 033C,E01008313,475,348,192,156,0,0,36,34,2,90,75,15,1
2021,Newcastle upon Tyne 012A,E01008314,471,354,191,163,0,0,45,40,5,72,60,12,0
2021,Newcastle upon Tyne 012B,E01008315,627,434,241,193,1,1,93,86,7,99,83,16,0
2021,Newcastle upon Tyne 012C,E01008316,652,545,283,262,0,0,8,4,4,99,77,22,0
2021,Newcastle upon Tyne 007A,E01008317,536,493,267,226,0,0,7,4,3,36,30,6,0
2021,Newcastle upon Tyne 012D,E01008318,600,268,115,153,1,1,251,230,21,73,64,9,7
2021,Newcastle upon Tyne 007B,E01008319,686,624,345,279,2,2,7,6,1,53,45,8,0
2021,Newcastle upon Tyne 007C,E01008320,668,527,282,245,2,2,58,51,7,81,67,14,0
2021,Newcastle upon Tyne 007D,E01008321,734,548,298,250,4,4,36,24,12,146,130,16,0
2021,Newcastle upon Tyne 007E,E01008322,586,524,269,255,2,2,18,16,2,42,38,4,0
2021,Newcastle upon Tyne 007F,E01008323,760,446,189,257,7,7,53,36,17,254,221,33,0
2021,Newcastle upon Tyne 015A,E01008324,544,240,135,105,3,3,205,150,55,93,83,10,3
2021,Newcastle upon Tyne 015B,E01008325,628,240,144,96,1,1,308,292,16,75,65,10,4
2021,Newcastle upon Tyne 015C,E01008326,580,516,267,249,0,0,13,12,1,50,38,12,1
2021,Newcastle upon Tyne 015D,E01008327,560,172,72,100,1,1,320,295,25,67,62,5,0
2021,Newcastle upon Tyne 015E,E01008328,564,520,352,168,2,2,7,3,4,35,23,12,0
2021,Newcastle upon Tyne 015F,E01008329,618,411,181,230,1,1,103,80,23,102,87,15,1
2021,Newcastle upon Tyne 015G,E01008330,651,293,115,178,3,3,267,230,37,86,72,14,2
2021,Newcastle upon Tyne 041A,E01008331,594,123,56,67,0,0,293,221,72,173,153,20,5
2021,Newcastle upon Tyne 038E,E01008333,536,250,130,120,1,1,82,53,29,203,180,23,0
2021,Newcastle upon Tyne 038A,E01008334,867,289,140,149,1,1,175,130,45,401,331,70,1
2021,Newcastle upon Tyne 038D,E01008335,689,298,134,164,3,3,38,14,24,348,328,20,2
2021,Newcastle upon Tyne 003A,E01008336,663,289,155,134,14,14,259,232,27,100,88,12,1
2021,Newcastle upon Tyne 003B,E01008337,550,210,134,76,2,2,281,265,16,57,47,10,0
2021,Newcastle upon Tyne 003C,E01008338,492,267,134,133,1,1,109,94,15,113,99,14,2
2021,Newcastle upon Tyne 003D,E01008339,777,311,120,191,0,0,318,236,82,147,126,21,1
2021,Newcastle upon Tyne 003E,E01008340,720,174,76,98,0,0,495,409,86,50,44,6,1
2021,Newcastle upon Tyne 003F,E01008341,658,315,157,158,4,4,233,205,28,102,92,10,4
2021,Newcastle upon Tyne 003G,E01008342,700,509,322,187,7,7,44,1,43,139,121,18,1
2021,Newcastle upon Tyne 019A,E01008343,629,474,223,251,1,1,58,48,10,95,79,16,1
2021,Newcastle upon Tyne 019B,E01008344,698,422,212,210,1,1,130,107,23,145,125,20,0
2021,Newcastle upon Tyne 019C,E01008345,825,324,158,166,1,1,416,338,78,82,76,6,2
2021,Newcastle upon Tyne 019D,E01008346,466,222,123,99,2,2,98,91,7,143,129,14,1
2021,Newcastle upon Tyne 019E,E01008347,542,402,202,200,0,0,59,55,4,80,60,20,1
2021,Newcastle upon Tyne 019F,E01008348,415,166,80,86,1,1,205,186,19,41,37,4,2
2021,Newcastle upon Tyne 019G,E01008349,471,308,140,168,1,1,20,16,4,142,130,12,0
2021,Newcastle upon Tyne 019H,E01008350,719,387,141,246,12,12,218,188,30,101,91,10,1
2021,Newcastle upon Tyne 005A,E01008351,615,486,273,213,0,0,67,45,22,60,53,7,2
2021,Newcastle upon Tyne 002C,E01008352,616,412,215,197,2,2,110,104,6,92,76,16,0
2021,Newcastle upon Tyne 006A,E01008353,709,405,230,175,1,1,223,187,36,80,71,9,0
2021,Newcastle upon Tyne 005B,E01008354,760,419,187,232,1,1,214,197,17,123,101,22,3
2021,Newcastle upon Tyne 006B,E01008355,752,562,311,251,6,6,39,9,30,145,131,14,0
2021,Newcastle upon Tyne 006C,E01008356,589,390,229,161,7,7,97,63,34,94,84,10,1
2021,Newcastle upon Tyne 002D,E01008357,678,596,414,182,0,0,15,11,4,67,56,11,0
2021,Newcastle upon Tyne 002E,E01008358,908,273,139,134,0,0,26,8,18,609,597,12,0
2021,Newcastle upon Tyne 018B,E01008359,560,179,70,109,3,3,122,37,85,256,245,11,0
2021,Newcastle upon Tyne 018C,E01008360,775,288,107,181,5,5,39,9,30,443,408,35,0
2021,Newcastle upon Tyne 018D,E01008361,675,174,65,109,3,3,132,83,49,366,352,14,0
2021,Newcastle upon Tyne 018E,E01008362,689,168,62,106,3,3,174,93,81,343,329,14,1
2021,Newcastle upon Tyne 012E,E01008363,837,575,345,230,5,5,8,3,5,249,226,23,0
2021,Newcastle upon Tyne 018F,E01008364,683,302,116,186,1,1,48,12,36,332,319,13,0
2021,Newcastle upon Tyne 012F,E01008365,575,483,257,226,2,2,9,2,7,80,65,15,1
2021,Newcastle upon Tyne 013A,E01008366,656,227,125,102,1,1,22,10,12,406,394,12,0
2021,Newcastle upon Tyne 017A,E01008367,784,246,122,124,7,7,81,4,77,450,430,20,0
2021,Newcastle upon Tyne 017B,E01008368,529,185,100,85,1,1,21,5,16,322,318,4,0
2021,Newcastle upon Tyne 013B,E01008369,673,234,144,90,1,1,41,9,32,396,379,17,1
2021,Newcastle upon Tyne 017C,E01008370,833,325,191,134,6,6,97,7,90,405,387,18,0
2021,Newcastle upon Tyne 013C,E01008371,627,516,351,165,0,0,11,4,7,100,87,13,0
2021,Newcastle upon Tyne 013D,E01008372,682,169,80,89,4,4,85,22,63,424,416,8,0
2021,Newcastle upon Tyne 013E,E01008373,686,106,58,48,5,5,23,13,10,550,535,15,2
2021,Newcastle upon Tyne 008B,E01008374,631,464,249,215,3,3,88,75,13,76,65,11,0
2021,Newcastle upon Tyne 008C,E01008375,735,341,156,185,0,0,306,252,54,86,66,20,2
2021,Newcastle upon Tyne 008D,E01008376,455,412,212,200,4,4,9,5,4,30,24,6,0
2021,Newcastle upon Tyne 008E,E01008377,851,325,88,237,32,32,286,281,5,205,193,12,3
2021,Newcastle upon Tyne 006D,E01008378,522,475,254,221,0,0,13,12,1,34,25,9,0
2021,Newcastle upon Tyne 008F,E01008379,807,388,240,148,0,0,347,269,78,71,62,9,1
2021,Newcastle upon Tyne 008G,E01008380,780,91,43,48,2,2,508,328,180,172,153,19,7
2021,Newcastle upon Tyne 021A,E01008381,704,569,271,298,1,1,14,7,7,120,109,11,0
2021,Newcastle upon Tyne 021B,E01008382,494,186,74,112,0,0,274,258,16,32,25,7,2
2021,Newcastle upon Tyne 021C,E01008383,654,290,140,150,0,0,256,243,13,102,89,13,6
2021,Newcastle upon Tyne 021D,E01008384,593,435,237,198,0,0,90,83,7,66,57,9,2
2021,Newcastle upon Tyne 021E,E01008385,683,316,153,163,1,1,141,29,112,224,204,20,1
2021,Newcastle upon Tyne 021F,E01008386,565,424,246,178,1,1,89,84,5,50,43,7,1
2021,Newcastle upon Tyne 021G,E01008387,598,460,260,200,0,0,20,16,4,118,101,17,0
2021,Newcastle upon Tyne 028A,E01008388,802,149,75,74,2,2,496,449,47,147,128,19,8
2021,Newcastle upon Tyne 028B,E01008389,787,195,87,108,1,1,540,518,22,49,36,13,2
2021,Newcastle upon Tyne 030A,E01008390,830,138,52,86,8,8,610,450,160,73,67,6,1
2021,Newcastle upon Tyne 035C,E01008391,612,181,80,101,2,2,367,343,24,60,51,9,2
2021,Newcastle upon Tyne 035A,E01008392,961,398,192,206,2,2,213,150,63,346,315,31,2
2021,Newcastle upon Tyne 022B,E01008396,636,59,41,18,1,1,315,124,191,259,240,19,2
2021,Newcastle upon Tyne 036B,E01008397,584,64,36,28,1,1,142,14,128,377,353,24,0
2021,Newcastle upon Tyne 022C,E01008398,831,57,37,20,1,1,556,323,233,210,183,27,7
2021,Newcastle upon Tyne 039A,E01008399,786,134,85,49,0,0,547,349,198,103,95,8,2
2021,Newcastle upon Tyne 014A,E01008400,887,316,132,184,10,10,474,319,155,87,74,13,0
2021,Newcastle upon Tyne 014B,E01008401,593,317,168,149,1,1,213,200,13,57,50,7,5
2021,Newcastle upon Tyne 014C,E01008402,650,401,227,174,0,0,157,116,41,92,84,8,0
2021,Newcastle upon Tyne 014D,E01008403,714,580,326,254,1,1,34,7,27,99,84,15,0
2021,Newcastle upon Tyne 014E,E01008404,810,389,185,204,1,1,257,216,41,160,137,23,3
2021,Newcastle upon Tyne 014F,E01008405,683,340,152,188,2,2,261,247,14,78,62,16,2
2021,Newcastle upon Tyne 037A,E01008406,732,104,60,44,2,2,429,307,122,191,176,15,6
2021,Newcastle upon Tyne 034D,E01008407,839,98,57,41,3,3,298,256,42,438,416,22,2
2021,Newcastle upon Tyne 017D,E01008409,688,317,171,146,17,17,55,26,29,299,287,12,0
2021,Newcastle upon Tyne 034B,E01008410,687,186,96,90,1,1,217,179,38,276,256,20,7
2021,Newcastle upon Tyne 017E,E01008411,721,153,77,76,24,24,99,13,86,445,436,9,0
2021,Newcastle upon Tyne 034A,E01008412,620,310,131,179,1,1,34,23,11,275,255,20,0
2021,Newcastle upon Tyne 034C,E01008413,602,146,62,84,2,2,192,128,64,262,244,18,0
2021,Newcastle upon Tyne 025B,E01008415,558,214,104,110,2,2,176,161,15,162,146,16,4
2021,Newcastle upon Tyne 025C,E01008416,732,581,294,287,6,6,55,25,30,90,62,28,0
2021,Newcastle upon Tyne 005C,E01008418,870,687,446,241,6,6,11,3,8,166,155,11,0
2021,Newcastle upon Tyne 006E,E01008419,629,450,221,229,0,0,20,3,17,159,144,15,0
2021,Newcastle upon Tyne 005D,E01008420,554,447,262,185,1,1,27,22,5,79,71,8,0
2021,Newcastle upon Tyne 006F,E01008421,665,493,255,238,2,2,19,9,10,151,138,13,0
2021,Newcastle upon Tyne 005E,E01008422,641,479,252,227,2,2,24,7,17,136,125,11,0
2021,Newcastle upon Tyne 006G,E01008423,511,456,279,177,1,1,12,7,5,42,38,4,0
2021,Newcastle upon Tyne 005F,E01008424,713,344,149,195,15,15,88,47,41,266,238,28,0
2021,Newcastle upon Tyne 030B,E01008425,758,182,76,106,2,2,508,328,180,60,46,14,6
2021,Newcastle upon Tyne 028C,E01008426,639,156,63,93,0,0,435,394,41,47,42,5,1
2021,Newcastle upon Tyne 030C,E01008427,620,111,51,60,0,0,451,382,69,56,45,11,2
2021,Newcastle upon Tyne 030D,E01008428,667,291,147,144,0,0,316,292,24,59,46,13,1
2021,Newcastle upon Tyne 028D,E01008429,655,195,88,107,3,3,386,319,67,69,62,7,2
2021,Newcastle upon Tyne 020A,E01008430,606,332,186,146,2,2,129,113,16,143,130,13,0
2021,Newcastle upon Tyne 020B,E01008431,717,491,261,230,3,3,86,74,12,137,125,12,0
2021,Newcastle upon Tyne 035B,E01008432,681,404,225,179,0,0,149,126,23,124,105,19,4
2021,Newcastle upon Tyne 020C,E01008433,632,494,305,189,24,24,61,5,56,52,34,18,1
2021,Newcastle upon Tyne 020D,E01008434,598,508,295,213,2,2,51,25,26,36,21,15,1
2021,Newcastle upon Tyne 020E,E01008435,688,280,143,137,0,0,352,317,35,56,41,15,0
2021,Newcastle upon Tyne 020F,E01008436,782,280,114,166,1,1,426,393,33,64,52,12,11
2021,Newcastle upon Tyne 041C,E01008437,621,60,20,40,1,1,496,294,202,61,49,12,3
2021,Newcastle upon Tyne 041B,E01008438,953,156,58,98,3,3,725,644,81,56,49,7,13
2021,Newcastle upon Tyne 039D,E01008439,762,120,55,65,2,2,547,423,124,85,76,9,8
2021,Newcastle upon Tyne 031A,E01008441,834,404,178,226,2,2,310,213,97,118,101,17,0
2021,Newcastle upon Tyne 031B,E01008442,610,543,350,193,3,3,7,5,2,57,45,12,0
2021,Newcastle upon Tyne 014G,E01008443,610,556,333,223,0,0,6,5,1,48,38,10,0
2021,Newcastle upon Tyne 031C,E01008444,719,611,355,256,0,0,40,18,22,68,54,14,0
2021,Newcastle upon Tyne 031D,E01008445,873,638,320,318,0,0,111,82,29,122,106,16,2
2021,Newcastle upon Tyne 031E,E01008446,637,578,397,181,1,1,11,8,3,47,26,21,0
2021,Newcastle upon Tyne 031F,E01008447,634,499,334,165,0,0,73,40,33,60,44,16,2
2021,Newcastle upon Tyne 031G,E01008448,630,580,392,188,0,0,9,5,4,41,36,5,0
2021,Newcastle upon Tyne 022D,E01008449,615,114,52,62,0,0,108,24,84,391,353,38,2
2021,Newcastle upon Tyne 016B,E01008450,634,285,104,181,3,3,259,247,12,84,79,5,3
2021,Newcastle upon Tyne 016C,E01008451,876,352,158,194,0,0,107,91,16,415,389,26,2
2021,Newcastle upon Tyne 016D,E01008452,502,416,225,191,2,2,22,5,17,62,44,18,0
2021,Newcastle upon Tyne 022E,E01008453,606,491,228,263,1,1,8,7,1,106,81,25,0
2021,Newcastle upon Tyne 022G,E01008455,517,253,133,120,0,0,38,13,25,226,203,23,0
2021,Newcastle upon Tyne 004B,E01008456,661,261,111,150,9,9,314,264,50,74,62,12,3
2021,Newcastle upon Tyne 004C,E01008457,796,264,132,132,9,9,432,350,82,90,74,16,1
2021,Newcastle upon Tyne 004D,E01008458,921,818,390,428,4,4,16,12,4,83,70,13,0
2021,Newcastle upon Tyne 004E,E01008459,704,152,72,80,1,1,477,430,47,70,63,7,4
2021,Newcastle upon Tyne 004F,E01008460,591,271,154,117,1,1,237,220,17,82,72,10,0
2021,North Tyneside 021A,E01008461,620,349,193,156,3,3,200,178,22,66,59,7,2
2021,North Tyneside 024A,E01008462,704,325,128,197,4,4,242,226,16,130,112,18,3
2021,North Tyneside 024B,E01008463,588,310,168,142,1,1,209,171,38,67,56,11,1
2021,North Tyneside 024C,E01008464,644,489,292,197,0,0,78,73,5,77,63,14,0
2021,North Tyneside 024D,E01008465,648,486,300,186,2,2,86,81,5,72,57,15,2
2021,North Tyneside 021B,E01008466,607,548,345,203,0,0,17,6,11,42,33,9,0
2021,North Tyneside 021C,E01008467,637,477,236,241,9,9,70,59,11,81,68,13,0
2021,North Tyneside 021D,E01008468,681,314,137,177,19,19,273,238,35,75,62,13,0
2021,North Tyneside 018A,E01008469,921,670,357,313,0,0,125,81,44,126,110,16,0
2021,North Tyneside 014A,E01008470,709,361,188,173,0,0,195,102,93,152,140,12,1
2021,North Tyneside 019A,E01008471,652,445,219,226,2,2,155,135,20,49,40,9,1
2021,North Tyneside 018B,E01008472,664,551,313,238,0,0,70,17,53,43,40,3,0
2021,North Tyneside 018C,E01008473,529,432,245,187,1,1,48,34,14,48,43,5,0
2021,North Tyneside 019B,E01008474,633,297,124,173,0,0,282,228,54,54,47,7,0
2021,North Tyneside 008A,E01008475,687,589,281,308,1,1,19,8,11,78,61,17,0
2021,North Tyneside 008B,E01008476,847,391,188,203,40,40,318,297,21,97,81,16,1
2021,North Tyneside 008C,E01008477,767,377,138,239,10,10,308,249,59,71,55,16,1
2021,North Tyneside 002A,E01008478,774,330,148,182,0,0,378,227,151,64,53,11,2
2021,North Tyneside 008D,E01008479,734,598,307,291,2,2,34,6,28,100,83,17,0
2021,North Tyneside 002B,E01008480,732,346,172,174,0,0,295,248,47,90,75,15,1
2021,North Tyneside 023A,E01008481,620,323,167,156,0,0,202,195,7,95,80,15,0
2021,North Tyneside 023B,E01008482,806,322,159,163,3,3,227,198,29,254,226,28,0
2021,North Tyneside 022A,E01008483,738,421,197,224,5,5,16,6,10,295,273,22,1
2021,North Tyneside 023C,E01008484,675,230,117,113,4,4,211,197,14,226,206,20,4
2021,North Tyneside 023D,E01008485,625,82,37,45,2,2,480,294,186,60,58,2,1
2021,North Tyneside 020A,E01008486,668,370,207,163,0,0,195,185,10,101,83,18,2
2021,North Tyneside 020B,E01008487,686,442,239,203,0,0,171,165,6,73,60,13,0
2021,North Tyneside 015A,E01008488,666,328,156,172,1,1,240,207,33,97,87,10,0
2021,North Tyneside 015B,E01008489,783,306,125,181,1,1,388,360,28,86,73,13,2
2021,North Tyneside 015C,E01008490,776,508,289,219,4,4,131,85,46,133,117,16,0
2021,North Tyneside 015D,E01008491,620,337,151,186,0,0,221,214,7,61,53,8,1
2021,North Tyneside 023E,E01008492,746,333,178,155,1,1,256,234,22,156,133,23,0
2021,North Tyneside 013A,E01008493,618,519,295,224,0,0,52,48,4,47,35,12,0
2021,North Tyneside 013B,E01008494,751,508,262,246,2,2,170,105,65,71,55,16,0
2021,North Tyneside 010A,E01008495,736,670,408,262,3,3,19,12,7,44,33,11,0
2021,North Tyneside 010B,E01008496,772,449,243,206,2,2,175,162,13,145,124,21,1
2021,North Tyneside 010C,E01008497,647,612,365,247,1,1,11,10,1,23,17,6,0
2021,North Tyneside 010D,E01008498,736,648,456,192,1,1,40,35,5,47,31,16,0
2021,North Tyneside 014B,E01008499,737,505,225,280,1,1,165,155,10,66,53,13,0
2021,North Tyneside 012A,E01008500,721,534,268,266,1,1,92,79,13,92,79,13,2
2021,North Tyneside 014C,E01008502,705,432,204,228,0,0,206,196,10,67,51,16,0
2021,North Tyneside 018E,E01008503,925,493,218,275,0,0,263,227,36,168,151,17,1
2021,North Tyneside 002C,E01008504,681,612,377,235,23,23,15,6,9,30,26,4,1
2021,North Tyneside 012B,E01008505,881,549,299,250,5,5,191,20,171,136,119,17,0
2021,North Tyneside 012C,E01008506,609,335,176,159,2,2,194,190,4,76,70,6,2
2021,North Tyneside 012D,E01008507,739,575,303,272,9,9,98,31,67,56,43,13,1
2021,North Tyneside 026A,E01008508,634,344,151,193,0,0,234,228,6,56,47,9,0
2021,North Tyneside 026B,E01008509,799,304,119,185,1,1,411,261,150,80,68,12,3
2021,North Tyneside 026C,E01008510,758,421,229,192,2,2,139,69,70,195,173,22,1
2021,North Tyneside 028A,E01008511,808,369,183,186,4,4,233,208,25,202,179,23,0
2021,North Tyneside 026D,E01008512,806,285,113,172,1,1,464,376,88,54,46,8,2
2021,North Tyneside 019C,E01008513,1094,480,176,304,8,8,392,259,133,213,195,18,1
2021,North Tyneside 019D,E01008514,820,440,197,243,3,3,277,111,166,100,93,7,0
2021,North Tyneside 014D,E01008516,865,733,323,410,3,3,59,16,43,69,52,17,1
2021,North Tyneside 005A,E01008517,605,566,291,275,0,0,6,4,2,33,27,6,0
2021,North Tyneside 007A,E01008518,753,580,330,250,1,1,93,89,4,78,61,17,1
2021,North Tyneside 005B,E01008519,650,417,250,167,18,18,121,19,102,94,88,6,0
2021,North Tyneside 003A,E01008520,588,471,252,219,0,0,64,59,5,53,48,5,0
2021,North Tyneside 005C,E01008521,677,579,351,228,3,3,24,17,7,71,63,8,0
2021,North Tyneside 005D,E01008522,669,609,369,240,0,0,6,4,2,52,42,10,2
2021,North Tyneside 003B,E01008523,491,448,238,210,1,1,8,7,1,34,31,3,0
2021,North Tyneside 022B,E01008524,1234,359,215,144,4,4,418,153,265,449,418,31,4
2021,North Tyneside 017A,E01008525,723,552,331,221,4,4,50,41,9,117,105,12,0
2021,North Tyneside 020C,E01008526,634,569,317,252,1,1,16,8,8,48,36,12,0
2021,North Tyneside 017B,E01008527,715,505,264,241,1,1,24,8,16,185,162,23,0
2021,North Tyneside 022C,E01008528,645,450,195,255,2,2,14,6,8,179,169,10,0
2021,North Tyneside 022D,E01008529,730,564,298,266,0,0,32,12,20,134,120,14,0
2021,North Tyneside 020D,E01008530,772,556,367,189,2,2,129,97,32,84,70,14,1
2021,North Tyneside 025A,E01008531,631,543,343,200,4,4,7,4,3,77,63,14,0
2021,North Tyneside 025B,E01008532,769,447,181,266,21,21,205,184,21,96,81,15,0
2021,North Tyneside 030A,E01008533,647,322,143,179,1,1,277,202,75,47,35,12,0
2021,North Tyneside 025C,E01008534,599,493,336,157,3,3,24,14,10,79,63,16,0
2021,North Tyneside 030B,E01008535,658,499,284,215,0,0,86,77,9,73,60,13,0
2021,North Tyneside 030C,E01008536,726,364,171,193,0,0,92,27,65,270,247,23,0
2021,North Tyneside 030D,E01008537,618,351,181,170,1,1,144,92,52,122,100,22,0
2021,North Tyneside 025D,E01008538,1075,860,263,597,7,7,117,11,106,91,70,21,0
2021,North Tyneside 027A,E01008539,805,533,253,280,1,1,82,10,72,189,176,13,0
2021,North Tyneside 027B,E01008540,751,206,109,97,0,0,362,316,46,183,156,27,0
2021,North Tyneside 027C,E01008541,785,289,106,183,2,2,364,157,207,130,114,16,0
2021,North Tyneside 028B,E01008542,769,224,98,126,0,0,421,337,84,123,112,11,1
2021,North Tyneside 028C,E01008543,1061,535,176,359,4,4,279,105,174,241,222,19,2
2021,North Tyneside 027D,E01008544,901,250,116,134,12,12,354,180,174,285,276,9,0
2021,North Tyneside 027E,E01008545,624,120,53,67,15,15,403,150,253,85,74,11,1
2021,North Tyneside 003C,E01008546,607,566,317,249,0,0,10,7,3,31,22,9,0
2021,North Tyneside 001A,E01008547,600,532,345,187,0,0,24,18,6,44,31,13,0
2021,North Tyneside 001B,E01008548,720,697,417,280,2,2,5,4,1,16,11,5,0
2021,North Tyneside 001C,E01008549,683,617,394,223,0,0,11,10,1,55,49,6,0
2021,North Tyneside 003D,E01008550,614,534,253,281,2,2,12,7,5,66,61,5,0
2021,North Tyneside 001D,E01008551,617,574,384,190,0,0,9,4,5,34,23,11,0
2021,North Tyneside 009A,E01008552,740,568,314,254,3,3,56,49,7,113,99,14,0
2021,North Tyneside 009B,E01008553,848,618,339,279,3,3,29,18,11,198,171,27,0
2021,North Tyneside 009C,E01008554,679,452,213,239,2,2,171,167,4,54,42,12,0
2021,North Tyneside 009D,E01008555,690,403,159,244,2,2,221,197,24,64,48,16,0
2021,North Tyneside 013C,E01008556,853,727,393,334,3,3,21,13,8,102,80,22,0
2021,North Tyneside 013D,E01008557,654,624,355,269,2,2,5,2,3,23,17,6,0
2021,North Tyneside 016A,E01008558,816,533,334,199,3,3,71,17,54,209,192,17,0
2021,North Tyneside 017C,E01008559,764,468,180,288,11,11,73,24,49,212,196,16,0
2021,North Tyneside 016B,E01008560,814,528,306,222,2,2,70,7,63,214,197,17,0
2021,North Tyneside 016C,E01008561,904,377,183,194,3,3,338,104,234,185,162,23,1
2021,North Tyneside 016D,E01008562,631,510,286,224,1,1,65,61,4,55,49,6,0
2021,North Tyneside 017D,E01008563,584,562,366,196,0,0,6,4,2,16,8,8,0
2021,North Tyneside 007B,E01008564,656,583,297,286,1,1,6,4,2,66,52,14,0
2021,North Tyneside 007D,E01008567,678,388,161,227,1,1,170,167,3,119,97,22,0
2021,North Tyneside 011B,E01008568,677,453,285,168,5,5,159,144,15,60,50,10,0
2021,North Tyneside 011C,E01008569,683,341,153,188,2,2,285,257,28,55,42,13,0
2021,North Tyneside 011D,E01008570,605,419,181,238,0,0,60,40,20,126,106,20,0
2021,North Tyneside 028D,E01008571,900,351,146,205,17,17,383,258,125,148,133,15,1
2021,North Tyneside 029A,E01008572,908,329,161,168,3,3,122,63,59,454,420,34,0
2021,North Tyneside 029B,E01008573,874,265,128,137,4,4,223,107,116,380,349,31,2
2021,North Tyneside 029C,E01008574,844,619,289,330,9,9,127,102,25,89,74,15,0
2021,North Tyneside 030E,E01008575,712,267,126,141,1,1,259,149,110,183,153,30,2
2021,North Tyneside 029D,E01008576,817,450,185,265,1,1,219,204,15,147,128,19,0
2021,North Tyneside 004A,E01008577,901,618,260,358,14,14,166,103,63,103,87,16,0
2021,North Tyneside 002D,E01008578,611,396,207,189,0,0,142,107,35,72,66,6,1
2021,North Tyneside 004B,E01008579,714,651,468,183,0,0,13,10,3,50,37,13,0
2021,North Tyneside 004C,E01008580,599,491,280,211,3,3,16,9,7,89,61,28,0
2021,North Tyneside 004D,E01008581,885,764,451,313,3,3,53,18,35,65,49,16,0
2021,North Tyneside 004E,E01008582,657,370,183,187,2,2,200,179,21,83,69,14,2
2021,North Tyneside 002E,E01008583,650,375,179,196,7,7,181,135,46,87,79,8,0
2021,North Tyneside 006A,E01008584,723,410,175,235,2,2,29,12,17,281,262,19,1
2021,North Tyneside 006B,E01008585,635,475,213,262,1,1,41,31,10,117,104,13,1
2021,North Tyneside 009E,E01008586,670,486,255,231,3,3,51,10,41,130,116,14,0
2021,North Tyneside 006C,E01008587,634,431,222,209,12,12,59,23,36,132,123,9,0
2021,North Tyneside 006D,E01008588,700,478,220,258,2,2,42,16,26,178,159,19,0
2021,North Tyneside 006E,E01008589,585,547,295,252,3,3,7,4,3,28,23,5,0
2021,South Tyneside 011A,E01008590,744,323,194,129,3,3,254,223,31,164,147,17,0
2021,South Tyneside 011B,E01008591,701,274,130,144,2,2,140,75,65,284,260,24,1
2021,South Tyneside 011C,E01008592,639,333,182,151,0,0,42,34,8,264,238,26,0
2021,South Tyneside 016A,E01008593,607,209,110,99,0,0,338,286,52,59,49,10,1
2021,South Tyneside 011D,E01008594,778,385,147,238,3,3,284,215,69,106,90,16,0
2021,South Tyneside 001A,E01008595,769,414,223,191,6,6,83,62,21,265,233,32,1
2021,South Tyneside 001B,E01008596,511,187,83,104,1,1,204,143,61,116,100,16,3
2021,South Tyneside 001C,E01008597,1071,717,358,359,61,61,57,35,22,236,199,37,0
2021,South Tyneside 001D,E01008598,618,439,228,211,3,3,7,0,7,169,139,30,0
2021,South Tyneside 001E,E01008599,715,353,212,141,1,1,248,194,54,112,96,16,1
2021,South Tyneside 007A,E01008600,607,197,104,93,1,1,257,237,20,148,136,12,4
2021,South Tyneside 012A,E01008601,634,267,132,135,0,0,335,301,34,31,27,4,1
2021,South Tyneside 014A,E01008602,627,250,127,123,2,2,323,317,6,52,45,7,0
2021,South Tyneside 014B,E01008603,673,266,135,131,2,2,333,322,11,72,61,11,0
2021,South Tyneside 007B,E01008604,806,216,104,112,2,2,483,447,36,102,88,14,3
2021,South Tyneside 016B,E01008605,499,337,183,154,2,2,108,105,3,52,41,11,0
2021,South Tyneside 016C,E01008606,768,336,124,212,2,2,319,255,64,109,96,13,2
2021,South Tyneside 016D,E01008607,629,161,93,68,0,0,421,413,8,45,36,9,2
2021,South Tyneside 014C,E01008608,535,193,101,92,0,0,292,257,35,50,49,1,0
2021,South Tyneside 016E,E01008609,640,259,113,146,1,1,299,287,12,81,75,6,0
2021,South Tyneside 021A,E01008610,656,221,102,119,0,0,371,346,25,63,50,13,1
2021,South Tyneside 021B,E01008611,597,501,263,238,2,2,34,7,27,60,49,11,0
2021,South Tyneside 021C,E01008612,649,527,300,227,2,2,62,23,39,58,48,10,0
2021,South Tyneside 021D,E01008613,762,332,179,153,0,0,260,155,105,170,159,11,0
2021,South Tyneside 023A,E01008614,682,454,183,271,0,0,172,170,2,56,48,8,0
2021,South Tyneside 023B,E01008615,683,444,250,194,0,0,152,132,20,86,64,22,1
2021,South Tyneside 022A,E01008616,638,574,311,263,0,0,13,9,4,51,39,12,0
2021,South Tyneside 023C,E01008617,625,548,346,202,1,1,31,4,27,45,32,13,0
2021,South Tyneside 022B,E01008618,532,515,308,207,0,0,5,3,2,12,11,1,0
2021,South Tyneside 022C,E01008619,721,650,438,212,3,3,14,8,6,54,37,17,0
2021,South Tyneside 023D,E01008620,636,554,329,225,2,2,42,36,6,38,28,10,0
2021,South Tyneside 022D,E01008621,607,578,353,225,3,3,7,7,0,19,16,3,0
2021,South Tyneside 013A,E01008622,769,631,422,209,4,4,92,72,20,42,31,11,0
2021,South Tyneside 018A,E01008624,570,300,159,141,7,7,236,106,130,27,20,7,0
2021,South Tyneside 013C,E01008625,688,186,108,78,1,1,476,220,256,25,23,2,0
2021,South Tyneside 020A,E01008627,589,503,324,179,2,2,3,2,1,81,64,17,0
2021,South Tyneside 020B,E01008628,625,258,145,113,2,2,322,311,11,43,37,6,0
2021,South Tyneside 020C,E01008629,587,449,266,183,5,5,84,78,6,49,42,7,0
2021,South Tyneside 020D,E01008630,616,221,76,145,0,0,353,255,98,42,37,5,0
2021,South Tyneside 017A,E01008631,582,358,197,161,3,3,194,179,15,26,21,5,1
2021,South Tyneside 017B,E01008632,559,239,126,113,0,0,284,270,14,35,29,6,1
2021,South Tyneside 008A,E01008633,601,309,153,156,2,2,231,224,7,59,45,14,0
2021,South Tyneside 008B,E01008634,599,155,71,84,0,0,376,94,282,68,57,11,0
2021,South Tyneside 006A,E01008635,623,438,293,145,11,11,110,16,94,63,47,16,1
2021,South Tyneside 008C,E01008636,584,378,201,177,3,3,159,153,6,44,36,8,0
2021,South Tyneside 008D,E01008637,621,348,179,169,1,1,227,196,31,45,40,5,0
2021,South Tyneside 010A,E01008638,585,434,189,245,2,2,14,11,3,135,121,14,0
2021,South Tyneside 009A,E01008639,1053,441,139,302,16,16,448,144,304,147,137,10,1
2021,South Tyneside 010B,E01008640,1149,726,257,469,0,0,198,165,33,225,192,33,0
2021,South Tyneside 010C,E01008641,546,239,122,117,0,0,221,202,19,86,75,11,0
2021,South Tyneside 010D,E01008642,765,678,330,348,7,7,23,8,15,57,42,15,0
2021,South Tyneside 015A,E01008643,744,543,249,294,2,2,161,147,14,37,33,4,1
2021,South Tyneside 015B,E01008644,786,310,158,152,0,0,405,384,21,66,58,8,5
2021,South Tyneside 015C,E01008645,1115,700,169,531,7,7,312,293,19,94,85,9,2
2021,South Tyneside 015D,E01008646,604,422,254,168,1,1,142,139,3,39,30,9,0
2021,South Tyneside 004A,E01008647,669,594,378,216,1,1,28,26,2,46,42,4,0
2021,South Tyneside 004B,E01008648,665,482,305,177,1,1,123,106,17,59,46,13,0
2021,South Tyneside 004C,E01008649,646,274,141,133,32,32,291,251,40,47,44,3,2
2021,South Tyneside 006B,E01008650,591,516,303,213,2,2,37,37,0,36,29,7,0
2021,South Tyneside 004D,E01008651,795,201,102,99,0,0,527,457,70,64,57,7,3
2021,South Tyneside 009B,E01008652,576,271,143,128,2,2,197,133,64,103,86,17,3
2021,South Tyneside 009C,E01008653,529,198,89,109,0,0,297,219,78,34,31,3,0
2021,South Tyneside 009D,E01008654,593,307,146,161,3,3,90,51,39,192,172,20,1
2021,South Tyneside 009E,E01008655,795,405,141,264,0,0,317,268,49,72,60,12,1
2021,South Tyneside 015E,E01008656,648,385,217,168,0,0,211,169,42,52,41,11,0
2021,South Tyneside 009F,E01008657,583,491,278,213,2,2,31,28,3,59,42,17,0
2021,South Tyneside 015F,E01008658,584,197,118,79,1,1,337,327,10,43,35,8,6
2021,South Tyneside 017C,E01008659,627,375,195,180,0,0,205,197,8,47,39,8,0
2021,South Tyneside 007C,E01008660,664,450,227,223,2,2,96,59,37,116,102,14,0
2021,South Tyneside 007D,E01008661,452,265,154,111,0,0,163,158,5,24,19,5,0
2021,South Tyneside 017D,E01008662,505,256,115,141,0,0,222,199,23,25,24,1,2
2021,South Tyneside 017E,E01008663,637,306,189,117,0,0,279,213,66,51,44,7,1
2021,South Tyneside 002A,E01008664,624,206,123,83,0,0,150,77,73,265,244,21,3
2021,South Tyneside 002B,E01008665,699,266,145,121,2,2,262,101,161,166,147,19,3
2021,South Tyneside 002C,E01008666,919,251,63,188,4,4,560,409,151,104,94,10,0
2021,South Tyneside 002D,E01008667,972,324,196,128,9,9,461,279,182,178,155,23,0
2021,South Tyneside 002E,E01008668,743,279,154,125,2,2,276,194,82,186,165,21,0
2021,South Tyneside 012B,E01008669,685,249,110,139,1,1,356,254,102,78,68,10,1
2021,South Tyneside 014D,E01008670,727,330,157,173,0,0,308,277,31,89,75,14,0
2021,South Tyneside 012C,E01008671,596,243,150,93,3,3,202,66,136,148,118,30,0
2021,South Tyneside 012D,E01008672,608,384,218,166,2,2,151,118,33,71,60,11,0
2021,South Tyneside 003A,E01008673,514,418,221,197,4,4,11,1,10,81,72,9,0
2021,South Tyneside 006C,E01008674,518,494,310,184,0,0,2,1,1,22,19,3,0
2021,South Tyneside 003B,E01008675,747,415,191,224,1,1,64,5,59,267,235,32,0
2021,South Tyneside 003C,E01008676,527,329,160,169,0,0,83,7,76,115,103,12,0
2021,South Tyneside 003D,E01008677,627,480,304,176,15,15,53,21,32,79,68,11,0
2021,South Tyneside 003E,E01008678,571,320,179,141,21,21,47,14,33,183,165,18,0
2021,South Tyneside 005A,E01008679,584,412,236,176,0,0,54,46,8,118,103,15,0
2021,South Tyneside 005B,E01008680,644,539,346,193,1,1,66,63,3,38,29,9,0
2021,South Tyneside 006D,E01008681,632,589,388,201,1,1,7,4,3,34,22,12,1
2021,South Tyneside 005C,E01008682,512,181,111,70,11,11,267,174,93,52,44,8,1
2021,South Tyneside 005D,E01008683,667,344,187,157,4,4,78,36,42,241,210,31,0
2021,South Tyneside 018B,E01008684,511,275,153,122,0,0,197,154,43,39,27,12,0
2021,South Tyneside 018C,E01008685,836,584,313,271,5,5,183,175,8,63,54,9,1
2021,South Tyneside 018D,E01008686,703,491,258,233,0,0,151,148,3,61,44,17,0
2021,South Tyneside 018E,E01008687,908,593,368,225,1,1,231,174,57,83,62,21,0
2021,South Tyneside 019A,E01008688,638,299,159,140,3,3,245,234,11,91,79,12,0
2021,South Tyneside 019B,E01008689,723,253,127,126,0,0,414,404,10,55,46,9,1
2021,South Tyneside 019C,E01008690,624,311,141,170,11,11,232,216,16,70,67,3,0
2021,South Tyneside 019D,E01008691,493,446,270,176,0,0,20,18,2,27,23,4,0
2021,South Tyneside 019E,E01008692,626,372,193,179,3,3,190,174,16,60,48,12,1
2021,Sunderland 008A,E01008693,608,308,165,143,2,2,189,69,120,108,94,14,1
2021,Sunderland 008B,E01008694,633,309,161,148,1,1,234,112,122,88,82,6,1
2021,Sunderland 008C,E01008695,596,278,135,143,0,0,244,104,140,74,72,2,0
2021,Sunderland 008D,E01008696,483,384,214,170,0,0,73,42,31,26,20,6,0
2021,Sunderland 008E,E01008697,614,285,156,129,1,1,284,132,152,42,35,7,2
2021,Sunderland 003A,E01008698,712,250,124,126,0,0,372,138,234,90,81,9,0
2021,Sunderland 008F,E01008699,607,243,127,116,0,0,283,148,135,81,76,5,0
2021,Sunderland 013A,E01008700,682,435,176,259,2,2,62,29,33,182,172,10,1
2021,Sunderland 011A,E01008701,615,304,157,147,7,7,80,9,71,224,207,17,0
2021,Sunderland 016A,E01008702,648,96,62,34,1,1,489,132,357,60,48,12,2
2021,Sunderland 013B,E01008703,1091,84,46,38,3,3,559,209,350,444,431,13,1
2021,Sunderland 011B,E01008704,618,347,195,152,0,0,84,28,56,186,155,31,1
2021,Sunderland 013C,E01008705,463,192,122,70,0,0,71,31,40,200,187,13,0
2021,Sunderland 011C,E01008706,628,322,164,158,0,0,64,10,54,242,223,19,0
2021,Sunderland 011D,E01008707,504,264,142,122,3,3,11,3,8,224,203,21,2
2021,Sunderland 005A,E01008708,675,389,205,184,3,3,223,90,133,60,47,13,0
2021,Sunderland 005B,E01008709,622,171,102,69,1,1,288,103,185,157,147,10,5
2021,Sunderland 005D,E01008711,679,436,203,233,0,0,110,50,60,133,120,13,0
2021,Sunderland 004A,E01008712,864,306,181,125,13,13,430,193,237,114,104,10,1
2021,Sunderland 001A,E01008713,632,565,329,236,2,2,4,1,3,61,40,21,0
2021,Sunderland 034A,E01008714,641,221,95,126,7,7,341,132,209,71,61,10,1
2021,Sunderland 034B,E01008715,604,352,183,169,8,8,127,36,91,116,101,15,1
2021,Sunderland 034C,E01008716,649,598,384,214,0,0,12,3,9,39,34,5,0
2021,Sunderland 034D,E01008717,706,411,242,169,0,0,230,110,120,65,58,7,0
2021,Sunderland 035A,E01008718,799,520,226,294,8,8,196,90,106,75,60,15,0
2021,Sunderland 035B,E01008719,538,270,157,113,2,2,125,39,86,141,130,11,0
2021,Sunderland 032A,E01008720,606,410,228,182,0,0,90,42,48,106,99,7,0
2021,Sunderland 032B,E01008721,615,523,267,256,0,0,35,19,16,57,53,4,0
2021,Sunderland 001B,E01008722,642,564,338,226,3,3,29,1,28,46,34,12,0
2021,Sunderland 002A,E01008723,599,561,352,209,2,2,0,0,0,36,30,6,0
2021,Sunderland 001C,E01008724,480,466,257,209,0,0,0,0,0,14,13,1,0
2021,Sunderland 002B,E01008725,617,541,342,199,4,4,39,1,38,33,22,11,0
2021,Sunderland 001D,E01008726,656,578,338,240,3,3,3,1,2,72,64,8,0
2021,Sunderland 002C,E01008727,754,597,337,260,0,0,22,11,11,135,110,25,0
2021,Sunderland 002D,E01008728,575,499,290,209,2,2,13,3,10,61,48,13,0
2021,Sunderland 021B,E01008730,641,203,108,95,1,1,379,192,187,58,53,5,0
2021,Sunderland 021D,E01008732,914,498,250,248,1,1,262,136,126,153,140,13,0
2021,Sunderland 021E,E01008733,835,286,146,140,1,1,463,204,259,85,66,19,0
2021,Sunderland 021F,E01008734,622,577,418,159,1,1,11,5,6,33,30,3,0
2021,Sunderland 016B,E01008735,943,304,169,135,3,3,243,45,198,393,361,32,0
2021,Sunderland 016C,E01008736,505,157,90,67,1,1,137,46,91,210,192,18,0
2021,Sunderland 016D,E01008737,539,262,148,114,2,2,81,32,49,194,177,17,0
2021,Sunderland 016E,E01008738,515,279,176,103,2,2,55,17,38,179,173,6,0
2021,Sunderland 024A,E01008739,593,328,189,139,1,1,189,99,90,75,63,12,0
2021,Sunderland 022A,E01008740,608,514,333,181,0,0,8,0,8,86,68,18,0
2021,Sunderland 024B,E01008741,624,486,272,214,0,0,54,18,36,84,75,9,0
2021,Sunderland 035C,E01008742,726,460,274,186,4,4,95,29,66,167,144,23,0
2021,Sunderland 036A,E01008743,685,191,106,85,1,1,417,205,212,75,69,6,1
2021,Sunderland 036B,E01008744,911,526,191,335,2,2,216,77,139,167,145,22,0
2021,Sunderland 036C,E01008745,747,615,380,235,8,8,36,2,34,88,65,23,0
2021,Sunderland 036D,E01008746,914,425,166,259,3,3,361,198,163,125,113,12,0
2021,Sunderland 035D,E01008747,777,528,281,247,5,5,181,81,100,62,52,10,1
2021,Sunderland 035E,E01008748,711,455,283,172,0,0,209,95,114,47,42,5,0
2021,Sunderland 034E,E01008749,630,543,381,162,0,0,48,18,30,39,30,9,0
2021,Sunderland 033A,E01008750,862,672,317,355,3,3,118,53,65,69,64,5,0
2021,Sunderland 033B,E01008751,633,399,141,258,9,9,175,76,99,50,39,11,0
2021,Sunderland 033C,E01008752,826,451,159,292,3,3,270,125,145,102,94,8,0
2021,Sunderland 033D,E01008753,599,341,204,137,4,4,139,65,74,115,95,20,0
2021,Sunderland 034F,E01008754,670,283,166,117,0,0,275,118,157,112,101,11,0
2021,Sunderland 033E,E01008755,605,330,180,150,4,4,147,64,83,124,110,14,0
2021,Sunderland 012A,E01008756,637,280,142,138,3,3,283,111,172,70,55,15,1
2021,Sunderland 015A,E01008757,631,357,230,127,1,1,93,42,51,180,157,23,0
2021,Sunderland 015B,E01008758,590,468,270,198,1,1,74,12,62,47,36,11,0
2021,Sunderland 015C,E01008759,642,486,293,193,2,2,15,7,8,139,119,20,0
2021,Sunderland 018A,E01008760,614,511,268,243,1,1,5,2,3,97,79,18,0
2021,Sunderland 015D,E01008761,586,520,320,200,2,2,6,3,3,58,48,10,0
2021,Sunderland 012B,E01008762,776,244,122,122,36,36,389,164,225,107,96,11,0
2021,Sunderland 028A,E01008763,611,305,160,145,0,0,247,126,121,59,51,8,0
2021,Sunderland 028B,E01008764,680,415,257,158,3,3,176,74,102,86,73,13,0
2021,Sunderland 031A,E01008765,625,527,296,231,0,0,52,14,38,46,38,8,0
2021,Sunderland 028C,E01008766,1192,761,212,549,0,0,332,133,199,99,76,23,0
2021,Sunderland 031B,E01008767,624,421,222,199,3,3,142,62,80,58,49,9,0
2021,Sunderland 028D,E01008768,806,511,235,276,2,2,217,81,136,74,62,12,2
2021,Sunderland 028E,E01008769,773,374,188,186,0,0,207,76,131,192,176,16,0
2021,Sunderland 031C,E01008770,557,411,243,168,3,3,94,14,80,49,43,6,0
2021,Sunderland 031D,E01008771,611,416,200,216,5,5,147,75,72,43,36,7,0
2021,Sunderland 029A,E01008772,592,502,322,180,0,0,58,3,55,32,25,7,0
2021,Sunderland 026A,E01008773,635,221,103,118,2,2,283,131,152,129,111,18,0
2021,Sunderland 029B,E01008774,593,463,292,171,1,1,60,24,36,69,59,10,0
2021,Sunderland 029C,E01008775,600,555,351,204,2,2,18,5,13,25,17,8,0
2021,Sunderland 026B,E01008776,498,257,128,129,0,0,170,86,84,68,61,7,3
2021,Sunderland 026C,E01008777,938,154,81,73,0,0,708,275,433,76,62,14,0
2021,Sunderland 026D,E01008778,596,349,188,161,1,1,156,69,87,90,76,14,0
2021,Sunderland 024C,E01008779,649,388,213,175,0,0,156,60,96,105,89,16,0
2021,Sunderland 024D,E01008780,820,444,208,236,1,1,299,139,160,76,62,14,0
2021,Sunderland 022B,E01008781,630,539,349,190,4,4,4,2,2,83,63,20,0
2021,Sunderland 022C,E01008782,601,554,338,216,0,0,24,5,19,23,13,10,0
2021,Sunderland 022D,E01008783,612,539,345,194,1,1,6,3,3,66,55,11,0
2021,Sunderland 022E,E01008784,624,572,338,234,2,2,14,7,7,36,32,4,0
2021,Sunderland 022F,E01008785,619,585,407,178,5,5,5,2,3,24,15,9,0
2021,Sunderland 006A,E01008786,641,500,302,198,0,0,41,25,16,100,80,20,0
2021,Sunderland 006B,E01008787,674,442,274,168,0,0,38,8,30,194,171,23,0
2021,Sunderland 006C,E01008788,735,509,317,192,4,4,31,17,14,191,169,22,0
2021,Sunderland 006D,E01008789,640,465,279,186,11,11,18,8,10,146,130,16,0
2021,Sunderland 006E,E01008790,648,448,247,201,4,4,76,23,53,120,106,14,0
2021,Sunderland 006F,E01008791,904,175,103,72,25,25,510,133,377,193,168,25,1
2021,Sunderland 002E,E01008792,491,459,331,128,2,2,3,1,2,27,24,3,0
2021,Sunderland 030A,E01008793,788,216,113,103,0,0,467,208,259,105,85,20,0
2021,Sunderland 030B,E01008795,718,536,253,283,0,0,129,56,73,53,34,19,0
2021,Sunderland 032D,E01008796,768,604,235,369,1,1,52,17,35,111,99,12,0
2021,Sunderland 025A,E01008799,675,568,286,282,0,0,36,17,19,71,57,14,0
2021,Sunderland 030D,E01008800,599,199,77,122,0,0,355,147,208,45,41,4,0
2021,Sunderland 030E,E01008801,668,607,348,259,0,0,6,3,3,55,40,15,0
2021,Sunderland 029D,E01008802,632,451,297,154,25,25,104,42,62,52,41,11,0
2021,Sunderland 027A,E01008803,676,325,192,133,4,4,226,85,141,121,108,13,0
2021,Sunderland 027B,E01008804,660,354,188,166,0,0,250,58,192,56,47,9,0
2021,Sunderland 027C,E01008805,629,346,182,164,0,0,118,52,66,165,145,20,0
2021,Sunderland 029E,E01008808,700,553,304,249,2,2,10,2,8,135,120,15,0
2021,Sunderland 026E,E01008809,754,463,271,192,1,1,220,86,134,69,58,11,1
2021,Sunderland 014A,E01008810,689,301,118,183,0,0,287,143,144,101,79,22,0
2021,Sunderland 014B,E01008811,672,494,238,256,0,0,108,54,54,70,58,12,0
2021,Sunderland 012C,E01008812,751,277,116,161,0,0,367,120,247,107,92,15,0
2021,Sunderland 014C,E01008813,706,356,179,177,1,1,294,132,162,55,47,8,0
2021,Sunderland 014D,E01008814,664,421,241,180,1,1,150,63,87,92,74,18,0
2021,Sunderland 004B,E01008817,485,109,60,49,2,2,334,162,172,39,28,11,1
2021,Sunderland 004C,E01008819,620,283,142,141,1,1,259,116,143,77,71,6,0
2021,Sunderland 004D,E01008821,599,246,127,119,0,0,248,124,124,105,90,15,0
2021,Sunderland 004E,E01008822,716,307,149,158,1,1,324,157,167,84,75,9,0
2021,Sunderland 023A,E01008823,591,213,104,109,0,0,323,160,163,55,45,10,0
2021,Sunderland 023B,E01008824,601,196,77,119,0,0,338,168,170,67,60,7,0
2021,Sunderland 023C,E01008825,667,337,176,161,2,2,261,110,151,67,49,18,0
2021,Sunderland 023D,E01008826,589,307,161,146,1,1,219,71,148,62,52,10,0
2021,Sunderland 023E,E01008827,506,169,91,78,3,3,293,77,216,40,35,5,1
2021,Sunderland 023F,E01008828,613,188,105,83,0,0,357,63,294,68,64,4,0
2021,Sunderland 023G,E01008829,580,160,65,95,2,2,361,174,187,57,47,10,0
2021,Sunderland 018B,E01008830,500,270,119,151,0,0,26,3,23,200,184,16,4
2021,Sunderland 013D,E01008831,839,184,99,85,1,1,213,52,161,440,417,23,1
2021,Sunderland 018C,E01008832,593,395,201,194,1,1,31,4,27,166,146,20,0
2021,Sunderland 018D,E01008833,598,453,263,190,1,1,6,0,6,138,119,19,0
2021,Sunderland 013E,E01008834,799,297,139,158,4,4,186,65,121,312,296,16,0
2021,Sunderland 022G,E01008835,579,415,189,226,2,2,15,2,13,146,129,17,1
2021,Sunderland 016F,E01008836,667,103,51,52,0,0,409,159,250,155,133,22,0
2021,Sunderland 003B,E01008837,605,222,115,107,2,2,258,97,161,123,117,6,0
2021,Sunderland 003C,E01008838,662,240,126,114,0,0,336,172,164,83,80,3,3
2021,Sunderland 003D,E01008839,681,168,91,77,0,0,419,172,247,94,80,14,0
2021,Sunderland 003E,E01008840,581,267,110,157,1,1,201,88,113,112,97,15,0
2021,Sunderland 003F,E01008841,594,182,78,104,0,0,340,150,190,72,63,9,0
2021,Sunderland 004F,E01008842,588,392,223,169,0,0,138,73,65,58,49,9,0
2021,Sunderland 019A,E01008843,542,426,268,158,2,2,29,13,16,85,69,16,0
2021,Sunderland 019B,E01008844,684,444,279,165,3,3,146,50,96,91,78,13,0
2021,Sunderland 017A,E01008845,657,489,311,178,1,1,80,41,39,87,76,11,0
2021,Sunderland 017B,E01008846,465,132,74,58,0,0,271,131,140,62,55,7,0
2021,Sunderland 017C,E01008847,507,178,85,93,0,0,252,110,142,77,68,9,0
2021,Sunderland 019C,E01008848,648,437,300,137,1,1,132,69,63,78,73,5,0
2021,Sunderland 019D,E01008849,572,155,69,86,8,8,352,183,169,57,55,2,0
2021,Sunderland 017E,E01008851,752,358,155,203,4,4,246,125,121,144,124,20,0
2021,Sunderland 019E,E01008852,531,415,225,190,0,0,69,32,37,47,40,7,0
2021,Sunderland 009A,E01008853,678,215,118,97,1,1,378,192,186,84,74,10,0
2021,Sunderland 009B,E01008854,639,247,153,94,1,1,147,70,77,244,231,13,0
2021,Sunderland 007A,E01008855,613,381,152,229,0,0,171,96,75,61,48,13,0
2021,Sunderland 007B,E01008856,613,522,357,165,2,2,39,21,18,50,35,15,0
2021,Sunderland 009C,E01008857,616,279,149,130,0,0,259,130,129,78,70,8,0
2021,Sunderland 009D,E01008858,600,126,66,60,0,0,385,217,168,89,82,7,0
2021,Sunderland 009E,E01008859,518,171,84,87,0,0,270,131,139,77,72,5,0
2021,Sunderland 009F,E01008860,590,293,153,140,1,1,220,119,101,75,59,16,1
2021,Sunderland 025B,E01008861,645,381,236,145,7,7,174,75,99,83,73,10,0
2021,Sunderland 025C,E01008862,562,487,342,145,0,0,52,22,30,23,19,4,0
2021,Sunderland 025D,E01008863,637,580,356,224,0,0,46,21,25,11,10,1,0
2021,Sunderland 025E,E01008864,543,475,322,153,1,1,44,17,27,23,20,3,0
2021,Sunderland 025F,E01008865,603,327,170,157,2,2,205,94,111,69,56,13,0
2021,Sunderland 025G,E01008866,581,280,126,154,0,0,199,94,105,102,94,8,0
2021,Sunderland 020A,E01008867,741,193,77,116,0,0,432,229,203,113,102,11,3
2021,Sunderland 020B,E01008868,505,428,233,195,3,3,27,14,13,47,35,12,0
2021,Sunderland 020C,E01008869,515,372,220,152,0,0,84,44,40,59,50,9,0
2021,Sunderland 020D,E01008870,598,474,246,228,20,20,44,18,26,60,46,14,0
2021,Sunderland 020E,E01008871,589,309,141,168,0,0,205,94,111,75,67,8,0
2021,Sunderland 020F,E01008872,768,575,302,273,6,6,105,47,58,82,67,15,0
2021,Sunderland 010A,E01008873,537,463,272,191,0,0,34,16,18,37,33,4,3
2021,Sunderland 010B,E01008874,672,239,130,109,0,0,366,206,160,67,62,5,0
2021,Sunderland 010C,E01008875,661,329,118,211,4,4,221,73,148,107,94,13,0
2021,Sunderland 007C,E01008876,631,557,318,239,2,2,38,17,21,34,25,9,0
2021,Sunderland 007D,E01008877,722,594,317,277,2,2,31,12,19,95,80,15,0
2021,Sunderland 009G,E01008878,627,412,195,217,0,0,142,75,67,73,60,13,0
2021,Sunderland 010D,E01008879,620,373,203,170,1,1,129,63,66,113,99,14,4
2021,Sunderland 010E,E01008880,492,310,186,124,7,7,140,69,71,35,28,7,0
2021,Birmingham 067A,E01008881,583,326,161,165,0,0,134,107,27,112,98,14,11
2021,Birmingham 066A,E01008882,671,298,123,175,4,4,225,165,60,142,125,17,2
2021,Birmingham 078A,E01008883,637,364,143,221,4,4,111,91,20,154,136,18,4
2021,Birmingham 078B,E01008884,710,245,100,145,0,0,164,87,77,299,278,21,2
2021,Birmingham 076A,E01008885,504,403,207,196,1,1,7,4,3,93,80,13,0
2021,Birmingham 076B,E01008886,693,319,146,173,8,8,154,124,30,210,194,16,2
2021,Birmingham 078C,E01008887,614,327,135,192,1,1,113,96,17,170,155,15,3
2021,Birmingham 076C,E01008888,633,490,226,264,0,0,22,7,15,120,107,13,1
2021,Birmingham 078D,E01008889,662,333,170,163,1,1,98,57,41,227,214,13,3
2021,Birmingham 089A,E01008890,709,396,179,217,10,10,113,11,102,188,175,13,2
2021,Birmingham 089B,E01008891,711,454,201,253,9,9,149,137,12,98,90,8,1
2021,Birmingham 089C,E01008892,500,211,122,89,7,7,158,11,147,124,108,16,0
2021,Birmingham 089D,E01008893,729,420,209,211,1,1,70,42,28,236,221,15,2
2021,Birmingham 089E,E01008894,710,230,136,94,3,3,187,78,109,285,272,13,5
2021,Birmingham 089F,E01008895,768,485,197,288,15,15,87,64,23,177,165,12,4
2021,Birmingham 066B,E01008896,565,287,115,172,2,2,172,159,13,101,93,8,3
2021,Birmingham 067B,E01008897,617,381,174,207,3,3,131,87,44,101,92,9,1
2021,Birmingham 066C,E01008898,553,257,101,156,3,3,200,186,14,85,81,4,8
2021,Birmingham 037A,E01008899,458,122,63,59,0,0,240,143,97,94,80,14,2
2021,Birmingham 037C,E01008901,609,230,126,104,4,4,249,155,94,124,105,19,2
2021,Birmingham 040A,E01008905,489,245,146,99,2,2,121,41,80,120,102,18,1
2021,Birmingham 049A,E01008906,510,187,91,96,0,0,211,129,82,109,88,21,3
2021,Birmingham 040B,E01008907,619,129,63,66,5,5,375,80,295,107,93,14,3
2021,Birmingham 041D,E01008909,551,186,73,113,11,11,273,185,88,73,62,11,8
2021,Birmingham 050A,E01008910,441,147,70,77,0,0,221,189,32,70,63,7,3
2021,Birmingham 049B,E01008911,640,83,39,44,11,11,496,400,96,38,27,11,12
2021,Birmingham 050B,E01008913,933,123,66,57,24,24,695,462,233,77,67,10,14
2021,Birmingham 030A,E01008915,560,255,124,131,1,1,53,25,28,246,232,14,5
2021,Birmingham 037E,E01008916,479,189,95,94,1,1,142,32,110,145,127,18,2
2021,Birmingham 102A,E01008917,511,375,198,177,13,13,72,66,6,50,41,9,1
2021,Birmingham 094A,E01008918,722,249,135,114,2,2,372,357,15,94,86,8,5
2021,Birmingham 095A,E01008919,699,370,190,180,2,2,212,192,20,111,96,15,4
2021,Birmingham 094B,E01008920,548,423,230,193,3,3,55,52,3,66,53,13,1
2021,Birmingham 094C,E01008921,625,376,215,161,6,6,133,119,14,107,98,9,3
2021,Birmingham 102B,E01008923,643,244,117,127,2,2,317,302,15,77,69,8,3
2021,Birmingham 101A,E01008924,632,392,174,218,17,17,133,129,4,81,72,9,9
2021,Birmingham 102C,E01008925,508,448,276,172,6,6,4,3,1,50,42,8,0
2021,Birmingham 102D,E01008927,600,218,117,101,2,2,310,214,96,65,61,4,5
2021,Birmingham 102E,E01008928,735,220,113,107,3,3,449,352,97,56,48,8,7
2021,Birmingham 106C,E01008929,698,193,84,109,46,46,390,233,157,66,50,16,3
2021,Birmingham 106D,E01008930,787,432,139,293,59,59,217,82,135,78,66,12,1
2021,Birmingham 094D,E01008931,625,271,139,132,5,5,254,241,13,92,85,7,3
2021,Birmingham 111A,E01008932,654,319,155,164,6,6,208,168,40,117,108,9,4
2021,Birmingham 105A,E01008933,544,391,190,201,2,2,63,58,5,88,74,14,0
2021,Birmingham 105B,E01008934,550,415,232,183,0,0,53,46,7,81,67,14,1
2021,Birmingham 111B,E01008935,677,276,137,139,2,2,263,246,17,131,113,18,5
2021,Birmingham 111C,E01008936,656,378,209,169,4,4,227,209,18,47,40,7,0
2021,Birmingham 115A,E01008937,631,313,166,147,2,2,185,144,41,128,119,9,3
2021,Birmingham 111D,E01008938,572,341,149,192,1,1,147,143,4,80,73,7,3
2021,Birmingham 111E,E01008939,701,373,170,203,48,48,135,71,64,142,128,14,3
2021,Birmingham 115B,E01008940,581,285,140,145,4,4,185,158,27,105,93,12,2
2021,Birmingham 115C,E01008941,577,330,142,188,1,1,177,171,6,63,57,6,6
2021,Birmingham 117A,E01008942,629,382,162,220,7,7,156,150,6,82,70,12,2
2021,Birmingham 117B,E01008943,573,303,127,176,27,27,159,115,44,79,72,7,5
2021,Birmingham 115D,E01008944,735,405,199,206,13,13,180,161,19,132,107,25,5
2021,Birmingham 122A,E01008945,740,475,189,286,1,1,113,100,13,151,138,13,0
2021,Birmingham 122B,E01008946,646,379,176,203,0,0,166,120,46,93,83,10,8
2021,Birmingham 122C,E01008947,535,366,174,192,12,12,56,46,10,100,90,10,1
2021,Birmingham 122D,E01008948,616,500,280,220,2,2,17,12,5,97,82,15,0
2021,Birmingham 122E,E01008949,505,462,255,207,1,1,3,2,1,38,30,8,1
2021,Birmingham 113A,E01008950,718,315,195,120,1,1,357,21,336,45,38,7,0
2021,Birmingham 112A,E01008951,612,345,170,175,3,3,190,14,176,74,68,6,0
2021,Birmingham 112B,E01008952,868,454,139,315,6,6,51,25,26,356,331,25,1
2021,Birmingham 107A,E01008953,658,421,215,206,6,6,90,88,2,141,124,17,0
2021,Birmingham 113B,E01008954,599,293,175,118,7,7,256,10,246,43,33,10,0
2021,Birmingham 112C,E01008955,745,463,220,243,3,3,75,10,65,204,183,21,0
2021,Birmingham 112D,E01008956,553,411,191,220,0,0,77,28,49,65,51,14,0
2021,Birmingham 112E,E01008957,729,380,164,216,23,23,117,20,97,209,185,24,0
2021,Birmingham 113C,E01008958,767,216,148,68,8,8,490,32,458,52,46,6,1
2021,Birmingham 116A,E01008959,801,418,270,148,51,51,195,62,133,135,117,18,2
2021,Birmingham 116B,E01008960,623,484,242,242,1,1,43,16,27,95,88,7,0
2021,Birmingham 116C,E01008961,723,419,235,184,5,5,25,11,14,273,261,12,1
2021,Birmingham 116D,E01008962,856,333,172,161,4,4,413,311,102,100,91,9,6
2021,Birmingham 107B,E01008963,619,389,185,204,2,2,93,78,15,133,119,14,2
2021,Birmingham 107C,E01008964,622,361,158,203,4,4,173,133,40,80,69,11,4
2021,Birmingham 107D,E01008965,575,471,244,227,3,3,29,4,25,72,59,13,0
2021,Birmingham 107E,E01008966,683,321,146,175,2,2,229,141,88,128,113,15,3
2021,Birmingham 110A,E01008967,649,538,308,230,1,1,60,48,12,49,39,10,1
2021,Birmingham 110B,E01008968,714,566,305,261,5,5,47,15,32,96,84,12,0
2021,Birmingham 117C,E01008969,689,500,270,230,1,1,83,26,57,104,91,13,1
2021,Birmingham 110C,E01008970,601,341,187,154,4,4,172,142,30,80,68,12,4
2021,Birmingham 117D,E01008971,748,457,266,191,45,45,104,8,96,141,133,8,1
2021,Birmingham 118A,E01008972,758,359,166,193,39,39,276,170,106,81,73,8,3
2021,Birmingham 118B,E01008973,878,589,276,313,11,11,138,119,19,135,114,21,5
2021,Birmingham 118C,E01008974,1110,723,305,418,62,62,111,29,82,212,202,10,2
2021,Birmingham 118D,E01008975,664,512,274,238,4,4,66,31,35,80,65,15,2
2021,Birmingham 121A,E01008976,644,333,183,150,4,4,217,196,21,81,72,9,9
2021,Birmingham 123A,E01008977,701,402,169,233,0,0,142,130,12,154,143,11,3
2021,Birmingham 121B,E01008978,630,90,54,36,0,0,490,437,53,41,36,5,9
2021,Birmingham 121C,E01008979,705,324,178,146,1,1,304,290,14,69,55,14,7
2021,Birmingham 121D,E01008980,680,275,155,120,2,2,321,294,27,69,60,9,13
2021,Birmingham 110D,E01008981,592,476,277,199,1,1,43,37,6,68,60,8,4
2021,Birmingham 079A,E01008982,704,260,152,108,4,4,63,28,35,374,350,24,3
2021,Birmingham 074A,E01008984,780,154,97,57,1,1,405,306,99,210,197,13,10
2021,Birmingham 064A,E01008986,784,213,103,110,1,1,151,37,114,419,407,12,0
2021,Birmingham 064B,E01008987,626,125,75,50,4,4,245,112,133,251,243,8,1
2021,Birmingham 064C,E01008988,985,285,122,163,3,3,131,28,103,566,551,15,0
2021,Birmingham 064D,E01008989,926,263,142,121,2,2,173,33,140,483,465,18,5
2021,Birmingham 064E,E01008990,511,307,173,134,1,1,11,4,7,192,166,26,0
2021,Birmingham 064F,E01008991,574,471,283,188,1,1,5,3,2,97,88,9,0
2021,Birmingham 079C,E01008992,479,331,191,140,0,0,8,2,6,140,125,15,0
2021,Birmingham 074B,E01008994,648,291,155,136,0,0,157,45,112,200,190,10,0
2021,Birmingham 134A,E01008995,913,109,49,60,29,29,617,104,513,150,113,37,8
2021,Birmingham 074C,E01008996,677,190,113,77,11,11,320,165,155,152,141,11,4
2021,Birmingham 074D,E01008997,630,339,197,142,1,1,159,11,148,130,123,7,1
2021,Birmingham 031A,E01008998,652,315,139,176,0,0,206,173,33,128,109,19,3
2021,Birmingham 031B,E01008999,523,345,177,168,2,2,80,60,20,90,78,12,6
2021,Birmingham 031C,E01009000,847,293,163,130,4,4,194,39,155,350,335,15,6
2021,Birmingham 018A,E01009001,716,493,236,257,16,16,94,17,77,113,100,13,0
2021,Birmingham 023A,E01009002,788,244,94,150,3,3,451,432,19,82,72,10,8
2021,Birmingham 018B,E01009003,687,451,263,188,2,2,28,17,11,206,196,10,0
2021,Birmingham 025A,E01009005,729,402,164,238,15,15,151,119,32,158,138,20,3
2021,Birmingham 023C,E01009006,747,419,225,194,4,4,38,8,30,286,260,26,0
2021,Birmingham 023D,E01009007,902,220,114,106,3,3,148,59,89,530,496,34,1
2021,Birmingham 141A,E01009008,598,466,247,219,4,4,47,4,43,81,73,8,0
2021,Birmingham 025B,E01009009,632,423,221,202,1,1,117,23,94,90,80,10,1
2021,Birmingham 141B,E01009011,791,475,239,236,2,2,156,42,114,158,139,19,0
2021,Birmingham 141C,E01009012,603,446,238,208,3,3,15,3,12,138,126,12,1
2021,Birmingham 031D,E01009013,897,406,200,206,17,17,143,21,122,331,311,20,0
2021,Birmingham 090A,E01009014,814,444,174,270,15,15,162,113,49,189,169,20,4
2021,Birmingham 089G,E01009015,790,384,196,188,7,7,168,66,102,226,209,17,5
2021,Birmingham 098A,E01009016,728,291,144,147,2,2,301,289,12,126,115,11,8
2021,Birmingham 097A,E01009017,488,344,193,151,1,1,27,18,9,113,98,15,3
2021,Birmingham 090B,E01009018,719,419,233,186,4,4,79,17,62,217,192,25,0
2021,Birmingham 103A,E01009019,604,283,117,166,1,1,213,200,13,103,92,11,4
2021,Birmingham 103B,E01009020,556,327,162,165,0,0,129,123,6,95,90,5,5
2021,Birmingham 103C,E01009021,678,274,105,169,0,0,225,173,52,178,165,13,1
2021,Birmingham 098B,E01009022,594,387,164,223,2,2,94,86,8,110,95,15,1
2021,Birmingham 098C,E01009023,559,446,210,236,0,0,21,8,13,90,79,11,2
2021,Birmingham 103D,E01009024,615,290,119,171,1,1,217,212,5,103,96,7,4
2021,Birmingham 103E,E01009025,570,287,100,187,0,0,178,166,12,101,96,5,4
2021,Birmingham 090C,E01009026,709,355,130,225,11,11,169,135,34,172,154,18,2
2021,Birmingham 090D,E01009028,621,319,142,177,0,0,146,137,9,152,129,23,4
2021,Birmingham 090E,E01009029,513,307,139,168,0,0,92,85,7,107,98,9,7
2021,Birmingham 098D,E01009030,624,460,208,252,16,16,70,13,57,78,68,10,0
2021,Birmingham 105C,E01009031,644,499,291,208,5,5,33,10,23,107,92,15,0
2021,Birmingham 108A,E01009032,590,472,241,231,2,2,33,26,7,83,70,13,0
2021,Birmingham 103F,E01009033,700,314,128,186,2,2,207,200,7,171,152,19,6
2021,Birmingham 108B,E01009034,554,456,257,199,4,4,8,1,7,86,75,11,0
2021,Birmingham 108C,E01009035,613,425,210,215,2,2,68,63,5,118,104,14,0
2021,Birmingham 108D,E01009036,537,438,249,189,3,3,5,3,2,91,82,9,0
2021,Birmingham 105D,E01009037,757,536,300,236,3,3,92,23,69,125,102,23,1
2021,Birmingham 132A,E01009039,652,551,295,256,0,0,11,5,6,89,80,9,1
2021,Birmingham 132B,E01009040,614,550,261,289,1,1,9,5,4,54,45,9,0
2021,Birmingham 132C,E01009041,637,506,240,266,3,3,20,12,8,106,88,18,2
2021,Birmingham 132D,E01009042,524,364,158,206,2,2,4,2,2,154,150,4,0
2021,Birmingham 097B,E01009043,600,389,197,192,3,3,90,41,49,117,106,11,1
2021,Birmingham 097C,E01009044,455,292,156,136,1,1,41,27,14,120,107,13,1
2021,Birmingham 097D,E01009045,700,495,280,215,8,8,47,32,15,150,133,17,0
2021,Birmingham 097E,E01009046,605,485,251,234,0,0,49,2,47,71,58,13,0
2021,Birmingham 040C,E01009047,556,196,121,75,4,4,261,68,193,92,73,19,3
2021,Birmingham 040D,E01009048,641,198,111,87,8,8,320,74,246,111,97,14,4
2021,Birmingham 032A,E01009049,579,355,211,144,3,3,103,16,87,113,95,18,5
2021,Birmingham 035A,E01009050,752,283,150,133,6,6,235,50,185,225,207,18,3
2021,Birmingham 033A,E01009051,543,216,118,98,2,2,161,41,120,160,143,17,4
2021,Birmingham 033B,E01009053,440,197,98,99,1,1,131,39,92,110,88,22,1
2021,Birmingham 033C,E01009054,437,324,206,118,3,3,20,4,16,90,81,9,0
2021,Birmingham 032B,E01009056,750,268,139,129,5,5,317,69,248,157,132,25,3
2021,Birmingham 035D,E01009057,628,229,135,94,2,2,264,41,223,132,114,18,1
2021,Birmingham 033D,E01009058,500,301,171,130,2,2,30,15,15,166,145,21,1
2021,Birmingham 035E,E01009059,571,159,115,44,4,4,300,33,267,106,81,25,2
2021,Birmingham 035F,E01009060,477,194,113,81,1,1,167,68,99,115,105,10,0
2021,Birmingham 033E,E01009061,458,248,167,81,3,3,81,13,68,126,109,17,0
2021,Birmingham 040E,E01009062,509,219,135,84,0,0,176,86,90,111,98,13,3
2021,Birmingham 095B,E01009064,594,315,167,148,2,2,129,114,15,145,137,8,3
2021,Birmingham 075A,E01009065,634,456,238,218,2,2,31,13,18,145,138,7,0
2021,Birmingham 073A,E01009066,878,590,361,229,85,85,135,11,124,65,54,11,3
2021,Birmingham 075B,E01009067,689,488,224,264,2,2,43,11,32,156,143,13,0
2021,Birmingham 075C,E01009068,728,369,196,173,6,6,64,17,47,289,274,15,0
2021,Birmingham 075D,E01009069,856,386,191,195,2,2,108,48,60,359,343,16,1
2021,Birmingham 073B,E01009070,676,472,217,255,19,19,64,18,46,120,102,18,1
2021,Birmingham 087B,E01009071,738,356,181,175,7,7,200,68,132,175,166,9,0
2021,Birmingham 075E,E01009072,848,466,202,264,16,16,121,47,74,244,234,10,1
2021,Birmingham 085A,E01009073,645,145,78,67,1,1,430,413,17,48,47,1,21
2021,Birmingham 085B,E01009074,709,188,87,101,3,3,357,336,21,152,146,6,9
2021,Birmingham 087C,E01009075,817,145,94,51,2,2,440,351,89,219,210,9,11
2021,Birmingham 095C,E01009077,690,444,247,197,1,1,98,90,8,147,136,11,0
2021,Birmingham 087E,E01009078,610,228,132,96,1,1,98,88,10,282,269,13,1
2021,Birmingham 141G,E01009079,488,238,101,137,0,0,166,159,7,83,74,9,1
2021,Birmingham 141F,E01009080,406,134,47,87,2,2,228,181,47,39,36,3,3
2021,Birmingham 141H,E01009081,556,183,86,97,5,5,298,276,22,65,63,2,5
2021,Birmingham 044A,E01009082,498,301,143,158,0,0,92,84,8,105,91,14,0
2021,Birmingham 141I,E01009083,548,208,97,111,15,15,239,186,53,83,64,19,3
2021,Birmingham 042A,E01009084,528,389,182,207,1,1,44,37,7,93,80,13,1
2021,Birmingham 042B,E01009085,492,423,205,218,0,0,3,2,1,65,49,16,1
2021,Birmingham 044B,E01009086,624,422,177,245,1,1,72,59,13,129,106,23,0
2021,Birmingham 042C,E01009087,577,442,224,218,2,2,13,2,11,119,112,7,1
2021,Birmingham 045A,E01009088,685,393,231,162,62,62,166,78,88,64,48,16,0
2021,Birmingham 042D,E01009089,489,404,178,226,2,2,6,3,3,77,67,10,0
2021,Birmingham 042E,E01009090,542,399,188,211,1,1,49,30,19,89,74,15,4
2021,Birmingham 045B,E01009091,660,332,167,165,9,9,211,135,76,103,89,14,5
2021,Birmingham 054A,E01009092,617,208,81,127,4,4,297,195,102,108,97,11,0
2021,Birmingham 054B,E01009093,647,269,101,168,1,1,230,167,63,144,120,24,3
2021,Birmingham 054C,E01009094,546,280,114,166,0,0,143,132,11,122,107,15,1
2021,Birmingham 056A,E01009095,666,418,196,222,32,32,61,15,46,155,142,13,0
2021,Birmingham 029A,E01009096,772,272,151,121,0,0,418,42,376,82,69,13,0
2021,Birmingham 029B,E01009097,768,231,120,111,1,1,467,59,408,67,58,9,2
2021,Birmingham 025C,E01009098,935,411,154,257,2,2,379,243,136,138,122,16,5
2021,Birmingham 029C,E01009099,794,165,73,92,3,3,546,58,488,80,66,14,0
2021,Birmingham 025D,E01009100,815,417,169,248,9,9,254,131,123,133,117,16,2
2021,Birmingham 029D,E01009101,610,250,136,114,4,4,302,36,266,52,46,6,2
2021,Birmingham 141E,E01009102,646,303,150,153,11,11,196,156,40,126,110,16,10
2021,Birmingham 029E,E01009103,688,168,84,84,5,5,476,64,412,39,35,4,0
2021,Birmingham 141D,E01009104,623,300,104,196,3,3,198,178,20,117,108,9,5
2021,Birmingham 025E,E01009105,743,545,227,318,3,3,101,56,45,93,83,10,1
2021,Birmingham 029F,E01009106,576,389,199,190,2,2,107,14,93,78,66,12,0
2021,Birmingham 128A,E01009107,694,219,96,123,2,2,355,303,52,103,92,11,15
2021,Birmingham 127A,E01009108,435,375,229,146,2,2,24,17,7,33,23,10,1
2021,Birmingham 123B,E01009109,516,167,55,112,19,19,289,207,82,38,38,0,3
2021,Birmingham 128B,E01009110,603,290,149,141,9,9,212,155,57,87,72,15,5
2021,Birmingham 127B,E01009111,599,438,202,236,0,0,92,76,16,63,51,12,6
2021,Birmingham 127C,E01009112,638,404,188,216,6,6,131,108,23,92,76,16,5
2021,Birmingham 128C,E01009113,702,215,81,134,4,4,440,427,13,41,39,2,2
2021,Birmingham 128D,E01009114,650,310,163,147,2,2,260,251,9,72,56,16,6
2021,Birmingham 128E,E01009115,607,269,130,139,3,3,270,258,12,62,57,5,3
2021,Birmingham 127D,E01009116,572,513,324,189,0,0,10,3,7,49,45,4,0
2021,Birmingham 126A,E01009117,801,134,70,64,52,52,573,191,382,39,33,6,3
2021,Birmingham 127E,E01009118,679,397,204,193,7,7,178,168,10,94,84,10,3
2021,Birmingham 123C,E01009119,658,452,241,211,2,2,96,51,45,107,94,13,1
2021,Birmingham 123D,E01009120,772,497,253,244,7,7,102,23,79,166,140,26,0
2021,Birmingham 014B,E01009122,666,274,98,176,2,2,255,201,54,128,119,9,7
2021,Birmingham 022A,E01009123,613,323,149,174,8,8,128,101,27,148,130,18,6
2021,Birmingham 022B,E01009124,714,125,61,64,1,1,497,392,105,83,57,26,8
2021,Birmingham 022C,E01009125,683,377,168,209,5,5,147,118,29,148,139,9,6
2021,Birmingham 026A,E01009126,542,451,216,235,1,1,7,2,5,82,69,13,1
2021,Birmingham 011A,E01009127,570,255,112,143,4,4,219,176,43,90,82,8,2
2021,Birmingham 011B,E01009128,521,229,107,122,3,3,163,153,10,122,116,6,4
2021,Birmingham 014C,E01009129,567,247,75,172,1,1,214,198,16,101,93,8,4
2021,Birmingham 011C,E01009130,596,261,125,136,14,14,198,169,29,117,110,7,6
2021,Birmingham 011D,E01009131,506,267,94,173,0,0,142,132,10,96,86,10,1
2021,Birmingham 014D,E01009132,592,295,137,158,4,4,173,161,12,117,109,8,3
2021,Birmingham 011E,E01009133,600,272,111,161,1,1,217,203,14,101,89,12,9
2021,Birmingham 011F,E01009134,653,308,143,165,0,0,232,209,23,107,101,6,6
2021,Birmingham 010A,E01009135,596,485,272,213,5,5,57,11,46,47,37,10,2
2021,Birmingham 014E,E01009136,848,387,206,181,18,18,335,257,78,103,81,22,5
2021,Birmingham 011G,E01009137,583,313,139,174,0,0,149,135,14,117,96,21,4
2021,Birmingham 060A,E01009138,676,439,214,225,9,9,19,10,9,207,193,14,2
2021,Birmingham 060B,E01009139,556,295,165,130,1,1,35,17,18,224,207,17,1
2021,Birmingham 060C,E01009140,842,460,217,243,15,15,95,28,67,271,251,20,1
2021,Birmingham 137A,E01009141,811,145,75,70,4,4,558,541,17,98,92,6,6
2021,Birmingham 136A,E01009143,752,95,48,47,9,9,526,514,12,109,101,8,13
2021,Birmingham 060D,E01009145,725,343,176,167,6,6,92,13,79,283,262,21,1
2021,Birmingham 136B,E01009146,1044,100,44,56,3,3,645,37,608,293,275,18,3
2021,Birmingham 060E,E01009147,670,201,115,86,3,3,96,25,71,368,347,21,2
2021,Birmingham 053A,E01009151,626,318,176,142,2,2,105,19,86,200,168,32,1
2021,Birmingham 053B,E01009152,574,246,170,76,5,5,154,34,120,168,151,17,1
2021,Birmingham 053C,E01009153,824,214,112,102,6,6,371,170,201,228,208,20,5
2021,Birmingham 125B,E01009155,583,259,121,138,1,1,270,265,5,51,44,7,2
2021,Birmingham 125D,E01009157,616,249,137,112,1,1,299,289,10,56,52,4,11
2021,Birmingham 129A,E01009158,895,422,178,244,19,19,232,97,135,217,207,10,5
2021,Birmingham 130A,E01009159,913,648,283,365,27,27,68,19,49,170,151,19,0
2021,Birmingham 125E,E01009160,710,163,88,75,10,10,476,374,102,58,53,5,3
2021,Birmingham 125F,E01009161,608,309,153,156,10,10,220,214,6,65,64,1,4
2021,Birmingham 124A,E01009162,634,460,220,240,1,1,64,53,11,104,96,8,5
2021,Birmingham 130B,E01009164,626,432,226,206,7,7,85,65,20,96,78,18,6
2021,Birmingham 129C,E01009165,643,285,122,163,9,9,177,116,61,164,155,9,8
2021,Birmingham 131A,E01009166,565,299,134,165,6,6,131,60,71,129,121,8,0
2021,Birmingham 130C,E01009167,590,418,205,213,0,0,68,61,7,103,90,13,1
2021,Birmingham 131B,E01009168,651,544,275,269,3,3,25,19,6,78,70,8,1
2021,Birmingham 129D,E01009169,701,492,217,275,1,1,87,59,28,121,108,13,0
2021,Birmingham 131C,E01009170,635,522,271,251,5,5,28,13,15,79,66,13,1
2021,Birmingham 130D,E01009171,722,426,188,238,0,0,179,163,16,115,105,10,2
2021,Birmingham 119A,E01009172,557,275,121,154,27,27,189,162,27,63,53,10,3
2021,Birmingham 119B,E01009173,635,265,102,163,3,3,259,249,10,102,96,6,6
2021,Birmingham 119C,E01009174,521,234,106,128,5,5,163,156,7,113,103,10,6
2021,Birmingham 104A,E01009175,588,397,171,226,0,0,26,17,9,165,153,12,0
2021,Birmingham 105E,E01009176,674,417,255,162,0,0,126,94,32,129,107,22,2
2021,Birmingham 104B,E01009177,635,444,220,224,0,0,49,11,38,141,130,11,1
2021,Birmingham 104C,E01009178,757,392,187,205,2,2,100,77,23,262,241,21,1
2021,Birmingham 104D,E01009179,638,486,273,213,0,0,64,51,13,86,71,15,2
2021,Birmingham 092A,E01009182,642,169,98,71,2,2,257,22,235,212,200,12,2
2021,Birmingham 088C,E01009183,578,439,226,213,6,6,22,10,12,111,102,9,0
2021,Birmingham 092B,E01009184,721,335,154,181,2,2,135,12,123,248,229,19,1
2021,Birmingham 093A,E01009185,763,448,272,176,2,2,71,8,63,241,223,18,1
2021,Birmingham 088D,E01009186,777,457,219,238,4,4,114,91,23,201,185,16,1
2021,Birmingham 092C,E01009187,649,400,217,183,2,2,106,7,99,141,134,7,0
2021,Birmingham 092D,E01009188,659,395,220,175,6,6,75,35,40,180,164,16,3
2021,Birmingham 104E,E01009189,590,439,253,186,3,3,49,14,35,99,86,13,0
2021,Birmingham 052B,E01009192,612,407,282,125,4,4,45,8,37,154,130,24,2
2021,Birmingham 058A,E01009195,674,368,204,164,1,1,125,61,64,180,147,33,0
2021,Birmingham 058C,E01009197,482,201,89,112,22,22,99,36,63,158,145,13,2
2021,Birmingham 052D,E01009199,541,181,75,106,2,2,145,28,117,213,201,12,0
2021,Birmingham 139A,E01009200,606,183,78,105,2,2,296,121,175,122,116,6,3
2021,Birmingham 043A,E01009201,707,247,145,102,1,1,346,276,70,109,95,14,4
2021,Birmingham 043B,E01009202,634,142,90,52,6,6,397,176,221,85,79,6,4
2021,Birmingham 052E,E01009204,712,106,71,35,11,11,507,402,105,77,67,10,11
2021,Birmingham 120A,E01009205,615,468,255,213,2,2,59,17,42,86,69,17,0
2021,Birmingham 120B,E01009206,654,529,310,219,3,3,26,25,1,96,86,10,0
2021,Birmingham 124B,E01009207,664,559,305,254,3,3,5,1,4,97,86,11,0
2021,Birmingham 124C,E01009208,702,554,276,278,8,8,33,6,27,105,94,11,2
2021,Birmingham 124D,E01009209,950,484,228,256,28,28,213,77,136,224,214,10,1
2021,Birmingham 126B,E01009210,830,397,222,175,19,19,227,169,58,181,164,17,6
2021,Birmingham 120C,E01009211,684,526,286,240,0,0,42,38,4,116,107,9,0
2021,Birmingham 126C,E01009212,775,366,165,201,4,4,268,250,18,130,111,19,7
2021,Birmingham 124E,E01009213,755,496,303,193,2,2,144,131,13,111,101,10,2
2021,Birmingham 126D,E01009214,766,273,133,140,3,3,380,341,39,100,92,8,10
2021,Birmingham 126E,E01009215,934,293,166,127,27,27,508,422,86,101,88,13,5
2021,Birmingham 131D,E01009216,837,550,298,252,10,10,171,107,64,104,99,5,2
2021,Birmingham 131E,E01009217,659,542,274,268,1,1,6,2,4,108,93,15,2
2021,Birmingham 120D,E01009218,646,468,255,213,9,9,109,53,56,58,49,9,2
2021,Birmingham 120E,E01009219,610,396,205,191,13,13,83,19,64,116,100,16,2
2021,Birmingham 008A,E01009220,615,387,170,217,1,1,94,85,9,131,115,16,2
2021,Birmingham 007A,E01009221,594,449,226,223,2,2,60,52,8,81,73,8,2
2021,Birmingham 008B,E01009222,578,286,130,156,1,1,184,137,47,102,91,11,5
2021,Birmingham 013A,E01009223,689,462,219,243,1,1,90,86,4,135,117,18,1
2021,Birmingham 008C,E01009224,593,483,269,214,2,2,11,3,8,96,81,15,1
2021,Birmingham 013B,E01009225,746,392,205,187,1,1,240,129,111,111,89,22,2
2021,Birmingham 017A,E01009226,667,487,252,235,0,0,16,5,11,163,150,13,1
2021,Birmingham 013C,E01009227,714,519,257,262,3,3,22,5,17,170,151,19,0
2021,Birmingham 013D,E01009228,677,502,244,258,1,1,28,13,15,145,129,16,1
2021,Birmingham 017B,E01009229,658,513,269,244,3,3,5,0,5,137,123,14,0
2021,Birmingham 017C,E01009230,735,483,277,206,0,0,32,2,30,220,209,11,0
2021,Birmingham 017D,E01009231,780,634,371,263,6,6,12,4,8,126,117,9,2
2021,Birmingham 022D,E01009232,586,439,255,184,2,2,17,12,5,128,119,9,0
2021,Birmingham 008D,E01009233,622,323,140,183,0,0,192,184,8,104,96,8,3
2021,Birmingham 019A,E01009234,611,447,175,272,0,0,18,2,16,145,139,6,1
2021,Birmingham 016A,E01009235,627,485,255,230,2,2,7,1,6,133,121,12,0
2021,Birmingham 019B,E01009236,600,449,228,221,1,1,32,5,27,118,108,10,0
2021,Birmingham 024A,E01009237,581,348,173,175,3,3,91,80,11,134,105,29,5
2021,Birmingham 024B,E01009238,627,474,258,216,1,1,56,5,51,96,89,7,0
2021,Birmingham 033F,E01009239,556,212,87,125,3,3,124,64,60,214,191,23,3
2021,Birmingham 024C,E01009240,595,430,222,208,4,4,11,3,8,149,121,28,1
2021,Birmingham 024D,E01009241,593,437,206,231,0,0,15,5,10,140,128,12,1
2021,Birmingham 024E,E01009242,638,416,221,195,3,3,17,5,12,202,180,22,0
2021,Birmingham 016B,E01009243,733,538,231,307,14,14,46,40,6,134,113,21,1
2021,Birmingham 019C,E01009244,806,515,216,299,13,13,82,10,72,196,181,15,0
2021,Birmingham 016C,E01009245,571,417,211,206,4,4,59,36,23,90,79,11,1
2021,Birmingham 016D,E01009246,664,523,265,258,0,0,44,16,28,97,86,11,0
2021,Birmingham 016E,E01009247,584,450,230,220,2,2,9,7,2,123,98,25,0
2021,Birmingham 019D,E01009248,707,556,280,276,4,4,6,2,4,140,117,23,1
2021,Birmingham 080A,E01009249,648,467,223,244,2,2,76,50,26,102,90,12,1
2021,Birmingham 080B,E01009250,731,542,296,246,4,4,67,61,6,118,105,13,0
2021,Birmingham 080C,E01009251,629,507,267,240,0,0,24,18,6,98,87,11,0
2021,Birmingham 073C,E01009252,639,473,219,254,0,0,22,9,13,144,136,8,0
2021,Birmingham 080D,E01009253,628,478,253,225,2,2,53,49,4,93,86,7,2
2021,Birmingham 085C,E01009254,851,404,196,208,16,16,286,163,123,141,120,21,4
2021,Birmingham 080E,E01009255,623,374,193,181,9,9,116,65,51,122,111,11,2
2021,Birmingham 085D,E01009256,678,411,206,205,1,1,156,151,5,109,99,10,1
2021,Birmingham 080F,E01009257,617,322,161,161,4,4,157,135,22,133,120,13,1
2021,Birmingham 085E,E01009258,656,273,144,129,4,4,275,260,15,92,81,11,12
2021,Birmingham 094E,E01009259,718,262,122,140,0,0,368,351,17,81,78,3,7
2021,Birmingham 073D,E01009260,626,490,300,190,3,3,39,5,34,94,80,14,0
2021,Birmingham 073E,E01009261,726,562,322,240,0,0,22,12,10,141,128,13,1
2021,Birmingham 133A,E01009262,533,400,191,209,0,0,27,22,5,105,96,9,1
2021,Birmingham 032C,E01009263,626,291,157,134,0,0,137,25,112,197,176,21,1
2021,Birmingham 032D,E01009264,686,69,37,32,2,2,128,58,70,483,475,8,4
2021,Birmingham 032E,E01009265,592,320,197,123,1,1,76,22,54,195,178,17,0
2021,Birmingham 034A,E01009266,588,255,146,109,1,1,98,27,71,234,197,37,0
2021,Birmingham 133B,E01009267,601,403,239,164,2,2,62,26,36,122,107,15,12
2021,Birmingham 036A,E01009268,433,346,193,153,1,1,12,8,4,72,63,9,2
2021,Birmingham 034B,E01009269,506,176,99,77,8,8,91,19,72,227,198,29,4
2021,Birmingham 034C,E01009270,632,255,144,111,3,3,268,63,205,103,82,21,3
2021,Birmingham 034D,E01009271,514,252,130,122,4,4,102,37,65,156,132,24,0
2021,Birmingham 036B,E01009272,471,201,119,82,4,4,190,90,100,74,63,11,2
2021,Birmingham 034E,E01009273,495,281,183,98,2,2,69,17,52,141,119,22,2
2021,Birmingham 036C,E01009274,710,293,170,123,5,5,200,30,170,209,190,19,3
2021,Birmingham 039A,E01009275,502,204,116,88,4,4,163,35,128,129,104,25,2
2021,Birmingham 133C,E01009276,543,443,231,212,1,1,11,4,7,86,65,21,2
2021,Birmingham 133D,E01009278,544,442,226,216,2,2,27,0,27,73,59,14,0
2021,Birmingham 133E,E01009279,452,379,206,173,0,0,7,3,4,66,56,10,0
2021,Birmingham 100A,E01009280,744,430,174,256,10,10,174,23,151,130,120,10,0
2021,Birmingham 099A,E01009281,697,380,209,171,4,4,235,9,226,77,65,12,1
2021,Birmingham 100B,E01009282,695,342,195,147,2,2,117,60,57,233,220,13,1
2021,Birmingham 079E,E01009283,612,361,192,169,3,3,47,4,43,201,176,25,0
2021,Birmingham 096A,E01009284,991,305,139,166,39,39,154,49,105,489,463,26,4
2021,Birmingham 096C,E01009286,514,69,46,23,6,6,26,13,13,413,407,6,0
2021,Birmingham 100C,E01009288,447,284,182,102,2,2,28,8,20,133,122,11,0
2021,Birmingham 096E,E01009289,608,58,41,17,8,8,78,38,40,463,451,12,1
2021,Birmingham 096F,E01009290,526,33,26,7,3,3,47,13,34,443,438,5,0
2021,Birmingham 095D,E01009291,587,293,129,164,2,2,159,152,7,132,124,8,1
2021,Birmingham 099B,E01009292,665,470,255,215,0,0,13,1,12,182,169,13,0
2021,Birmingham 100D,E01009293,613,341,181,160,17,17,41,14,27,214,193,21,0
2021,Birmingham 099C,E01009294,805,440,231,209,0,0,194,117,77,169,153,16,2
2021,Birmingham 099D,E01009295,669,347,244,103,2,2,127,51,76,193,171,22,0
2021,Birmingham 100E,E01009296,590,282,116,166,1,1,45,14,31,259,241,18,3
2021,Birmingham 057A,E01009297,799,387,214,173,8,8,322,241,81,80,65,15,2
2021,Birmingham 054D,E01009298,580,231,91,140,11,11,214,186,28,124,115,9,0
2021,Birmingham 057B,E01009299,625,291,133,158,4,4,235,156,79,94,84,10,1
2021,Birmingham 057C,E01009300,719,282,124,158,2,2,279,234,45,151,136,15,5
2021,Birmingham 057D,E01009301,767,251,108,143,1,1,378,360,18,131,118,13,6
2021,Birmingham 069A,E01009302,613,472,293,179,3,3,60,52,8,76,72,4,2
2021,Birmingham 057E,E01009303,715,367,180,187,3,3,212,189,23,129,118,11,4
2021,Birmingham 046A,E01009304,802,410,190,220,13,13,260,239,21,118,101,17,1
2021,Birmingham 045C,E01009305,706,253,124,129,31,31,339,277,62,81,70,11,2
2021,Birmingham 046B,E01009306,710,378,182,196,0,0,222,179,43,95,83,12,15
2021,Birmingham 045D,E01009307,728,319,167,152,2,2,311,250,61,90,81,9,6
2021,Birmingham 046C,E01009308,764,324,123,201,32,32,314,207,107,92,81,11,2
2021,Birmingham 045E,E01009309,785,329,158,171,9,9,341,300,41,106,98,8,0
2021,Birmingham 046D,E01009310,808,393,186,207,11,11,303,239,64,95,78,17,6
2021,Birmingham 054E,E01009311,559,297,147,150,1,1,160,137,23,100,96,4,1
2021,Birmingham 072A,E01009312,615,491,235,256,1,1,54,49,5,69,56,13,0
2021,Birmingham 076D,E01009313,631,431,221,210,0,0,109,97,12,91,84,7,0
2021,Birmingham 069B,E01009314,749,456,235,221,7,7,158,141,17,122,112,10,6
2021,Birmingham 081A,E01009315,839,468,267,201,7,7,124,100,24,239,221,18,1
2021,Birmingham 081B,E01009316,794,524,254,270,1,1,82,75,7,186,173,13,1
2021,Birmingham 081C,E01009317,848,519,228,291,9,9,223,206,17,92,84,8,5
2021,Birmingham 081D,E01009318,639,552,280,272,5,5,5,2,3,77,69,8,0
2021,Birmingham 081E,E01009319,625,528,287,241,0,0,6,3,3,91,88,3,0
2021,Birmingham 081F,E01009320,653,489,276,213,5,5,10,3,7,149,137,12,0
2021,Birmingham 069C,E01009321,813,208,94,114,12,12,460,359,101,131,125,6,2
2021,Birmingham 069D,E01009322,724,294,115,179,6,6,342,305,37,77,66,11,5
2021,Birmingham 069E,E01009323,636,357,133,224,5,5,206,152,54,66,55,11,2
2021,Birmingham 072B,E01009324,714,589,342,247,2,2,23,16,7,100,83,17,0
2021,Birmingham 063A,E01009325,507,262,129,133,1,1,140,85,55,103,78,25,1
2021,Birmingham 066D,E01009326,558,319,157,162,2,2,111,100,11,124,113,11,2
2021,Birmingham 139B,E01009327,409,226,147,79,0,0,29,11,18,154,136,18,0
2021,Birmingham 139C,E01009328,509,371,259,112,1,1,17,4,13,120,92,28,0
2021,Birmingham 070A,E01009329,712,334,214,120,1,1,115,35,80,262,225,37,0
2021,Birmingham 139D,E01009331,579,363,224,139,0,0,37,8,29,178,168,10,1
2021,Birmingham 139E,E01009332,593,139,83,56,9,9,318,102,216,123,111,12,4
2021,Birmingham 139F,E01009333,402,196,105,91,0,0,72,59,13,132,117,15,2
2021,Birmingham 070B,E01009334,434,275,191,84,0,0,66,19,47,91,80,11,2
2021,Birmingham 139G,E01009335,488,315,186,129,4,4,24,9,15,145,130,15,0
2021,Birmingham 070C,E01009337,492,234,132,102,1,1,64,11,53,192,173,19,1
2021,Birmingham 070D,E01009338,429,198,108,90,0,0,85,18,67,146,108,38,0
2021,Birmingham 142A,E01009339,467,212,133,79,5,5,130,58,72,120,104,16,0
2021,Birmingham 066E,E01009341,522,166,99,67,2,2,249,224,25,98,83,15,7
2021,Birmingham 063D,E01009342,403,256,138,118,2,2,31,15,16,114,95,19,0
2021,Birmingham 063E,E01009343,494,212,114,98,5,5,115,52,63,160,141,19,2
2021,Birmingham 139H,E01009344,470,182,115,67,3,3,139,58,81,141,126,15,5
2021,Birmingham 053D,E01009345,501,138,60,78,1,1,269,202,67,88,76,12,5
2021,Birmingham 053E,E01009346,524,229,122,107,1,1,121,108,13,170,154,16,3
2021,Birmingham 049D,E01009347,564,160,86,74,6,6,307,224,83,89,84,5,2
2021,Birmingham 047A,E01009348,818,280,136,144,0,0,293,199,94,242,218,24,3
2021,Birmingham 036D,E01009349,558,193,99,94,8,8,184,53,131,170,146,24,3
2021,Birmingham 039B,E01009350,476,220,147,73,2,2,144,40,104,105,95,10,5
2021,Birmingham 036E,E01009351,553,220,130,90,2,2,144,44,100,186,164,22,1
2021,Birmingham 039C,E01009352,487,221,154,67,4,4,177,58,119,84,66,18,1
2021,Birmingham 039D,E01009353,473,248,153,95,1,1,89,15,74,135,109,26,0
2021,Birmingham 036F,E01009354,508,169,94,75,1,1,198,108,90,134,115,19,6
2021,Birmingham 039E,E01009355,474,155,107,48,3,3,199,37,162,114,93,21,3
2021,Birmingham 047B,E01009358,742,241,145,96,1,1,265,66,199,233,198,35,2
2021,Birmingham 047C,E01009359,690,211,136,75,1,1,237,43,194,234,200,34,7
2021,Birmingham 047D,E01009360,958,285,149,136,7,7,374,168,206,288,268,20,4
2021,Birmingham 047E,E01009361,777,211,138,73,8,8,293,105,188,257,233,24,8
2021,Birmingham 071A,E01009362,492,86,31,55,0,0,353,273,80,42,34,8,11
2021,Birmingham 071B,E01009363,571,216,141,75,9,9,244,81,163,101,86,15,1
2021,Birmingham 071C,E01009364,554,97,55,42,2,2,381,281,100,65,63,2,9
2021,Birmingham 071D,E01009365,588,167,110,57,2,2,296,100,196,121,96,25,2
2021,Birmingham 084A,E01009366,538,242,138,104,2,2,161,119,42,127,122,5,6
2021,Birmingham 083A,E01009367,555,247,155,92,3,3,139,84,55,166,153,13,0
2021,Birmingham 077A,E01009368,414,138,106,32,0,0,220,62,158,55,46,9,1
2021,Birmingham 077D,E01009371,520,236,147,89,0,0,145,31,114,138,112,26,1
2021,Birmingham 082A,E01009372,417,246,150,96,0,0,57,38,19,114,85,29,0
2021,Birmingham 082B,E01009373,462,273,151,122,0,0,76,38,38,113,93,20,0
2021,Birmingham 084B,E01009374,439,169,111,58,3,3,218,146,72,46,42,4,3
2021,Birmingham 083B,E01009375,551,248,144,104,0,0,166,24,142,137,115,22,0
2021,Birmingham 084C,E01009376,539,167,102,65,1,1,198,32,166,171,159,12,2
2021,Birmingham 083C,E01009377,434,91,53,38,1,1,243,53,190,98,85,13,1
2021,Birmingham 071E,E01009379,677,189,104,85,3,3,365,271,94,111,90,21,9
2021,Birmingham 070E,E01009380,504,201,120,81,3,3,108,12,96,190,168,22,2
2021,Birmingham 142D,E01009382,466,292,174,118,1,1,51,10,41,120,105,15,2
2021,Birmingham 083D,E01009383,410,214,144,70,0,0,91,11,80,105,95,10,0
2021,Birmingham 092E,E01009384,701,180,60,120,10,10,321,51,270,190,173,17,0
2021,Birmingham 092F,E01009385,601,247,139,108,2,2,94,17,77,258,246,12,0
2021,Birmingham 093B,E01009389,480,345,224,121,2,2,52,4,48,81,69,12,0
2021,Birmingham 093C,E01009390,649,205,124,81,0,0,127,17,110,316,302,14,1
2021,Birmingham 143C,E01009391,514,241,106,135,1,1,43,10,33,228,206,22,1
2021,Birmingham 142E,E01009392,420,281,163,118,2,2,18,5,13,119,98,21,0
2021,Birmingham 143D,E01009393,479,238,105,133,0,0,29,13,16,212,187,25,0
2021,Birmingham 093D,E01009394,730,503,241,262,2,2,19,2,17,206,175,31,0
2021,Birmingham 097F,E01009395,523,259,153,106,0,0,109,17,92,155,142,13,0
2021,Birmingham 082D,E01009396,507,302,207,95,2,2,44,17,27,159,128,31,0
2021,Birmingham 077E,E01009397,461,190,124,66,0,0,177,46,131,94,81,13,0
2021,Birmingham 083E,E01009399,420,193,98,95,3,3,86,11,75,137,121,16,1
2021,Birmingham 031E,E01009400,574,290,154,136,3,3,155,66,89,124,115,9,2
2021,Birmingham 031F,E01009401,636,233,107,126,14,14,201,97,104,188,177,11,0
2021,Birmingham 020A,E01009403,606,317,127,190,5,5,166,149,17,115,108,7,3
2021,Birmingham 020B,E01009404,627,320,124,196,2,2,193,181,12,107,99,8,5
2021,Birmingham 020C,E01009405,608,361,190,171,3,3,133,118,15,110,99,11,1
2021,Birmingham 020D,E01009406,760,360,160,200,19,19,226,165,61,150,138,12,5
2021,Birmingham 020E,E01009407,694,356,179,177,5,5,149,101,48,181,170,11,3
2021,Birmingham 026B,E01009408,658,372,178,194,4,4,144,118,26,136,119,17,2
2021,Birmingham 026C,E01009409,838,307,159,148,33,33,202,44,158,294,262,32,2
2021,Birmingham 026D,E01009410,812,408,239,169,2,2,192,41,151,210,193,17,0
2021,Birmingham 030B,E01009411,873,509,264,245,5,5,8,4,4,350,326,24,1
2021,Birmingham 030C,E01009412,647,309,171,138,0,0,105,23,82,230,215,15,3
2021,Birmingham 030D,E01009413,671,325,170,155,3,3,110,32,78,231,203,28,2
2021,Birmingham 030E,E01009414,861,447,198,249,12,12,119,27,92,279,257,22,4
2021,Birmingham 002A,E01009415,686,613,341,272,1,1,8,3,5,64,59,5,0
2021,Birmingham 003A,E01009416,1069,860,377,483,2,2,53,3,50,154,134,20,0
2021,Birmingham 001A,E01009417,637,477,227,250,1,1,101,32,69,56,48,8,2
2021,Birmingham 001B,E01009418,640,438,241,197,2,2,130,19,111,70,59,11,0
2021,Birmingham 001C,E01009419,601,432,239,193,0,0,92,86,6,75,63,12,2
2021,Birmingham 003B,E01009420,648,547,244,303,2,2,39,36,3,60,53,7,0
2021,Birmingham 004A,E01009421,651,612,378,234,5,5,6,3,3,28,21,7,0
2021,Birmingham 002B,E01009422,852,679,390,289,1,1,21,6,15,149,132,17,2
2021,Birmingham 002C,E01009423,759,471,258,213,2,2,182,175,7,100,86,14,4
2021,Birmingham 004B,E01009424,724,483,246,237,1,1,35,12,23,205,184,21,0
2021,Birmingham 002D,E01009425,840,633,409,224,0,0,109,57,52,98,82,16,0
2021,Birmingham 003C,E01009426,613,564,360,204,0,0,5,4,1,44,39,5,0
2021,Birmingham 004C,E01009427,682,458,277,181,3,3,68,1,67,153,144,9,0
2021,Birmingham 004D,E01009428,639,611,364,247,0,0,5,1,4,22,19,3,1
2021,Birmingham 003D,E01009429,581,532,317,215,0,0,8,3,5,41,37,4,0
2021,Birmingham 004E,E01009430,684,583,338,245,1,1,29,1,28,61,56,5,10
2021,Birmingham 003E,E01009431,664,582,292,290,0,0,5,2,3,77,73,4,0
2021,Birmingham 006A,E01009432,648,421,227,194,0,0,155,151,4,70,55,15,2
2021,Birmingham 001D,E01009433,755,684,414,270,0,0,5,1,4,66,61,5,0
2021,Birmingham 012A,E01009434,704,599,279,320,8,8,10,2,8,87,81,6,0
2021,Birmingham 006B,E01009435,710,595,290,305,4,4,17,1,16,93,88,5,1
2021,Birmingham 012B,E01009436,555,511,324,187,3,3,4,1,3,36,30,6,1
2021,Birmingham 006C,E01009437,821,584,328,256,3,3,115,5,110,116,104,12,3
2021,Birmingham 012C,E01009438,595,520,309,211,3,3,1,0,1,71,61,10,0
2021,Birmingham 021A,E01009439,601,495,295,200,1,1,27,20,7,76,62,14,2
2021,Birmingham 012D,E01009440,645,574,355,219,3,3,8,3,5,60,46,14,0
2021,Birmingham 021B,E01009441,639,409,198,211,3,3,121,71,50,103,91,12,3
2021,Birmingham 021C,E01009442,592,543,302,241,4,4,9,6,3,35,30,5,1
2021,Birmingham 021D,E01009443,522,429,235,194,3,3,5,2,3,85,76,9,0
2021,Birmingham 006D,E01009444,604,566,344,222,0,0,2,0,2,35,33,2,1
2021,Birmingham 005A,E01009445,798,316,140,176,6,6,359,306,53,110,97,13,7
2021,Birmingham 005B,E01009446,1008,675,294,381,6,6,161,76,85,165,151,14,1
2021,Birmingham 005C,E01009447,633,458,207,251,1,1,78,71,7,94,85,9,2
2021,Birmingham 005D,E01009448,675,408,196,212,3,3,193,171,22,68,58,10,3
2021,Birmingham 009A,E01009449,1112,608,312,296,1,1,78,57,21,422,402,20,3
2021,Birmingham 012E,E01009450,669,564,279,285,2,2,29,13,16,71,63,8,3
2021,Birmingham 009B,E01009451,640,446,201,245,4,4,35,30,5,155,145,10,0
2021,Birmingham 005E,E01009452,694,547,296,251,4,4,54,49,5,86,75,11,3
2021,Birmingham 009C,E01009453,519,462,231,231,1,1,24,21,3,32,21,11,0
2021,Birmingham 006E,E01009454,649,520,309,211,2,2,1,1,0,125,119,6,1
2021,Birmingham 005F,E01009455,693,288,151,137,12,12,326,15,311,67,56,11,0
2021,Birmingham 018C,E01009456,709,609,338,271,1,1,14,12,2,85,73,12,0
2021,Birmingham 015A,E01009457,604,574,370,204,0,0,6,3,3,24,21,3,0
2021,Birmingham 018D,E01009458,737,378,224,154,81,81,217,98,119,61,55,6,0
2021,Birmingham 015B,E01009459,640,544,315,229,0,0,11,3,8,84,72,12,1
2021,Birmingham 018E,E01009460,812,435,225,210,29,29,101,27,74,246,225,21,1
2021,Birmingham 015C,E01009461,520,482,283,199,1,1,12,0,12,23,19,4,2
2021,Birmingham 018F,E01009462,773,456,206,250,10,10,147,95,52,158,147,11,2
2021,Birmingham 015D,E01009463,616,538,321,217,0,0,8,3,5,70,61,9,0
2021,Birmingham 007B,E01009464,542,501,263,238,3,3,5,1,4,32,29,3,1
2021,Birmingham 007C,E01009465,498,458,210,248,1,1,5,5,0,34,28,6,0
2021,Birmingham 009D,E01009466,659,554,292,262,1,1,13,5,8,91,81,10,0
2021,Birmingham 007D,E01009467,657,510,297,213,1,1,92,4,88,53,49,4,1
2021,Birmingham 004F,E01009468,609,541,323,218,2,2,8,3,5,57,49,8,1
2021,Birmingham 010B,E01009469,587,504,314,190,2,2,8,4,4,73,62,11,0
2021,Birmingham 010C,E01009470,532,508,280,228,0,0,4,1,3,19,17,2,1
2021,Birmingham 009E,E01009471,727,590,336,254,1,1,16,9,7,120,108,12,0
2021,Birmingham 010D,E01009472,662,560,289,271,2,2,46,24,22,53,46,7,1
2021,Birmingham 010E,E01009473,689,490,267,223,2,2,56,37,19,140,125,15,1
2021,Birmingham 010F,E01009474,637,483,269,214,0,0,59,58,1,93,79,14,2
2021,Birmingham 055A,E01009475,610,328,155,173,7,7,174,162,12,100,86,14,1
2021,Birmingham 055B,E01009476,579,292,135,157,0,0,148,139,9,132,116,16,7
2021,Birmingham 055C,E01009477,528,281,135,146,1,1,122,107,15,124,107,17,0
2021,Birmingham 048A,E01009478,619,238,87,151,6,6,273,194,79,97,87,10,5
2021,Birmingham 048B,E01009479,595,268,152,116,1,1,190,48,142,134,109,25,2
2021,Birmingham 044C,E01009480,577,326,137,189,0,0,130,113,17,119,110,9,2
2021,Birmingham 044D,E01009481,716,469,216,253,7,7,39,15,24,201,182,19,0
2021,Birmingham 048C,E01009482,473,211,123,88,2,2,162,108,54,90,82,8,8
2021,Birmingham 051B,E01009483,522,227,123,104,2,2,131,63,68,153,124,29,9
2021,Birmingham 048D,E01009484,491,209,132,77,3,3,169,69,100,108,98,10,2
2021,Birmingham 048E,E01009485,504,328,184,144,1,1,72,50,22,103,89,14,0
2021,Birmingham 044E,E01009486,606,330,165,165,6,6,85,29,56,185,166,19,0
2021,Birmingham 044F,E01009487,572,338,186,152,2,2,49,35,14,180,162,18,3
2021,Birmingham 051C,E01009488,718,243,127,116,0,0,368,112,256,105,97,8,2
2021,Birmingham 051D,E01009489,521,265,157,108,5,5,109,26,83,141,126,15,1
2021,Birmingham 055D,E01009490,637,306,165,141,0,0,225,205,20,105,94,11,1
2021,Birmingham 051E,E01009491,526,298,203,95,0,0,102,50,52,125,100,25,1
2021,Birmingham 055E,E01009492,541,292,130,162,2,2,112,96,16,132,115,17,3
2021,Birmingham 113D,E01009493,1020,264,148,116,85,85,476,378,98,191,176,15,4
2021,Birmingham 109A,E01009494,623,25,9,16,1,1,569,36,533,27,21,6,1
2021,Birmingham 106E,E01009495,536,223,141,82,14,14,258,188,70,39,34,5,2
2021,Birmingham 109B,E01009496,639,513,313,200,1,1,48,7,41,76,58,18,1
2021,Birmingham 109C,E01009497,754,396,189,207,30,30,189,104,85,137,128,9,2
2021,Birmingham 119D,E01009498,677,284,123,161,3,3,269,250,19,119,108,11,2
2021,Birmingham 119E,E01009499,663,350,169,181,13,13,189,157,32,106,99,7,5
2021,Birmingham 095E,E01009500,607,266,131,135,3,3,245,174,71,89,82,7,4
2021,Birmingham 101B,E01009501,570,239,118,121,1,1,186,175,11,143,135,8,1
2021,Birmingham 101C,E01009502,579,273,130,143,27,27,176,122,54,102,95,7,1
2021,Birmingham 101D,E01009503,582,290,132,158,1,1,184,173,11,105,96,9,2
2021,Birmingham 109D,E01009504,643,453,270,183,0,0,129,41,88,60,53,7,1
2021,Birmingham 101E,E01009505,644,253,112,141,0,0,281,126,155,110,101,9,0
2021,Birmingham 109E,E01009506,622,493,314,179,6,6,33,5,28,90,79,11,0
2021,Birmingham 056B,E01009507,574,229,127,102,6,6,202,33,169,136,126,10,1
2021,Birmingham 056C,E01009508,607,388,221,167,2,2,103,95,8,111,100,11,3
2021,Birmingham 056D,E01009509,627,307,154,153,5,5,81,36,45,233,222,11,1
2021,Birmingham 056E,E01009510,683,271,136,135,1,1,348,259,89,60,54,6,3
2021,Birmingham 054F,E01009511,484,210,96,114,0,0,185,175,10,80,62,18,9
2021,Birmingham 062A,E01009512,706,371,166,205,11,11,224,141,83,94,88,6,6
2021,Birmingham 066F,E01009513,591,310,132,178,0,0,152,121,31,124,113,11,5
2021,Birmingham 062B,E01009514,623,269,107,162,25,25,235,160,75,90,79,11,4
2021,Birmingham 067C,E01009515,635,395,224,171,3,3,105,73,32,132,116,16,0
2021,Birmingham 062C,E01009516,517,322,164,158,2,2,91,75,16,100,92,8,2
2021,Birmingham 062D,E01009517,700,414,185,229,0,0,189,166,23,91,69,22,6
2021,Birmingham 067D,E01009518,707,512,313,199,1,1,66,30,36,127,113,14,1
2021,Birmingham 072C,E01009519,595,499,250,249,0,0,17,9,8,78,62,16,1
2021,Birmingham 072D,E01009520,709,568,301,267,7,7,32,2,30,102,94,8,0
2021,Birmingham 067E,E01009521,616,478,250,228,1,1,13,2,11,124,115,9,0
2021,Coventry 014A,E01009522,739,440,210,230,9,9,164,62,102,124,113,11,2
2021,Coventry 010A,E01009523,628,571,344,227,1,1,8,1,7,48,40,8,0
2021,Coventry 006A,E01009524,749,438,261,177,0,0,223,71,152,84,67,17,4
2021,Coventry 006B,E01009525,576,473,275,198,4,4,13,6,7,86,72,14,0
2021,Coventry 010B,E01009526,603,511,269,242,0,0,10,4,6,82,66,16,0
2021,Coventry 006C,E01009527,657,461,221,240,1,1,47,18,29,148,118,30,0
2021,Coventry 010C,E01009528,860,738,388,350,5,5,42,10,32,75,60,15,0
2021,Coventry 014B,E01009529,628,515,276,239,0,0,14,7,7,99,84,15,0
2021,Coventry 014C,E01009530,554,473,251,222,0,0,5,2,3,76,70,6,0
2021,Coventry 010D,E01009531,775,519,298,221,1,1,114,60,54,138,113,25,3
2021,Coventry 033A,E01009532,578,454,242,212,3,3,31,14,17,90,77,13,0
2021,Coventry 033B,E01009535,569,494,314,180,1,1,22,9,13,52,47,5,0
2021,Coventry 033C,E01009536,606,520,301,219,1,1,7,3,4,78,67,11,0
2021,Coventry 035C,E01009537,626,371,184,187,0,0,171,54,117,81,71,10,3
2021,Coventry 035D,E01009538,624,403,192,211,1,1,156,58,98,64,58,6,0
2021,Coventry 039A,E01009539,942,356,117,239,1,1,457,191,266,126,113,13,2
2021,Coventry 039B,E01009540,759,169,79,90,2,2,525,234,291,60,51,9,3
2021,Coventry 039C,E01009541,812,390,231,159,5,5,260,107,153,157,140,17,0
2021,Coventry 039D,E01009542,815,293,140,153,6,6,423,120,303,90,77,13,3
2021,Coventry 033D,E01009543,621,564,250,314,0,0,6,1,5,51,42,9,0
2021,Coventry 038A,E01009544,737,385,210,175,6,6,169,29,140,176,164,12,1
2021,Coventry 031A,E01009548,929,429,233,196,2,2,75,19,56,421,403,18,2
2021,Coventry 037B,E01009549,657,542,320,222,0,0,7,1,6,107,96,11,1
2021,Coventry 037C,E01009550,721,469,256,213,2,2,13,4,9,237,209,28,0
2021,Coventry 037E,E01009552,682,369,214,155,0,0,162,57,105,150,125,25,1
2021,Coventry 031B,E01009553,873,175,76,99,10,10,169,20,149,517,501,16,2
2021,Coventry 034A,E01009554,581,384,225,159,0,0,25,8,17,172,160,12,0
2021,Coventry 034B,E01009555,589,505,309,196,1,1,10,1,9,72,61,11,1
2021,Coventry 034C,E01009556,705,398,233,165,2,2,87,11,76,218,202,16,0
2021,Coventry 034D,E01009557,538,504,307,197,0,0,6,1,5,28,24,4,0
2021,Coventry 034E,E01009558,629,433,237,196,1,1,20,5,15,175,164,11,0
2021,Coventry 034F,E01009559,580,477,308,169,8,8,27,4,23,68,54,14,0
2021,Coventry 040A,E01009560,534,492,293,199,1,1,5,1,4,36,28,8,0
2021,Coventry 040B,E01009561,755,483,296,187,2,2,135,46,89,134,122,12,1
2021,Coventry 040C,E01009562,673,550,352,198,0,0,51,20,31,72,61,11,0
2021,Coventry 040D,E01009563,621,581,316,265,0,0,4,1,3,36,27,9,0
2021,Coventry 005A,E01009564,685,307,104,203,4,4,133,27,106,239,218,21,2
2021,Coventry 009A,E01009565,458,263,167,96,0,0,29,10,19,165,147,18,1
2021,Coventry 009B,E01009566,657,167,67,100,32,32,212,56,156,245,223,22,1
2021,Coventry 009C,E01009567,587,217,114,103,2,2,132,25,107,236,211,25,0
2021,Coventry 009D,E01009568,541,281,166,115,2,2,64,18,46,193,176,17,1
2021,Coventry 015A,E01009569,497,158,111,47,3,3,106,26,80,225,211,14,5
2021,Coventry 015B,E01009570,684,262,177,85,2,2,157,53,104,263,240,23,0
2021,Coventry 015C,E01009571,641,146,81,65,2,2,283,90,193,207,187,20,3
2021,Coventry 015E,E01009573,498,188,134,54,4,4,129,17,112,177,152,25,0
2021,Coventry 015F,E01009574,559,156,100,56,3,3,242,47,195,156,140,16,2
2021,Coventry 005B,E01009575,451,212,108,104,1,1,78,16,62,160,148,12,0
2021,Coventry 008A,E01009576,715,398,203,195,1,1,173,33,140,141,131,10,2
2021,Coventry 007A,E01009577,676,183,56,127,15,15,390,157,233,88,78,10,0
2021,Coventry 008B,E01009578,573,471,283,188,11,11,35,2,33,56,44,12,0
2021,Coventry 007B,E01009579,870,249,95,154,5,5,499,224,275,112,94,18,5
2021,Coventry 019A,E01009580,609,315,203,112,2,2,49,4,45,243,229,14,0
2021,Coventry 007C,E01009581,697,275,115,160,0,0,330,113,217,88,65,23,4
2021,Coventry 008C,E01009582,721,421,226,195,23,23,134,17,117,143,114,29,0
2021,Coventry 008D,E01009583,651,352,194,158,9,9,90,7,83,200,176,24,0
2021,Coventry 007D,E01009584,862,548,216,332,2,2,203,63,140,108,91,17,1
2021,Coventry 007E,E01009585,603,246,40,206,15,15,281,125,156,59,56,3,2
2021,Coventry 008E,E01009586,726,543,297,246,27,27,47,5,42,109,98,11,0
2021,Coventry 011A,E01009587,783,415,165,250,25,25,86,16,70,257,234,23,0
2021,Coventry 043A,E01009588,646,314,137,177,2,2,215,85,130,115,101,14,0
2021,Coventry 001A,E01009589,648,425,195,230,3,3,63,4,59,157,141,16,0
2021,Coventry 002A,E01009590,593,449,228,221,6,6,71,9,62,67,63,4,0
2021,Coventry 002B,E01009591,595,385,178,207,6,6,10,2,8,192,172,20,2
2021,Coventry 043B,E01009592,622,326,124,202,2,2,129,33,96,164,147,17,1
2021,Coventry 002C,E01009593,623,450,264,186,3,3,8,4,4,162,143,19,0
2021,Coventry 006D,E01009594,556,461,249,212,0,0,41,16,25,54,41,13,0
2021,Coventry 043C,E01009596,755,440,169,271,4,4,92,22,70,219,205,14,0
2021,Coventry 043D,E01009597,662,425,230,195,10,10,59,7,52,167,152,15,1
2021,Coventry 002D,E01009598,768,598,329,269,2,2,28,7,21,140,121,19,0
2021,Coventry 013A,E01009599,559,371,266,105,3,3,55,24,31,130,112,18,0
2021,Coventry 004A,E01009604,563,389,199,190,1,1,36,3,33,137,117,20,0
2021,Coventry 004B,E01009605,707,248,109,139,18,18,338,132,206,100,89,11,3
2021,Coventry 005C,E01009606,773,587,208,379,3,3,23,9,14,160,141,19,0
2021,Coventry 004C,E01009607,769,177,85,92,6,6,492,224,268,92,84,8,2
2021,Coventry 004D,E01009608,622,342,184,158,6,6,116,33,83,158,142,16,0
2021,Coventry 005D,E01009609,583,334,180,154,2,2,92,27,65,153,135,18,2
2021,Coventry 004E,E01009610,607,303,144,159,1,1,157,46,111,146,136,10,0
2021,Coventry 035F,E01009612,552,173,69,104,16,16,292,133,159,69,61,8,2
2021,Coventry 018A,E01009613,498,396,205,191,2,2,9,3,6,91,77,14,0
2021,Coventry 021A,E01009614,584,454,249,205,1,1,9,2,7,120,107,13,0
2021,Coventry 027A,E01009615,657,341,160,181,0,0,26,4,22,284,260,24,6
2021,Coventry 027B,E01009616,604,420,200,220,0,0,13,3,10,170,157,13,1
2021,Coventry 027C,E01009617,470,341,188,153,2,2,25,6,19,102,88,14,0
2021,Coventry 027D,E01009618,657,518,238,280,3,3,30,6,24,106,94,12,0
2021,Coventry 027E,E01009620,1023,690,252,438,30,30,111,17,94,192,161,31,0
2021,Coventry 027F,E01009621,548,286,158,128,4,4,117,54,63,140,130,10,1
2021,Coventry 012A,E01009622,664,310,139,171,2,2,195,87,108,155,142,13,2
2021,Coventry 012B,E01009623,661,340,167,173,2,2,116,42,74,203,185,18,0
2021,Coventry 011B,E01009624,603,352,174,178,2,2,22,13,9,225,214,11,2
2021,Coventry 011C,E01009625,875,554,263,291,2,2,54,19,35,262,234,28,3
2021,Coventry 011D,E01009626,636,403,194,209,0,0,24,9,15,207,181,26,2
2021,Coventry 012C,E01009627,723,336,182,154,4,4,107,35,72,274,260,14,2
2021,Coventry 012D,E01009628,633,451,245,206,3,3,38,13,25,141,133,8,0
2021,Coventry 020B,E01009630,706,296,129,167,0,0,155,64,91,255,237,18,0
2021,Coventry 020C,E01009631,600,175,91,84,0,0,244,99,145,180,171,9,1
2021,Coventry 020D,E01009632,986,142,79,63,4,4,396,120,276,440,422,18,4
2021,Coventry 028A,E01009633,736,148,91,57,9,9,143,52,91,436,410,26,0
2021,Coventry 028B,E01009634,687,252,168,84,2,2,56,17,39,371,342,29,6
2021,Coventry 024A,E01009636,958,206,109,97,2,2,137,33,104,613,591,22,0
2021,Coventry 024B,E01009637,522,166,90,76,4,4,211,56,155,140,124,16,1
2021,Coventry 024C,E01009638,758,73,44,29,5,5,567,198,369,105,84,21,8
2021,Coventry 024D,E01009639,558,239,169,70,3,3,79,15,64,234,203,31,3
2021,Coventry 024E,E01009640,738,175,82,93,2,2,249,59,190,309,292,17,3
2021,Coventry 024F,E01009641,825,109,58,51,2,2,297,72,225,416,374,42,1
2021,Coventry 017A,E01009643,590,478,217,261,2,2,5,0,5,105,94,11,0
2021,Coventry 017B,E01009644,681,537,264,273,1,1,18,3,15,125,118,7,0
2021,Coventry 014D,E01009645,564,438,222,216,1,1,9,2,7,116,102,14,0
2021,Coventry 022A,E01009646,604,492,211,281,0,0,12,2,10,100,87,13,0
2021,Coventry 017C,E01009647,826,517,298,219,3,3,17,7,10,287,263,24,2
2021,Coventry 017D,E01009648,593,493,235,258,0,0,7,2,5,93,81,12,0
2021,Coventry 026A,E01009649,573,441,221,220,3,3,16,9,7,113,99,14,0
2021,Coventry 020E,E01009650,759,194,105,89,5,5,68,8,60,486,468,18,6
2021,Coventry 031D,E01009651,732,114,78,36,0,0,461,168,293,151,137,14,6
2021,Coventry 017E,E01009652,616,487,277,210,2,2,35,10,25,92,74,18,0
2021,Coventry 017F,E01009653,633,508,260,248,13,13,8,1,7,104,90,14,0
2021,Coventry 021B,E01009654,711,518,248,270,2,2,9,1,8,182,169,13,0
2021,Coventry 016A,E01009655,843,374,142,232,3,3,269,141,128,196,181,15,1
2021,Coventry 016B,E01009656,702,300,157,143,3,3,175,55,120,224,210,14,0
2021,Coventry 018B,E01009657,611,461,240,221,2,2,7,5,2,140,127,13,1
2021,Coventry 021C,E01009658,635,382,199,183,5,5,23,4,19,225,216,9,0
2021,Coventry 016C,E01009659,784,176,104,72,3,3,257,91,166,348,329,19,0
2021,Coventry 021D,E01009660,653,321,194,127,0,0,48,14,34,283,268,15,1
2021,Coventry 028D,E01009661,799,155,109,46,1,1,137,22,115,502,479,23,4
2021,Coventry 016D,E01009662,568,345,205,140,1,1,128,51,77,92,85,7,2
2021,Coventry 013B,E01009663,621,493,335,158,0,0,17,3,14,111,92,19,0
2021,Coventry 016E,E01009664,593,387,182,205,2,2,75,33,42,129,118,11,0
2021,Coventry 042A,E01009665,476,400,266,134,0,0,19,4,15,57,49,8,0
2021,Coventry 041A,E01009666,510,447,265,182,1,1,4,2,2,58,50,8,0
2021,Coventry 041B,E01009667,568,520,382,138,3,3,3,1,2,42,33,9,0
2021,Coventry 041C,E01009668,626,504,245,259,1,1,23,8,15,97,84,13,1
2021,Coventry 042B,E01009669,466,401,208,193,1,1,6,0,6,57,51,6,1
2021,Coventry 041D,E01009670,662,568,278,290,2,2,9,4,5,83,73,10,0
2021,Coventry 042C,E01009671,409,363,217,146,6,6,3,0,3,37,30,7,0
2021,Coventry 040E,E01009672,826,729,465,264,3,3,17,7,10,77,56,21,0
2021,Coventry 029A,E01009674,745,360,157,203,15,15,242,77,165,128,117,11,0
2021,Coventry 032A,E01009676,682,443,197,246,15,15,56,11,45,167,150,17,1
2021,Coventry 036C,E01009679,802,247,113,134,6,6,270,115,155,275,265,10,4
2021,Coventry 032B,E01009681,545,439,226,213,2,2,3,1,2,101,95,6,0
2021,Coventry 032C,E01009682,597,484,260,224,3,3,11,5,6,99,88,11,0
2021,Coventry 032D,E01009683,713,362,168,194,2,2,121,52,69,228,208,20,0
2021,Coventry 026B,E01009684,679,356,193,163,1,1,206,65,141,116,98,18,0
2021,Coventry 026C,E01009685,717,552,264,288,4,4,46,18,28,115,101,14,0
2021,Coventry 026D,E01009686,675,534,260,274,2,2,18,4,14,120,99,21,1
2021,Coventry 026E,E01009687,601,459,241,218,1,1,8,1,7,133,115,18,0
2021,Coventry 030A,E01009688,631,296,139,157,1,1,57,7,50,277,256,21,0
2021,Coventry 030B,E01009689,911,345,222,123,104,104,78,10,68,382,351,31,2
2021,Coventry 030C,E01009690,635,260,147,113,2,2,27,6,21,346,319,27,0
2021,Coventry 030D,E01009691,598,260,125,135,1,1,30,4,26,307,296,11,0
2021,Coventry 022B,E01009692,523,481,311,170,2,2,7,1,6,33,31,2,0
2021,Coventry 022C,E01009693,675,550,301,249,4,4,11,2,9,110,91,19,0
2021,Coventry 022D,E01009694,614,519,292,227,1,1,20,10,10,74,63,11,0
2021,Coventry 023A,E01009695,745,632,426,206,0,0,16,4,12,97,87,10,0
2021,Coventry 023B,E01009696,651,549,332,217,0,0,6,2,4,96,83,13,0
2021,Coventry 025A,E01009697,864,704,318,386,2,2,37,12,25,121,107,14,0
2021,Coventry 025B,E01009698,633,553,323,230,3,3,13,5,8,64,55,9,0
2021,Coventry 029B,E01009699,629,474,279,195,0,0,58,20,38,95,84,11,2
2021,Coventry 029C,E01009700,833,266,131,135,3,3,445,163,282,119,104,15,0
2021,Coventry 029D,E01009701,714,372,212,160,2,2,256,118,138,82,68,14,2
2021,Coventry 029E,E01009702,738,271,154,117,0,0,326,124,202,141,133,8,0
2021,Coventry 023C,E01009704,599,528,312,216,0,0,6,0,6,65,58,7,0
2021,Coventry 023D,E01009705,574,515,312,203,1,1,9,5,4,49,43,6,0
2021,Coventry 025D,E01009706,643,524,289,235,4,4,19,8,11,96,84,12,0
2021,Coventry 033E,E01009707,728,549,267,282,12,12,51,2,49,116,107,9,0
2021,Coventry 033F,E01009708,607,478,291,187,0,0,22,8,14,107,93,14,0
2021,Coventry 007F,E01009709,421,66,39,27,2,2,287,175,112,42,39,3,24
2021,Coventry 013C,E01009710,603,380,213,167,1,1,25,7,18,196,180,16,1
2021,Coventry 013D,E01009711,753,581,237,344,1,1,64,27,37,107,91,16,0
2021,Coventry 018C,E01009712,598,406,202,204,1,1,23,4,19,167,149,18,1
2021,Coventry 019B,E01009713,521,369,181,188,2,2,19,5,14,131,116,15,0
2021,Coventry 018D,E01009714,564,422,190,232,2,2,6,3,3,134,124,10,0
2021,Coventry 019C,E01009715,586,322,199,123,0,0,106,30,76,157,146,11,1
2021,Coventry 018E,E01009716,646,489,226,263,2,2,34,12,22,120,110,10,1
2021,Coventry 019D,E01009717,572,446,263,183,9,9,14,5,9,103,99,4,0
2021,Coventry 019E,E01009718,844,270,138,132,7,7,408,146,262,157,129,28,2
2021,Dudley 027A,E01009719,567,481,242,239,0,0,10,6,4,75,63,12,1
2021,Dudley 028A,E01009720,527,477,272,205,1,1,4,2,2,44,37,7,1
2021,Dudley 031A,E01009721,1111,770,387,383,22,22,142,107,35,173,157,16,4
2021,Dudley 027B,E01009722,608,468,295,173,56,56,11,9,2,72,66,6,1
2021,Dudley 028B,E01009723,460,417,237,180,9,9,3,2,1,31,28,3,0
2021,Dudley 028C,E01009724,621,561,321,240,6,6,7,4,3,47,38,9,0
2021,Dudley 031B,E01009725,633,214,94,120,2,2,364,195,169,46,41,5,7
2021,Dudley 031C,E01009726,546,482,285,197,1,1,4,0,4,59,41,18,0
2021,Dudley 027C,E01009727,555,507,301,206,2,2,6,5,1,40,36,4,0
2021,Dudley 027D,E01009728,495,460,268,192,0,0,5,4,1,30,22,8,0
2021,Dudley 027E,E01009729,638,478,267,211,0,0,114,111,3,46,42,4,0
2021,Dudley 028D,E01009730,637,490,224,266,11,11,17,12,5,119,111,8,0
2021,Dudley 023A,E01009731,738,567,231,336,0,0,22,20,2,149,134,15,0
2021,Dudley 039A,E01009732,746,481,248,233,1,1,152,138,14,109,90,19,3
2021,Dudley 039B,E01009733,951,177,87,90,2,2,635,589,46,129,117,12,8
2021,Dudley 034A,E01009734,682,434,244,190,9,9,128,92,36,109,95,14,2
2021,Dudley 034B,E01009735,702,575,332,243,1,1,19,10,9,107,92,15,0
2021,Dudley 034C,E01009736,619,526,316,210,2,2,16,7,9,75,69,6,0
2021,Dudley 034D,E01009737,698,468,276,192,2,2,139,24,115,89,72,17,0
2021,Dudley 034E,E01009738,605,456,230,226,3,3,106,106,0,38,29,9,2
2021,Dudley 039C,E01009739,661,444,227,217,0,0,114,110,4,103,95,8,0
2021,Dudley 023B,E01009740,863,469,156,313,4,4,214,185,29,173,161,12,3
2021,Dudley 022A,E01009741,1085,245,123,122,0,0,662,633,29,168,149,19,10
2021,Dudley 023C,E01009742,669,306,137,169,0,0,291,262,29,65,60,5,7
2021,Dudley 023D,E01009743,707,284,139,145,1,1,335,330,5,81,74,7,6
2021,Dudley 022B,E01009744,1083,478,219,259,7,7,360,293,67,235,211,24,3
2021,Dudley 023E,E01009745,744,575,300,275,1,1,69,26,43,99,88,11,0
2021,Dudley 022C,E01009746,884,303,179,124,1,1,210,78,132,368,332,36,2
2021,Dudley 022D,E01009747,689,340,173,167,7,7,138,112,26,204,192,12,0
2021,Dudley 013A,E01009748,666,283,164,119,0,0,296,292,4,79,71,8,8
2021,Dudley 016A,E01009749,960,764,335,429,26,26,61,15,46,109,101,8,0
2021,Dudley 016B,E01009750,596,413,226,187,0,0,121,111,10,59,50,9,3
2021,Dudley 017A,E01009751,690,400,225,175,4,4,150,130,20,136,120,16,0
2021,Dudley 017B,E01009752,652,278,142,136,0,0,264,250,14,104,93,11,6
2021,Dudley 017C,E01009753,620,235,112,123,1,1,309,274,35,67,58,9,8
2021,Dudley 017D,E01009754,692,356,195,161,0,0,242,209,33,93,75,18,1
2021,Dudley 006B,E01009756,531,223,98,125,3,3,235,233,2,68,62,6,2
2021,Dudley 006C,E01009757,864,523,229,294,3,3,168,119,49,169,150,19,1
2021,Dudley 005A,E01009758,684,372,187,185,1,1,228,216,12,75,59,16,8
2021,Dudley 006D,E01009759,519,470,312,158,1,1,10,3,7,38,26,12,0
2021,Dudley 005B,E01009760,520,364,185,179,0,0,83,81,2,72,64,8,1
2021,Dudley 006F,E01009762,503,127,56,71,1,1,334,333,1,38,35,3,3
2021,Dudley 001A,E01009763,879,360,172,188,3,3,417,174,243,97,86,11,2
2021,Dudley 001B,E01009764,632,539,298,241,3,3,21,20,1,68,49,19,1
2021,Dudley 004A,E01009765,666,513,300,213,0,0,56,54,2,97,82,15,0
2021,Dudley 004B,E01009766,687,431,243,188,5,5,179,158,21,71,63,8,1
2021,Dudley 001C,E01009767,658,418,213,205,0,0,190,186,4,46,36,10,4
2021,Dudley 004C,E01009768,603,372,229,143,2,2,109,85,24,118,103,15,2
2021,Dudley 001D,E01009769,820,276,162,114,10,10,390,342,48,140,127,13,4
2021,Dudley 001E,E01009770,640,392,257,135,0,0,191,166,25,53,43,10,4
2021,Dudley 004D,E01009771,644,553,351,202,2,2,39,12,27,50,44,6,0
2021,Dudley 005C,E01009772,508,213,114,99,31,31,229,19,210,35,27,8,0
2021,Dudley 002A,E01009773,676,390,238,152,3,3,157,152,5,125,107,18,1
2021,Dudley 005D,E01009774,691,494,284,210,18,18,124,120,4,55,43,12,0
2021,Dudley 004E,E01009775,619,365,212,153,0,0,186,178,8,67,53,14,1
2021,Dudley 004F,E01009776,593,497,289,208,1,1,34,33,1,60,45,15,1
2021,Dudley 002B,E01009777,656,385,184,201,2,2,202,198,4,67,58,9,0
2021,Dudley 002C,E01009778,632,499,247,252,0,0,52,50,2,81,72,9,0
2021,Dudley 008A,E01009779,701,467,292,175,2,2,117,66,51,111,92,19,4
2021,Dudley 009A,E01009780,846,667,313,354,13,13,43,8,35,123,115,8,0
2021,Dudley 007A,E01009781,893,477,254,223,15,15,319,152,167,77,65,12,5
2021,Dudley 008B,E01009782,751,433,187,246,1,1,258,254,4,57,50,7,2
2021,Dudley 008C,E01009783,600,345,185,160,0,0,188,184,4,67,58,9,0
2021,Dudley 009B,E01009784,628,563,269,294,0,0,4,4,0,61,56,5,0
2021,Dudley 008D,E01009785,660,576,360,216,0,0,34,30,4,49,32,17,1
2021,Dudley 007B,E01009786,616,209,99,110,9,9,329,240,89,63,57,6,6
2021,Dudley 009C,E01009787,591,544,311,233,2,2,12,7,5,33,28,5,0
2021,Dudley 005E,E01009788,717,331,185,146,1,1,280,278,2,101,91,10,4
2021,Dudley 007C,E01009789,682,539,303,236,6,6,46,43,3,91,80,11,0
2021,Dudley 007D,E01009790,700,401,189,212,1,1,206,199,7,88,79,9,4
2021,Dudley 026A,E01009791,662,453,229,224,0,0,151,79,72,58,49,9,0
2021,Dudley 026B,E01009792,627,412,198,214,5,5,125,113,12,82,74,8,3
2021,Dudley 030A,E01009793,613,507,247,260,3,3,14,8,6,89,79,10,0
2021,Dudley 030B,E01009794,629,556,334,222,2,2,11,10,1,60,49,11,0
2021,Dudley 026C,E01009795,745,397,198,199,5,5,94,72,22,249,222,27,0
2021,Dudley 026D,E01009796,632,498,274,224,0,0,58,50,8,74,64,10,2
2021,Dudley 030C,E01009797,651,447,268,179,0,0,132,62,70,72,59,13,0
2021,Dudley 026E,E01009798,1003,694,301,393,21,21,88,54,34,199,175,24,1
2021,Dudley 039D,E01009799,702,598,337,261,0,0,15,3,12,89,77,12,0
2021,Dudley 036A,E01009800,646,534,330,204,0,0,61,57,4,51,38,13,0
2021,Dudley 030D,E01009801,700,565,364,201,0,0,29,26,3,106,86,20,0
2021,Dudley 036B,E01009802,678,496,253,243,1,1,124,119,5,55,50,5,2
2021,Dudley 036C,E01009803,648,616,394,222,1,1,11,10,1,18,8,10,2
2021,Dudley 036D,E01009804,533,480,322,158,0,0,6,3,3,47,39,8,0
2021,Dudley 039E,E01009805,652,495,298,197,0,0,59,5,54,98,87,11,0
2021,Dudley 039F,E01009806,698,548,307,241,2,2,37,8,29,110,98,12,1
2021,Dudley 043A,E01009807,752,697,408,289,0,0,8,7,1,47,35,12,0
2021,Dudley 043B,E01009808,590,554,375,179,1,1,9,7,2,26,22,4,0
2021,Dudley 033A,E01009809,684,323,145,178,3,3,284,268,16,72,68,4,2
2021,Dudley 043C,E01009810,769,592,334,258,1,1,91,88,3,83,74,9,2
2021,Dudley 043D,E01009811,654,489,274,215,1,1,93,28,65,69,64,5,2
2021,Dudley 043E,E01009812,577,522,293,229,0,0,28,26,2,27,23,4,0
2021,Dudley 033B,E01009813,651,403,217,186,1,1,150,119,31,93,77,16,4
2021,Dudley 014A,E01009814,513,487,311,176,1,1,4,3,1,21,16,5,0
2021,Dudley 014B,E01009815,495,473,274,199,0,0,6,4,2,16,12,4,0
2021,Dudley 012A,E01009816,712,656,380,276,6,6,19,6,13,31,23,8,0
2021,Dudley 012B,E01009817,536,498,334,164,0,0,10,8,2,28,20,8,0
2021,Dudley 014C,E01009818,548,329,174,155,1,1,150,149,1,67,57,10,1
2021,Dudley 012C,E01009819,685,527,319,208,2,2,29,23,6,127,113,14,0
2021,Dudley 012D,E01009820,664,535,325,210,0,0,48,37,11,80,67,13,1
2021,Dudley 014D,E01009821,604,566,392,174,1,1,7,6,1,30,26,4,0
2021,Dudley 014E,E01009822,656,552,363,189,2,2,42,41,1,57,50,7,3
2021,Dudley 016C,E01009823,534,494,308,186,0,0,7,6,1,32,24,8,1
2021,Dudley 016D,E01009824,856,450,214,236,1,1,202,200,2,198,191,7,5
2021,Dudley 019A,E01009825,615,414,214,200,0,0,145,142,3,55,41,14,1
2021,Dudley 019B,E01009826,631,582,399,183,1,1,6,5,1,42,30,12,0
2021,Dudley 019C,E01009827,627,600,340,260,2,2,5,3,2,20,16,4,0
2021,Dudley 019D,E01009828,571,464,310,154,3,3,48,47,1,55,50,5,1
2021,Dudley 019E,E01009829,627,579,362,217,1,1,8,4,4,39,34,5,0
2021,Dudley 019F,E01009830,632,580,350,230,0,0,22,20,2,30,25,5,0
2021,Dudley 037A,E01009831,636,331,193,138,0,0,242,236,6,53,46,7,10
2021,Dudley 042A,E01009832,732,274,140,134,0,0,349,345,4,107,101,6,2
2021,Dudley 032A,E01009833,531,277,152,125,3,3,61,44,17,190,162,28,0
2021,Dudley 031D,E01009834,735,406,225,181,10,10,218,173,45,98,84,14,3
2021,Dudley 032B,E01009835,603,415,221,194,4,4,38,10,28,146,123,23,0
2021,Dudley 037B,E01009836,883,211,129,82,1,1,452,396,56,214,197,17,5
2021,Dudley 037C,E01009837,665,394,227,167,1,1,71,28,43,199,171,28,0
2021,Dudley 037D,E01009838,692,460,239,221,1,1,133,131,2,93,81,12,5
2021,Dudley 013B,E01009839,626,370,199,171,1,1,121,110,11,134,122,12,0
2021,Dudley 018A,E01009840,542,294,174,120,3,3,63,33,30,171,159,12,11
2021,Dudley 017E,E01009841,672,290,162,128,1,1,249,244,5,120,111,9,12
2021,Dudley 018B,E01009842,678,282,169,113,4,4,228,201,27,155,140,15,9
2021,Dudley 018C,E01009843,656,465,277,188,2,2,98,53,45,89,78,11,2
2021,Dudley 011A,E01009844,620,241,120,121,0,0,176,134,42,197,183,14,6
2021,Dudley 041A,E01009845,649,587,376,211,1,1,34,8,26,27,19,8,0
2021,Dudley 041B,E01009846,640,508,312,196,2,2,76,74,2,54,41,13,0
2021,Dudley 038A,E01009847,616,484,294,190,1,1,76,74,2,55,51,4,0
2021,Dudley 038B,E01009848,621,467,255,212,1,1,83,80,3,66,55,11,4
2021,Dudley 038C,E01009849,653,447,239,208,0,0,147,147,0,59,52,7,0
2021,Dudley 041C,E01009850,662,521,311,210,0,0,64,34,30,77,59,18,0
2021,Dudley 038D,E01009851,652,541,321,220,1,1,64,55,9,39,34,5,7
2021,Dudley 041D,E01009852,606,589,413,176,1,1,3,2,1,13,13,0,0
2021,Dudley 042B,E01009853,621,573,399,174,1,1,13,11,2,34,27,7,0
2021,Dudley 040A,E01009854,646,580,356,224,0,0,6,4,2,60,48,12,0
2021,Dudley 042C,E01009855,644,613,411,202,0,0,5,4,1,26,24,2,0
2021,Dudley 035A,E01009856,973,522,247,275,1,1,236,212,24,214,202,12,0
2021,Dudley 040B,E01009857,700,365,181,184,1,1,244,234,10,85,73,12,5
2021,Dudley 040C,E01009858,670,386,239,147,2,2,44,13,31,238,217,21,0
2021,Dudley 040D,E01009859,641,570,329,241,0,0,6,5,1,65,59,6,0
2021,Dudley 042D,E01009860,634,594,408,186,1,1,17,17,0,22,14,8,0
2021,Dudley 033C,E01009861,725,480,223,257,0,0,84,80,4,160,141,19,1
2021,Dudley 033D,E01009862,755,428,226,202,1,1,210,178,32,114,109,5,2
2021,Dudley 033E,E01009863,790,535,211,324,5,5,128,82,46,116,109,7,6
2021,Dudley 025A,E01009864,602,400,209,191,1,1,142,140,2,57,46,11,2
2021,Dudley 025B,E01009865,666,357,181,176,2,2,240,176,64,63,52,11,4
2021,Dudley 025C,E01009866,773,476,242,234,5,5,96,82,14,193,168,25,3
2021,Dudley 025D,E01009867,709,535,317,218,0,0,100,100,0,72,58,14,2
2021,Dudley 033F,E01009868,662,391,209,182,8,8,124,92,32,137,122,15,2
2021,Dudley 032C,E01009869,675,532,285,247,1,1,14,11,3,127,114,13,1
2021,Dudley 032D,E01009870,755,505,305,200,8,8,95,16,79,147,129,18,0
2021,Dudley 018D,E01009871,910,536,292,244,2,2,206,169,37,157,134,23,9
2021,Dudley 020A,E01009872,510,264,131,133,1,1,142,136,6,103,92,11,0
2021,Dudley 020B,E01009873,650,492,306,186,0,0,63,56,7,91,84,7,4
2021,Dudley 020C,E01009874,581,321,182,139,0,0,206,198,8,53,49,4,1
2021,Dudley 018E,E01009875,636,383,213,170,4,4,149,144,5,98,90,8,2
2021,Dudley 020D,E01009876,675,445,257,188,2,2,148,135,13,76,66,10,4
2021,Dudley 020E,E01009877,670,272,138,134,0,0,313,306,7,81,68,13,4
2021,Dudley 025E,E01009878,897,741,329,412,10,10,37,21,16,109,92,17,0
2021,Dudley 011B,E01009879,953,563,306,257,38,38,156,95,61,195,185,10,1
2021,Dudley 009D,E01009880,567,466,227,239,1,1,12,8,4,88,79,9,0
2021,Dudley 009E,E01009882,566,433,258,175,0,0,28,20,8,105,91,14,0
2021,Dudley 013C,E01009883,664,389,193,196,1,1,214,209,5,55,48,7,5
2021,Dudley 013D,E01009884,626,257,172,85,8,8,258,163,95,103,67,36,0
2021,Dudley 011D,E01009885,669,346,237,109,1,1,178,143,35,139,127,12,5
2021,Dudley 013E,E01009886,1037,297,169,128,14,14,617,455,162,96,83,13,13
2021,Dudley 015A,E01009887,646,381,228,153,4,4,160,146,14,98,90,8,3
2021,Dudley 015B,E01009888,670,471,235,236,1,1,88,88,0,107,93,14,3
2021,Dudley 015C,E01009889,1183,389,186,203,2,2,192,66,126,600,561,39,0
2021,Dudley 015D,E01009890,670,315,140,175,3,3,264,224,40,77,69,8,11
2021,Dudley 010A,E01009891,645,321,145,176,0,0,218,212,6,100,91,9,6
2021,Dudley 010B,E01009892,643,199,117,82,1,1,229,209,20,203,188,15,11
2021,Dudley 010C,E01009893,651,226,89,137,1,1,324,294,30,94,87,7,6
2021,Dudley 010D,E01009894,697,430,224,206,2,2,168,122,46,97,90,7,0
2021,Dudley 002D,E01009895,624,393,242,151,2,2,162,92,70,64,52,12,3
2021,Dudley 003A,E01009896,598,507,315,192,1,1,51,50,1,37,28,9,2
2021,Dudley 003B,E01009897,602,563,376,187,0,0,6,6,0,32,24,8,1
2021,Dudley 003C,E01009898,672,537,362,175,1,1,78,77,1,55,46,9,1
2021,Dudley 008E,E01009899,619,569,377,192,1,1,13,9,4,33,25,8,3
2021,Dudley 008F,E01009900,638,582,414,168,0,0,6,3,3,48,35,13,2
2021,Dudley 003D,E01009901,633,530,351,179,9,9,62,17,45,32,26,6,0
2021,Dudley 003E,E01009902,521,469,325,144,0,0,22,17,5,30,22,8,0
2021,Dudley 029A,E01009903,620,567,372,195,2,2,5,4,1,46,36,10,0
2021,Dudley 029B,E01009904,613,522,306,216,0,0,24,18,6,67,53,14,0
2021,Dudley 035B,E01009905,664,465,253,212,1,1,72,69,3,125,106,19,1
2021,Dudley 035C,E01009906,903,373,190,183,4,4,352,346,6,170,153,17,4
2021,Dudley 035D,E01009907,671,482,278,204,0,0,45,40,5,144,130,14,0
2021,Dudley 035E,E01009908,690,561,300,261,1,1,26,20,6,101,87,14,1
2021,Dudley 029C,E01009909,677,500,289,211,2,2,112,105,7,61,49,12,2
2021,Dudley 029D,E01009910,715,361,201,160,1,1,269,246,23,74,57,17,10
2021,Dudley 021A,E01009911,605,513,342,171,6,6,16,11,5,70,63,7,0
2021,Dudley 021B,E01009912,888,719,349,370,0,0,40,7,33,129,116,13,0
2021,Dudley 021C,E01009913,651,466,276,190,1,1,110,97,13,67,59,8,7
2021,Dudley 021D,E01009914,590,546,385,161,0,0,9,7,2,35,28,7,0
2021,Dudley 021E,E01009915,737,581,287,294,3,3,22,17,5,131,119,12,0
2021,Dudley 021F,E01009916,755,500,248,252,2,2,95,92,3,157,141,16,1
2021,Dudley 024A,E01009917,495,448,268,180,1,1,11,10,1,35,31,4,0
2021,Dudley 024B,E01009918,605,321,177,144,0,0,225,148,77,57,52,5,2
2021,Dudley 024C,E01009919,500,470,323,147,0,0,1,1,0,29,25,4,0
2021,Dudley 024D,E01009920,730,579,291,288,1,1,24,8,16,126,107,19,0
2021,Sandwell 034A,E01009921,750,336,182,154,9,9,12,7,5,389,363,26,4
2021,Sandwell 034B,E01009922,503,295,137,158,0,0,121,118,3,84,77,7,3
2021,Sandwell 036A,E01009923,600,437,256,181,3,3,62,59,3,98,83,15,0
2021,Sandwell 034C,E01009924,631,454,216,238,2,2,11,9,2,163,151,12,1
2021,Sandwell 034D,E01009925,591,448,228,220,0,0,28,20,8,115,105,10,0
2021,Sandwell 034E,E01009926,617,386,169,217,1,1,42,34,8,187,173,14,1
2021,Sandwell 034F,E01009927,691,360,204,156,6,6,27,14,13,298,279,19,0
2021,Sandwell 034G,E01009928,753,280,123,157,2,2,167,160,7,302,284,18,2
2021,Sandwell 033A,E01009929,727,376,188,188,1,1,268,264,4,74,60,14,8
2021,Sandwell 033B,E01009930,643,367,166,201,2,2,194,181,13,80,69,11,0
2021,Sandwell 033C,E01009931,961,736,367,369,16,16,64,29,35,144,119,25,1
2021,Sandwell 033D,E01009932,793,290,153,137,6,6,324,149,175,170,146,24,3
2021,Sandwell 035A,E01009933,550,335,177,158,0,0,158,141,17,55,46,9,2
2021,Sandwell 027A,E01009934,592,285,138,147,2,2,221,165,56,75,70,5,9
2021,Sandwell 027B,E01009935,1043,382,159,223,4,4,559,518,41,90,75,15,8
2021,Sandwell 027C,E01009936,661,554,344,210,3,3,44,41,3,60,52,8,0
2021,Sandwell 032A,E01009937,614,332,136,196,1,1,205,201,4,72,64,8,4
2021,Sandwell 031A,E01009938,680,397,219,178,0,0,204,199,5,73,61,12,6
2021,Sandwell 032B,E01009939,679,496,270,226,1,1,75,70,5,107,92,15,0
2021,Sandwell 032C,E01009940,603,341,172,169,7,7,187,184,3,57,49,8,11
2021,Sandwell 032D,E01009941,614,419,240,179,0,0,107,98,9,85,68,17,3
2021,Sandwell 032E,E01009942,652,375,193,182,3,3,182,178,4,90,84,6,2
2021,Sandwell 031B,E01009943,492,286,146,140,1,1,147,144,3,55,41,14,3
2021,Sandwell 031C,E01009944,621,349,169,180,0,0,182,148,34,85,71,14,5
2021,Sandwell 039A,E01009946,686,521,301,220,0,0,44,24,20,121,100,21,0
2021,Sandwell 017A,E01009947,911,586,315,271,10,10,157,139,18,155,137,18,3
2021,Sandwell 039B,E01009948,607,495,315,180,0,0,48,45,3,64,54,10,0
2021,Sandwell 039C,E01009949,572,491,292,199,0,0,19,15,4,62,55,7,0
2021,Sandwell 039D,E01009950,656,482,280,202,0,0,97,93,4,72,53,19,5
2021,Sandwell 039E,E01009951,1060,250,158,92,12,12,500,463,37,288,281,7,10
2021,Sandwell 035B,E01009952,941,239,94,145,8,8,549,439,110,120,113,7,25
2021,Sandwell 038A,E01009953,975,443,208,235,3,3,271,183,88,252,240,12,6
2021,Sandwell 038B,E01009954,755,467,246,221,10,10,188,183,5,83,69,14,7
2021,Sandwell 035C,E01009955,887,411,206,205,7,7,193,178,15,268,248,20,8
2021,Sandwell 035D,E01009956,719,357,170,187,2,2,209,173,36,151,142,9,0
2021,Sandwell 038C,E01009957,696,251,111,140,5,5,324,291,33,111,104,7,5
2021,Sandwell 038D,E01009958,662,551,308,243,1,1,30,26,4,79,72,7,1
2021,Sandwell 035E,E01009959,608,548,330,218,2,2,12,10,2,46,42,4,0
2021,Sandwell 003A,E01009960,628,315,157,158,0,0,252,246,6,56,48,8,5
2021,Sandwell 003B,E01009961,533,458,256,202,3,3,25,22,3,47,37,10,0
2021,Sandwell 004A,E01009962,512,211,114,97,0,0,253,251,2,43,39,4,5
2021,Sandwell 004B,E01009963,500,215,109,106,3,3,221,221,0,55,49,6,6
2021,Sandwell 004C,E01009964,584,226,112,114,1,1,301,297,4,51,48,3,5
2021,Sandwell 004D,E01009965,453,183,83,100,1,1,228,225,3,37,34,3,4
2021,Sandwell 003C,E01009966,463,238,138,100,2,2,173,172,1,49,43,6,1
2021,Sandwell 003D,E01009967,770,501,253,248,3,3,160,157,3,100,88,12,6
2021,Sandwell 006A,E01009968,634,488,307,181,0,0,45,18,27,101,93,8,0
2021,Sandwell 002A,E01009969,800,324,129,195,2,2,286,185,101,187,173,14,1
2021,Sandwell 002B,E01009970,692,438,202,236,9,9,165,143,22,77,72,5,3
2021,Sandwell 002C,E01009971,680,313,133,180,8,8,274,178,96,84,71,13,1
2021,Sandwell 006B,E01009972,745,615,337,278,2,2,30,26,4,98,85,13,0
2021,Sandwell 002D,E01009973,766,565,270,295,3,3,53,46,7,143,129,14,2
2021,Sandwell 006C,E01009974,668,534,311,223,1,1,13,9,4,119,103,16,1
2021,Sandwell 006D,E01009975,673,569,327,242,1,1,37,33,4,65,57,8,1
2021,Sandwell 016A,E01009976,1052,708,274,434,3,3,49,44,5,291,282,9,1
2021,Sandwell 016B,E01009977,794,418,137,281,8,8,163,147,16,201,179,22,4
2021,Sandwell 014A,E01009978,647,401,214,187,2,2,165,163,2,74,67,7,5
2021,Sandwell 016C,E01009979,848,189,95,94,0,0,574,506,68,79,75,4,6
2021,Sandwell 016D,E01009980,858,453,178,275,3,3,195,181,14,205,186,19,2
2021,Sandwell 018A,E01009981,764,390,222,168,0,0,244,225,19,128,118,10,2
2021,Sandwell 009A,E01009982,551,266,139,127,2,2,199,175,24,80,68,12,4
2021,Sandwell 009B,E01009983,601,286,151,135,0,0,262,248,14,49,40,9,4
2021,Sandwell 018C,E01009985,666,289,154,135,17,17,261,221,40,94,81,13,5
2021,Sandwell 019A,E01009986,540,249,161,88,1,1,104,80,24,186,157,29,0
2021,Sandwell 019B,E01009987,593,156,66,90,17,17,296,205,91,118,105,13,6
2021,Sandwell 020A,E01009988,1060,441,142,299,3,3,484,247,237,130,105,25,2
2021,Sandwell 019C,E01009989,654,345,187,158,11,11,131,103,28,161,137,24,6
2021,Sandwell 010A,E01009991,843,371,179,192,3,3,310,155,155,155,139,16,4
2021,Sandwell 017B,E01009992,616,364,197,167,1,1,114,106,8,137,118,19,0
2021,Sandwell 017C,E01009993,729,290,138,152,2,2,328,322,6,104,97,7,5
2021,Sandwell 010B,E01009994,644,320,162,158,0,0,205,188,17,114,98,16,5
2021,Sandwell 010C,E01009995,630,397,213,184,1,1,122,98,24,110,102,8,0
2021,Sandwell 010D,E01009996,652,249,133,116,0,0,316,310,6,80,68,12,7
2021,Sandwell 010E,E01009997,659,319,137,182,1,1,196,175,21,138,123,15,5
2021,Sandwell 010F,E01009998,806,382,167,215,1,1,300,206,94,119,110,9,4
2021,Sandwell 033E,E01009999,559,378,203,175,0,0,84,69,15,97,88,9,0
2021,Sandwell 030A,E01010000,750,503,256,247,2,2,156,141,15,87,73,14,2
2021,Sandwell 037A,E01010001,767,468,204,264,0,0,207,198,9,86,80,6,6
2021,Sandwell 030B,E01010002,867,606,264,342,2,2,21,11,10,235,217,18,3
2021,Sandwell 030C,E01010003,703,246,119,127,9,9,314,247,67,129,117,12,5
2021,Sandwell 027D,E01010004,872,369,181,188,9,9,222,214,8,264,243,21,8
2021,Sandwell 030D,E01010005,609,389,225,164,1,1,69,38,31,148,127,21,2
2021,Sandwell 030E,E01010006,675,496,287,209,2,2,36,20,16,140,122,18,1
2021,Sandwell 012A,E01010007,544,337,193,144,2,2,102,78,24,102,94,8,1
2021,Sandwell 011A,E01010008,623,462,249,213,0,0,78,52,26,82,74,8,1
2021,Sandwell 012B,E01010009,552,376,176,200,0,0,106,99,7,68,62,6,2
2021,Sandwell 011B,E01010010,625,252,142,110,0,0,294,268,26,75,70,5,4
2021,Sandwell 011C,E01010011,716,531,314,217,0,0,9,7,2,176,161,15,0
2021,Sandwell 011D,E01010012,573,498,275,223,0,0,11,11,0,64,54,10,0
2021,Sandwell 012C,E01010013,522,446,277,169,0,0,10,8,2,66,59,7,0
2021,Sandwell 012D,E01010014,695,550,310,240,1,1,30,30,0,113,102,11,1
2021,Sandwell 021A,E01010015,715,542,279,263,0,0,38,30,8,135,119,16,0
2021,Sandwell 021B,E01010016,615,346,171,175,3,3,74,67,7,192,180,12,0
2021,Sandwell 024A,E01010017,873,265,146,119,0,0,287,184,103,312,282,30,9
2021,Sandwell 021C,E01010018,1004,555,183,372,4,4,182,112,70,263,246,17,0
2021,Sandwell 024B,E01010019,668,341,185,156,3,3,70,45,25,252,224,28,2
2021,Sandwell 024C,E01010020,701,449,213,236,2,2,142,138,4,105,91,14,3
2021,Sandwell 024D,E01010021,679,354,183,171,0,0,148,79,69,175,153,22,2
2021,Sandwell 037B,E01010022,622,527,277,250,1,1,26,23,3,67,56,11,1
2021,Sandwell 037C,E01010023,791,556,310,246,4,4,69,62,7,160,144,16,2
2021,Sandwell 036B,E01010024,659,543,342,201,0,0,24,6,18,92,80,12,0
2021,Sandwell 037D,E01010025,705,358,158,200,5,5,230,183,47,105,81,24,7
2021,Sandwell 036C,E01010026,716,521,287,234,2,2,131,106,25,62,56,6,0
2021,Sandwell 036D,E01010027,612,502,275,227,2,2,26,23,3,80,72,8,2
2021,Sandwell 037E,E01010028,650,298,121,177,42,42,223,202,21,83,72,11,4
2021,Sandwell 009C,E01010029,593,157,84,73,1,1,344,302,42,86,83,3,5
2021,Sandwell 007A,E01010030,718,228,127,101,2,2,385,365,20,95,88,7,8
2021,Sandwell 014B,E01010031,722,236,138,98,3,3,415,405,10,60,56,4,8
2021,Sandwell 014C,E01010032,518,118,49,69,2,2,371,345,26,24,21,3,3
2021,Sandwell 014D,E01010033,776,236,142,94,1,1,414,376,38,120,108,12,5
2021,Sandwell 007B,E01010034,500,435,234,201,8,8,6,2,4,51,42,9,0
2021,Sandwell 007C,E01010035,598,512,351,161,1,1,22,18,4,63,57,6,0
2021,Sandwell 007D,E01010036,691,312,125,187,2,2,261,131,130,112,102,10,4
2021,Sandwell 009D,E01010037,493,206,83,123,1,1,243,105,138,43,35,8,0
2021,Sandwell 029A,E01010038,708,402,176,226,6,6,202,184,18,96,86,10,2
2021,Sandwell 025A,E01010039,772,335,122,213,2,2,247,204,43,175,167,8,13
2021,Sandwell 029B,E01010040,596,416,244,172,2,2,126,78,48,50,45,5,2
2021,Sandwell 029C,E01010041,789,323,188,135,0,0,368,362,6,91,87,4,7
2021,Sandwell 035F,E01010042,811,468,267,201,12,12,193,89,104,137,130,7,1
2021,Sandwell 025B,E01010043,593,501,313,188,0,0,49,46,3,43,37,6,0
2021,Sandwell 025C,E01010044,623,351,175,176,4,4,184,160,24,79,71,8,5
2021,Sandwell 029D,E01010045,640,368,185,183,1,1,190,184,6,78,72,6,3
2021,Sandwell 023A,E01010046,811,349,109,240,7,7,217,93,124,234,217,17,4
2021,Sandwell 023B,E01010047,588,319,162,157,5,5,73,37,36,175,143,32,16
2021,Sandwell 023C,E01010048,521,250,154,96,7,7,12,2,10,252,218,34,0
2021,Sandwell 023D,E01010049,564,251,156,95,0,0,88,52,36,219,182,37,6
2021,Sandwell 023E,E01010050,515,335,192,143,2,2,38,21,17,137,121,16,3
2021,Sandwell 031D,E01010051,495,268,149,119,0,0,131,127,4,92,82,10,4
2021,Sandwell 023F,E01010052,477,252,126,126,1,1,120,75,45,98,88,10,6
2021,Sandwell 023G,E01010053,669,318,138,180,0,0,225,161,64,117,91,26,9
2021,Sandwell 028A,E01010054,912,212,122,90,3,3,488,216,272,197,177,20,12
2021,Sandwell 028B,E01010055,631,299,147,152,1,1,34,21,13,293,269,24,4
2021,Sandwell 028C,E01010056,657,293,153,140,11,11,258,240,18,87,70,17,8
2021,Sandwell 028D,E01010057,694,324,197,127,3,3,151,73,78,210,183,27,6
2021,Sandwell 031E,E01010058,649,295,152,143,9,9,257,234,23,77,68,9,11
2021,Sandwell 041D,E01010059,705,272,126,146,5,5,141,28,113,285,252,33,2
2021,Sandwell 028E,E01010060,699,254,168,86,9,9,171,105,66,261,241,20,4
2021,Sandwell 041B,E01010061,540,271,145,126,2,2,52,19,33,211,192,19,4
2021,Sandwell 040A,E01010062,851,280,121,159,4,4,404,247,157,143,127,16,20
2021,Sandwell 040D,E01010064,802,294,134,160,8,8,176,39,137,320,291,29,4
2021,Sandwell 015A,E01010066,695,278,150,128,0,0,320,275,45,74,66,8,23
2021,Sandwell 015B,E01010067,706,255,131,124,3,3,195,134,61,247,227,20,6
2021,Sandwell 015C,E01010068,697,347,177,170,12,12,209,180,29,124,115,9,5
2021,Sandwell 016E,E01010069,729,535,216,319,0,0,80,76,4,113,97,16,1
2021,Sandwell 015D,E01010070,826,438,223,215,6,6,247,107,140,135,116,19,0
2021,Sandwell 016F,E01010071,682,281,151,130,3,3,282,237,45,113,104,9,3
2021,Sandwell 021D,E01010072,972,461,154,307,6,6,202,122,80,301,290,11,2
2021,Sandwell 021E,E01010073,630,337,183,154,1,1,146,63,83,145,138,7,1
2021,Sandwell 015E,E01010075,490,355,139,216,24,24,22,8,14,89,80,9,0
2021,Sandwell 015F,E01010076,861,396,162,234,3,3,371,270,101,85,71,14,6
2021,Sandwell 022A,E01010077,671,314,158,156,0,0,279,276,3,69,59,10,9
2021,Sandwell 025D,E01010078,522,475,319,156,5,5,11,11,0,31,26,5,0
2021,Sandwell 022B,E01010079,613,495,270,225,0,0,47,43,4,71,56,15,0
2021,Sandwell 022C,E01010080,768,275,132,143,3,3,303,262,41,181,173,8,6
2021,Sandwell 022D,E01010081,663,516,304,212,1,1,49,41,8,96,80,16,1
2021,Sandwell 022E,E01010082,854,658,270,388,1,1,69,66,3,126,119,7,0
2021,Sandwell 022F,E01010083,688,382,180,202,3,3,205,204,1,93,75,18,5
2021,Sandwell 022G,E01010084,553,240,116,124,3,3,226,222,4,81,73,8,3
2021,Sandwell 001A,E01010085,664,435,232,203,0,0,77,62,15,152,144,8,0
2021,Sandwell 001B,E01010086,675,310,148,162,0,0,247,210,37,111,97,14,7
2021,Sandwell 001C,E01010087,621,380,192,188,1,1,164,156,8,75,66,9,1
2021,Sandwell 001D,E01010088,562,341,163,178,0,0,155,148,7,64,58,6,2
2021,Sandwell 001E,E01010089,696,392,203,189,0,0,230,210,20,70,61,9,4
2021,Sandwell 005A,E01010090,818,285,144,141,5,5,281,234,47,242,230,12,5
2021,Sandwell 005B,E01010091,688,358,206,152,4,4,204,75,129,120,107,13,2
2021,Sandwell 003E,E01010092,796,416,216,200,4,4,262,190,72,109,94,15,5
2021,Sandwell 013A,E01010093,712,308,87,221,4,4,298,175,123,98,87,11,4
2021,Sandwell 013B,E01010094,570,333,189,144,1,1,123,35,88,111,98,13,2
2021,Sandwell 013C,E01010095,689,280,107,173,17,17,282,149,133,109,87,22,1
2021,Sandwell 005C,E01010096,796,366,214,152,2,2,288,273,15,130,117,13,10
2021,Sandwell 005D,E01010097,784,589,385,204,4,4,121,99,22,69,60,9,1
2021,Sandwell 013D,E01010098,813,305,141,164,1,1,381,271,110,119,74,45,7
2021,Sandwell 013E,E01010099,669,433,222,211,0,0,137,107,30,99,81,18,0
2021,Sandwell 013F,E01010100,724,448,256,192,12,12,72,41,31,189,171,18,3
2021,Sandwell 020B,E01010101,926,239,139,100,8,8,537,408,129,91,82,9,51
2021,Sandwell 020C,E01010102,708,296,172,124,3,3,205,174,31,203,177,26,1
2021,Sandwell 017D,E01010103,961,335,176,159,1,1,413,268,145,207,178,29,5
2021,Sandwell 017E,E01010104,817,334,201,133,2,2,304,285,19,172,161,11,5
2021,Sandwell 017F,E01010105,539,315,185,130,1,1,94,8,86,129,121,8,0
2021,Sandwell 019D,E01010106,635,252,153,99,6,6,118,44,74,255,232,23,4
2021,Sandwell 020D,E01010107,801,238,147,91,6,6,318,27,291,238,213,25,1
2021,Solihull 017A,E01010108,916,751,363,388,5,5,68,33,35,92,79,13,0
2021,Solihull 009A,E01010109,653,529,277,252,15,15,33,2,31,75,71,4,1
2021,Solihull 009B,E01010110,578,458,239,219,1,1,64,20,44,54,51,3,1
2021,Solihull 008A,E01010111,635,235,117,118,4,4,274,236,38,120,109,11,2
2021,Solihull 009C,E01010112,686,396,187,209,12,12,137,55,82,138,124,14,3
2021,Solihull 009D,E01010113,554,342,188,154,9,9,116,107,9,85,79,6,2
2021,Solihull 009E,E01010114,779,607,324,283,12,12,67,7,60,93,80,13,0
2021,Solihull 015A,E01010115,673,461,236,225,0,0,112,107,5,99,83,16,1
2021,Solihull 015B,E01010116,519,490,302,188,0,0,1,1,0,28,23,5,0
2021,Solihull 003A,E01010117,568,502,288,214,28,28,8,4,4,30,24,6,0
2021,Solihull 001A,E01010118,504,384,225,159,3,3,103,52,51,14,13,1,0
2021,Solihull 003B,E01010119,601,550,290,260,0,0,4,3,1,47,39,8,0
2021,Solihull 001B,E01010120,647,301,178,123,13,13,268,27,241,65,55,10,0
2021,Solihull 001C,E01010121,604,529,305,224,0,0,9,6,3,66,57,9,0
2021,Solihull 001D,E01010122,604,529,341,188,1,1,5,3,2,69,56,13,0
2021,Solihull 003C,E01010123,630,558,325,233,2,2,23,7,16,47,43,4,0
2021,Solihull 003D,E01010124,620,561,295,266,1,1,8,8,0,50,44,6,0
2021,Solihull 006A,E01010125,841,300,112,188,1,1,434,335,99,102,93,9,4
2021,Solihull 008B,E01010126,636,237,130,107,1,1,315,291,24,80,75,5,3
2021,Solihull 008C,E01010127,747,422,196,226,17,17,222,132,90,86,76,10,0
2021,Solihull 008D,E01010128,655,346,194,152,1,1,200,124,76,106,95,11,2
2021,Solihull 006B,E01010129,746,279,124,155,0,0,383,298,85,83,73,10,1
2021,Solihull 008E,E01010130,776,245,127,118,3,3,423,338,85,105,99,6,0
2021,Solihull 008F,E01010131,687,270,131,139,3,3,300,282,18,113,107,6,1
2021,Solihull 011A,E01010132,626,443,221,222,4,4,67,35,32,112,98,14,0
2021,Solihull 011B,E01010133,685,544,324,220,4,4,14,9,5,122,105,17,1
2021,Solihull 011C,E01010134,580,512,257,255,1,1,2,0,2,65,57,8,0
2021,Solihull 011D,E01010135,652,462,249,213,1,1,106,88,18,83,72,11,0
2021,Solihull 012A,E01010136,513,434,169,265,1,1,19,3,16,59,54,5,0
2021,Solihull 012B,E01010137,642,305,159,146,2,2,243,225,18,91,79,12,1
2021,Solihull 011E,E01010138,587,508,262,246,1,1,8,5,3,70,58,12,0
2021,Solihull 006C,E01010139,432,288,163,125,0,0,100,75,25,44,39,5,0
2021,Solihull 007A,E01010140,607,243,127,116,0,0,267,244,23,94,84,10,3
2021,Solihull 006D,E01010141,630,141,63,78,9,9,436,336,100,42,39,3,2
2021,Solihull 007B,E01010142,635,197,110,87,1,1,344,311,33,93,84,9,0
2021,Solihull 007C,E01010143,703,280,132,148,1,1,322,299,23,97,87,10,3
2021,Solihull 007D,E01010144,737,466,205,261,7,7,154,116,38,109,96,13,1
2021,Solihull 005A,E01010145,677,511,258,253,3,3,94,67,27,69,58,11,0
2021,Solihull 004A,E01010146,627,316,157,159,3,3,227,198,29,81,72,9,0
2021,Solihull 005B,E01010147,650,204,85,119,12,12,342,301,41,88,81,7,4
2021,Solihull 005C,E01010148,701,260,109,151,2,2,319,263,56,120,113,7,0
2021,Solihull 005D,E01010149,627,515,275,240,2,2,60,45,15,50,42,8,0
2021,Solihull 028A,E01010150,659,579,349,230,0,0,35,5,30,45,36,9,0
2021,Solihull 026A,E01010151,789,481,283,198,1,1,121,60,61,183,167,16,3
2021,Solihull 026B,E01010152,495,481,274,207,1,1,2,1,1,11,10,1,0
2021,Solihull 026C,E01010153,729,626,377,249,16,16,34,10,24,53,44,9,0
2021,Solihull 026D,E01010154,672,590,391,199,0,0,20,18,2,62,49,13,0
2021,Solihull 026E,E01010155,775,650,393,257,10,10,37,15,22,77,66,11,1
2021,Solihull 026F,E01010156,620,581,371,210,1,1,3,2,1,35,32,3,0
2021,Solihull 010A,E01010157,594,491,188,303,2,2,10,3,7,91,85,6,0
2021,Solihull 012C,E01010158,637,336,183,153,2,2,189,171,18,109,93,16,1
2021,Solihull 010B,E01010159,540,438,215,223,1,1,31,27,4,70,64,6,0
2021,Solihull 012D,E01010160,631,455,257,198,3,3,110,92,18,62,60,2,1
2021,Solihull 012E,E01010161,617,525,274,251,8,8,18,15,3,66,56,10,0
2021,Solihull 010C,E01010162,622,547,310,237,3,3,4,3,1,68,60,8,0
2021,Solihull 010D,E01010163,565,465,220,245,7,7,23,15,8,70,62,8,0
2021,Solihull 017B,E01010164,725,599,368,231,7,7,48,27,21,71,54,17,0
2021,Solihull 017C,E01010165,832,551,322,229,9,9,178,83,95,91,75,16,3
2021,Solihull 025A,E01010166,728,624,325,299,10,10,41,15,26,53,45,8,0
2021,Solihull 017D,E01010167,644,490,270,220,2,2,69,60,9,80,60,20,3
2021,Solihull 025B,E01010168,791,624,340,284,5,5,36,3,33,126,114,12,0
2021,Solihull 025C,E01010169,710,589,360,229,0,0,7,2,5,113,98,15,1
2021,Solihull 025D,E01010170,559,528,312,216,0,0,1,1,0,30,24,6,0
2021,Solihull 025E,E01010171,549,445,251,194,1,1,55,53,2,46,40,6,2
2021,Solihull 014A,E01010172,579,542,302,240,0,0,4,1,3,33,30,3,0
2021,Solihull 014B,E01010173,544,506,291,215,0,0,1,1,0,37,31,6,0
2021,Solihull 013A,E01010174,686,526,271,255,2,2,15,9,6,143,133,10,0
2021,Solihull 013B,E01010175,712,562,328,234,3,3,28,6,22,119,107,12,0
2021,Solihull 014C,E01010176,487,457,243,214,0,0,2,2,0,28,20,8,0
2021,Solihull 013C,E01010177,575,405,211,194,0,0,70,52,18,99,86,13,1
2021,Solihull 013D,E01010178,975,432,216,216,16,16,308,198,110,216,202,14,3
2021,Solihull 014D,E01010179,785,626,437,189,3,3,20,16,4,135,119,16,1
2021,Solihull 029A,E01010180,634,530,275,255,11,11,40,7,33,53,46,7,0
2021,Solihull 029B,E01010181,1052,801,330,471,44,44,89,13,76,118,106,12,0
2021,Solihull 029D,E01010183,743,618,288,330,25,25,47,10,37,53,42,11,0
2021,Solihull 028B,E01010184,696,489,277,212,9,9,112,90,22,85,79,6,1
2021,Solihull 028C,E01010185,621,567,343,224,0,0,24,4,20,30,26,4,0
2021,Solihull 028D,E01010186,784,641,362,279,2,2,15,9,6,126,109,17,0
2021,Solihull 028E,E01010187,517,482,245,237,0,0,5,3,2,30,25,5,0
2021,Solihull 028F,E01010188,704,645,408,237,0,0,8,4,4,51,45,6,0
2021,Solihull 029E,E01010189,669,569,307,262,19,19,23,22,1,56,39,17,2
2021,Solihull 024A,E01010190,668,559,338,221,2,2,7,2,5,100,91,9,0
2021,Solihull 022A,E01010191,804,646,374,272,0,0,44,6,38,114,103,11,0
2021,Solihull 019A,E01010192,813,538,318,220,1,1,11,6,5,262,251,11,1
2021,Solihull 024B,E01010193,469,448,270,178,1,1,3,1,2,17,16,1,0
2021,Solihull 024C,E01010194,650,563,329,234,0,0,1,0,1,86,83,3,0
2021,Solihull 016A,E01010195,581,544,317,227,0,0,10,0,10,27,20,7,0
2021,Solihull 019B,E01010196,619,592,343,249,1,1,4,4,0,22,20,2,0
2021,Solihull 019C,E01010197,638,606,384,222,0,0,4,3,1,28,27,1,0
2021,Solihull 019D,E01010198,736,546,353,193,10,10,67,7,60,113,104,9,0
2021,Solihull 018A,E01010199,684,616,311,305,3,3,8,5,3,57,44,13,0
2021,Solihull 018B,E01010200,651,429,258,171,4,4,135,124,11,82,73,9,1
2021,Solihull 018C,E01010201,722,629,385,244,0,0,19,7,12,74,66,8,0
2021,Solihull 022B,E01010202,605,538,290,248,1,1,8,6,2,58,47,11,0
2021,Solihull 022C,E01010203,733,541,281,260,11,11,38,12,26,142,129,13,1
2021,Solihull 018D,E01010204,664,297,148,149,8,8,249,143,106,108,100,8,2
2021,Solihull 018E,E01010205,542,473,270,203,0,0,3,2,1,66,61,5,0
2021,Solihull 018F,E01010206,641,568,270,298,1,1,7,1,6,65,61,4,0
2021,Solihull 024D,E01010207,588,517,325,192,1,1,9,1,8,61,52,9,0
2021,Solihull 023A,E01010208,622,569,324,245,0,0,9,4,5,44,34,10,0
2021,Solihull 022D,E01010209,679,524,269,255,1,1,34,32,2,120,107,13,0
2021,Solihull 023B,E01010210,632,593,377,216,0,0,2,1,1,37,32,5,0
2021,Solihull 023C,E01010211,656,418,245,173,1,1,191,180,11,43,31,12,3
2021,Solihull 027A,E01010212,480,445,261,184,0,0,2,2,0,33,31,2,0
2021,Solihull 022E,E01010213,708,464,215,249,4,4,157,113,44,82,71,11,1
2021,Solihull 027B,E01010214,505,447,269,178,2,2,14,14,0,42,38,4,0
2021,Solihull 027C,E01010215,657,509,290,219,16,16,28,25,3,101,91,10,3
2021,Solihull 027D,E01010216,611,506,254,252,5,5,6,1,5,93,86,7,1
2021,Solihull 023D,E01010217,629,564,306,258,2,2,3,3,0,60,52,8,0
2021,Solihull 021A,E01010218,650,389,218,171,0,0,174,136,38,85,73,12,2
2021,Solihull 021B,E01010219,677,553,299,254,3,3,26,24,2,95,86,9,0
2021,Solihull 030A,E01010220,663,573,278,295,1,1,4,2,2,85,74,11,0
2021,Solihull 021C,E01010221,911,624,313,311,38,38,129,15,114,120,105,15,0
2021,Solihull 021D,E01010222,628,504,290,214,0,0,36,2,34,88,79,9,0
2021,Solihull 030B,E01010223,474,345,151,194,1,1,71,64,7,55,50,5,2
2021,Solihull 030C,E01010225,576,512,231,281,1,1,5,3,2,58,50,8,0
2021,Solihull 016B,E01010226,918,590,434,156,7,7,77,51,26,242,219,23,2
2021,Solihull 015C,E01010227,774,662,385,277,3,3,12,2,10,97,85,12,0
2021,Solihull 015D,E01010228,656,513,287,226,4,4,23,22,1,115,106,9,1
2021,Solihull 016C,E01010229,562,524,299,225,1,1,4,3,1,33,32,1,0
2021,Solihull 016D,E01010230,753,461,269,192,26,26,126,81,45,140,133,7,0
2021,Solihull 016E,E01010231,644,592,353,239,3,3,1,1,0,48,45,3,0
2021,Solihull 015E,E01010232,1009,513,257,256,19,19,143,87,56,333,313,20,1
2021,Solihull 016F,E01010233,810,484,227,257,7,7,141,127,14,176,162,14,2
2021,Solihull 004B,E01010234,741,318,137,181,0,0,366,203,163,55,45,10,2
2021,Solihull 002A,E01010235,561,268,151,117,0,0,220,170,50,71,63,8,2
2021,Solihull 002B,E01010236,576,194,104,90,9,9,294,210,84,77,65,12,2
2021,Solihull 004C,E01010237,761,508,274,234,14,14,170,123,47,69,59,10,0
2021,Solihull 004D,E01010238,628,237,106,131,0,0,322,267,55,64,56,8,5
2021,Solihull 002C,E01010239,622,356,171,185,0,0,188,164,24,75,66,9,3
2021,Solihull 002D,E01010240,556,264,120,144,1,1,189,167,22,98,90,8,4
2021,Walsall 015A,E01010241,1112,821,525,296,0,0,78,13,65,213,193,20,0
2021,Walsall 015B,E01010242,782,399,207,192,10,10,291,101,190,82,64,18,0
2021,Walsall 015C,E01010243,691,567,375,192,2,2,65,32,33,57,42,15,0
2021,Walsall 015D,E01010244,606,300,141,159,0,0,231,104,127,74,67,7,1
2021,Walsall 022A,E01010245,680,595,359,236,1,1,34,13,21,50,38,12,0
2021,Walsall 022B,E01010246,632,558,295,263,0,0,22,4,18,52,42,10,0
2021,Walsall 022C,E01010247,680,527,323,204,0,0,85,28,57,68,60,8,0
2021,Walsall 022D,E01010248,633,591,328,263,1,1,10,4,6,31,18,13,0
2021,Walsall 004A,E01010249,764,437,221,216,6,6,151,56,95,166,148,18,4
2021,Walsall 004B,E01010250,574,453,254,199,3,3,59,17,42,58,45,13,1
2021,Walsall 007A,E01010251,565,511,258,253,2,2,10,3,7,42,30,12,0
2021,Walsall 004C,E01010252,737,457,225,232,8,8,171,67,104,96,81,15,5
2021,Walsall 007B,E01010253,524,303,165,138,1,1,171,87,84,48,34,14,1
2021,Walsall 004D,E01010254,617,373,191,182,16,16,150,71,79,77,66,11,1
2021,Walsall 007C,E01010255,617,544,384,160,1,1,19,5,14,53,41,12,0
2021,Walsall 007D,E01010256,707,498,264,234,0,0,110,46,64,99,84,15,0
2021,Walsall 007E,E01010257,497,458,291,167,0,0,6,2,4,33,29,4,0
2021,Walsall 023A,E01010258,731,268,129,139,0,0,392,185,207,69,62,7,2
2021,Walsall 023B,E01010259,626,450,274,176,1,1,97,51,46,78,64,14,0
2021,Walsall 023C,E01010260,714,381,215,166,0,0,247,108,139,84,74,10,2
2021,Walsall 033A,E01010261,728,303,142,161,1,1,290,67,223,134,124,10,0
2021,Walsall 036A,E01010262,684,365,192,173,3,3,155,77,78,160,149,11,1
2021,Walsall 033B,E01010263,534,311,196,115,0,0,87,23,64,135,118,17,1
2021,Walsall 033C,E01010264,762,340,172,168,22,22,281,75,206,116,104,12,3
2021,Walsall 033D,E01010265,696,253,133,120,2,2,280,82,198,160,136,24,1
2021,Walsall 023D,E01010266,503,236,123,113,1,1,203,92,111,63,57,6,0
2021,Walsall 021A,E01010267,686,439,216,223,8,8,120,7,113,119,110,9,0
2021,Walsall 021B,E01010268,568,289,154,135,4,4,93,25,68,180,162,18,2
2021,Walsall 026A,E01010269,541,245,137,108,1,1,91,25,66,204,182,22,0
2021,Walsall 026B,E01010270,649,359,206,153,1,1,155,52,103,132,118,14,2
2021,Walsall 017A,E01010271,793,273,125,148,1,1,405,75,330,114,102,12,0
2021,Walsall 017B,E01010272,695,178,100,78,0,0,382,99,283,134,127,7,1
2021,Walsall 017C,E01010273,602,195,122,73,0,0,328,49,279,79,72,7,0
2021,Walsall 021C,E01010274,593,211,114,97,0,0,290,28,262,92,87,5,0
2021,Walsall 021D,E01010275,739,232,120,112,0,0,412,43,369,92,84,8,3
2021,Walsall 013B,E01010277,657,354,173,181,6,6,170,79,91,126,111,15,1
2021,Walsall 018B,E01010279,788,345,157,188,5,5,306,116,190,129,116,13,3
2021,Walsall 012A,E01010282,505,236,103,133,8,8,137,34,103,124,114,10,0
2021,Walsall 013D,E01010283,674,264,118,146,1,1,252,131,121,156,148,8,1
2021,Walsall 006A,E01010284,684,361,196,165,1,1,249,102,147,73,67,6,0
2021,Walsall 006B,E01010285,746,593,349,244,0,0,71,37,34,82,67,15,0
2021,Walsall 006C,E01010286,635,275,158,117,0,0,297,153,144,61,55,6,2
2021,Walsall 012B,E01010287,717,375,181,194,1,1,185,56,129,155,139,16,1
2021,Walsall 012C,E01010288,625,289,145,144,1,1,240,114,126,95,85,10,0
2021,Walsall 012D,E01010289,715,241,118,123,0,0,398,194,204,75,62,13,1
2021,Walsall 006D,E01010290,771,427,261,166,7,7,261,96,165,75,69,6,1
2021,Walsall 009A,E01010291,545,250,127,123,3,3,208,102,106,84,72,12,0
2021,Walsall 008A,E01010292,931,358,182,176,1,1,414,96,318,157,113,44,1
2021,Walsall 009B,E01010293,777,368,227,141,1,1,335,117,218,70,58,12,3
2021,Walsall 008B,E01010294,649,267,144,123,0,0,291,143,148,86,74,12,5
2021,Walsall 017D,E01010295,638,278,153,125,0,0,240,108,132,119,109,10,1
2021,Walsall 008C,E01010296,621,520,289,231,2,2,10,3,7,89,80,9,0
2021,Walsall 008D,E01010297,578,549,382,167,0,0,11,5,6,18,10,8,0
2021,Walsall 009C,E01010298,489,321,173,148,2,2,85,43,42,81,71,10,0
2021,Walsall 009D,E01010299,593,295,132,163,3,3,193,116,77,102,98,4,0
2021,Walsall 009E,E01010300,621,264,154,110,5,5,246,114,132,105,94,11,1
2021,Walsall 001A,E01010301,616,278,160,118,8,8,269,100,169,60,49,11,1
2021,Walsall 002A,E01010302,632,396,234,162,0,0,168,78,90,66,57,9,2
2021,Walsall 001B,E01010303,631,446,259,187,4,4,100,28,72,81,73,8,0
2021,Walsall 002B,E01010304,734,548,339,209,0,0,112,32,80,74,59,15,0
2021,Walsall 002C,E01010305,518,324,180,144,0,0,147,41,106,46,36,10,1
2021,Walsall 001C,E01010306,903,625,261,364,35,35,88,34,54,154,129,25,1
2021,Walsall 001D,E01010307,680,566,226,340,2,2,55,30,25,57,50,7,0
2021,Walsall 002D,E01010308,877,284,127,157,16,16,510,170,340,63,55,8,4
2021,Walsall 036B,E01010309,886,350,173,177,4,4,264,61,203,266,255,11,2
2021,Walsall 038A,E01010310,765,414,192,222,8,8,174,75,99,169,160,9,0
2021,Walsall 036C,E01010311,1070,490,184,306,4,4,436,73,363,138,125,13,2
2021,Walsall 038B,E01010312,699,290,132,158,7,7,242,97,145,159,144,15,1
2021,Walsall 038C,E01010313,541,263,148,115,1,1,203,87,116,73,60,13,1
2021,Walsall 038D,E01010314,694,277,160,117,0,0,338,131,207,74,67,7,5
2021,Walsall 038E,E01010315,781,396,150,246,0,0,298,148,150,85,75,10,2
2021,Walsall 036D,E01010316,624,200,97,103,0,0,321,171,150,101,83,18,2
2021,Walsall 024A,E01010317,679,602,382,220,0,0,7,1,6,70,57,13,0
2021,Walsall 024B,E01010318,782,237,139,98,21,21,384,71,313,139,130,9,1
2021,Walsall 010A,E01010319,479,428,225,203,0,0,9,4,5,42,31,11,0
2021,Walsall 016A,E01010320,588,330,185,145,7,7,175,67,108,76,60,16,0
2021,Walsall 010B,E01010321,634,378,189,189,21,21,140,57,83,93,79,14,2
2021,Walsall 016B,E01010322,709,438,191,247,7,7,149,55,94,110,101,9,5
2021,Walsall 016C,E01010323,620,426,233,193,1,1,139,65,74,52,43,9,2
2021,Walsall 016D,E01010324,832,532,211,321,9,9,154,28,126,137,114,23,0
2021,Walsall 024C,E01010325,774,550,287,263,4,4,59,2,57,161,142,19,0
2021,Walsall 029A,E01010326,558,486,281,205,0,0,14,5,9,58,45,13,0
2021,Walsall 029B,E01010327,581,318,160,158,1,1,44,7,37,218,200,18,0
2021,Walsall 029C,E01010328,507,470,259,211,1,1,4,0,4,32,21,11,0
2021,Walsall 039A,E01010329,654,596,352,244,0,0,6,1,5,52,43,9,0
2021,Walsall 029D,E01010330,615,347,187,160,4,4,55,6,49,209,194,15,0
2021,Walsall 035A,E01010331,624,570,351,219,1,1,5,1,4,48,31,17,0
2021,Walsall 035B,E01010332,651,574,341,233,2,2,7,2,5,68,56,12,0
2021,Walsall 035C,E01010333,627,509,303,206,2,2,57,4,53,59,45,14,0
2021,Walsall 035D,E01010334,571,538,321,217,0,0,5,3,2,28,26,2,0
2021,Walsall 037A,E01010335,597,274,134,140,6,6,210,58,152,106,97,9,1
2021,Walsall 034A,E01010336,503,289,147,142,3,3,80,16,64,131,130,1,0
2021,Walsall 037B,E01010337,535,356,197,159,6,6,90,20,70,82,74,8,1
2021,Walsall 037C,E01010338,536,331,142,189,0,0,100,29,71,105,94,11,0
2021,Walsall 037D,E01010339,514,393,196,197,0,0,36,10,26,85,74,11,0
2021,Walsall 034B,E01010340,589,200,124,76,2,2,241,70,171,143,128,15,3
2021,Walsall 034C,E01010341,472,285,172,113,2,2,94,26,68,91,76,15,0
2021,Walsall 034D,E01010342,521,197,108,89,2,2,77,12,65,244,221,23,1
2021,Walsall 034E,E01010343,461,213,133,80,3,3,112,22,90,133,117,16,0
2021,Walsall 034F,E01010344,584,286,125,161,1,1,153,47,106,139,127,12,5
2021,Walsall 003A,E01010345,477,404,264,140,2,2,30,15,15,41,31,10,0
2021,Walsall 003B,E01010346,518,478,281,197,0,0,6,3,3,34,31,3,0
2021,Walsall 003C,E01010347,638,299,173,126,2,2,268,110,158,65,59,6,4
2021,Walsall 005A,E01010348,636,422,240,182,3,3,107,37,70,102,87,15,2
2021,Walsall 005B,E01010349,612,358,225,133,3,3,155,29,126,96,88,8,0
2021,Walsall 003D,E01010350,579,468,241,227,1,1,49,21,28,61,53,8,0
2021,Walsall 005C,E01010351,745,562,336,226,0,0,88,36,52,95,85,10,0
2021,Walsall 005D,E01010352,686,612,409,203,4,4,24,4,20,46,35,11,0
2021,Walsall 010C,E01010353,678,460,243,217,1,1,153,51,102,64,54,10,0
2021,Walsall 010D,E01010354,650,444,260,184,1,1,112,42,70,93,85,8,0
2021,Walsall 039B,E01010355,597,502,281,221,0,0,51,19,32,44,38,6,0
2021,Walsall 039C,E01010356,607,538,313,225,2,2,13,3,10,54,46,8,0
2021,Walsall 039D,E01010357,964,776,346,430,23,23,61,6,55,104,90,14,0
2021,Walsall 039E,E01010358,627,514,245,269,2,2,31,16,15,80,69,11,0
2021,Walsall 039F,E01010359,635,512,257,255,1,1,19,8,11,103,92,11,0
2021,Walsall 039G,E01010360,613,516,294,222,0,0,12,3,9,85,76,9,0
2021,Walsall 031A,E01010361,566,381,231,150,0,0,20,3,17,164,157,7,1
2021,Walsall 026C,E01010362,612,306,165,141,0,0,179,82,97,123,112,11,4
2021,Walsall 026D,E01010363,1123,244,110,134,6,6,453,113,340,416,391,25,4
2021,Walsall 031B,E01010364,473,232,131,101,3,3,112,31,81,123,103,20,3
2021,Walsall 031C,E01010365,674,183,109,74,1,1,306,78,228,179,165,14,5
2021,Walsall 031D,E01010366,624,246,121,125,1,1,213,86,127,160,136,24,4
2021,Walsall 031E,E01010367,626,313,181,132,2,2,96,40,56,212,187,25,3
2021,Walsall 030A,E01010368,1171,196,137,59,2,2,474,81,393,497,477,20,2
2021,Walsall 024D,E01010369,819,230,128,102,9,9,366,55,311,212,200,12,2
2021,Walsall 030B,E01010370,872,240,145,95,2,2,446,64,382,183,170,13,1
2021,Walsall 030D,E01010372,603,272,138,134,1,1,190,43,147,139,123,16,1
2021,Walsall 030E,E01010373,517,381,212,169,0,0,56,2,54,79,45,34,1
2021,Walsall 018D,E01010374,904,472,172,300,11,11,210,75,135,209,196,13,2
2021,Walsall 018E,E01010375,731,272,118,154,9,9,189,55,134,260,244,16,1
2021,Walsall 020A,E01010376,499,417,296,121,2,2,5,2,3,75,64,11,0
2021,Walsall 020B,E01010377,727,519,206,313,1,1,116,65,51,89,79,10,2
2021,Walsall 019A,E01010378,471,376,234,142,1,1,19,4,15,75,70,5,0
2021,Walsall 019B,E01010379,565,494,340,154,1,1,8,2,6,62,54,8,0
2021,Walsall 020C,E01010380,671,605,419,186,2,2,12,6,6,52,43,9,0
2021,Walsall 020D,E01010381,674,348,200,148,0,0,194,93,101,130,115,15,2
2021,Walsall 019C,E01010382,641,429,271,158,0,0,136,67,69,75,72,3,1
2021,Walsall 019D,E01010383,747,299,157,142,10,10,352,158,194,86,83,3,0
2021,Walsall 032A,E01010384,565,517,265,252,2,2,8,3,5,38,32,6,0
2021,Walsall 028A,E01010385,615,551,321,230,1,1,8,1,7,54,47,7,1
2021,Walsall 028B,E01010386,713,656,440,216,1,1,10,3,7,46,40,6,0
2021,Walsall 028C,E01010387,604,550,327,223,0,0,11,7,4,43,37,6,0
2021,Walsall 022E,E01010388,561,527,323,204,2,2,6,3,3,26,19,7,0
2021,Walsall 032B,E01010389,579,486,278,208,0,0,62,29,33,31,27,4,0
2021,Walsall 032C,E01010390,705,608,336,272,3,3,8,2,6,86,81,5,0
2021,Walsall 032D,E01010391,756,670,354,316,3,3,12,5,7,71,64,7,0
2021,Walsall 028D,E01010392,632,555,319,236,1,1,10,5,5,66,54,12,0
2021,Walsall 014A,E01010393,584,466,284,182,3,3,62,37,25,51,42,9,2
2021,Walsall 014B,E01010394,516,403,235,168,3,3,12,3,9,98,86,12,0
2021,Walsall 011A,E01010395,493,448,254,194,8,8,4,1,3,33,29,4,0
2021,Walsall 014C,E01010396,643,446,205,241,0,0,95,35,60,101,88,13,1
2021,Walsall 011B,E01010397,612,319,156,163,0,0,207,99,108,85,76,9,1
2021,Walsall 011C,E01010398,620,555,314,241,24,24,3,0,3,38,32,6,0
2021,Walsall 011D,E01010399,629,465,265,200,2,2,101,52,49,61,51,10,0
2021,Walsall 014D,E01010400,961,332,183,149,0,0,489,215,274,138,127,11,2
2021,Walsall 025A,E01010401,660,346,190,156,4,4,221,105,116,87,79,8,2
2021,Walsall 027A,E01010402,664,447,226,221,5,5,96,50,46,115,104,11,1
2021,Walsall 025B,E01010403,725,323,135,188,2,2,211,61,150,189,175,14,0
2021,Walsall 025C,E01010404,806,386,183,203,12,12,185,70,115,222,207,15,1
2021,Walsall 027B,E01010405,778,383,196,187,6,6,116,50,66,273,251,22,0
2021,Walsall 027C,E01010406,1190,423,157,266,1,1,371,148,223,393,373,20,2
2021,Walsall 025D,E01010407,693,435,235,200,11,11,165,85,80,82,72,10,0
2021,Walsall 025E,E01010408,733,340,151,189,1,1,158,81,77,234,218,16,0
2021,Walsall 027D,E01010409,629,322,193,129,2,2,208,102,106,92,81,11,5
2021,Wolverhampton 033A,E01010410,1048,511,202,309,4,4,385,330,55,144,129,15,4
2021,Wolverhampton 033B,E01010411,795,482,180,302,2,2,212,186,26,97,89,8,2
2021,Wolverhampton 033C,E01010412,835,412,211,201,0,0,249,227,22,172,160,12,2
2021,Wolverhampton 033D,E01010413,691,299,163,136,0,0,303,262,41,83,75,8,6
2021,Wolverhampton 027A,E01010414,1000,275,134,141,3,3,481,355,126,229,206,23,12
2021,Wolverhampton 027B,E01010415,604,242,122,120,0,0,257,184,73,104,86,18,1
2021,Wolverhampton 027C,E01010416,744,226,145,81,3,3,281,214,67,228,210,18,6
2021,Wolverhampton 023A,E01010417,695,297,153,144,0,0,328,302,26,57,52,5,13
2021,Wolverhampton 022A,E01010418,575,475,286,189,0,0,21,19,2,78,57,21,1
2021,Wolverhampton 023B,E01010419,671,347,171,176,0,0,197,189,8,125,114,11,2
2021,Wolverhampton 023C,E01010420,521,303,182,121,0,0,145,133,12,70,56,14,3
2021,Wolverhampton 022B,E01010421,589,248,127,121,1,1,271,254,17,67,53,14,2
2021,Wolverhampton 027D,E01010422,725,478,282,196,0,0,122,70,52,122,109,13,3
2021,Wolverhampton 022C,E01010423,655,261,141,120,1,1,292,173,119,92,86,6,9
2021,Wolverhampton 022D,E01010424,594,462,285,177,3,3,13,9,4,116,105,11,0
2021,Wolverhampton 023D,E01010425,517,326,204,122,0,0,96,76,20,94,84,10,1
2021,Wolverhampton 035A,E01010426,542,308,183,125,6,6,87,44,43,140,114,26,1
2021,Wolverhampton 030A,E01010427,547,346,230,116,2,2,18,8,10,181,153,28,0
2021,Wolverhampton 035B,E01010428,547,184,119,65,4,4,97,22,75,261,230,31,1
2021,Wolverhampton 035C,E01010429,478,237,156,81,0,0,68,12,56,172,154,18,1
2021,Wolverhampton 035D,E01010430,682,340,211,129,0,0,163,66,97,179,161,18,0
2021,Wolverhampton 030B,E01010431,467,393,245,148,1,1,4,2,2,68,52,16,1
2021,Wolverhampton 030C,E01010432,506,396,258,138,0,0,29,26,3,81,72,9,0
2021,Wolverhampton 035E,E01010433,497,164,91,73,0,0,151,32,119,181,156,25,1
2021,Wolverhampton 001A,E01010434,742,450,231,219,6,6,105,40,65,181,165,16,0
2021,Wolverhampton 001B,E01010436,635,575,344,231,3,3,19,15,4,37,27,10,1
2021,Wolverhampton 001C,E01010437,500,446,244,202,2,2,7,7,0,44,40,4,1
2021,Wolverhampton 001D,E01010438,628,458,276,182,8,8,84,72,12,77,68,9,1
2021,Wolverhampton 001E,E01010439,530,316,176,140,0,0,167,150,17,45,38,7,2
2021,Wolverhampton 001F,E01010440,697,287,151,136,0,0,328,251,77,79,72,7,3
2021,Wolverhampton 001G,E01010441,541,297,152,145,0,0,201,190,11,41,36,5,2
2021,Wolverhampton 018A,E01010442,532,245,163,82,3,3,168,134,34,113,101,12,3
2021,Wolverhampton 018B,E01010443,628,225,112,113,0,0,311,292,19,87,81,6,5
2021,Wolverhampton 018C,E01010444,551,351,239,112,1,1,123,111,12,76,71,5,0
2021,Wolverhampton 018D,E01010445,490,183,89,94,0,0,240,231,9,63,58,5,4
2021,Wolverhampton 023E,E01010446,699,413,252,161,6,6,154,144,10,123,113,10,3
2021,Wolverhampton 018E,E01010447,852,336,168,168,0,0,349,301,48,164,154,10,3
2021,Wolverhampton 018F,E01010448,755,323,155,168,9,9,332,164,168,84,74,10,7
2021,Wolverhampton 029A,E01010449,936,445,217,228,3,3,212,166,46,272,245,27,4
2021,Wolverhampton 029B,E01010450,1070,526,173,353,10,10,345,267,78,182,167,15,7
2021,Wolverhampton 029C,E01010451,790,410,200,210,5,5,146,60,86,227,214,13,2
2021,Wolverhampton 029D,E01010452,677,295,148,147,2,2,286,260,26,90,79,11,4
2021,Wolverhampton 035G,E01010454,623,273,139,134,6,6,200,168,32,142,123,19,2
2021,Wolverhampton 029E,E01010455,1063,430,160,270,3,3,383,260,123,240,228,12,7
2021,Wolverhampton 004A,E01010456,496,110,47,63,0,0,354,312,42,30,28,2,2
2021,Wolverhampton 004B,E01010457,648,462,237,225,1,1,102,81,21,80,66,14,3
2021,Wolverhampton 008A,E01010458,756,375,181,194,3,3,263,250,13,107,88,19,8
2021,Wolverhampton 008B,E01010459,603,445,225,220,1,1,74,60,14,80,73,7,3
2021,Wolverhampton 008C,E01010460,634,469,252,217,2,2,50,46,4,113,94,19,0
2021,Wolverhampton 008D,E01010461,610,531,305,226,2,2,6,6,0,70,62,8,1
2021,Wolverhampton 004C,E01010462,636,274,125,149,1,1,302,277,25,54,46,8,5
2021,Wolverhampton 020A,E01010463,747,202,127,75,0,0,222,38,184,319,299,20,4
2021,Wolverhampton 020B,E01010464,888,188,119,69,4,4,536,327,209,154,137,17,6
2021,Wolverhampton 020C,E01010465,596,321,191,130,10,10,56,38,18,198,186,12,11
2021,Wolverhampton 020D,E01010466,537,185,101,84,2,2,63,12,51,281,258,23,6
2021,Wolverhampton 026A,E01010467,632,352,178,174,0,0,44,8,36,234,220,14,2
2021,Wolverhampton 026B,E01010468,605,441,206,235,3,3,93,58,35,67,53,14,1
2021,Wolverhampton 026C,E01010469,624,479,253,226,0,0,22,12,10,123,111,12,0
2021,Wolverhampton 020E,E01010470,703,265,160,105,6,6,190,136,54,242,225,17,0
2021,Wolverhampton 015A,E01010471,832,148,84,64,5,5,482,314,168,194,174,20,3
2021,Wolverhampton 015B,E01010472,1012,234,117,117,18,18,507,224,283,251,231,20,2
2021,Wolverhampton 015C,E01010473,964,80,45,35,1,1,819,711,108,55,48,7,9
2021,Wolverhampton 012A,E01010474,613,331,180,151,1,1,203,184,19,78,68,10,0
2021,Wolverhampton 015D,E01010475,644,431,231,200,1,1,50,35,15,161,110,51,1
2021,Wolverhampton 015E,E01010476,873,224,135,89,8,8,442,392,50,197,180,17,2
2021,Wolverhampton 015F,E01010477,693,315,167,148,2,2,185,130,55,190,176,14,1
2021,Wolverhampton 011A,E01010478,515,141,75,66,2,2,127,94,33,241,208,33,4
2021,Wolverhampton 011B,E01010479,578,343,181,162,1,1,137,113,24,96,88,8,1
2021,Wolverhampton 011C,E01010480,514,299,139,160,5,5,53,18,35,156,150,6,1
2021,Wolverhampton 004D,E01010481,525,217,113,104,5,5,238,226,12,64,56,8,1
2021,Wolverhampton 007A,E01010482,483,137,96,41,0,0,318,246,72,24,23,1,4
2021,Wolverhampton 007B,E01010483,550,95,40,55,4,4,415,322,93,34,28,6,2
2021,Wolverhampton 007C,E01010484,498,149,69,80,0,0,307,266,41,41,35,6,1
2021,Wolverhampton 007D,E01010485,815,282,116,166,7,7,315,178,137,211,194,17,0
2021,Wolverhampton 011D,E01010486,625,156,66,90,0,0,418,381,37,48,38,10,3
2021,Wolverhampton 021A,E01010487,606,505,275,230,3,3,14,11,3,84,70,14,0
2021,Wolverhampton 021B,E01010488,630,462,295,167,6,6,87,73,14,71,61,10,4
2021,Wolverhampton 028A,E01010489,653,417,224,193,5,5,157,141,16,69,56,13,5
2021,Wolverhampton 028B,E01010490,942,228,108,120,3,3,594,510,84,110,98,12,7
2021,Wolverhampton 028C,E01010491,608,382,180,202,3,3,132,117,15,89,77,12,2
2021,Wolverhampton 028D,E01010492,509,441,252,189,3,3,18,10,8,47,39,8,0
2021,Wolverhampton 021C,E01010493,625,471,252,219,0,0,67,51,16,84,77,7,3
2021,Wolverhampton 028E,E01010494,601,535,296,239,0,0,20,14,6,46,42,4,0
2021,Wolverhampton 002A,E01010495,768,407,196,211,0,0,255,229,26,104,93,11,2
2021,Wolverhampton 003A,E01010496,626,261,110,151,14,14,245,125,120,104,95,9,2
2021,Wolverhampton 002B,E01010497,457,388,209,179,13,13,9,3,6,47,41,6,0
2021,Wolverhampton 003B,E01010498,652,489,285,204,8,8,20,18,2,133,124,9,2
2021,Wolverhampton 002C,E01010499,524,388,194,194,2,2,30,29,1,103,99,4,1
2021,Wolverhampton 002D,E01010500,513,239,93,146,0,0,192,176,16,78,73,5,4
2021,Wolverhampton 006B,E01010501,584,368,180,188,1,1,145,131,14,68,61,7,2
2021,Wolverhampton 006C,E01010502,523,434,216,218,2,2,5,2,3,82,71,11,0
2021,Wolverhampton 006D,E01010503,577,270,138,132,0,0,175,71,104,128,112,16,4
2021,Wolverhampton 021D,E01010504,586,489,278,211,1,1,14,0,14,80,71,9,2
2021,Wolverhampton 021E,E01010505,501,423,276,147,3,3,9,7,2,66,56,10,0
2021,Wolverhampton 017A,E01010506,830,271,149,122,7,7,80,19,61,472,449,23,0
2021,Wolverhampton 021F,E01010507,619,534,338,196,1,1,9,7,2,75,64,11,0
2021,Wolverhampton 017B,E01010508,817,176,126,50,2,2,264,125,139,371,344,27,4
2021,Wolverhampton 019A,E01010509,728,391,201,190,4,4,200,189,11,125,112,13,8
2021,Wolverhampton 017C,E01010510,722,350,182,168,0,0,56,21,35,307,284,23,9
2021,Wolverhampton 017D,E01010511,669,249,149,100,3,3,175,40,135,241,206,35,1
2021,Wolverhampton 017E,E01010512,618,310,186,124,2,2,52,18,34,252,243,9,2
2021,Wolverhampton 031A,E01010513,631,537,339,198,2,2,28,6,22,63,55,8,1
2021,Wolverhampton 031B,E01010514,644,552,262,290,1,1,5,5,0,86,77,9,0
2021,Wolverhampton 031C,E01010515,672,557,327,230,0,0,12,9,3,102,95,7,1
2021,Wolverhampton 026D,E01010516,520,469,260,209,0,0,10,7,3,40,33,7,1
2021,Wolverhampton 031D,E01010517,655,477,269,208,0,0,97,71,26,79,66,13,2
2021,Wolverhampton 026E,E01010518,631,517,297,220,0,0,52,5,47,62,48,14,0
2021,Wolverhampton 030D,E01010519,561,431,246,185,2,2,5,4,1,123,114,9,0
2021,Wolverhampton 030E,E01010520,665,560,344,216,3,3,12,7,5,90,72,18,0
2021,Wolverhampton 013A,E01010522,623,238,100,138,15,15,229,127,102,140,121,19,1
2021,Wolverhampton 013B,E01010523,613,361,178,183,2,2,55,14,41,194,179,15,1
2021,Wolverhampton 013C,E01010524,670,268,125,143,0,0,279,173,106,117,110,7,6
2021,Wolverhampton 013D,E01010525,647,277,115,162,6,6,117,48,69,247,222,25,0
2021,Wolverhampton 016A,E01010526,494,158,100,58,2,2,124,31,93,210,197,13,0
2021,Wolverhampton 016B,E01010527,704,170,106,64,1,1,357,188,169,171,152,19,5
2021,Wolverhampton 016C,E01010528,491,51,34,17,1,1,274,183,91,164,156,8,1
2021,Wolverhampton 016D,E01010529,670,148,91,57,1,1,230,35,195,287,272,15,4
2021,Wolverhampton 035H,E01010530,657,206,98,108,1,1,226,107,119,222,196,26,2
2021,Wolverhampton 034A,E01010531,713,361,209,152,3,3,256,191,65,91,82,9,2
2021,Wolverhampton 034B,E01010532,666,354,183,171,2,2,225,219,6,80,72,8,5
2021,Wolverhampton 032A,E01010533,693,351,152,199,2,2,217,210,7,117,108,9,6
2021,Wolverhampton 034C,E01010534,478,406,248,158,0,0,4,3,1,68,58,10,0
2021,Wolverhampton 032B,E01010535,615,289,165,124,2,2,216,206,10,100,92,8,8
2021,Wolverhampton 032C,E01010536,627,545,350,195,1,1,29,27,2,52,36,16,0
2021,Wolverhampton 032D,E01010537,662,573,381,192,1,1,15,8,7,73,64,9,0
2021,Wolverhampton 034D,E01010538,621,435,224,211,0,0,120,109,11,65,51,14,1
2021,Wolverhampton 009A,E01010539,647,439,211,228,4,4,61,54,7,143,137,6,0
2021,Wolverhampton 009B,E01010540,637,488,308,180,2,2,28,6,22,119,112,7,0
2021,Wolverhampton 003C,E01010541,623,191,73,118,1,1,360,294,66,63,56,7,8
2021,Wolverhampton 009C,E01010542,642,453,216,237,4,4,97,80,17,86,77,9,2
2021,Wolverhampton 003D,E01010543,556,198,78,120,2,2,280,255,25,74,66,8,2
2021,Wolverhampton 009D,E01010544,598,513,301,212,0,0,25,23,2,59,50,9,1
2021,Wolverhampton 009E,E01010545,658,533,272,261,2,2,25,9,16,98,87,11,0
2021,Wolverhampton 014A,E01010546,596,536,310,226,0,0,13,10,3,47,43,4,0
2021,Wolverhampton 014B,E01010547,768,547,382,165,20,20,77,63,14,124,112,12,0
2021,Wolverhampton 014C,E01010548,722,466,301,165,3,3,136,97,39,103,87,16,14
2021,Wolverhampton 014D,E01010549,637,470,267,203,17,17,68,68,0,81,71,10,1
2021,Wolverhampton 019B,E01010550,658,601,373,228,1,1,14,10,4,42,30,12,0
2021,Wolverhampton 019C,E01010551,775,558,353,205,1,1,77,71,6,139,128,11,0
2021,Wolverhampton 019D,E01010552,801,541,288,253,1,1,143,133,10,113,99,14,3
2021,Wolverhampton 014E,E01010553,646,529,316,213,3,3,38,35,3,74,62,12,2
2021,Wolverhampton 010A,E01010554,613,487,303,184,0,0,80,76,4,45,38,7,1
2021,Wolverhampton 005A,E01010555,693,314,171,143,2,2,279,268,11,93,76,17,5
2021,Wolverhampton 005B,E01010556,598,402,204,198,0,0,136,125,11,59,54,5,1
2021,Wolverhampton 005C,E01010557,622,507,329,178,0,0,59,53,6,53,41,12,3
2021,Wolverhampton 010B,E01010558,663,519,336,183,2,2,68,42,26,72,60,12,2
2021,Wolverhampton 005D,E01010559,647,347,174,173,1,1,213,199,14,83,75,8,3
2021,Wolverhampton 005E,E01010560,787,434,241,193,0,0,247,223,24,103,88,15,3
2021,Wolverhampton 012B,E01010561,619,545,324,221,0,0,28,27,1,46,40,6,0
2021,Wolverhampton 010C,E01010562,705,401,252,149,0,0,214,199,15,84,72,12,6
2021,Wolverhampton 010D,E01010563,656,335,173,162,0,0,224,215,9,94,57,37,3
2021,Wolverhampton 012C,E01010564,972,487,202,285,8,8,173,115,58,304,284,20,0
2021,Wolverhampton 012D,E01010565,729,640,400,240,1,1,5,4,1,83,71,12,0
2021,Wolverhampton 008E,E01010566,738,425,206,219,9,9,205,131,74,95,80,15,4
2021,Wolverhampton 010E,E01010567,641,364,182,182,3,3,205,186,19,66,48,18,3
2021,Bradford 016A,E01010568,825,590,323,267,0,0,107,46,61,126,107,19,2
2021,Bradford 016B,E01010569,845,496,237,259,5,5,232,106,126,107,90,17,5
2021,Bradford 018A,E01010570,584,560,332,228,1,1,1,0,1,22,17,5,0
2021,Bradford 016C,E01010571,938,510,224,286,1,1,180,94,86,245,222,23,2
2021,Bradford 016D,E01010572,674,579,321,258,0,0,16,7,9,79,55,24,0
2021,Bradford 013A,E01010573,816,718,447,271,10,10,18,12,6,70,59,11,0
2021,Bradford 013B,E01010574,639,496,289,207,1,1,62,13,49,80,69,11,0
2021,Bradford 013C,E01010575,759,577,353,224,2,2,83,30,53,96,77,19,1
2021,Bradford 016E,E01010576,666,558,303,255,1,1,31,15,16,76,65,11,0
2021,Bradford 013D,E01010577,658,576,309,267,3,3,13,4,9,66,49,17,0
2021,Bradford 015A,E01010578,775,525,278,247,4,4,36,16,20,210,199,11,0
2021,Bradford 010A,E01010579,636,562,353,209,1,1,17,2,15,56,47,9,0
2021,Bradford 010B,E01010580,1053,865,440,425,2,2,48,32,16,138,120,18,0
2021,Bradford 015B,E01010581,701,532,259,273,3,3,34,19,15,132,118,14,0
2021,Bradford 015C,E01010582,742,481,221,260,2,2,47,5,42,212,194,18,0
2021,Bradford 018B,E01010583,587,376,225,151,3,3,115,59,56,91,77,14,2
2021,Bradford 015D,E01010584,902,375,158,217,5,5,238,72,166,280,255,25,4
2021,Bradford 015E,E01010585,1034,600,341,259,4,4,182,68,114,246,221,25,2
2021,Bradford 022A,E01010586,742,635,385,250,1,1,13,8,5,93,77,16,0
2021,Bradford 022B,E01010587,886,695,330,365,9,9,50,6,44,132,107,25,0
2021,Bradford 022C,E01010588,675,548,311,237,2,2,42,18,24,83,75,8,0
2021,Bradford 022D,E01010589,645,549,337,212,1,1,5,1,4,90,74,16,0
2021,Bradford 031A,E01010590,933,754,398,356,7,7,27,10,17,145,123,22,0
2021,Bradford 022E,E01010591,706,402,179,223,0,0,173,55,118,131,119,12,0
2021,Bradford 031B,E01010592,780,547,306,241,2,2,140,40,100,91,75,16,0
2021,Bradford 022F,E01010593,783,580,329,251,0,0,72,29,43,130,105,25,1
2021,Bradford 031C,E01010594,709,545,271,274,1,1,76,22,54,86,66,20,1
2021,Bradford 031D,E01010595,957,585,249,336,1,1,144,28,116,225,210,15,2
2021,Bradford 022G,E01010596,636,568,322,246,1,1,15,2,13,52,44,8,0
2021,Bradford 028A,E01010597,621,386,183,203,2,2,101,24,77,132,118,14,0
2021,Bradford 028B,E01010598,639,542,282,260,0,0,9,4,5,88,66,22,0
2021,Bradford 028C,E01010599,460,332,151,181,4,4,7,1,6,117,105,12,0
2021,Bradford 028D,E01010600,475,344,189,155,0,0,6,1,5,125,107,18,0
2021,Bradford 032A,E01010601,769,501,216,285,26,26,33,2,31,209,177,32,0
2021,Bradford 028E,E01010602,655,458,234,224,0,0,19,4,15,178,127,51,0
2021,Bradford 024A,E01010603,633,495,257,238,0,0,26,15,11,112,100,12,0
2021,Bradford 024B,E01010604,765,634,391,243,6,6,24,13,11,100,85,15,1
2021,Bradford 024C,E01010605,652,341,143,198,0,0,198,116,82,113,88,25,0
2021,Bradford 064E,E01010606,586,176,126,50,0,0,226,26,200,184,150,34,0
2021,Bradford 064C,E01010607,622,269,137,132,0,0,82,23,59,271,243,28,0
2021,Bradford 045A,E01010608,479,225,131,94,0,0,120,21,99,134,121,13,0
2021,Bradford 046A,E01010609,694,349,187,162,2,2,160,57,103,181,161,20,2
2021,Bradford 046B,E01010610,885,214,58,156,0,0,541,59,482,130,116,14,0
2021,Bradford 046C,E01010611,899,350,180,170,2,2,266,110,156,281,265,16,0
2021,Bradford 052A,E01010612,594,122,52,70,1,1,322,146,176,147,134,13,2
2021,Bradford 045B,E01010613,699,260,153,107,3,3,113,53,60,321,298,23,2
2021,Bradford 046D,E01010614,606,296,163,133,1,1,152,62,90,157,147,10,0
2021,Bradford 053A,E01010615,540,374,175,199,3,3,11,3,8,152,127,25,0
2021,Bradford 053B,E01010616,605,311,167,144,2,2,167,69,98,125,102,23,0
2021,Bradford 064B,E01010617,613,125,63,62,2,2,399,157,242,87,75,12,0
2021,Bradford 038A,E01010618,517,260,131,129,0,0,137,88,49,118,84,34,2
2021,Bradford 038B,E01010619,526,384,205,179,1,1,7,3,4,134,109,25,0
2021,Bradford 042A,E01010620,558,287,165,122,1,1,51,7,44,218,193,25,1
2021,Bradford 042B,E01010621,537,385,210,175,1,1,7,3,4,144,127,17,0
2021,Bradford 042C,E01010622,666,340,206,134,2,2,72,22,50,250,211,39,2
2021,Bradford 042D,E01010623,569,203,124,79,3,3,226,40,186,132,110,22,5
2021,Bradford 042E,E01010624,586,354,252,102,4,4,78,35,43,149,122,27,1
2021,Bradford 038C,E01010625,513,229,96,133,1,1,207,113,94,73,66,7,3
2021,Bradford 038D,E01010626,524,349,149,200,0,0,64,34,30,111,102,9,0
2021,Bradford 038E,E01010627,533,323,179,144,2,2,28,20,8,180,160,20,0
2021,Bradford 040A,E01010628,675,441,251,190,2,2,52,19,33,180,164,16,0
2021,Bradford 040B,E01010629,638,470,217,253,9,9,8,4,4,151,137,14,0
2021,Bradford 040C,E01010630,672,429,148,281,3,3,125,49,76,115,105,10,0
2021,Bradford 040D,E01010631,552,227,89,138,0,0,211,53,158,114,105,9,0
2021,Bradford 040E,E01010632,561,193,71,122,7,7,192,122,70,169,156,13,0
2021,Bradford 047A,E01010633,675,470,269,201,3,3,33,3,30,169,146,23,0
2021,Bradford 047B,E01010634,656,540,275,265,0,0,15,13,2,101,78,23,0
2021,Bradford 047C,E01010635,659,230,108,122,12,12,343,143,200,73,64,9,1
2021,Bradford 047D,E01010636,741,546,279,267,7,7,27,2,25,161,137,24,0
2021,Bradford 047E,E01010637,571,369,147,222,1,1,20,8,12,181,166,15,0
2021,Bradford 062A,E01010638,691,551,377,174,2,2,35,22,13,101,86,15,2
2021,Bradford 063C,E01010639,983,645,378,267,5,5,52,19,33,280,251,29,1
2021,Bradford 063A,E01010640,832,492,239,253,3,3,9,3,6,328,305,23,0
2021,Bradford 063B,E01010641,643,501,305,196,5,5,79,34,45,58,51,7,0
2021,Bradford 062B,E01010642,888,775,471,304,6,6,42,16,26,65,54,11,0
2021,Bradford 062E,E01010643,668,457,247,210,1,1,11,2,9,199,178,21,0
2021,Bradford 062D,E01010644,826,634,260,374,9,9,74,38,36,109,84,25,0
2021,Bradford 062C,E01010645,742,689,332,357,0,0,6,2,4,47,43,4,0
2021,Bradford 001A,E01010646,672,555,389,166,6,6,45,14,31,66,52,14,0
2021,Bradford 001B,E01010647,524,361,224,137,4,4,104,38,66,55,44,11,0
2021,Bradford 001C,E01010648,660,572,378,194,0,0,23,13,10,65,54,11,0
2021,Bradford 027A,E01010649,664,407,188,219,0,0,110,38,72,147,132,15,0
2021,Bradford 027B,E01010650,733,333,124,209,2,2,283,172,111,115,108,7,0
2021,Bradford 032B,E01010651,636,506,218,288,0,0,7,5,2,123,105,18,0
2021,Bradford 026A,E01010652,796,477,260,217,27,27,113,60,53,179,166,13,0
2021,Bradford 026B,E01010653,840,325,113,212,4,4,325,87,238,183,174,9,3
2021,Bradford 027C,E01010654,674,254,115,139,1,1,315,145,170,104,94,10,0
2021,Bradford 026C,E01010655,579,268,108,160,8,8,165,102,63,137,126,11,1
2021,Bradford 026D,E01010656,616,501,260,241,2,2,38,2,36,74,62,12,1
2021,Bradford 026E,E01010657,667,428,210,218,4,4,10,3,7,225,205,20,0
2021,Bradford 041A,E01010658,611,367,185,182,2,2,36,4,32,206,188,18,0
2021,Bradford 049A,E01010659,619,248,116,132,1,1,267,148,119,101,88,13,2
2021,Bradford 049D,E01010662,500,391,208,183,1,1,9,2,7,99,89,10,0
2021,Bradford 050A,E01010663,673,270,145,125,1,1,93,34,59,308,278,30,1
2021,Bradford 049E,E01010664,533,402,208,194,2,2,46,17,29,82,71,11,1
2021,Bradford 050B,E01010665,626,436,219,217,1,1,29,2,27,160,144,16,0
2021,Bradford 050C,E01010666,691,191,90,101,0,0,218,51,167,282,264,18,0
2021,Bradford 050D,E01010667,599,349,156,193,0,0,47,5,42,201,179,22,2
2021,Bradford 055A,E01010668,496,428,219,209,0,0,6,1,5,62,54,8,0
2021,Bradford 030A,E01010669,652,479,197,282,6,6,6,4,2,161,151,10,0
2021,Bradford 029A,E01010670,459,336,176,160,0,0,8,0,8,115,100,15,0
2021,Bradford 029B,E01010671,513,377,175,202,0,0,34,7,27,101,80,21,1
2021,Bradford 036A,E01010672,556,455,212,243,5,5,2,1,1,94,85,9,0
2021,Bradford 029C,E01010673,486,343,186,157,2,2,14,3,11,127,103,24,0
2021,Bradford 030B,E01010674,639,348,103,245,1,1,110,57,53,180,157,23,0
2021,Bradford 029D,E01010675,641,433,236,197,11,11,75,3,72,122,105,17,0
2021,Bradford 034A,E01010676,561,384,241,143,1,1,18,2,16,158,120,38,0
2021,Bradford 036B,E01010678,555,368,211,157,0,0,85,3,82,102,89,13,0
2021,Bradford 034B,E01010679,611,200,143,57,1,1,206,36,170,204,190,14,0
2021,Bradford 019A,E01010680,852,244,91,153,0,0,509,226,283,97,92,5,2
2021,Bradford 019B,E01010681,573,527,269,258,1,1,12,5,7,33,24,9,0
2021,Bradford 019C,E01010682,681,340,142,198,0,0,223,68,155,118,111,7,0
2021,Bradford 017A,E01010683,1042,820,287,533,19,19,45,3,42,158,148,10,0
2021,Bradford 017B,E01010684,668,501,276,225,8,8,47,16,31,112,103,9,0
2021,Bradford 017C,E01010685,780,544,269,275,9,9,84,16,68,143,122,21,0
2021,Bradford 017D,E01010686,779,625,337,288,0,0,59,13,46,95,83,12,0
2021,Bradford 019D,E01010687,737,645,270,375,6,6,5,2,3,81,69,12,0
2021,Bradford 019E,E01010688,852,589,219,370,15,15,24,8,16,224,205,19,0
2021,Bradford 019F,E01010689,878,630,256,374,7,7,36,15,21,203,179,24,2
2021,Bradford 019G,E01010690,855,550,239,311,45,45,127,41,86,132,110,22,1
2021,Bradford 002A,E01010691,676,615,389,226,3,3,8,3,5,50,39,11,0
2021,Bradford 001D,E01010692,906,732,489,243,9,9,31,6,25,134,120,14,0
2021,Bradford 002B,E01010693,570,540,334,206,1,1,5,2,3,24,23,1,0
2021,Bradford 002C,E01010694,628,554,388,166,2,2,9,5,4,62,50,12,1
2021,Bradford 002D,E01010695,849,521,360,161,0,0,69,12,57,259,230,29,0
2021,Bradford 002E,E01010696,620,550,313,237,1,1,5,4,1,63,55,8,1
2021,Bradford 002F,E01010697,639,535,361,174,2,2,28,13,15,74,63,11,0
2021,Bradford 002G,E01010698,960,615,366,249,23,23,93,36,57,229,214,15,0
2021,Bradford 002H,E01010699,891,559,313,246,9,9,229,96,133,94,83,11,0
2021,Bradford 008A,E01010700,465,278,167,111,1,1,3,2,1,183,148,35,0
2021,Bradford 008B,E01010701,434,218,136,82,2,2,59,18,41,154,117,37,1
2021,Bradford 008C,E01010702,489,312,218,94,1,1,66,5,61,110,93,17,0
2021,Bradford 008D,E01010703,650,443,220,223,1,1,74,13,61,132,123,9,0
2021,Bradford 008E,E01010704,608,389,213,176,1,1,61,35,26,157,140,17,0
2021,Bradford 008F,E01010705,679,594,339,255,2,2,13,8,5,69,54,15,1
2021,Bradford 006A,E01010706,702,596,326,270,3,3,15,9,6,87,76,11,1
2021,Bradford 006B,E01010707,795,685,350,335,0,0,6,1,5,104,89,15,0
2021,Bradford 006C,E01010708,638,495,245,250,0,0,5,3,2,138,127,11,0
2021,Bradford 006D,E01010709,1054,883,439,444,36,36,17,4,13,117,99,18,1
2021,Bradford 008G,E01010710,938,197,115,82,6,6,167,62,105,565,533,32,3
2021,Bradford 011A,E01010711,862,161,105,56,0,0,377,126,251,320,309,11,4
2021,Bradford 009A,E01010712,474,295,126,169,5,5,4,2,2,170,151,19,0
2021,Bradford 011B,E01010713,652,321,170,151,0,0,210,116,94,118,112,6,3
2021,Bradford 011C,E01010714,622,360,179,181,1,1,54,20,34,207,192,15,0
2021,Bradford 012A,E01010715,464,277,155,122,3,3,121,71,50,62,52,10,1
2021,Bradford 011D,E01010716,948,476,228,248,5,5,188,36,152,279,258,21,0
2021,Bradford 012B,E01010717,685,383,184,199,4,4,136,25,111,162,141,21,0
2021,Bradford 012C,E01010718,655,258,111,147,6,6,278,156,122,99,91,8,14
2021,Bradford 007A,E01010719,517,346,211,135,1,1,36,21,15,132,116,16,2
2021,Bradford 009B,E01010720,629,254,115,139,2,2,260,193,67,110,94,16,3
2021,Bradford 009C,E01010721,803,422,183,239,0,0,267,141,126,111,96,15,3
2021,Bradford 014A,E01010722,647,386,200,186,3,3,131,85,46,127,115,12,0
2021,Bradford 009D,E01010723,488,281,143,138,0,0,20,10,10,185,167,18,2
2021,Bradford 009E,E01010724,611,280,147,133,5,5,222,51,171,101,92,9,3
2021,Bradford 009F,E01010725,691,405,195,210,2,2,48,4,44,236,219,17,0
2021,Bradford 012D,E01010726,609,539,308,231,2,2,12,4,8,56,45,11,0
2021,Bradford 007B,E01010727,752,545,288,257,5,5,58,18,40,143,116,27,1
2021,Bradford 007C,E01010728,515,354,200,154,0,0,14,4,10,147,134,13,0
2021,Bradford 007D,E01010729,489,426,241,185,0,0,3,0,3,60,52,8,0
2021,Bradford 045C,E01010730,664,47,35,12,0,0,491,132,359,125,104,21,1
2021,Bradford 048A,E01010731,630,135,89,46,10,10,160,34,126,323,287,36,2
2021,Bradford 048B,E01010732,454,172,93,79,0,0,136,5,131,146,127,19,0
2021,Bradford 048C,E01010733,579,209,128,81,5,5,198,54,144,164,145,19,3
2021,Bradford 045D,E01010734,493,235,117,118,0,0,22,6,16,236,218,18,0
2021,Bradford 051A,E01010735,550,209,110,99,2,2,249,141,108,88,76,12,2
2021,Bradford 048D,E01010736,627,234,123,111,3,3,87,29,58,301,260,41,2
2021,Bradford 048E,E01010737,521,190,140,50,3,3,146,37,109,180,161,19,2
2021,Bradford 051B,E01010738,573,321,182,139,1,1,78,29,49,173,153,20,0
2021,Bradford 051C,E01010739,632,213,116,97,0,0,288,138,150,128,113,15,3
2021,Bradford 051D,E01010740,537,327,199,128,3,3,83,23,60,124,100,24,0
2021,Bradford 059A,E01010741,653,475,251,224,1,1,24,16,8,153,131,22,0
2021,Bradford 053C,E01010742,576,279,178,101,1,1,80,8,72,216,192,24,0
2021,Bradford 053D,E01010743,629,256,161,95,5,5,213,68,145,152,129,23,3
2021,Bradford 051E,E01010744,467,289,130,159,2,2,34,9,25,142,125,17,0
2021,Bradford 056A,E01010745,610,324,144,180,6,6,82,39,43,196,152,44,2
2021,Bradford 060A,E01010746,813,660,356,304,1,1,21,9,12,131,111,20,0
2021,Bradford 056B,E01010747,644,405,188,217,1,1,84,7,77,154,133,21,0
2021,Bradford 056C,E01010748,698,282,117,165,1,1,294,137,157,120,108,12,1
2021,Bradford 056D,E01010749,636,348,189,159,1,1,120,61,59,167,151,16,0
2021,Bradford 060B,E01010750,684,518,278,240,3,3,51,7,44,112,95,17,0
2021,Bradford 060C,E01010751,675,404,207,197,0,0,193,58,135,78,63,15,0
2021,Bradford 058A,E01010752,950,547,232,315,2,2,53,15,38,348,321,27,0
2021,Bradford 058B,E01010753,616,531,327,204,3,3,8,4,4,74,56,18,0
2021,Bradford 058C,E01010754,684,495,212,283,19,19,47,20,27,122,111,11,1
2021,Bradford 055B,E01010755,736,342,93,249,1,1,148,102,46,244,230,14,1
2021,Bradford 058D,E01010756,749,556,228,328,1,1,60,37,23,132,109,23,0
2021,Bradford 058E,E01010758,507,458,214,244,0,0,5,1,4,44,36,8,0
2021,Bradford 058F,E01010759,738,434,193,241,0,0,157,67,90,146,125,21,1
2021,Bradford 058G,E01010760,746,641,285,356,3,3,31,4,27,71,54,17,0
2021,Bradford 049G,E01010761,678,430,238,192,6,6,61,12,49,180,167,13,1
2021,Bradford 055C,E01010762,611,413,197,216,7,7,25,3,22,166,145,21,0
2021,Bradford 055D,E01010763,642,472,225,247,6,6,10,3,7,154,134,20,0
2021,Bradford 010C,E01010764,686,619,379,240,1,1,4,0,4,62,45,17,0
2021,Bradford 010D,E01010765,1105,730,406,324,2,2,191,79,112,182,166,16,0
2021,Bradford 010E,E01010766,538,482,298,184,11,11,8,4,4,37,34,3,0
2021,Bradford 003A,E01010767,634,445,248,197,6,6,134,50,84,46,40,6,3
2021,Bradford 003B,E01010768,645,595,320,275,0,0,2,1,1,48,45,3,0
2021,Bradford 003C,E01010769,743,506,271,235,18,18,61,17,44,158,140,18,0
2021,Bradford 005A,E01010770,672,607,329,278,2,2,12,3,9,51,40,11,0
2021,Bradford 003D,E01010771,493,458,253,205,0,0,11,4,7,24,21,3,0
2021,Bradford 005B,E01010772,508,464,266,198,0,0,23,2,21,21,11,10,0
2021,Bradford 005C,E01010773,681,540,295,245,13,13,41,4,37,87,78,9,0
2021,Bradford 005D,E01010774,752,611,372,239,1,1,49,22,27,91,81,10,0
2021,Bradford 024D,E01010775,702,606,302,304,8,8,6,4,2,82,66,16,0
2021,Bradford 021A,E01010776,683,383,183,200,5,5,169,65,104,125,112,13,1
2021,Bradford 021B,E01010777,780,289,108,181,9,9,313,163,150,166,144,22,3
2021,Bradford 024E,E01010778,809,411,173,238,6,6,196,63,133,195,173,22,1
2021,Bradford 021C,E01010779,767,457,214,243,3,3,202,107,95,103,91,12,2
2021,Bradford 021D,E01010781,620,353,158,195,0,0,100,63,37,167,137,30,0
2021,Bradford 020B,E01010782,1098,410,170,240,3,3,323,173,150,359,314,45,3
2021,Bradford 021E,E01010783,680,497,257,240,9,9,81,38,43,91,76,15,2
2021,Bradford 018C,E01010784,773,450,216,234,10,10,97,42,55,216,183,33,0
2021,Bradford 018D,E01010785,867,501,273,228,8,8,82,7,75,276,263,13,0
2021,Bradford 018E,E01010786,551,479,264,215,5,5,12,3,9,55,41,14,0
2021,Bradford 020C,E01010787,688,562,321,241,4,4,53,4,49,69,57,12,0
2021,Bradford 020D,E01010788,583,412,216,196,3,3,21,6,15,147,126,21,0
2021,Bradford 025A,E01010789,677,438,213,225,6,6,61,34,27,172,151,21,0
2021,Bradford 018F,E01010790,601,530,276,254,7,7,8,5,3,56,51,5,0
2021,Bradford 025B,E01010791,524,399,197,202,2,2,18,2,16,105,92,13,0
2021,Bradford 025C,E01010792,598,371,216,155,1,1,62,15,47,163,132,31,1
2021,Bradford 025D,E01010793,587,346,186,160,4,4,19,5,14,218,196,22,0
2021,Bradford 043A,E01010794,798,564,317,247,0,0,101,46,55,133,119,14,0
2021,Bradford 043B,E01010795,839,624,296,328,1,1,30,2,28,184,144,40,0
2021,Bradford 043C,E01010796,712,394,184,210,1,1,193,86,107,124,113,11,0
2021,Bradford 043D,E01010797,581,502,221,281,1,1,2,1,1,76,57,19,0
2021,Bradford 043E,E01010798,718,416,200,216,7,7,57,14,43,238,219,19,0
2021,Bradford 036C,E01010799,659,422,212,210,1,1,95,60,35,141,129,12,0
2021,Bradford 036D,E01010800,702,206,97,109,1,1,380,206,174,111,102,9,4
2021,Bradford 036E,E01010801,647,447,193,254,1,1,45,8,37,153,138,15,1
2021,Bradford 036F,E01010802,783,426,146,280,0,0,223,93,130,133,102,31,1
2021,Bradford 037A,E01010803,572,289,154,135,5,5,31,2,29,247,221,26,0
2021,Bradford 033A,E01010804,481,403,228,175,1,1,4,2,2,72,57,15,1
2021,Bradford 030D,E01010805,510,356,167,189,3,3,19,13,6,126,117,9,6
2021,Bradford 033B,E01010806,500,289,136,153,1,1,69,24,45,141,115,26,0
2021,Bradford 033C,E01010807,861,279,173,106,1,1,192,34,158,389,370,19,0
2021,Bradford 033D,E01010808,556,378,178,200,3,3,17,4,13,157,127,30,1
2021,Bradford 033E,E01010809,493,356,207,149,1,1,9,1,8,127,100,27,0
2021,Bradford 037B,E01010810,559,380,172,208,0,0,18,6,12,160,148,12,1
2021,Bradford 037C,E01010811,583,317,167,150,0,0,20,6,14,245,200,45,1
2021,Bradford 041B,E01010812,614,241,121,120,5,5,77,30,47,290,252,38,1
2021,Bradford 037D,E01010813,528,251,127,124,9,9,136,49,87,131,113,18,1
2021,Bradford 057A,E01010814,796,366,204,162,2,2,126,29,97,302,276,26,0
2021,Bradford 057B,E01010815,972,527,207,320,13,13,154,76,78,277,252,25,1
2021,Bradford 057C,E01010816,796,639,294,345,3,3,25,14,11,129,110,19,0
2021,Bradford 057D,E01010817,984,411,105,306,0,0,395,146,249,178,165,13,0
2021,Bradford 057E,E01010818,791,621,292,329,0,0,22,6,16,148,130,18,0
2021,Bradford 052B,E01010819,656,143,66,77,0,0,412,227,185,100,89,11,1
2021,Bradford 052C,E01010820,618,154,81,73,2,2,393,242,151,69,62,7,0
2021,Bradford 052D,E01010821,786,244,75,169,1,1,381,174,207,156,144,12,4
2021,Bradford 052E,E01010822,545,209,110,99,2,2,218,120,98,114,85,29,2
2021,Bradford 034C,E01010824,745,191,85,106,4,4,301,34,267,246,219,27,3
2021,Bradford 032C,E01010825,574,430,175,255,1,1,24,8,16,119,100,19,0
2021,Bradford 027D,E01010826,532,193,70,123,0,0,257,163,94,80,72,8,2
2021,Bradford 032D,E01010827,557,420,183,237,0,0,17,5,12,120,101,19,0
2021,Bradford 035A,E01010828,724,337,163,174,2,2,145,22,123,240,210,30,0
2021,Bradford 035B,E01010829,604,291,170,121,1,1,102,41,61,209,195,14,1
2021,Bradford 035C,E01010830,768,338,148,190,0,0,136,26,110,289,256,33,5
2021,Bradford 035D,E01010831,627,288,150,138,0,0,46,19,27,292,276,16,1
2021,Bradford 035E,E01010832,582,351,170,181,1,1,115,53,62,115,105,10,0
2021,Bradford 041C,E01010833,595,167,109,58,0,0,139,32,107,288,254,34,1
2021,Bradford 044A,E01010834,777,162,117,45,3,3,97,13,84,508,465,43,7
2021,Bradford 044C,E01010836,550,222,171,51,0,0,22,2,20,304,283,21,2
2021,Bradford 044D,E01010837,506,369,214,155,1,1,3,1,2,133,113,20,0
2021,Bradford 044E,E01010838,574,293,161,132,3,3,25,5,20,248,228,20,5
2021,Bradford 044F,E01010839,526,197,131,66,1,1,83,7,76,239,216,23,6
2021,Bradford 034D,E01010840,540,262,141,121,1,1,154,64,90,121,100,21,2
2021,Bradford 034E,E01010841,487,250,181,69,1,1,115,49,66,121,99,22,0
2021,Bradford 065A,E01010842,628,225,139,86,0,0,247,89,158,155,126,29,1
2021,Bradford 041D,E01010843,451,268,166,102,1,1,85,18,67,96,76,20,1
2021,Bradford 059B,E01010845,853,357,114,243,6,6,311,156,155,176,156,20,3
2021,Bradford 055E,E01010846,860,555,249,306,2,2,99,58,41,203,177,26,1
2021,Bradford 054A,E01010847,690,480,223,257,2,2,23,1,22,185,167,18,0
2021,Bradford 054B,E01010848,666,475,247,228,0,0,26,8,18,165,139,26,0
2021,Bradford 059C,E01010849,607,506,268,238,0,0,14,8,6,87,70,17,0
2021,Bradford 059D,E01010850,502,200,67,133,1,1,176,125,51,123,115,8,2
2021,Bradford 059E,E01010851,641,485,227,258,0,0,8,3,5,148,135,13,0
2021,Bradford 054C,E01010852,706,465,204,261,23,23,42,19,23,176,147,29,0
2021,Bradford 054D,E01010853,495,377,191,186,1,1,6,2,4,111,98,13,0
2021,Bradford 023A,E01010854,846,569,284,285,2,2,53,9,44,222,201,21,0
2021,Bradford 023B,E01010855,734,516,288,228,22,22,55,19,36,140,110,30,1
2021,Bradford 023C,E01010856,752,481,266,215,0,0,22,5,17,249,218,31,0
2021,Bradford 023D,E01010857,735,624,384,240,1,1,15,8,7,95,75,20,0
2021,Bradford 023E,E01010858,729,571,329,242,0,0,21,3,18,137,120,17,0
2021,Bradford 012E,E01010859,776,644,355,289,3,3,73,47,26,56,40,16,0
2021,Bradford 014B,E01010860,738,593,289,304,1,1,19,3,16,125,115,10,0
2021,Bradford 023F,E01010861,771,678,406,272,6,6,7,1,6,80,70,10,0
2021,Bradford 014C,E01010862,718,515,226,289,20,20,44,18,26,139,121,18,0
2021,Bradford 014D,E01010863,606,531,279,252,7,7,8,2,6,60,53,7,0
2021,Bradford 059F,E01010864,519,319,128,191,0,0,111,42,69,88,81,7,1
2021,Bradford 060D,E01010865,730,552,277,275,1,1,40,12,28,137,114,23,0
2021,Bradford 060E,E01010866,612,467,236,231,0,0,3,1,2,142,115,27,0
2021,Bradford 059G,E01010867,698,457,146,311,0,0,105,44,61,136,119,17,0
2021,Bradford 061A,E01010868,698,325,144,181,1,1,234,136,98,138,126,12,0
2021,Bradford 061B,E01010869,776,483,244,239,5,5,92,44,48,196,177,19,0
2021,Bradford 061C,E01010870,673,497,271,226,2,2,85,43,42,87,74,13,2
2021,Bradford 061D,E01010871,802,540,240,300,1,1,39,3,36,222,210,12,0
2021,Bradford 061E,E01010872,725,351,166,185,1,1,241,125,116,132,121,11,0
2021,Bradford 061F,E01010873,507,414,243,171,1,1,28,18,10,64,56,8,0
2021,Bradford 059H,E01010874,611,277,83,194,2,2,202,89,113,127,117,10,3
2021,Calderdale 019A,E01010875,771,673,424,249,0,0,18,6,12,80,67,13,0
2021,Calderdale 019B,E01010876,692,605,346,259,0,0,6,2,4,81,71,10,0
2021,Calderdale 019C,E01010877,781,470,270,200,0,0,60,22,38,251,228,23,0
2021,Calderdale 015A,E01010878,877,429,226,203,4,4,108,15,93,336,294,42,0
2021,Calderdale 015B,E01010879,800,603,351,252,2,2,101,39,62,94,89,5,0
2021,Calderdale 019D,E01010880,691,217,101,116,2,2,359,131,228,112,103,9,1
2021,Calderdale 004A,E01010881,708,511,296,215,21,21,101,24,77,75,68,7,0
2021,Calderdale 004B,E01010882,630,430,259,171,4,4,128,20,108,68,60,8,0
2021,Calderdale 004C,E01010883,652,572,325,247,3,3,6,2,4,71,56,15,0
2021,Calderdale 022A,E01010884,781,523,289,234,1,1,161,37,124,95,77,18,1
2021,Calderdale 022B,E01010885,702,502,268,234,0,0,39,5,34,161,154,7,0
2021,Calderdale 022C,E01010886,508,334,174,160,2,2,94,17,77,78,63,15,0
2021,Calderdale 004D,E01010887,699,570,373,197,4,4,16,7,9,109,88,21,0
2021,Calderdale 004E,E01010888,812,531,324,207,10,10,44,9,35,227,208,19,0
2021,Calderdale 025A,E01010889,863,272,159,113,11,11,417,141,276,161,149,12,2
2021,Calderdale 025B,E01010890,847,420,187,233,2,2,129,46,83,296,272,24,0
2021,Calderdale 024A,E01010891,806,413,220,193,2,2,259,98,161,129,112,17,3
2021,Calderdale 024B,E01010892,752,598,268,330,6,6,63,16,47,85,72,13,0
2021,Calderdale 025C,E01010893,621,402,203,199,3,3,88,16,72,128,107,21,0
2021,Calderdale 025D,E01010894,789,395,202,193,3,3,73,20,53,318,291,27,0
2021,Calderdale 024C,E01010895,637,388,216,172,0,0,185,76,109,63,54,9,1
2021,Calderdale 026A,E01010896,676,570,298,272,2,2,20,7,13,84,68,16,0
2021,Calderdale 026B,E01010897,727,548,298,250,1,1,65,20,45,113,91,22,0
2021,Calderdale 026C,E01010898,827,476,212,264,18,18,68,17,51,265,235,30,0
2021,Calderdale 026D,E01010899,570,433,225,208,0,0,65,22,43,72,62,10,0
2021,Calderdale 026E,E01010900,670,592,323,269,2,2,5,1,4,71,65,6,0
2021,Calderdale 025E,E01010901,813,686,369,317,0,0,41,11,30,86,75,11,0
2021,Calderdale 026F,E01010902,645,358,137,221,21,21,159,42,117,107,99,8,0
2021,Calderdale 025F,E01010903,726,519,283,236,11,11,109,14,95,87,75,12,0
2021,Calderdale 011A,E01010904,691,607,302,305,0,0,7,1,6,77,61,16,0
2021,Calderdale 015C,E01010905,811,688,344,344,5,5,13,6,7,105,91,14,0
2021,Calderdale 011B,E01010906,595,521,303,218,1,1,26,2,24,47,40,7,0
2021,Calderdale 011C,E01010907,638,497,270,227,6,6,42,0,42,93,78,15,0
2021,Calderdale 015D,E01010908,987,692,356,336,0,0,76,16,60,219,202,17,0
2021,Calderdale 011D,E01010909,787,509,259,250,1,1,95,23,72,182,163,19,0
2021,Calderdale 015E,E01010910,574,305,142,163,3,3,215,92,123,51,47,4,0
2021,Calderdale 001A,E01010911,738,611,319,292,4,4,17,6,11,106,92,14,0
2021,Calderdale 001B,E01010912,692,344,184,160,20,20,246,87,159,81,68,13,1
2021,Calderdale 001C,E01010913,567,497,336,161,0,0,14,5,9,56,35,21,0
2021,Calderdale 002A,E01010914,691,458,230,228,2,2,105,45,60,126,114,12,0
2021,Calderdale 001D,E01010915,642,473,205,268,3,3,59,18,41,107,93,14,0
2021,Calderdale 005A,E01010916,616,302,142,160,1,1,207,84,123,104,82,22,2
2021,Calderdale 007A,E01010917,864,671,419,252,3,3,14,7,7,176,155,21,0
2021,Calderdale 007B,E01010918,726,598,364,234,4,4,44,12,32,79,64,15,1
2021,Calderdale 007C,E01010919,785,403,238,165,1,1,238,43,195,143,128,15,0
2021,Calderdale 007D,E01010920,749,574,329,245,1,1,23,3,20,151,123,28,0
2021,Calderdale 007E,E01010921,737,436,230,206,0,0,190,60,130,111,94,17,0
2021,Calderdale 020A,E01010922,811,624,300,324,3,3,28,7,21,156,139,17,0
2021,Calderdale 004F,E01010923,788,467,270,197,3,3,94,17,77,223,207,16,1
2021,Calderdale 002B,E01010924,545,142,75,67,0,0,254,93,161,149,142,7,0
2021,Calderdale 002C,E01010925,592,310,162,148,0,0,181,77,104,101,90,11,0
2021,Calderdale 002D,E01010926,428,123,56,67,3,3,210,103,107,92,81,11,0
2021,Calderdale 009A,E01010927,918,756,362,394,2,2,55,2,53,104,81,23,1
2021,Calderdale 009B,E01010928,632,222,107,115,0,0,299,69,230,110,98,12,1
2021,Calderdale 010A,E01010929,924,539,209,330,1,1,65,15,50,315,278,37,4
2021,Calderdale 010B,E01010930,742,362,190,172,5,5,145,47,98,230,207,23,0
2021,Calderdale 003A,E01010931,633,460,247,213,0,0,104,24,80,68,62,6,1
2021,Calderdale 003B,E01010932,681,560,344,216,1,1,9,2,7,111,90,21,0
2021,Calderdale 003C,E01010933,732,583,309,274,1,1,22,4,18,126,105,21,0
2021,Calderdale 008A,E01010934,939,677,399,278,1,1,44,9,35,217,192,25,0
2021,Calderdale 003D,E01010935,675,573,361,212,2,2,6,2,4,94,83,11,0
2021,Calderdale 003E,E01010936,867,668,336,332,4,4,76,4,72,119,99,20,0
2021,Calderdale 003F,E01010937,685,544,291,253,0,0,47,18,29,93,77,16,1
2021,Calderdale 006A,E01010938,629,186,82,104,5,5,302,102,200,136,122,14,0
2021,Calderdale 005B,E01010939,717,621,315,306,0,0,8,3,5,88,68,20,0
2021,Calderdale 006B,E01010940,665,423,192,231,3,3,98,33,65,141,120,21,0
2021,Calderdale 005C,E01010941,543,279,146,133,0,0,189,74,115,75,51,24,0
2021,Calderdale 005D,E01010942,850,433,176,257,0,0,190,46,144,226,200,26,1
2021,Calderdale 006C,E01010943,588,197,91,106,0,0,310,146,164,81,77,4,0
2021,Calderdale 005E,E01010944,623,245,131,114,3,3,245,81,164,128,110,18,2
2021,Calderdale 024D,E01010945,678,510,284,226,1,1,77,27,50,90,67,23,0
2021,Calderdale 023A,E01010946,550,505,330,175,1,1,24,3,21,20,13,7,0
2021,Calderdale 023B,E01010947,648,563,355,208,2,2,10,5,5,73,63,10,0
2021,Calderdale 024E,E01010948,660,470,253,217,2,2,117,39,78,69,60,9,2
2021,Calderdale 019E,E01010949,774,486,289,197,5,5,63,13,50,220,193,27,0
2021,Calderdale 023C,E01010950,693,358,175,183,1,1,135,39,96,199,187,12,0
2021,Calderdale 023D,E01010951,677,470,248,222,0,0,62,28,34,145,132,13,0
2021,Calderdale 027A,E01010952,755,529,292,237,6,6,82,26,56,137,120,17,1
2021,Calderdale 027B,E01010953,624,508,280,228,0,0,28,4,24,88,72,16,0
2021,Calderdale 027C,E01010954,975,795,357,438,6,6,26,3,23,148,134,14,0
2021,Calderdale 027D,E01010955,577,472,243,229,0,0,28,11,17,77,58,19,0
2021,Calderdale 020B,E01010956,701,496,275,221,1,1,95,24,71,109,89,20,0
2021,Calderdale 027E,E01010957,655,540,309,231,1,1,12,2,10,102,85,17,0
2021,Calderdale 020C,E01010958,590,263,130,133,1,1,260,93,167,64,54,10,2
2021,Calderdale 020D,E01010959,700,441,225,216,1,1,165,55,110,93,86,7,0
2021,Calderdale 012A,E01010960,456,240,146,94,0,0,35,6,29,181,153,28,0
2021,Calderdale 006D,E01010961,521,297,138,159,1,1,14,2,12,209,191,18,0
2021,Calderdale 012B,E01010964,544,175,95,80,0,0,220,35,185,146,120,26,3
2021,Calderdale 012C,E01010965,489,179,124,55,1,1,247,55,192,61,46,15,1
2021,Calderdale 012D,E01010966,497,231,158,73,0,0,157,40,117,108,91,17,1
2021,Calderdale 008D,E01010967,825,260,124,136,0,0,364,73,291,199,177,22,2
2021,Calderdale 021A,E01010968,783,548,296,252,3,3,27,1,26,205,186,19,0
2021,Calderdale 016A,E01010969,766,541,291,250,3,3,39,10,29,183,163,20,0
2021,Calderdale 016B,E01010970,902,575,309,266,0,0,29,1,28,298,262,36,0
2021,Calderdale 021B,E01010971,823,651,349,302,0,0,16,1,15,156,134,22,0
2021,Calderdale 021C,E01010972,676,526,314,212,1,1,31,2,29,117,104,13,1
2021,Calderdale 021D,E01010973,800,582,327,255,10,10,121,13,108,87,73,14,0
2021,Calderdale 016C,E01010974,633,308,175,133,0,0,153,6,147,169,155,14,3
2021,Calderdale 017A,E01010975,726,493,287,206,2,2,168,40,128,63,48,15,0
2021,Calderdale 017B,E01010976,802,647,345,302,3,3,61,16,45,91,78,13,0
2021,Calderdale 016D,E01010977,822,683,323,360,9,9,19,4,15,111,96,15,0
2021,Calderdale 017C,E01010978,612,400,180,220,6,6,86,9,77,120,105,15,0
2021,Calderdale 017D,E01010979,772,240,117,123,4,4,265,89,176,262,243,19,1
2021,Calderdale 017E,E01010980,694,393,181,212,4,4,86,10,76,211,192,19,0
2021,Calderdale 017F,E01010981,741,392,208,184,6,6,55,16,39,288,260,28,0
2021,Calderdale 013A,E01010982,612,437,250,187,4,4,28,2,26,142,125,17,1
2021,Calderdale 013B,E01010983,769,399,226,173,1,1,65,10,55,304,279,25,0
2021,Calderdale 022D,E01010984,618,413,217,196,4,4,18,6,12,183,157,26,0
2021,Calderdale 013C,E01010985,641,398,195,203,27,27,125,30,95,90,75,15,1
2021,Calderdale 013D,E01010986,779,456,213,243,2,2,123,43,80,198,188,10,0
2021,Calderdale 013E,E01010987,791,539,291,248,0,0,121,27,94,131,114,17,0
2021,Calderdale 013F,E01010988,643,361,205,156,3,3,213,86,127,65,54,11,1
2021,Calderdale 018A,E01010989,728,389,205,184,1,1,90,20,70,247,220,27,1
2021,Calderdale 018B,E01010990,740,511,267,244,2,2,117,37,80,108,96,12,2
2021,Calderdale 018C,E01010991,667,529,305,224,3,3,34,8,26,101,86,15,0
2021,Calderdale 018D,E01010992,779,504,227,277,0,0,86,21,65,189,164,25,0
2021,Calderdale 018E,E01010993,737,396,187,209,0,0,147,58,89,193,177,16,1
2021,Calderdale 012E,E01010995,416,202,133,69,0,0,39,4,35,175,161,14,0
2021,Calderdale 014A,E01010996,441,269,160,109,0,0,21,3,18,150,128,22,1
2021,Calderdale 009C,E01010997,638,566,334,232,0,0,4,1,3,68,56,12,0
2021,Calderdale 010C,E01010998,712,412,203,209,0,0,128,35,93,172,150,22,0
2021,Calderdale 009D,E01010999,624,531,267,264,1,1,2,1,1,90,77,13,0
2021,Calderdale 010D,E01011000,621,391,180,211,0,0,50,10,40,178,140,38,2
2021,Calderdale 014B,E01011001,474,275,159,116,4,4,40,10,30,154,130,24,1
2021,Calderdale 014C,E01011002,629,439,203,236,0,0,19,4,15,169,141,28,2
2021,Calderdale 014D,E01011003,595,255,144,111,2,2,87,9,78,249,227,22,2
2021,Kirklees 040A,E01011004,655,264,125,139,0,0,337,317,20,54,43,11,0
2021,Kirklees 044A,E01011005,642,557,344,213,1,1,22,20,2,62,48,14,0
2021,Kirklees 040B,E01011006,636,469,243,226,0,0,68,21,47,99,85,14,0
2021,Kirklees 042A,E01011007,672,382,213,169,1,1,66,15,51,223,198,25,0
2021,Kirklees 040C,E01011008,668,385,205,180,2,2,23,13,10,258,236,22,0
2021,Kirklees 044B,E01011009,609,433,267,166,1,1,73,65,8,102,91,11,0
2021,Kirklees 044C,E01011010,648,328,157,171,0,0,191,155,36,128,111,17,1
2021,Kirklees 044D,E01011011,685,592,390,202,2,2,14,4,10,77,66,11,0
2021,Kirklees 040D,E01011012,669,414,164,250,2,2,84,44,40,169,151,18,0
2021,Kirklees 007A,E01011013,609,523,323,200,2,2,1,1,0,83,70,13,0
2021,Kirklees 007B,E01011014,623,323,169,154,2,2,99,32,67,198,172,26,1
2021,Kirklees 010A,E01011015,562,216,162,54,2,2,225,63,162,115,98,17,4
2021,Kirklees 013A,E01011016,514,299,199,100,8,8,43,20,23,163,145,18,1
2021,Kirklees 013B,E01011017,452,299,227,72,1,1,75,48,27,74,66,8,3
2021,Kirklees 013C,E01011018,413,280,196,84,0,0,59,41,18,70,60,10,4
2021,Kirklees 013D,E01011019,512,401,292,109,1,1,21,19,2,87,73,14,2
2021,Kirklees 013E,E01011020,441,187,132,55,0,0,167,128,39,83,71,12,4
2021,Kirklees 014A,E01011021,666,557,299,258,2,2,9,4,5,98,75,23,0
2021,Kirklees 014B,E01011022,579,461,255,206,1,1,5,5,0,112,93,19,0
2021,Kirklees 007C,E01011023,635,461,253,208,2,2,14,8,6,158,141,17,0
2021,Kirklees 007D,E01011024,682,369,195,174,0,0,178,85,93,132,121,11,3
2021,Kirklees 016A,E01011025,578,293,158,135,1,1,170,165,5,112,103,9,2
2021,Kirklees 016B,E01011026,556,328,182,146,1,1,60,24,36,167,145,22,0
2021,Kirklees 006A,E01011027,525,346,177,169,5,5,76,73,3,97,82,15,1
2021,Kirklees 006B,E01011028,646,356,148,208,2,2,93,71,22,193,160,33,2
2021,Kirklees 010B,E01011029,687,201,111,90,1,1,376,310,66,106,95,11,3
2021,Kirklees 006C,E01011030,597,261,114,147,0,0,209,151,58,127,115,12,0
2021,Kirklees 006D,E01011031,768,616,325,291,2,2,61,33,28,89,74,15,0
2021,Kirklees 010C,E01011032,925,250,152,98,18,18,255,108,147,400,389,11,2
2021,Kirklees 012A,E01011033,658,489,253,236,1,1,26,11,15,141,125,16,1
2021,Kirklees 010D,E01011034,455,287,203,84,3,3,87,84,3,71,63,8,7
2021,Kirklees 012B,E01011035,477,315,202,113,0,0,91,82,9,65,52,13,6
2021,Kirklees 012C,E01011036,580,300,124,176,2,2,173,166,7,103,87,16,2
2021,Kirklees 012D,E01011037,840,552,243,309,5,5,35,11,24,248,218,30,0
2021,Kirklees 029A,E01011038,703,228,121,107,5,5,314,136,178,152,138,14,4
2021,Kirklees 027A,E01011039,663,483,306,177,1,1,38,28,10,138,122,16,3
2021,Kirklees 031A,E01011040,656,376,184,192,5,5,19,9,10,253,230,23,3
2021,Kirklees 029B,E01011041,654,367,190,177,4,4,36,14,22,246,231,15,1
2021,Kirklees 027B,E01011042,636,504,273,231,0,0,16,8,8,116,96,20,0
2021,Kirklees 031B,E01011043,949,465,211,254,3,3,73,19,54,406,379,27,2
2021,Kirklees 031C,E01011044,545,403,199,204,2,2,13,5,8,127,119,8,0
2021,Kirklees 031D,E01011045,708,275,169,106,2,2,202,126,76,222,196,26,7
2021,Kirklees 022A,E01011046,526,497,306,191,2,2,11,6,5,16,12,4,0
2021,Kirklees 027C,E01011047,638,561,371,190,2,2,10,8,2,65,57,8,0
2021,Kirklees 002A,E01011048,866,373,184,189,11,11,244,214,30,233,208,25,5
2021,Kirklees 002B,E01011049,730,507,226,281,1,1,129,117,12,93,73,20,0
2021,Kirklees 002C,E01011050,617,528,280,248,1,1,28,25,3,59,49,10,1
2021,Kirklees 001A,E01011051,733,599,270,329,1,1,30,6,24,103,90,13,0
2021,Kirklees 002D,E01011052,709,428,187,241,1,1,180,161,19,95,78,17,5
2021,Kirklees 002E,E01011053,625,517,271,246,0,0,17,16,1,91,79,12,0
2021,Kirklees 006E,E01011054,592,532,312,220,0,0,11,10,1,48,38,10,1
2021,Kirklees 001B,E01011055,547,447,237,210,0,0,10,9,1,90,82,8,0
2021,Kirklees 001C,E01011056,710,593,308,285,4,4,23,4,19,90,79,11,0
2021,Kirklees 001D,E01011057,709,518,226,292,1,1,66,14,52,124,102,22,0
2021,Kirklees 001E,E01011058,502,363,186,177,1,1,63,44,19,74,57,17,1
2021,Kirklees 002F,E01011059,695,300,108,192,12,12,309,282,27,72,63,9,2
2021,Kirklees 005A,E01011060,769,438,240,198,1,1,231,214,17,91,75,16,8
2021,Kirklees 005B,E01011061,919,353,175,178,7,7,251,151,100,303,276,27,5
2021,Kirklees 003A,E01011062,820,577,252,325,0,0,36,20,16,207,182,25,0
2021,Kirklees 005C,E01011063,999,600,294,306,3,3,92,64,28,303,275,28,1
2021,Kirklees 003B,E01011064,717,410,209,201,6,6,192,177,15,105,90,15,4
2021,Kirklees 005D,E01011065,706,485,217,268,0,0,27,17,10,194,171,23,0
2021,Kirklees 005E,E01011066,662,520,315,205,2,2,20,11,9,120,105,15,0
2021,Kirklees 008A,E01011067,698,528,296,232,1,1,75,7,68,94,79,15,0
2021,Kirklees 003C,E01011068,712,601,318,283,3,3,6,5,1,101,81,20,1
2021,Kirklees 003D,E01011069,629,504,278,226,1,1,40,40,0,83,71,12,1
2021,Kirklees 052A,E01011070,698,586,326,260,2,2,34,31,3,76,57,19,0
2021,Kirklees 049A,E01011071,826,695,335,360,11,11,26,24,2,94,74,20,0
2021,Kirklees 049B,E01011072,689,511,232,279,0,0,65,52,13,113,102,11,0
2021,Kirklees 049C,E01011073,704,435,206,229,2,2,85,69,16,181,158,23,1
2021,Kirklees 052B,E01011074,844,615,338,277,1,1,63,35,28,165,144,21,0
2021,Kirklees 052C,E01011075,647,460,263,197,3,3,55,49,6,128,114,14,1
2021,Kirklees 052D,E01011076,627,461,274,187,0,0,86,78,8,79,70,9,1
2021,Kirklees 045A,E01011077,731,488,225,263,1,1,36,25,11,206,182,24,0
2021,Kirklees 049D,E01011078,866,589,298,291,3,3,30,18,12,243,219,24,1
2021,Kirklees 047A,E01011079,891,453,239,214,4,4,121,97,24,311,278,33,2
2021,Kirklees 043A,E01011080,763,373,189,184,3,3,50,37,13,332,297,35,5
2021,Kirklees 043B,E01011081,715,324,174,150,2,2,139,81,58,242,210,32,8
2021,Kirklees 043C,E01011082,469,263,174,89,0,0,38,8,30,167,142,25,1
2021,Kirklees 047B,E01011083,720,594,334,260,1,1,11,10,1,113,100,13,1
2021,Kirklees 047C,E01011084,661,211,103,108,0,0,314,233,81,131,122,9,5
2021,Kirklees 047D,E01011085,692,477,265,212,2,2,118,96,22,92,70,22,3
2021,Kirklees 050A,E01011086,698,621,398,223,1,1,17,15,2,59,54,5,0
2021,Kirklees 050B,E01011087,742,434,246,188,0,0,198,176,22,108,97,11,2
2021,Kirklees 050C,E01011088,594,542,381,161,0,0,7,7,0,45,38,7,0
2021,Kirklees 032A,E01011089,577,415,238,177,1,1,84,76,8,77,65,12,0
2021,Kirklees 037A,E01011090,672,422,220,202,2,2,128,87,41,113,95,18,7
2021,Kirklees 032B,E01011091,570,499,275,224,0,0,7,6,1,64,48,16,0
2021,Kirklees 032C,E01011092,575,516,353,163,0,0,3,3,0,56,45,11,0
2021,Kirklees 035A,E01011093,670,234,117,117,2,2,349,310,39,79,70,9,6
2021,Kirklees 035B,E01011094,658,210,90,120,2,2,381,346,35,56,51,5,9
2021,Kirklees 037B,E01011095,626,465,255,210,2,2,65,38,27,93,80,13,1
2021,Kirklees 035C,E01011096,622,473,278,195,6,6,28,19,9,115,98,17,0
2021,Kirklees 037C,E01011097,716,439,225,214,15,15,112,108,4,149,134,15,1
2021,Kirklees 035D,E01011098,712,336,172,164,4,4,55,22,33,316,299,17,1
2021,Kirklees 037D,E01011099,618,426,253,173,2,2,99,91,8,91,73,18,0
2021,Kirklees 022B,E01011100,685,392,185,207,2,2,195,144,51,94,84,10,2
2021,Kirklees 025A,E01011101,735,215,79,136,7,7,415,364,51,91,82,9,7
2021,Kirklees 022C,E01011102,509,439,249,190,1,1,9,9,0,60,46,14,0
2021,Kirklees 025B,E01011103,629,318,163,155,2,2,206,186,20,101,78,23,2
2021,Kirklees 025C,E01011104,750,395,203,192,0,0,260,210,50,88,69,19,7
2021,Kirklees 025D,E01011105,894,360,79,281,5,5,328,228,100,198,178,20,3
2021,Kirklees 029C,E01011106,709,248,112,136,3,3,289,264,25,161,149,12,8
2021,Kirklees 029D,E01011107,884,151,83,68,3,3,237,199,38,486,462,24,7
2021,Kirklees 022D,E01011108,637,470,260,210,3,3,28,25,3,136,125,11,0
2021,Kirklees 054A,E01011109,802,641,308,333,3,3,16,3,13,142,125,17,0
2021,Kirklees 057A,E01011110,620,468,263,205,4,4,24,10,14,123,101,22,1
2021,Kirklees 057B,E01011111,731,607,282,325,0,0,48,29,19,76,63,13,0
2021,Kirklees 057C,E01011112,678,511,272,239,1,1,80,75,5,86,73,13,0
2021,Kirklees 054B,E01011113,722,612,408,204,0,0,10,4,6,100,88,12,0
2021,Kirklees 054C,E01011114,743,491,258,233,4,4,159,116,43,85,76,9,4
2021,Kirklees 057D,E01011115,781,609,336,273,2,2,15,13,2,155,139,16,0
2021,Kirklees 057E,E01011116,697,574,335,239,0,0,57,48,9,65,49,16,1
2021,Kirklees 057F,E01011117,743,631,353,278,1,1,17,16,1,92,76,16,2
2021,Kirklees 056A,E01011118,626,506,251,255,9,9,42,32,10,68,55,13,1
2021,Kirklees 054D,E01011119,655,472,272,200,1,1,107,89,18,71,57,14,4
2021,Kirklees 056B,E01011120,573,524,277,247,0,0,4,2,2,45,34,11,0
2021,Kirklees 018A,E01011121,731,371,124,247,5,5,217,197,20,130,117,13,8
2021,Kirklees 018B,E01011122,494,179,81,98,2,2,262,254,8,47,43,4,4
2021,Kirklees 018C,E01011123,689,398,205,193,0,0,132,94,38,155,138,17,4
2021,Kirklees 018D,E01011124,862,573,225,348,14,14,132,91,41,140,118,22,3
2021,Kirklees 018E,E01011125,842,595,260,335,19,19,146,132,14,82,63,19,0
2021,Kirklees 014C,E01011126,876,454,201,253,10,10,284,265,19,121,106,15,7
2021,Kirklees 014D,E01011127,577,480,274,206,0,0,13,10,3,84,71,13,0
2021,Kirklees 017A,E01011128,762,341,187,154,3,3,129,69,60,283,259,24,6
2021,Kirklees 018F,E01011129,485,364,185,179,1,1,80,47,33,40,30,10,0
2021,Kirklees 017B,E01011130,969,242,133,109,2,2,365,241,124,348,326,22,12
2021,Kirklees 020A,E01011132,632,576,365,211,2,2,8,4,4,46,35,11,0
2021,Kirklees 023A,E01011133,468,276,129,147,0,0,93,89,4,96,82,14,3
2021,Kirklees 023B,E01011134,587,288,127,161,5,5,157,100,57,128,112,16,9
2021,Kirklees 016C,E01011136,644,315,161,154,1,1,216,178,38,109,96,13,3
2021,Kirklees 016D,E01011137,630,336,128,208,2,2,183,174,9,104,100,4,5
2021,Kirklees 019A,E01011138,638,273,131,142,0,0,280,214,66,83,67,16,2
2021,Kirklees 019B,E01011139,487,356,167,189,1,1,44,32,12,86,82,4,0
2021,Kirklees 019C,E01011140,492,211,79,132,1,1,210,165,45,69,61,8,1
2021,Kirklees 019D,E01011141,529,335,183,152,2,2,51,34,17,140,114,26,1
2021,Kirklees 020B,E01011142,678,546,297,249,1,1,16,12,4,115,104,11,0
2021,Kirklees 023C,E01011143,541,277,134,143,4,4,108,85,23,149,130,19,3
2021,Kirklees 023D,E01011144,520,223,133,90,0,0,127,35,92,163,144,19,7
2021,Kirklees 041A,E01011145,644,515,295,220,0,0,44,40,4,85,72,13,0
2021,Kirklees 036A,E01011146,684,594,308,286,0,0,6,5,1,84,71,13,0
2021,Kirklees 041B,E01011147,709,525,216,309,0,0,63,35,28,121,101,20,0
2021,Kirklees 041C,E01011148,764,283,146,137,2,2,388,337,51,78,69,9,13
2021,Kirklees 045B,E01011149,911,392,181,211,1,1,178,58,120,340,316,24,0
2021,Kirklees 038A,E01011150,740,495,229,266,5,5,51,41,10,189,166,23,0
2021,Kirklees 036B,E01011151,656,572,335,237,1,1,4,3,1,78,56,22,1
2021,Kirklees 041D,E01011152,812,585,262,323,0,0,10,8,2,217,193,24,0
2021,Kirklees 045C,E01011153,769,509,246,263,7,7,53,21,32,200,170,30,0
2021,Kirklees 045D,E01011154,660,445,201,244,0,0,111,104,7,101,92,9,3
2021,Kirklees 038B,E01011155,1011,714,333,381,12,12,26,13,13,259,236,23,0
2021,Kirklees 015A,E01011156,675,466,259,207,0,0,140,88,52,67,52,15,2
2021,Kirklees 011A,E01011157,599,397,186,211,2,2,88,41,47,111,96,15,1
2021,Kirklees 015B,E01011158,770,552,257,295,1,1,39,34,5,178,159,19,0
2021,Kirklees 015C,E01011159,718,587,327,260,3,3,29,26,3,99,75,24,0
2021,Kirklees 015D,E01011160,533,462,227,235,0,0,7,5,2,63,49,14,1
2021,Kirklees 011B,E01011161,539,437,222,215,1,1,1,1,0,100,88,12,0
2021,Kirklees 015E,E01011162,678,569,345,224,2,2,19,14,5,88,77,11,0
2021,Kirklees 011C,E01011163,623,320,159,161,0,0,234,212,22,63,50,13,6
2021,Kirklees 011D,E01011164,718,555,262,293,1,1,74,66,8,86,71,15,2
2021,Kirklees 011E,E01011165,574,429,185,244,1,1,13,6,7,130,113,17,1
2021,Kirklees 011F,E01011166,661,389,172,217,0,0,95,83,12,170,147,23,7
2021,Kirklees 011G,E01011167,715,351,172,179,0,0,181,74,107,178,156,22,5
2021,Kirklees 055A,E01011168,700,603,355,248,2,2,19,17,2,76,62,14,0
2021,Kirklees 053A,E01011169,613,533,320,213,1,1,12,9,3,67,57,10,0
2021,Kirklees 053B,E01011170,790,687,400,287,1,1,18,16,2,84,68,16,0
2021,Kirklees 053E,E01011173,519,466,288,178,0,0,18,17,1,34,26,8,1
2021,Kirklees 055B,E01011174,739,654,392,262,3,3,12,2,10,70,59,11,0
2021,Kirklees 055C,E01011175,703,431,191,240,3,3,172,146,26,93,79,14,4
2021,Kirklees 053F,E01011176,592,474,264,210,2,2,37,34,3,79,59,20,0
2021,Kirklees 055D,E01011177,853,725,391,334,9,9,30,25,5,89,73,16,0
2021,Kirklees 055E,E01011178,891,487,257,230,14,14,174,109,65,212,196,16,4
2021,Kirklees 059A,E01011179,750,612,376,236,2,2,13,13,0,123,103,20,0
2021,Kirklees 058A,E01011180,805,664,375,289,1,1,31,27,4,109,95,14,0
2021,Kirklees 059B,E01011181,837,612,354,258,1,1,15,4,11,209,186,23,0
2021,Kirklees 058B,E01011182,759,599,340,259,0,0,47,42,5,112,98,14,1
2021,Kirklees 059C,E01011183,920,745,374,371,12,12,10,2,8,153,121,32,0
2021,Kirklees 059D,E01011184,579,373,207,166,2,2,145,130,15,59,49,10,0
2021,Kirklees 059E,E01011185,719,569,326,243,0,0,56,32,24,93,82,11,1
2021,Kirklees 058C,E01011186,791,643,394,249,13,13,22,6,16,113,95,18,0
2021,Kirklees 059F,E01011187,690,551,313,238,0,0,48,41,7,90,81,9,1
2021,Kirklees 058D,E01011188,716,550,330,220,2,2,89,75,14,72,65,7,3
2021,Kirklees 059G,E01011189,774,671,385,286,3,3,21,5,16,79,73,6,0
2021,Kirklees 051A,E01011190,729,583,339,244,2,2,2,1,1,142,128,14,0
2021,Kirklees 046A,E01011191,663,561,330,231,1,1,34,31,3,67,54,13,0
2021,Kirklees 046B,E01011192,715,445,241,204,3,3,161,147,14,105,90,15,1
2021,Kirklees 046C,E01011193,933,738,336,402,12,12,89,75,14,92,76,16,2
2021,Kirklees 046D,E01011194,602,549,362,187,2,2,5,5,0,46,38,8,0
2021,Kirklees 051B,E01011195,494,420,245,175,0,0,31,21,10,43,33,10,0
2021,Kirklees 051C,E01011196,782,675,379,296,7,7,16,5,11,83,65,18,1
2021,Kirklees 051D,E01011197,666,455,258,197,13,13,98,96,2,100,88,12,0
2021,Kirklees 056C,E01011198,659,566,329,237,2,2,10,7,3,79,60,19,2
2021,Kirklees 056D,E01011199,616,497,277,220,4,4,43,29,14,71,58,13,1
2021,Kirklees 032D,E01011200,887,653,271,382,2,2,28,5,23,204,185,19,0
2021,Kirklees 030A,E01011201,895,512,314,198,1,1,139,87,52,243,227,16,0
2021,Kirklees 036C,E01011202,717,476,294,182,0,0,137,106,31,102,81,21,2
2021,Kirklees 030B,E01011203,785,645,358,287,0,0,50,36,14,87,72,15,3
2021,Kirklees 033A,E01011204,554,482,281,201,1,1,14,11,3,56,46,10,1
2021,Kirklees 036D,E01011205,696,562,320,242,0,0,8,4,4,126,114,12,0
2021,Kirklees 033B,E01011206,780,461,242,219,1,1,118,108,10,199,190,9,1
2021,Kirklees 038C,E01011207,624,509,275,234,20,20,13,12,1,82,67,15,0
2021,Kirklees 033C,E01011208,794,395,202,193,8,8,67,42,25,323,299,24,1
2021,Kirklees 027D,E01011210,881,627,336,291,4,4,39,27,12,210,190,20,1
2021,Kirklees 030D,E01011211,792,679,364,315,5,5,36,27,9,72,61,11,0
2021,Kirklees 026A,E01011212,761,410,202,208,4,4,242,222,20,99,92,7,6
2021,Kirklees 026B,E01011213,657,579,339,240,3,3,15,6,9,60,42,18,0
2021,Kirklees 026C,E01011214,668,495,255,240,1,1,65,46,19,107,96,11,0
2021,Kirklees 026D,E01011215,1164,727,381,346,3,3,129,60,69,303,281,22,2
2021,Kirklees 021A,E01011216,603,520,297,223,1,1,12,9,3,70,60,10,0
2021,Kirklees 020C,E01011217,719,593,369,224,4,4,50,43,7,71,58,13,1
2021,Kirklees 020D,E01011218,725,507,252,255,1,1,119,114,5,93,82,11,5
2021,Kirklees 021B,E01011219,715,586,330,256,1,1,37,28,9,91,70,21,0
2021,Kirklees 021C,E01011220,733,354,156,198,0,0,274,263,11,103,94,9,2
2021,Kirklees 021D,E01011221,712,591,319,272,3,3,17,7,10,101,86,15,0
2021,Kirklees 050D,E01011222,909,475,254,221,1,1,215,197,18,214,199,15,4
2021,Kirklees 042B,E01011223,735,317,171,146,0,0,277,258,19,135,119,16,6
2021,Kirklees 048A,E01011224,803,323,178,145,0,0,286,187,99,194,171,23,0
2021,Kirklees 042C,E01011225,714,289,143,146,2,2,170,149,21,250,233,17,3
2021,Kirklees 048B,E01011226,650,539,328,211,4,4,38,30,8,69,60,9,0
2021,Kirklees 048C,E01011227,782,271,131,140,9,9,400,315,85,96,83,13,6
2021,Kirklees 048D,E01011228,643,503,302,201,6,6,68,59,9,66,60,6,0
2021,Kirklees 042D,E01011229,819,147,74,73,3,3,303,113,190,365,347,18,1
2021,Kirklees 043D,E01011230,549,257,146,111,2,2,74,9,65,214,183,31,2
2021,Kirklees 034A,E01011231,729,424,234,190,1,1,32,24,8,272,243,29,0
2021,Kirklees 039A,E01011232,642,279,167,112,1,1,167,90,77,192,166,26,3
2021,Kirklees 039B,E01011233,657,504,236,268,1,1,23,14,9,129,109,20,0
2021,Kirklees 038D,E01011234,685,355,159,196,0,0,197,186,11,127,117,10,6
2021,Kirklees 039C,E01011235,826,210,140,70,3,3,263,174,89,342,313,29,8
2021,Kirklees 034B,E01011236,839,149,93,56,1,1,167,25,142,522,496,26,0
2021,Kirklees 039D,E01011237,637,352,197,155,1,1,74,61,13,206,181,25,4
2021,Kirklees 034C,E01011238,806,361,208,153,3,3,89,4,85,353,330,23,0
2021,Kirklees 034D,E01011239,672,427,240,187,2,2,80,12,68,163,147,16,0
2021,Kirklees 033D,E01011240,785,452,217,235,0,0,112,74,38,218,202,16,3
2021,Kirklees 004A,E01011241,639,524,287,237,2,2,25,2,23,88,79,9,0
2021,Kirklees 004B,E01011242,698,421,196,225,1,1,183,177,6,92,80,12,1
2021,Kirklees 004C,E01011243,738,583,339,244,0,0,32,25,7,123,109,14,0
2021,Kirklees 004D,E01011244,820,618,281,337,4,4,63,50,13,135,119,16,0
2021,Kirklees 009A,E01011245,600,412,227,185,1,1,94,89,5,93,79,14,0
2021,Kirklees 009B,E01011246,640,305,140,165,1,1,245,173,72,86,77,9,3
2021,Kirklees 008B,E01011247,669,540,246,294,0,0,20,4,16,109,97,12,0
2021,Kirklees 009C,E01011248,685,387,181,206,0,0,190,86,104,106,97,9,2
2021,Kirklees 008C,E01011249,716,435,194,241,1,1,190,180,10,86,72,14,4
2021,Kirklees 009D,E01011250,896,408,151,257,1,1,238,202,36,240,229,11,9
2021,Kirklees 008D,E01011251,712,253,103,150,8,8,342,267,75,104,95,9,5
2021,Kirklees 028A,E01011252,497,433,253,180,2,2,16,16,0,46,38,8,0
2021,Kirklees 028B,E01011253,511,244,128,116,2,2,201,198,3,61,52,9,3
2021,Kirklees 028C,E01011254,650,561,345,216,1,1,18,18,0,70,57,13,0
2021,Kirklees 028D,E01011255,617,263,135,128,0,0,284,272,12,68,57,11,2
2021,Kirklees 028E,E01011256,583,286,141,145,1,1,220,215,5,72,64,8,4
2021,Kirklees 024A,E01011257,489,413,340,73,0,0,4,3,1,72,53,19,0
2021,Kirklees 024B,E01011258,408,337,271,66,0,0,7,2,5,64,46,18,0
2021,Kirklees 024C,E01011259,626,310,181,129,1,1,195,140,55,118,102,16,2
2021,Kirklees 023E,E01011260,523,326,176,150,0,0,101,97,4,93,86,7,3
2021,Kirklees 024D,E01011261,428,248,128,120,4,4,110,97,13,65,52,13,1
2021,Kirklees 024E,E01011262,556,299,158,141,3,3,141,134,7,107,95,12,6
2021,Kirklees 024F,E01011263,668,462,262,200,4,4,87,38,49,115,90,25,0
2021,Leeds 011A,E01011264,573,421,263,158,2,2,113,111,2,36,29,7,1
2021,Leeds 009A,E01011265,910,596,291,305,4,4,101,22,79,209,185,24,0
2021,Leeds 008A,E01011266,1139,883,413,470,36,36,27,2,25,192,172,20,1
2021,Leeds 009B,E01011267,725,416,223,193,3,3,204,177,27,97,67,30,5
2021,Leeds 010A,E01011268,630,311,151,160,3,3,252,216,36,61,52,9,3
2021,Leeds 011B,E01011269,756,449,245,204,14,14,187,137,50,105,87,18,1
2021,Leeds 008B,E01011270,676,644,391,253,3,3,12,11,1,17,10,7,0
2021,Leeds 009C,E01011271,892,761,392,369,7,7,47,29,18,77,71,6,0
2021,Leeds 009D,E01011272,566,518,287,231,2,2,4,2,2,42,37,5,0
2021,Leeds 010B,E01011273,726,497,250,247,0,0,66,51,15,163,153,10,0
2021,Leeds 010C,E01011274,669,238,115,123,0,0,329,228,101,101,95,6,1
2021,Leeds 010D,E01011275,610,445,236,209,3,3,92,86,6,67,58,9,3
2021,Leeds 011C,E01011276,793,603,282,321,5,5,61,18,43,124,105,19,0
2021,Leeds 014A,E01011277,642,526,211,315,2,2,38,25,13,76,69,7,0
2021,Leeds 014B,E01011278,740,616,314,302,2,2,11,6,5,111,97,14,0
2021,Leeds 008C,E01011279,578,436,237,199,0,0,78,45,33,64,54,10,0
2021,Leeds 008D,E01011280,843,723,341,382,8,8,25,6,19,86,73,13,1
2021,Leeds 059A,E01011281,902,428,177,251,3,3,244,122,122,226,209,17,1
2021,Leeds 059B,E01011282,617,285,119,166,3,3,166,159,7,159,139,20,4
2021,Leeds 059C,E01011283,633,214,91,123,2,2,362,277,85,53,48,5,2
2021,Leeds 071A,E01011284,1090,260,125,135,0,0,160,135,25,670,652,18,0
2021,Leeds 059D,E01011286,587,423,174,249,0,0,49,23,26,115,102,13,0
2021,Leeds 067B,E01011287,653,443,219,224,3,3,120,4,116,87,78,9,0
2021,Leeds 071B,E01011292,958,145,87,58,2,2,521,401,120,286,278,8,4
2021,Leeds 071C,E01011293,848,240,110,130,10,10,249,190,59,346,331,15,3
2021,Leeds 071D,E01011294,489,142,66,76,0,0,210,146,64,134,106,28,3
2021,Leeds 059E,E01011295,748,314,140,174,10,10,255,221,34,161,148,13,8
2021,Leeds 030A,E01011296,775,664,448,216,2,2,39,34,5,68,46,22,2
2021,Leeds 030B,E01011297,706,564,256,308,0,0,71,37,34,71,60,11,0
2021,Leeds 088A,E01011298,699,377,145,232,2,2,169,162,7,150,143,7,1
2021,Leeds 088B,E01011299,1165,817,278,539,48,48,142,75,67,158,148,10,0
2021,Leeds 089A,E01011300,618,403,172,231,0,0,161,123,38,51,40,11,3
2021,Leeds 089B,E01011301,553,502,281,221,0,0,5,2,3,44,34,10,2
2021,Leeds 088C,E01011302,778,710,413,297,6,6,18,3,15,44,35,9,0
2021,Leeds 088D,E01011303,498,349,189,160,4,4,86,83,3,55,45,10,4
2021,Leeds 089C,E01011304,701,400,192,208,0,0,172,158,14,126,115,11,3
2021,Leeds 089D,E01011305,656,534,247,287,1,1,42,9,33,79,67,12,0
2021,Leeds 089E,E01011306,544,488,245,243,2,2,0,0,0,54,48,6,0
2021,Leeds 103A,E01011307,651,441,214,227,1,1,126,122,4,82,64,18,1
2021,Leeds 103B,E01011308,660,482,250,232,2,2,99,88,11,75,64,11,2
2021,Leeds 030C,E01011309,662,518,295,223,0,0,58,56,2,85,60,25,1
2021,Leeds 030D,E01011310,732,541,286,255,15,15,90,82,8,84,72,12,2
2021,Leeds 022A,E01011311,483,438,240,198,0,0,4,0,4,41,34,7,0
2021,Leeds 086A,E01011312,752,130,62,68,1,1,235,81,154,386,372,14,0
2021,Leeds 091A,E01011313,651,302,150,152,0,0,32,21,11,316,298,18,1
2021,Leeds 091B,E01011314,671,352,176,176,2,2,28,11,17,289,265,24,0
2021,Leeds 090A,E01011315,657,394,210,184,1,1,77,72,5,185,171,14,0
2021,Leeds 086B,E01011316,696,197,105,92,3,3,85,26,59,409,389,20,2
2021,Leeds 090B,E01011317,883,257,122,135,1,1,504,460,44,111,102,9,10
2021,Leeds 090C,E01011318,642,185,79,106,0,0,367,360,7,86,82,4,4
2021,Leeds 091C,E01011319,617,378,192,186,11,11,38,29,9,190,173,17,0
2021,Leeds 091D,E01011320,687,503,255,248,0,0,18,14,4,165,143,22,1
2021,Leeds 090D,E01011321,664,236,113,123,0,0,332,301,31,92,88,4,4
2021,Leeds 091E,E01011322,688,456,258,198,0,0,143,104,39,89,77,12,0
2021,Leeds 051A,E01011323,612,382,183,199,4,4,145,135,10,77,64,13,4
2021,Leeds 046A,E01011324,550,93,28,65,1,1,413,393,20,40,34,6,3
2021,Leeds 046B,E01011325,751,486,184,302,5,5,168,163,5,86,74,12,6
2021,Leeds 046C,E01011326,629,246,94,152,1,1,291,245,46,90,78,12,1
2021,Leeds 052A,E01011327,655,302,138,164,0,0,236,170,66,112,102,10,5
2021,Leeds 052B,E01011328,707,388,148,240,0,0,223,202,21,95,81,14,1
2021,Leeds 051B,E01011329,696,555,272,283,4,4,18,2,16,119,103,16,0
2021,Leeds 051C,E01011330,583,387,194,193,0,0,132,123,9,63,57,6,1
2021,Leeds 058A,E01011331,634,361,162,199,11,11,92,38,54,166,150,16,4
2021,Leeds 046D,E01011332,690,292,119,173,1,1,334,240,94,63,50,13,0
2021,Leeds 051D,E01011333,634,347,167,180,2,2,206,193,13,75,64,11,4
2021,Leeds 058B,E01011334,690,311,138,173,7,7,122,86,36,249,238,11,1
2021,Leeds 052C,E01011335,821,513,242,271,1,1,98,57,41,204,194,10,5
2021,Leeds 058C,E01011336,829,309,140,169,14,14,341,269,72,160,139,21,5
2021,Leeds 058D,E01011337,567,126,33,93,20,20,377,284,93,42,37,5,2
2021,Leeds 064A,E01011338,807,64,45,19,0,0,717,611,106,19,17,2,7
2021,Leeds 060A,E01011339,862,301,109,192,5,5,460,432,28,89,80,9,7
2021,Leeds 060B,E01011340,674,223,92,131,2,2,364,172,192,83,70,13,2
2021,Leeds 061A,E01011341,872,511,158,353,19,19,261,16,245,80,73,7,1
2021,Leeds 060C,E01011342,659,186,76,110,39,39,355,324,31,77,73,4,2
2021,Leeds 061B,E01011343,932,568,207,361,2,2,183,161,22,176,162,14,3
2021,Leeds 065A,E01011344,834,188,88,100,1,1,207,114,93,437,428,9,1
2021,Leeds 061C,E01011345,673,272,110,162,17,17,289,125,164,94,79,15,1
2021,Leeds 060D,E01011346,792,255,99,156,0,0,408,391,17,125,119,6,4
2021,Leeds 065B,E01011347,785,183,91,92,1,1,218,175,43,376,354,22,7
2021,Leeds 065C,E01011348,681,184,77,107,0,0,334,292,42,160,151,9,3
2021,Leeds 065D,E01011349,926,230,134,96,1,1,576,540,36,108,101,7,11
2021,Leeds 034A,E01011350,681,508,263,245,2,2,19,17,2,152,140,12,0
2021,Leeds 034B,E01011351,907,560,278,282,4,4,98,44,54,245,229,16,0
2021,Leeds 034C,E01011352,964,408,160,248,18,18,141,41,100,394,378,16,3
2021,Leeds 034D,E01011353,849,679,294,385,1,1,22,4,18,147,139,8,0
2021,Leeds 038A,E01011354,659,191,73,118,3,3,387,354,33,73,65,8,5
2021,Leeds 038B,E01011355,607,282,89,193,1,1,237,169,68,85,75,10,2
2021,Leeds 042A,E01011356,938,515,244,271,5,5,133,17,116,285,266,19,0
2021,Leeds 038C,E01011357,910,251,98,153,2,2,501,264,237,151,141,10,5
2021,Leeds 042B,E01011358,716,298,145,153,9,9,322,280,42,84,73,11,3
2021,Leeds 042C,E01011359,833,398,196,202,0,0,162,42,120,273,253,20,0
2021,Leeds 042D,E01011360,753,320,205,115,4,4,149,51,98,280,253,27,0
2021,Leeds 042E,E01011361,1142,293,157,136,3,3,588,277,311,250,231,19,8
2021,Leeds 081A,E01011362,1033,313,129,184,2,2,461,362,99,255,233,22,2
2021,Leeds 071E,E01011363,862,225,80,145,3,3,478,453,25,145,134,11,11
2021,Leeds 085A,E01011364,877,205,88,117,12,12,383,334,49,272,255,17,5
2021,Leeds 082A,E01011366,784,182,96,86,4,4,272,148,124,324,308,16,2
2021,Leeds 082C,E01011368,719,103,42,61,8,8,229,136,93,374,363,11,5
2021,Leeds 090E,E01011369,740,392,217,175,2,2,128,55,73,217,204,13,1
2021,Leeds 082D,E01011370,687,259,132,127,6,6,72,58,14,347,333,14,3
2021,Leeds 085B,E01011371,755,147,71,76,2,2,428,342,86,174,162,12,4
2021,Leeds 086C,E01011372,581,122,58,64,21,21,177,91,86,258,249,9,3
2021,Leeds 085C,E01011373,591,137,61,76,2,2,267,229,38,180,166,14,5
2021,Leeds 085D,E01011374,594,212,107,105,1,1,53,22,31,328,316,12,0
2021,Leeds 086D,E01011375,689,202,113,89,0,0,120,46,74,364,346,18,3
2021,Leeds 013A,E01011376,678,627,337,290,11,11,12,4,8,28,22,6,0
2021,Leeds 013B,E01011377,606,561,338,223,1,1,13,3,10,31,25,6,0
2021,Leeds 013C,E01011378,701,245,127,118,1,1,380,319,61,70,63,7,5
2021,Leeds 017A,E01011379,760,361,192,169,0,0,306,180,126,91,76,15,2
2021,Leeds 016A,E01011380,675,558,307,251,0,0,50,42,8,65,56,9,2
2021,Leeds 016B,E01011381,566,513,287,226,4,4,3,0,3,46,34,12,0
2021,Leeds 013D,E01011382,744,656,353,303,11,11,14,1,13,63,55,8,0
2021,Leeds 019A,E01011383,754,497,261,236,5,5,117,75,42,134,119,15,1
2021,Leeds 017B,E01011384,665,483,246,237,1,1,124,115,9,52,41,11,5
2021,Leeds 016C,E01011385,533,439,255,184,0,0,36,35,1,58,50,8,0
2021,Leeds 016D,E01011386,748,603,270,333,5,5,14,4,10,125,114,11,1
2021,Leeds 019B,E01011388,731,508,250,258,13,13,126,103,23,80,67,13,4
2021,Leeds 087A,E01011390,602,390,191,199,2,2,144,134,10,65,55,10,1
2021,Leeds 087B,E01011391,718,505,313,192,1,1,169,167,2,40,35,5,3
2021,Leeds 087C,E01011392,814,614,298,316,3,3,142,121,21,50,44,6,5
2021,Leeds 103C,E01011393,905,697,258,439,26,26,100,78,22,82,72,10,0
2021,Leeds 103D,E01011394,492,409,224,185,0,0,36,32,4,47,35,12,0
2021,Leeds 103E,E01011395,463,349,118,231,0,0,61,54,7,53,48,5,0
2021,Leeds 074A,E01011396,895,487,226,261,5,5,114,95,19,287,263,24,2
2021,Leeds 077A,E01011397,608,508,286,222,1,1,53,51,2,46,38,8,0
2021,Leeds 077B,E01011398,493,444,238,206,1,1,0,0,0,48,41,7,0
2021,Leeds 074B,E01011399,623,489,251,238,2,2,50,41,9,82,71,11,0
2021,Leeds 074C,E01011400,604,437,258,179,0,0,107,105,2,60,45,15,0
2021,Leeds 077C,E01011401,712,637,317,320,7,7,9,1,8,58,50,8,1
2021,Leeds 087D,E01011402,882,692,410,282,10,10,89,76,13,88,72,16,3
2021,Leeds 074D,E01011403,670,520,324,196,2,2,68,26,42,80,68,12,0
2021,Leeds 077D,E01011404,543,502,264,238,1,1,6,2,4,34,31,3,0
2021,Leeds 077E,E01011405,663,572,377,195,5,5,44,3,41,42,28,14,0
2021,Leeds 057A,E01011406,585,513,273,240,1,1,5,4,1,66,59,7,0
2021,Leeds 057B,E01011407,663,508,287,221,1,1,64,59,5,88,79,9,2
2021,Leeds 057C,E01011408,766,613,422,191,1,1,34,7,27,118,104,14,0
2021,Leeds 057D,E01011409,663,455,240,215,1,1,8,3,5,199,182,17,0
2021,Leeds 057E,E01011410,779,676,381,295,0,0,36,6,30,66,56,10,1
2021,Leeds 073A,E01011411,733,608,318,290,0,0,10,8,2,115,99,16,0
2021,Leeds 057F,E01011412,797,700,373,327,2,2,29,5,24,65,52,13,1
2021,Leeds 069A,E01011413,593,532,267,265,1,1,3,0,3,57,48,9,0
2021,Leeds 073B,E01011414,643,534,295,239,1,1,5,1,4,103,89,14,0
2021,Leeds 069B,E01011415,731,544,281,263,2,2,26,20,6,159,139,20,0
2021,Leeds 069C,E01011416,617,488,244,244,2,2,46,42,4,80,66,14,1
2021,Leeds 069D,E01011417,739,554,344,210,1,1,93,48,45,90,75,15,1
2021,Leeds 073C,E01011418,624,519,276,243,3,3,0,0,0,102,85,17,0
2021,Leeds 073D,E01011419,497,468,312,156,0,0,1,1,0,28,22,6,0
2021,Leeds 069E,E01011420,629,577,395,182,1,1,4,2,2,47,30,17,0
2021,Leeds 040A,E01011421,597,309,125,184,2,2,186,141,45,98,90,8,2
2021,Leeds 048A,E01011422,548,186,104,82,3,3,51,12,39,307,289,18,1
2021,Leeds 047A,E01011423,607,307,125,182,3,3,220,191,29,75,60,15,2
2021,Leeds 047B,E01011424,575,296,109,187,3,3,193,143,50,82,68,14,1
2021,Leeds 040B,E01011425,606,491,251,240,2,2,27,25,2,86,71,15,0
2021,Leeds 048B,E01011426,495,196,102,94,2,2,133,41,92,163,150,13,1
2021,Leeds 047C,E01011427,583,219,91,128,2,2,258,234,24,98,87,11,6
2021,Leeds 048C,E01011428,648,253,134,119,3,3,68,37,31,322,281,41,2
2021,Leeds 048D,E01011429,741,202,124,78,4,4,301,89,212,232,217,15,2
2021,Leeds 053A,E01011430,487,200,109,91,1,1,74,47,27,211,194,17,1
2021,Leeds 047D,E01011431,832,245,57,188,16,16,477,419,58,90,83,7,4
2021,Leeds 053B,E01011432,568,188,98,90,0,0,87,42,45,291,267,24,2
2021,Leeds 053C,E01011433,688,121,69,52,2,2,125,88,37,438,402,36,2
2021,Leeds 053D,E01011434,657,179,95,84,5,5,115,63,52,358,331,27,0
2021,Leeds 044A,E01011435,606,66,30,36,0,0,38,5,33,502,495,7,0
2021,Leeds 044D,E01011440,664,149,76,73,3,3,106,17,89,406,397,9,0
2021,Leeds 044E,E01011441,686,182,94,88,4,4,62,19,43,438,421,17,0
2021,Leeds 110A,E01011442,627,76,37,39,0,0,68,18,50,483,474,9,0
2021,Leeds 110B,E01011443,718,121,49,72,4,4,88,16,72,505,498,7,0
2021,Leeds 110C,E01011444,624,49,25,24,1,1,75,17,58,499,497,2,0
2021,Leeds 054A,E01011445,474,45,20,25,3,3,25,5,20,401,397,4,0
2021,Leeds 054B,E01011446,510,79,54,25,3,3,43,7,36,385,382,3,0
2021,Leeds 054C,E01011447,433,63,37,26,6,6,46,13,33,318,312,6,0
2021,Leeds 054D,E01011448,479,35,16,19,0,0,148,43,105,296,292,4,0
2021,Leeds 054E,E01011449,613,63,32,31,2,2,120,72,48,427,417,10,1
2021,Leeds 038D,E01011450,519,257,108,149,5,5,165,163,2,91,84,7,1
2021,Leeds 110D,E01011451,526,209,101,108,4,4,97,9,88,216,208,8,0
2021,Leeds 027A,E01011452,659,575,299,276,1,1,17,2,15,66,54,12,0
2021,Leeds 028A,E01011453,707,547,303,244,0,0,63,2,61,97,86,11,0
2021,Leeds 027B,E01011454,684,550,238,312,1,1,6,3,3,127,122,5,0
2021,Leeds 021A,E01011455,478,454,254,200,0,0,2,0,2,22,20,2,0
2021,Leeds 021B,E01011456,671,616,346,270,5,5,16,1,15,34,30,4,0
2021,Leeds 027C,E01011457,621,497,230,267,0,0,41,38,3,81,60,21,2
2021,Leeds 027D,E01011458,1020,896,318,578,25,25,38,8,30,61,54,7,0
2021,Leeds 021C,E01011459,767,530,310,220,10,10,25,11,14,202,187,15,0
2021,Leeds 028B,E01011460,656,423,173,250,1,1,91,79,12,139,124,15,2
2021,Leeds 021D,E01011461,613,581,340,241,3,3,4,3,1,25,19,6,0
2021,Leeds 028C,E01011462,727,413,166,247,1,1,227,217,10,84,75,9,2
2021,Leeds 028D,E01011463,755,353,159,194,0,0,329,307,22,69,60,9,4
2021,Leeds 028E,E01011464,901,552,224,328,4,4,41,22,19,304,283,21,0
2021,Leeds 027E,E01011465,836,459,219,240,4,4,217,171,46,155,142,13,1
2021,Leeds 094A,E01011466,640,359,168,191,1,1,219,212,7,58,48,10,3
2021,Leeds 112A,E01011467,815,245,93,152,7,7,246,143,103,316,303,13,1
2021,Leeds 112B,E01011468,918,366,125,241,1,1,434,333,101,116,104,12,1
2021,Leeds 094B,E01011469,632,504,270,234,2,2,54,51,3,71,57,14,1
2021,Leeds 112C,E01011470,600,341,175,166,0,0,149,117,32,109,99,10,1
2021,Leeds 092A,E01011471,662,223,117,106,0,0,335,166,169,99,91,8,5
2021,Leeds 092B,E01011472,715,253,102,151,2,2,381,311,70,73,60,13,6
2021,Leeds 092C,E01011473,615,141,48,93,5,5,386,277,109,80,73,7,3
2021,Leeds 092D,E01011474,657,176,63,113,0,0,394,285,109,81,71,10,6
2021,Leeds 094C,E01011475,699,222,105,117,2,2,388,300,88,86,76,10,1
2021,Leeds 094D,E01011476,493,225,98,127,0,0,200,189,11,62,55,7,6
2021,Leeds 045A,E01011477,917,315,143,172,4,4,336,282,54,259,239,20,3
2021,Leeds 056A,E01011478,808,244,103,141,2,2,157,59,98,404,389,15,1
2021,Leeds 056B,E01011479,617,124,47,77,13,13,33,17,16,447,431,16,0
2021,Leeds 045B,E01011480,648,469,256,213,7,7,16,3,13,156,134,22,0
2021,Leeds 056C,E01011481,710,122,52,70,6,6,148,90,58,429,398,31,5
2021,Leeds 056D,E01011482,872,313,134,179,2,2,58,42,16,499,479,20,0
2021,Leeds 056E,E01011483,698,143,80,63,3,3,241,200,41,308,295,13,3
2021,Leeds 033A,E01011484,666,213,89,124,1,1,402,385,17,50,39,11,0
2021,Leeds 033B,E01011485,765,350,170,180,3,3,316,280,36,94,78,16,2
2021,Leeds 045C,E01011488,701,279,85,194,0,0,151,122,29,266,245,21,5
2021,Leeds 045D,E01011489,862,293,131,162,8,8,312,246,66,245,231,14,4
2021,Leeds 101A,E01011491,606,225,97,128,0,0,297,288,9,79,72,7,5
2021,Leeds 101B,E01011492,660,186,74,112,15,15,366,188,178,92,87,5,1
2021,Leeds 101C,E01011493,665,245,109,136,18,18,270,256,14,123,111,12,9
2021,Leeds 101D,E01011494,628,242,105,137,1,1,259,172,87,126,117,9,0
2021,Leeds 100A,E01011496,606,523,204,319,0,0,3,2,1,80,70,10,0
2021,Leeds 101E,E01011497,679,219,99,120,0,0,360,330,30,91,89,2,9
2021,Leeds 105D,E01011500,687,531,298,233,2,2,79,74,5,74,65,9,1
2021,Leeds 099C,E01011502,587,332,141,191,3,3,184,162,22,66,55,11,2
2021,Leeds 032A,E01011504,749,283,112,171,1,1,387,376,11,75,57,18,3
2021,Leeds 025A,E01011505,649,496,258,238,1,1,78,74,4,74,67,7,0
2021,Leeds 025B,E01011506,525,410,182,228,0,0,5,0,5,110,103,7,0
2021,Leeds 025C,E01011507,664,575,238,337,2,2,11,5,6,76,67,9,0
2021,Leeds 024A,E01011508,472,398,194,204,1,1,2,2,0,71,65,6,0
2021,Leeds 023A,E01011509,643,515,298,217,2,2,33,2,31,93,74,19,0
2021,Leeds 025D,E01011510,835,223,110,113,3,3,545,252,293,59,49,10,5
2021,Leeds 023B,E01011511,534,363,189,174,1,1,57,10,47,113,94,19,0
2021,Leeds 023C,E01011512,715,468,239,229,3,3,21,13,8,223,201,22,0
2021,Leeds 031A,E01011513,967,662,287,375,6,6,91,10,81,208,190,18,0
2021,Leeds 025E,E01011514,648,514,230,284,3,3,9,0,9,122,115,7,0
2021,Leeds 023D,E01011515,660,407,220,187,2,2,9,4,5,242,227,15,0
2021,Leeds 023E,E01011516,660,587,285,302,1,1,2,0,2,70,64,6,0
2021,Leeds 024B,E01011517,748,502,211,291,0,0,129,75,54,114,96,18,3
2021,Leeds 093A,E01011518,1004,677,258,419,5,5,110,95,15,212,195,17,0
2021,Leeds 095A,E01011519,679,407,176,231,0,0,209,182,27,59,49,10,4
2021,Leeds 096A,E01011520,672,553,322,231,1,1,22,2,20,96,79,17,0
2021,Leeds 096B,E01011521,997,757,377,380,21,21,62,49,13,157,129,28,0
2021,Leeds 095B,E01011522,591,509,307,202,2,2,8,5,3,72,60,12,0
2021,Leeds 096C,E01011523,816,544,229,315,2,2,116,105,11,152,128,24,2
2021,Leeds 093B,E01011524,556,441,229,212,0,0,15,8,7,100,91,9,0
2021,Leeds 095C,E01011525,697,503,228,275,2,2,28,26,2,164,146,18,0
2021,Leeds 093C,E01011526,491,439,200,239,0,0,4,1,3,46,42,4,2
2021,Leeds 096D,E01011527,774,658,374,284,3,3,6,5,1,107,94,13,0
2021,Leeds 095D,E01011528,620,520,207,313,0,0,35,2,33,65,60,5,0
2021,Leeds 096E,E01011529,585,385,201,184,0,0,135,131,4,63,54,9,2
2021,Leeds 106A,E01011530,638,486,264,222,0,0,25,5,20,127,109,18,0
2021,Leeds 093D,E01011531,770,676,418,258,7,7,25,1,24,61,50,11,1
2021,Leeds 095E,E01011532,705,359,140,219,1,1,244,203,41,100,81,19,1
2021,Leeds 104A,E01011533,750,400,218,182,0,0,126,99,27,223,203,20,1
2021,Leeds 106B,E01011534,1019,737,236,501,18,18,74,11,63,190,177,13,0
2021,Leeds 108A,E01011535,687,604,349,255,0,0,13,11,2,70,58,12,0
2021,Leeds 108B,E01011536,705,591,338,253,6,6,41,34,7,67,54,13,0
2021,Leeds 107A,E01011537,967,713,413,300,1,1,93,73,20,158,137,21,2
2021,Leeds 107B,E01011538,691,441,191,250,1,1,170,164,6,76,66,10,3
2021,Leeds 102B,E01011540,874,530,148,382,19,19,264,243,21,60,49,11,1
2021,Leeds 104B,E01011541,1187,410,201,209,0,0,331,110,221,444,419,25,2
2021,Leeds 104C,E01011545,665,421,207,214,5,5,38,23,15,200,182,18,1
2021,Leeds 106C,E01011546,783,509,240,269,2,2,73,49,24,198,180,18,1
2021,Leeds 104D,E01011547,940,476,184,292,7,7,239,197,42,218,209,9,0
2021,Leeds 106D,E01011548,642,522,301,221,1,1,33,31,2,85,67,18,1
2021,Leeds 108C,E01011549,517,483,238,245,0,0,2,2,0,32,24,8,0
2021,Leeds 106E,E01011550,562,487,249,238,0,0,7,6,1,68,57,11,0
2021,Leeds 107C,E01011551,731,556,213,343,6,6,72,10,62,97,85,12,0
2021,Leeds 107D,E01011552,601,311,135,176,1,1,224,191,33,65,49,16,0
2021,Leeds 108D,E01011553,611,527,280,247,0,0,28,26,2,54,47,7,2
2021,Leeds 012A,E01011554,586,501,259,242,2,2,13,7,6,70,62,8,0
2021,Leeds 018A,E01011555,564,482,274,208,0,0,14,8,6,66,59,7,2
2021,Leeds 015A,E01011556,791,480,247,233,6,6,50,28,22,255,232,23,0
2021,Leeds 015B,E01011557,612,484,274,210,2,2,72,7,65,54,45,9,0
2021,Leeds 018B,E01011558,735,295,118,177,3,3,327,317,10,104,93,11,6
2021,Leeds 018C,E01011559,591,240,101,139,1,1,270,221,49,76,61,15,4
2021,Leeds 018D,E01011560,866,303,119,184,4,4,472,405,67,85,70,15,2
2021,Leeds 006A,E01011561,529,408,216,192,0,0,19,15,4,101,76,25,1
2021,Leeds 012B,E01011562,625,568,333,235,0,0,1,1,0,56,44,12,0
2021,Leeds 012C,E01011563,611,529,317,212,2,2,10,3,7,70,55,15,0
2021,Leeds 012D,E01011564,608,527,280,247,2,2,14,1,13,65,61,4,0
2021,Leeds 015C,E01011565,592,518,267,251,1,1,10,2,8,63,53,10,0
2021,Leeds 015D,E01011566,555,429,234,195,0,0,23,21,2,103,93,10,0
2021,Leeds 012E,E01011567,560,482,264,218,2,2,3,1,2,73,64,9,0
2021,Leeds 015E,E01011568,906,721,432,289,28,28,20,2,18,137,118,19,0
2021,Leeds 004A,E01011569,898,575,363,212,2,2,57,11,46,264,229,35,0
2021,Leeds 007A,E01011570,965,782,403,379,12,12,82,72,10,87,73,14,2
2021,Leeds 004B,E01011571,756,538,306,232,1,1,104,35,69,112,95,17,1
2021,Leeds 004C,E01011572,828,672,351,321,4,4,33,26,7,119,107,12,0
2021,Leeds 004D,E01011573,543,468,262,206,0,0,46,43,3,29,23,6,0
2021,Leeds 004E,E01011574,697,425,269,156,1,1,149,140,9,119,103,16,3
2021,Leeds 007C,E01011576,580,513,283,230,1,1,13,13,0,51,46,5,2
2021,Leeds 011D,E01011578,618,445,252,193,1,1,72,45,27,100,90,10,0
2021,Leeds 014C,E01011579,520,402,167,235,2,2,50,46,4,66,58,8,0
2021,Leeds 014D,E01011580,620,497,253,244,0,0,57,47,10,66,58,8,0
2021,Leeds 003A,E01011581,731,546,331,215,26,26,113,41,72,46,40,6,0
2021,Leeds 003B,E01011582,745,367,186,181,2,2,315,305,10,50,38,12,11
2021,Leeds 003C,E01011583,648,540,309,231,3,3,52,49,3,53,40,13,0
2021,Leeds 003D,E01011584,760,610,353,257,2,2,80,26,54,67,54,13,1
2021,Leeds 062A,E01011585,670,422,183,239,0,0,161,158,3,85,75,10,2
2021,Leeds 066A,E01011586,699,561,278,283,16,16,12,8,4,110,92,18,0
2021,Leeds 062B,E01011587,794,589,225,364,2,2,39,22,17,164,148,16,0
2021,Leeds 039A,E01011588,708,572,225,347,0,0,54,52,2,82,71,11,0
2021,Leeds 039B,E01011589,700,501,191,310,1,1,54,48,6,144,135,9,0
2021,Leeds 039C,E01011590,662,580,288,292,2,2,22,18,4,58,53,5,0
2021,Leeds 052D,E01011591,830,593,222,371,0,0,38,5,33,199,189,10,0
2021,Leeds 039D,E01011592,794,522,245,277,5,5,127,109,18,137,126,11,3
2021,Leeds 039E,E01011593,853,702,327,375,12,12,10,1,9,129,117,12,0
2021,Leeds 062C,E01011594,630,359,143,216,1,1,219,215,4,48,43,5,3
2021,Leeds 066B,E01011595,803,535,293,242,1,1,11,5,6,255,233,22,1
2021,Leeds 062D,E01011596,781,604,299,305,0,0,4,1,3,173,156,17,0
2021,Leeds 066C,E01011597,561,451,219,232,1,1,6,3,3,103,88,15,0
2021,Leeds 062E,E01011598,753,545,216,329,1,1,38,27,11,167,154,13,2
2021,Leeds 066D,E01011599,706,511,230,281,3,3,77,61,16,114,105,9,1
2021,Leeds 079A,E01011600,691,523,255,268,8,8,67,38,29,92,80,12,1
2021,Leeds 079B,E01011601,665,391,151,240,6,6,141,132,9,125,105,20,2
2021,Leeds 076A,E01011602,911,551,256,295,17,17,185,123,62,155,138,17,3
2021,Leeds 076B,E01011603,709,521,275,246,4,4,41,23,18,143,125,18,0
2021,Leeds 079C,E01011604,624,449,207,242,1,1,63,51,12,110,100,10,1
2021,Leeds 076C,E01011605,715,624,313,311,0,0,38,26,12,51,38,13,2
2021,Leeds 076D,E01011606,762,623,287,336,4,4,8,4,4,126,99,27,1
2021,Leeds 079D,E01011607,710,488,220,268,10,10,102,100,2,108,100,8,2
2021,Leeds 068A,E01011608,597,345,170,175,0,0,183,179,4,67,60,7,2
2021,Leeds 068B,E01011609,659,319,155,164,3,3,253,207,46,83,75,8,1
2021,Leeds 068C,E01011610,694,504,263,241,1,1,33,16,17,155,143,12,1
2021,Leeds 068D,E01011611,621,261,99,162,0,0,299,289,10,60,48,12,1
2021,Leeds 079E,E01011612,742,306,159,147,5,5,252,232,20,173,160,13,6
2021,Leeds 076E,E01011613,695,431,178,253,1,1,176,94,82,86,77,9,1
2021,Leeds 068E,E01011614,854,613,290,323,16,16,58,48,10,165,147,18,2
2021,Leeds 070A,E01011615,650,438,220,218,2,2,18,11,7,192,173,19,0
2021,Leeds 072A,E01011616,697,290,145,145,0,0,359,87,272,46,35,11,2
2021,Leeds 070B,E01011617,685,322,156,166,1,1,274,271,3,84,69,15,4
2021,Leeds 070C,E01011618,710,321,181,140,1,1,108,85,23,280,260,20,0
2021,Leeds 072B,E01011620,495,238,115,123,0,0,226,207,19,30,24,6,1
2021,Leeds 070D,E01011621,594,249,113,136,1,1,275,269,6,68,58,10,1
2021,Leeds 072C,E01011622,703,180,59,121,17,17,416,357,59,85,70,15,5
2021,Leeds 075B,E01011623,701,168,95,73,1,1,259,188,71,270,245,25,3
2021,Leeds 072D,E01011624,727,185,55,130,2,2,444,367,77,90,76,14,6
2021,Leeds 075C,E01011625,730,259,145,114,2,2,112,85,27,354,332,22,3
2021,Leeds 075D,E01011626,1168,232,77,155,3,3,483,284,199,446,429,17,4
2021,Leeds 098A,E01011627,586,374,224,150,1,1,160,147,13,51,40,11,0
2021,Leeds 098B,E01011628,584,530,328,202,1,1,4,3,1,49,38,11,0
2021,Leeds 098C,E01011629,625,368,181,187,2,2,186,79,107,69,63,6,0
2021,Leeds 100B,E01011630,894,694,304,390,1,1,42,9,33,157,145,12,0
2021,Leeds 098D,E01011632,597,244,86,158,2,2,273,200,73,77,59,18,1
2021,Leeds 098E,E01011633,642,473,250,223,1,1,89,85,4,75,64,11,4
2021,Leeds 100C,E01011634,678,448,240,208,0,0,149,145,4,80,67,13,1
2021,Leeds 097B,E01011635,773,564,267,297,3,3,57,47,10,149,140,9,0
2021,Leeds 100D,E01011636,838,645,366,279,0,0,84,62,22,109,93,16,0
2021,Leeds 097C,E01011637,724,547,230,317,3,3,69,47,22,101,85,16,4
2021,Leeds 097D,E01011638,623,507,282,225,2,2,49,44,5,65,54,11,0
2021,Leeds 100E,E01011639,638,372,182,190,4,4,189,188,1,69,59,10,4
2021,Leeds 032B,E01011641,613,520,262,258,2,2,9,4,5,81,77,4,1
2021,Leeds 032C,E01011642,492,423,193,230,5,5,5,2,3,59,51,8,0
2021,Leeds 037A,E01011643,633,498,299,199,2,2,16,10,6,117,103,14,0
2021,Leeds 037B,E01011644,558,313,165,148,2,2,175,7,168,68,58,10,0
2021,Leeds 032D,E01011645,617,437,195,242,6,6,23,9,14,149,140,9,2
2021,Leeds 037C,E01011646,651,525,237,288,1,1,19,17,2,105,87,18,1
2021,Leeds 037D,E01011647,542,358,207,151,0,0,22,5,17,162,154,8,0
2021,Leeds 037E,E01011648,578,473,237,236,1,1,1,0,1,103,87,16,0
2021,Leeds 022B,E01011649,657,583,341,242,2,2,4,1,3,68,58,10,0
2021,Leeds 020A,E01011650,603,483,240,243,1,1,36,32,4,82,72,10,1
2021,Leeds 020B,E01011651,638,420,175,245,1,1,130,37,93,87,83,4,0
2021,Leeds 024C,E01011652,560,444,232,212,2,2,38,4,34,76,67,9,0
2021,Leeds 020C,E01011653,633,396,207,189,3,3,9,3,6,225,218,7,0
2021,Leeds 024D,E01011654,532,496,246,250,0,0,5,4,1,31,29,2,0
2021,Leeds 020D,E01011655,724,494,295,199,0,0,32,6,26,197,183,14,1
2021,Leeds 035A,E01011656,638,250,96,154,0,0,302,292,10,81,72,9,5
2021,Leeds 035B,E01011657,605,227,121,106,1,1,330,324,6,45,33,12,2
2021,Leeds 040C,E01011658,753,183,57,126,9,9,467,414,53,89,81,8,5
2021,Leeds 035C,E01011659,663,246,107,139,2,2,331,326,5,81,58,23,3
2021,Leeds 040D,E01011660,757,331,88,243,35,35,285,229,56,103,82,21,3
2021,Leeds 035D,E01011661,878,218,118,100,0,0,603,531,72,48,37,11,9
2021,Leeds 040E,E01011662,518,94,33,61,0,0,381,322,59,40,36,4,3
2021,Leeds 050A,E01011663,591,200,37,163,25,25,315,232,83,50,40,10,1
2021,Leeds 050B,E01011664,578,296,114,182,3,3,225,180,45,52,41,11,2
2021,Leeds 050C,E01011665,648,367,200,167,4,4,191,183,8,83,76,7,3
2021,Leeds 061D,E01011666,595,514,276,238,0,0,20,17,3,61,54,7,0
2021,Leeds 050D,E01011667,543,81,30,51,0,0,416,361,55,45,41,4,1
2021,Leeds 110E,E01011668,598,76,41,35,3,3,101,35,66,418,408,10,0
2021,Leeds 110F,E01011669,523,129,49,80,6,6,66,39,27,322,310,12,0
2021,Leeds 055A,E01011670,783,133,72,61,1,1,413,312,101,229,220,9,7
2021,Leeds 055B,E01011671,639,150,60,90,4,4,355,264,91,124,113,11,6
2021,Leeds 064B,E01011673,788,97,57,40,3,3,286,31,255,400,378,22,2
2021,Leeds 064D,E01011677,781,115,64,51,3,3,384,311,73,274,237,37,5
2021,Leeds 063B,E01011678,857,76,34,42,2,2,201,113,88,577,568,9,1
2021,Leeds 063D,E01011681,641,74,43,31,3,3,289,148,141,274,263,11,1
2021,Leeds 019C,E01011684,646,507,261,246,2,2,70,67,3,64,58,6,3
2021,Leeds 109A,E01011685,849,525,262,263,11,11,47,6,41,266,244,22,0
2021,Leeds 033E,E01011686,801,283,124,159,1,1,435,389,46,79,71,8,3
2021,Leeds 109B,E01011687,588,473,240,233,1,1,34,17,17,78,67,11,2
2021,Leeds 031B,E01011688,609,403,168,235,3,3,94,17,77,109,100,9,0
2021,Leeds 031C,E01011689,799,515,269,246,1,1,139,35,104,144,104,40,0
2021,Leeds 109C,E01011690,664,423,283,140,3,3,22,3,19,215,197,18,1
2021,Leeds 031D,E01011691,690,252,104,148,0,0,283,107,176,151,139,12,4
2021,Leeds 109D,E01011692,719,421,221,200,1,1,44,22,22,252,240,12,1
2021,Leeds 109E,E01011693,758,367,122,245,0,0,30,21,9,361,348,13,0
2021,Leeds 109F,E01011694,732,362,191,171,2,2,27,11,16,341,331,10,0
2021,Leeds 019D,E01011695,727,268,110,158,2,2,368,339,29,85,71,14,4
2021,Leeds 006B,E01011696,657,591,346,245,3,3,34,30,4,28,20,8,1
2021,Leeds 002A,E01011697,688,500,266,234,8,8,94,61,33,84,66,18,2
2021,Leeds 001A,E01011698,632,518,293,225,1,1,55,52,3,57,50,7,1
2021,Leeds 001B,E01011699,576,506,310,196,1,1,5,1,4,64,55,9,0
2021,Leeds 002B,E01011700,603,506,326,180,6,6,35,13,22,56,51,5,0
2021,Leeds 001C,E01011701,597,503,315,188,8,8,36,23,13,49,42,7,1
2021,Leeds 001D,E01011702,665,605,342,263,4,4,14,8,6,42,34,8,0
2021,Leeds 001E,E01011703,565,539,406,133,0,0,7,2,5,19,16,3,0
2021,Leeds 002C,E01011704,1146,611,335,276,29,29,273,165,108,231,201,30,2
2021,Leeds 002D,E01011705,642,361,176,185,2,2,217,194,23,60,56,4,2
2021,Leeds 006C,E01011706,617,544,329,215,0,0,14,10,4,58,48,10,1
2021,Leeds 005A,E01011707,593,472,285,187,1,1,81,80,1,38,29,9,1
2021,Leeds 006D,E01011708,628,522,297,225,0,0,43,41,2,63,55,8,0
2021,Leeds 005B,E01011709,847,669,396,273,32,32,79,28,51,66,49,17,1
2021,Leeds 005C,E01011710,626,496,257,239,3,3,46,38,8,80,69,11,1
2021,Leeds 005D,E01011711,659,490,295,195,1,1,71,68,3,95,89,6,2
2021,Leeds 005E,E01011712,607,440,233,207,0,0,67,65,2,100,82,18,0
2021,Leeds 006E,E01011713,705,645,342,303,0,0,10,9,1,50,34,16,0
2021,Leeds 029A,E01011714,774,636,308,328,2,2,83,75,8,53,35,18,0
2021,Leeds 022C,E01011715,582,519,272,247,3,3,14,2,12,46,41,5,0
2021,Leeds 029B,E01011716,623,534,275,259,1,1,24,16,8,64,48,16,0
2021,Leeds 029C,E01011717,724,455,213,242,0,0,213,99,114,56,40,16,0
2021,Leeds 029D,E01011718,824,478,147,331,13,13,228,143,85,103,84,19,2
2021,Leeds 022D,E01011719,631,543,321,222,0,0,52,50,2,34,31,3,2
2021,Leeds 029E,E01011720,693,312,120,192,2,2,295,286,9,79,70,9,5
2021,Leeds 041A,E01011721,618,275,126,149,1,1,245,216,29,97,86,11,0
2021,Leeds 041B,E01011722,910,493,160,333,4,4,285,235,50,127,114,13,1
2021,Leeds 041C,E01011723,711,269,127,142,2,2,353,261,92,87,68,19,0
2021,Leeds 041D,E01011724,842,373,149,224,7,7,382,269,113,78,66,12,2
2021,Leeds 078A,E01011725,677,180,84,96,5,5,425,408,17,63,51,12,4
2021,Leeds 080A,E01011726,659,300,139,161,6,6,288,275,13,64,57,7,1
2021,Leeds 080B,E01011727,681,516,234,282,4,4,68,51,17,90,85,5,3
2021,Leeds 080C,E01011728,615,510,304,206,1,1,40,20,20,64,54,10,0
2021,Leeds 078B,E01011729,797,253,102,151,6,6,253,227,26,282,263,19,3
2021,Leeds 078C,E01011730,678,290,112,178,2,2,249,238,11,132,118,14,5
2021,Leeds 081B,E01011731,599,502,249,253,0,0,46,25,21,51,38,13,0
2021,Leeds 081C,E01011732,803,619,280,339,2,2,46,36,10,136,121,15,0
2021,Leeds 081D,E01011733,727,516,275,241,36,36,75,15,60,100,89,11,0
2021,Leeds 083A,E01011734,1192,907,295,612,3,3,36,24,12,246,225,21,0
2021,Leeds 078D,E01011735,708,274,137,137,3,3,348,340,8,78,67,11,5
2021,Leeds 083B,E01011736,642,494,251,243,2,2,72,43,29,73,65,8,1
2021,Leeds 083C,E01011737,765,354,187,167,0,0,184,144,40,222,208,14,5
2021,Leeds 083D,E01011738,651,499,253,246,1,1,72,69,3,77,67,10,2
2021,Leeds 080D,E01011739,738,305,155,150,0,0,377,360,17,53,45,8,3
2021,Wakefield 001A,E01011740,683,272,108,164,3,3,339,252,87,68,54,14,1
2021,Wakefield 001B,E01011741,629,492,308,184,1,1,83,68,15,53,47,6,0
2021,Wakefield 001C,E01011742,724,321,151,170,3,3,324,189,135,75,67,8,1
2021,Wakefield 003A,E01011743,596,568,352,216,0,0,7,5,2,21,18,3,0
2021,Wakefield 003B,E01011744,685,608,341,267,13,13,8,5,3,56,44,12,0
2021,Wakefield 001D,E01011745,686,230,91,139,1,1,396,319,77,58,49,9,1
2021,Wakefield 001E,E01011746,932,448,146,302,12,12,391,300,91,81,71,10,0
2021,Wakefield 003C,E01011747,735,266,120,146,1,1,415,305,110,51,47,4,2
2021,Wakefield 005A,E01011748,663,524,318,206,1,1,51,45,6,87,71,16,0
2021,Wakefield 003D,E01011750,610,221,114,107,2,2,322,246,76,61,55,6,4
2021,Wakefield 005C,E01011751,529,456,242,214,0,0,8,4,4,65,54,11,0
2021,Wakefield 002A,E01011752,821,484,245,239,6,6,72,41,31,259,224,35,0
2021,Wakefield 002B,E01011753,642,434,254,180,1,1,47,29,18,159,144,15,1
2021,Wakefield 003E,E01011754,649,392,200,192,4,4,202,154,48,50,36,14,1
2021,Wakefield 005D,E01011755,683,601,336,265,3,3,16,8,8,63,51,12,0
2021,Wakefield 002C,E01011756,721,239,142,97,2,2,378,278,100,101,91,10,1
2021,Wakefield 004A,E01011757,975,672,253,419,8,8,187,140,47,107,96,11,1
2021,Wakefield 013A,E01011758,1057,571,168,403,34,34,250,186,64,202,187,15,0
2021,Wakefield 004B,E01011759,884,414,179,235,9,9,360,249,111,101,87,14,0
2021,Wakefield 004C,E01011761,965,713,322,391,2,2,85,53,32,164,146,18,1
2021,Wakefield 002E,E01011762,742,456,261,195,1,1,16,5,11,269,247,22,0
2021,Wakefield 004D,E01011763,726,339,184,155,0,0,261,169,92,126,105,21,0
2021,Wakefield 004E,E01011764,809,384,156,228,10,10,262,183,79,152,132,20,1
2021,Wakefield 032A,E01011765,817,560,248,312,17,17,151,107,44,89,75,14,0
2021,Wakefield 032B,E01011766,672,461,224,237,1,1,130,87,43,80,62,18,0
2021,Wakefield 034A,E01011767,763,646,393,253,2,2,66,47,19,49,37,12,0
2021,Wakefield 034B,E01011768,594,502,304,198,0,0,19,13,6,73,60,13,0
2021,Wakefield 034D,E01011770,816,521,297,224,10,10,184,122,62,101,87,14,0
2021,Wakefield 040A,E01011771,609,270,136,134,0,0,281,183,98,57,47,10,1
2021,Wakefield 040B,E01011772,725,543,281,262,0,0,61,45,16,121,97,24,0
2021,Wakefield 032C,E01011773,614,568,385,183,1,1,7,4,3,38,32,6,0
2021,Wakefield 032D,E01011774,641,469,265,204,4,4,112,87,25,55,48,7,1
2021,Wakefield 024B,E01011776,655,373,177,196,2,2,187,147,40,91,80,11,2
2021,Wakefield 024C,E01011777,642,424,240,184,1,1,84,66,18,133,115,18,0
2021,Wakefield 024D,E01011778,701,462,244,218,0,0,109,70,39,130,116,14,0
2021,Wakefield 027A,E01011779,609,391,219,172,21,21,144,111,33,53,43,10,0
2021,Wakefield 027B,E01011780,843,249,102,147,9,9,527,405,122,57,52,5,1
2021,Wakefield 027C,E01011781,1088,602,221,381,24,24,323,198,125,138,124,14,1
2021,Wakefield 027D,E01011782,688,520,284,236,1,1,99,76,23,68,54,14,0
2021,Wakefield 027E,E01011783,772,482,213,269,6,6,65,39,26,219,198,21,0
2021,Wakefield 040C,E01011784,773,508,295,213,3,3,177,112,65,85,65,20,0
2021,Wakefield 039A,E01011785,918,613,212,401,3,3,121,78,43,181,147,34,0
2021,Wakefield 040D,E01011786,635,417,201,216,1,1,92,21,71,125,108,17,0
2021,Wakefield 042A,E01011787,765,562,346,216,3,3,61,18,43,139,120,19,0
2021,Wakefield 042B,E01011788,748,595,375,220,3,3,68,34,34,82,71,11,0
2021,Wakefield 039B,E01011789,563,271,141,130,6,6,198,132,66,88,78,10,0
2021,Wakefield 042C,E01011790,773,347,194,153,0,0,248,172,76,178,164,14,0
2021,Wakefield 039C,E01011791,637,347,194,153,0,0,205,147,58,85,71,14,0
2021,Wakefield 039D,E01011792,622,190,90,100,8,8,339,270,69,83,71,12,2
2021,Wakefield 029A,E01011793,744,542,324,218,6,6,120,72,48,76,58,18,0
2021,Wakefield 029B,E01011794,598,369,190,179,2,2,161,121,40,66,55,11,0
2021,Wakefield 029C,E01011795,598,329,183,146,0,0,210,156,54,59,52,7,0
2021,Wakefield 029D,E01011796,676,543,263,280,5,5,68,57,11,60,45,15,0
2021,Wakefield 031A,E01011797,767,676,365,311,8,8,22,11,11,60,52,8,1
2021,Wakefield 031B,E01011798,679,412,223,189,0,0,56,15,41,211,191,20,0
2021,Wakefield 029E,E01011799,750,378,217,161,19,19,281,185,96,71,60,11,1
2021,Wakefield 029F,E01011800,748,535,284,251,2,2,54,38,16,157,143,14,0
2021,Wakefield 031C,E01011801,649,440,227,213,1,1,131,88,43,76,64,12,1
2021,Wakefield 031D,E01011802,648,488,308,180,0,0,82,61,21,78,68,10,0
2021,Wakefield 011A,E01011803,852,531,160,371,4,4,249,190,59,68,59,9,0
2021,Wakefield 011B,E01011804,699,453,273,180,13,13,159,121,38,74,58,16,0
2021,Wakefield 010A,E01011805,643,301,154,147,1,1,272,220,52,68,57,11,1
2021,Wakefield 011C,E01011806,628,425,251,174,2,2,120,100,20,81,72,9,0
2021,Wakefield 010B,E01011807,651,327,157,170,1,1,151,96,55,172,158,14,0
2021,Wakefield 010C,E01011808,867,604,330,274,9,9,123,83,40,131,112,19,0
2021,Wakefield 011D,E01011809,742,346,197,149,3,3,326,238,88,65,56,9,2
2021,Wakefield 010D,E01011810,567,412,212,200,0,0,111,92,19,44,40,4,0
2021,Wakefield 011E,E01011811,679,227,119,108,2,2,364,287,77,86,78,8,0
2021,Wakefield 013B,E01011812,1005,855,387,468,0,0,34,21,13,115,99,16,1
2021,Wakefield 016A,E01011813,730,320,125,195,16,16,335,229,106,57,45,12,2
2021,Wakefield 016B,E01011814,814,356,144,212,3,3,355,257,98,98,84,14,2
2021,Wakefield 016C,E01011815,677,397,204,193,2,2,202,136,66,76,67,9,0
2021,Wakefield 016D,E01011816,637,264,117,147,2,2,320,253,67,51,38,13,0
2021,Wakefield 024E,E01011817,628,367,141,226,3,3,218,158,60,40,32,8,0
2021,Wakefield 024F,E01011818,613,447,264,183,1,1,92,65,27,72,57,15,1
2021,Wakefield 016E,E01011819,788,453,241,212,0,0,74,24,50,261,250,11,0
2021,Wakefield 013C,E01011820,662,444,199,245,1,1,74,28,46,143,125,18,0
2021,Wakefield 013D,E01011821,617,400,214,186,15,15,156,103,53,46,40,6,0
2021,Wakefield 016F,E01011822,652,431,207,224,1,1,55,42,13,165,154,11,0
2021,Wakefield 021A,E01011823,669,449,244,205,3,3,92,63,29,125,115,10,0
2021,Wakefield 021B,E01011824,689,310,93,217,15,15,281,202,79,82,70,12,1
2021,Wakefield 021C,E01011825,796,560,241,319,0,0,71,60,11,164,149,15,1
2021,Wakefield 021D,E01011826,631,512,277,235,2,2,60,31,29,57,48,9,0
2021,Wakefield 021E,E01011827,533,450,278,172,0,0,43,32,11,40,29,11,0
2021,Wakefield 021F,E01011828,671,474,234,240,1,1,31,23,8,165,149,16,0
2021,Wakefield 025A,E01011829,614,487,265,222,0,0,31,21,10,95,83,12,1
2021,Wakefield 025B,E01011830,724,393,229,164,4,4,217,145,72,110,96,14,0
2021,Wakefield 025C,E01011831,799,432,215,217,2,2,214,83,131,151,136,15,0
2021,Wakefield 025D,E01011832,660,381,210,171,2,2,178,131,47,99,82,17,0
2021,Wakefield 025E,E01011833,661,502,300,202,3,3,92,14,78,62,47,15,2
2021,Wakefield 015A,E01011834,785,535,178,357,4,4,151,108,43,95,79,16,0
2021,Wakefield 012A,E01011835,949,813,394,419,10,10,37,13,24,89,73,16,0
2021,Wakefield 012B,E01011836,606,431,193,238,0,0,58,49,9,117,99,18,0
2021,Wakefield 015B,E01011837,752,408,180,228,0,0,177,124,53,167,148,19,0
2021,Wakefield 015C,E01011838,1094,351,144,207,8,8,424,255,169,309,297,12,2
2021,Wakefield 012C,E01011839,1031,718,319,399,64,64,145,87,58,104,87,17,0
2021,Wakefield 018A,E01011840,811,438,165,273,5,5,266,188,78,101,97,4,1
2021,Wakefield 015D,E01011841,985,678,285,393,14,14,172,90,82,121,110,11,0
2021,Wakefield 015E,E01011842,674,209,116,93,4,4,404,289,115,57,48,9,0
2021,Wakefield 012D,E01011843,681,423,187,236,0,0,159,28,131,99,84,15,0
2021,Wakefield 012E,E01011844,810,668,266,402,12,12,26,11,15,104,89,15,0
2021,Wakefield 023A,E01011845,805,706,464,242,21,21,43,33,10,35,19,16,0
2021,Wakefield 023B,E01011846,595,451,266,185,8,8,46,30,16,90,71,19,0
2021,Wakefield 023C,E01011847,612,540,338,202,1,1,13,5,8,58,51,7,0
2021,Wakefield 023D,E01011848,608,530,331,199,3,3,30,18,12,45,31,14,0
2021,Wakefield 034E,E01011849,722,598,412,186,1,1,35,27,8,88,73,15,0
2021,Wakefield 018B,E01011850,636,277,144,133,2,2,311,224,87,46,39,7,0
2021,Wakefield 023E,E01011851,707,365,209,156,5,5,213,117,96,124,114,10,0
2021,Wakefield 018C,E01011852,683,321,170,151,10,10,282,217,65,69,59,10,1
2021,Wakefield 018D,E01011853,579,332,171,161,0,0,210,163,47,36,26,10,1
2021,Wakefield 041A,E01011854,660,385,161,224,1,1,115,36,79,159,141,18,0
2021,Wakefield 041B,E01011855,645,481,254,227,0,0,79,48,31,85,70,15,0
2021,Wakefield 041C,E01011856,602,437,235,202,2,2,34,21,13,129,109,20,0
2021,Wakefield 034F,E01011857,735,646,412,234,1,1,29,23,6,57,45,12,2
2021,Wakefield 041D,E01011858,728,511,228,283,1,1,132,100,32,84,74,10,0
2021,Wakefield 043A,E01011859,671,290,163,127,3,3,270,214,56,108,91,17,0
2021,Wakefield 044A,E01011860,648,517,292,225,2,2,67,57,10,62,42,20,0
2021,Wakefield 044B,E01011861,826,572,283,289,1,1,98,43,55,155,135,20,0
2021,Wakefield 044C,E01011862,933,491,159,332,9,9,297,185,112,135,120,15,1
2021,Wakefield 044D,E01011863,646,228,106,122,5,5,336,225,111,77,74,3,0
2021,Wakefield 045A,E01011864,668,270,129,141,11,11,326,223,103,60,44,16,1
2021,Wakefield 042D,E01011865,739,361,210,151,3,3,311,239,72,63,51,12,1
2021,Wakefield 045B,E01011866,701,446,222,224,4,4,196,148,48,55,43,12,0
2021,Wakefield 042E,E01011867,683,348,163,185,14,14,234,166,68,85,71,14,2
2021,Wakefield 045C,E01011868,875,528,199,329,3,3,209,154,55,134,117,17,1
2021,Wakefield 043B,E01011869,664,219,127,92,3,3,104,72,32,337,323,14,1
2021,Wakefield 043C,E01011870,635,487,329,158,0,0,86,40,46,62,43,19,0
2021,Wakefield 043D,E01011871,662,412,241,171,0,0,110,78,32,139,126,13,1
2021,Wakefield 045D,E01011872,633,330,161,169,2,2,216,128,88,84,68,16,1
2021,Wakefield 006A,E01011873,884,697,243,454,8,8,35,11,24,144,130,14,0
2021,Wakefield 009A,E01011874,671,568,325,243,4,4,42,23,19,57,47,10,0
2021,Wakefield 007A,E01011875,664,363,157,206,7,7,204,160,44,90,79,11,0
2021,Wakefield 007B,E01011876,1010,670,211,459,18,18,180,113,67,142,120,22,0
2021,Wakefield 006B,E01011877,549,468,250,218,4,4,8,5,3,69,61,8,0
2021,Wakefield 007C,E01011878,665,548,318,230,0,0,25,14,11,92,80,12,0
2021,Wakefield 009B,E01011879,651,492,252,240,2,2,21,14,7,136,118,18,0
2021,Wakefield 007D,E01011880,706,547,290,257,6,6,15,10,5,138,126,12,0
2021,Wakefield 008A,E01011881,678,465,270,195,0,0,84,52,32,129,113,16,0
2021,Wakefield 009C,E01011882,635,511,313,198,0,0,84,69,15,40,35,5,0
2021,Wakefield 009D,E01011883,691,427,217,210,1,1,170,110,60,93,84,9,0
2021,Wakefield 017A,E01011884,1126,741,312,429,23,23,53,39,14,309,290,19,0
2021,Wakefield 014A,E01011885,654,541,302,239,15,15,44,32,12,54,42,12,0
2021,Wakefield 014B,E01011886,882,693,360,333,10,10,94,46,48,85,73,12,0
2021,Wakefield 008B,E01011887,979,861,300,561,17,17,34,9,25,66,49,17,1
2021,Wakefield 014C,E01011888,625,553,342,211,0,0,17,12,5,54,39,15,1
2021,Wakefield 022A,E01011889,653,558,227,331,10,10,28,12,16,57,53,4,0
2021,Wakefield 014D,E01011890,572,462,242,220,11,11,62,36,26,37,30,7,0
2021,Wakefield 014E,E01011891,732,418,206,212,0,0,248,125,123,66,56,10,0
2021,Wakefield 022B,E01011892,786,462,175,287,13,13,192,131,61,118,101,17,1
2021,Wakefield 008C,E01011893,595,512,298,214,0,0,10,7,3,73,55,18,0
2021,Wakefield 006C,E01011894,550,490,288,202,1,1,6,4,2,53,43,10,0
2021,Wakefield 006D,E01011895,579,429,238,191,4,4,97,71,26,49,38,11,0
2021,Wakefield 008D,E01011896,667,439,260,179,4,4,135,98,37,89,73,16,0
2021,Wakefield 008E,E01011897,758,336,167,169,9,9,337,195,142,76,67,9,0
2021,Wakefield 030A,E01011898,733,261,125,136,17,17,135,91,44,320,310,10,0
2021,Wakefield 026A,E01011899,588,241,116,125,9,9,306,245,61,32,23,9,0
2021,Wakefield 026B,E01011900,754,289,158,131,6,6,376,274,102,79,61,18,4
2021,Wakefield 026C,E01011901,590,133,75,58,2,2,419,312,107,36,27,9,0
2021,Wakefield 028A,E01011902,659,452,291,161,2,2,93,54,39,112,93,19,0
2021,Wakefield 028B,E01011903,622,424,288,136,1,1,148,107,41,49,47,2,0
2021,Wakefield 026D,E01011904,564,188,96,92,4,4,343,288,55,27,19,8,2
2021,Wakefield 028C,E01011905,711,620,396,224,7,7,11,7,4,73,55,18,0
2021,Wakefield 030B,E01011906,687,155,54,101,3,3,501,364,137,25,22,3,3
2021,Wakefield 028D,E01011907,915,420,211,209,3,3,252,159,93,238,221,17,2
2021,Wakefield 030C,E01011908,1024,535,273,262,13,13,82,44,38,394,368,26,0
2021,Wakefield 020A,E01011909,594,415,248,167,0,0,95,62,33,83,73,10,1
2021,Wakefield 020B,E01011910,727,201,93,108,2,2,466,338,128,58,53,5,0
2021,Wakefield 020C,E01011911,629,235,84,151,2,2,323,241,82,66,56,10,3
2021,Wakefield 017B,E01011912,814,272,152,120,3,3,215,75,140,321,297,24,3
2021,Wakefield 017C,E01011913,599,278,137,141,1,1,105,64,41,215,192,23,0
2021,Wakefield 020D,E01011914,684,288,117,171,1,1,339,226,113,56,48,8,0
2021,Wakefield 020E,E01011915,631,250,107,143,2,2,199,88,111,178,166,12,2
2021,Wakefield 030D,E01011917,796,246,121,125,2,2,282,167,115,263,241,22,3
2021,Wakefield 026E,E01011918,940,500,177,323,33,33,346,264,82,59,51,8,2
2021,Wakefield 022C,E01011919,830,420,178,242,2,2,213,166,47,194,171,23,1
2021,Wakefield 019A,E01011920,999,390,186,204,2,2,125,39,86,482,460,22,0
2021,Wakefield 022D,E01011921,629,452,218,234,1,1,118,91,27,58,51,7,0
2021,Wakefield 026F,E01011922,630,202,67,135,2,2,387,199,188,39,39,0,0
2021,Wakefield 019B,E01011923,770,507,268,239,4,4,10,3,7,248,229,19,1
2021,Wakefield 019C,E01011924,740,538,288,250,0,0,54,26,28,148,138,10,0
2021,Wakefield 019D,E01011925,695,228,97,131,2,2,362,266,96,100,87,13,3
2021,Wakefield 022E,E01011926,654,263,112,151,1,1,245,170,75,144,131,13,1
2021,Wakefield 022F,E01011927,593,306,136,170,0,0,216,138,78,69,64,5,2
2021,Wakefield 035A,E01011928,641,374,208,166,1,1,194,121,73,71,64,7,1
2021,Wakefield 036A,E01011929,971,800,429,371,25,25,56,31,25,89,78,11,1
2021,Wakefield 036B,E01011930,729,614,334,280,0,0,12,7,5,103,85,18,0
2021,Wakefield 035B,E01011931,630,496,295,201,1,1,82,56,26,51,41,10,0
2021,Wakefield 035C,E01011932,616,531,311,220,1,1,11,9,2,73,61,12,0
2021,Wakefield 036C,E01011933,687,507,294,213,8,8,95,11,84,77,69,8,0
2021,Wakefield 037A,E01011934,700,567,311,256,10,10,28,12,16,94,77,17,1
2021,Wakefield 038A,E01011935,822,682,282,400,2,2,25,18,7,113,100,13,0
2021,Wakefield 037B,E01011936,670,325,153,172,0,0,294,221,73,51,41,10,0
2021,Wakefield 036D,E01011937,611,522,321,201,1,1,10,7,3,78,62,16,0
2021,Wakefield 035D,E01011938,596,491,273,218,3,3,18,12,6,84,66,18,0
2021,Wakefield 033A,E01011939,631,592,367,225,0,0,10,5,5,29,22,7,0
2021,Wakefield 037C,E01011940,680,367,155,212,7,7,233,175,58,73,57,16,0
2021,Wakefield 038B,E01011941,700,491,315,176,26,26,138,86,52,45,33,12,0
2021,Wakefield 038C,E01011942,582,499,314,185,9,9,34,21,13,40,33,7,0
2021,Wakefield 037D,E01011943,951,449,161,288,26,26,397,245,152,77,71,6,2
2021,Wakefield 030E,E01011944,587,329,154,175,2,2,55,10,45,200,180,20,1
2021,Wakefield 033B,E01011945,664,493,305,188,45,45,67,45,22,59,50,9,0
2021,Wakefield 038D,E01011946,626,553,376,177,2,2,8,4,4,62,49,13,1
2021,Wakefield 033C,E01011947,679,630,416,214,0,0,8,7,1,41,34,7,0
2021,Wakefield 033D,E01011948,696,628,396,232,1,1,6,5,1,61,50,11,0
2021,Hartlepool 009A,E01011949,757,437,235,202,4,4,194,96,98,120,101,19,2
2021,Hartlepool 008A,E01011950,553,253,173,80,2,2,60,19,41,231,210,21,7
2021,Hartlepool 007A,E01011951,639,257,130,127,4,4,93,23,70,282,254,28,3
2021,Hartlepool 002A,E01011952,667,250,137,113,12,12,308,109,199,97,80,17,0
2021,Hartlepool 002B,E01011953,826,243,131,112,8,8,457,252,205,116,99,17,2
2021,Hartlepool 001A,E01011954,963,535,246,289,2,2,262,140,122,164,146,18,0
2021,Hartlepool 003A,E01011955,582,224,112,112,4,4,251,99,152,102,87,15,1
2021,Hartlepool 003C,E01011957,545,290,145,145,11,11,110,47,63,134,117,17,0
2021,Hartlepool 014A,E01011959,1132,937,437,500,0,0,57,21,36,138,106,32,0
2021,Hartlepool 014B,E01011960,611,562,390,172,1,1,13,7,6,35,29,6,0
2021,Hartlepool 012A,E01011961,615,355,201,154,0,0,163,75,88,95,87,8,2
2021,Hartlepool 012B,E01011962,609,291,185,106,2,2,242,134,108,73,66,7,1
2021,Hartlepool 014C,E01011963,659,563,378,185,0,0,15,3,12,81,63,18,0
2021,Hartlepool 007B,E01011964,493,349,190,159,0,0,48,9,39,96,83,13,0
2021,Hartlepool 015G,E01011965,650,617,350,267,0,0,7,0,7,25,21,4,1
2021,Hartlepool 015E,E01011966,608,427,230,197,1,1,64,21,43,115,100,15,1
2021,Hartlepool 007C,E01011967,530,427,193,234,1,1,16,4,12,86,79,7,0
2021,Hartlepool 014D,E01011968,949,656,402,254,3,3,168,32,136,121,97,24,1
2021,Hartlepool 001B,E01011969,601,508,333,175,0,0,22,7,15,71,61,10,0
2021,Hartlepool 001C,E01011970,485,438,271,167,1,1,6,3,3,40,33,7,0
2021,Hartlepool 001D,E01011971,521,456,190,266,4,4,10,3,7,51,41,10,0
2021,Hartlepool 015B,E01011974,908,187,112,75,2,2,214,42,172,505,490,15,0
2021,Hartlepool 015D,E01011975,561,303,166,137,1,1,44,16,28,213,191,22,0
2021,Hartlepool 012C,E01011977,736,255,134,121,2,2,326,196,130,152,147,5,1
2021,Hartlepool 012D,E01011978,801,211,89,122,1,1,435,217,218,151,144,7,3
2021,Hartlepool 012E,E01011979,624,218,120,98,0,0,289,158,131,116,105,11,1
2021,Hartlepool 009B,E01011980,773,296,165,131,7,7,340,171,169,127,116,11,3
2021,Hartlepool 009C,E01011981,697,243,121,122,4,4,326,177,149,120,99,21,4
2021,Hartlepool 014E,E01011982,676,632,355,277,14,14,8,2,6,22,14,8,0
2021,Hartlepool 015F,E01011983,652,601,352,249,0,0,11,5,6,40,29,11,0
2021,Hartlepool 009D,E01011984,583,537,353,184,3,3,11,4,7,32,29,3,0
2021,Hartlepool 010A,E01011985,573,438,248,190,1,1,20,11,9,114,98,16,0
2021,Hartlepool 008B,E01011986,535,411,240,171,2,2,48,26,22,74,62,12,0
2021,Hartlepool 008C,E01011987,607,372,207,165,2,2,41,21,20,191,171,20,1
2021,Hartlepool 010B,E01011988,830,464,231,233,2,2,264,110,154,98,83,15,2
2021,Hartlepool 010C,E01011989,820,342,162,180,0,0,387,170,217,87,75,12,4
2021,Hartlepool 010D,E01011990,752,518,251,267,0,0,123,75,48,111,91,20,0
2021,Hartlepool 002C,E01011991,758,465,264,201,0,0,175,64,111,116,96,20,2
2021,Hartlepool 002D,E01011992,850,386,134,252,4,4,284,89,195,176,158,18,0
2021,Hartlepool 002E,E01011993,854,314,167,147,2,2,385,163,222,146,129,17,7
2021,Hartlepool 002F,E01011994,646,165,81,84,0,0,410,173,237,69,63,6,2
2021,Hartlepool 011A,E01011995,572,527,351,176,2,2,5,1,4,38,27,11,0
2021,Hartlepool 011B,E01011996,634,466,278,188,2,2,55,12,43,111,91,20,0
2021,Hartlepool 011C,E01011997,820,714,379,335,2,2,35,12,23,68,56,12,1
2021,Hartlepool 011D,E01011998,933,723,317,406,2,2,107,9,98,100,83,17,1
2021,Hartlepool 007D,E01011999,858,253,162,91,1,1,223,50,173,381,352,29,0
2021,Hartlepool 007E,E01012000,721,122,74,48,0,0,481,211,270,116,107,9,2
2021,Hartlepool 008D,E01012001,945,308,151,157,13,13,451,109,342,172,155,17,1
2021,Hartlepool 015A,E01012002,632,422,224,198,0,0,56,8,48,153,136,17,1
2021,Hartlepool 014F,E01012003,754,678,414,264,1,1,10,2,8,65,49,16,0
2021,Hartlepool 014G,E01012005,723,614,298,316,0,0,28,13,15,81,68,13,0
2021,Middlesbrough 012A,E01012007,648,539,328,211,0,0,10,4,6,99,79,20,0
2021,Middlesbrough 012B,E01012008,538,469,238,231,0,0,13,6,7,55,48,7,1
2021,Middlesbrough 012C,E01012009,820,615,297,318,0,0,9,4,5,196,171,25,0
2021,Middlesbrough 012D,E01012010,550,505,265,240,0,0,4,4,0,41,32,9,0
2021,Middlesbrough 008A,E01012011,858,300,97,203,16,16,448,262,186,91,79,12,3
2021,Middlesbrough 008B,E01012012,638,524,251,273,1,1,12,7,5,101,79,22,0
2021,Middlesbrough 008C,E01012013,615,358,162,196,3,3,108,67,41,146,125,21,0
2021,Middlesbrough 008D,E01012014,627,241,113,128,2,2,221,99,122,161,143,18,2
2021,Middlesbrough 007A,E01012015,730,285,157,128,2,2,360,209,151,80,71,9,3
2021,Middlesbrough 007B,E01012016,832,255,131,124,8,8,390,271,119,177,163,14,2
2021,Middlesbrough 007C,E01012017,726,483,306,177,0,0,98,45,53,144,124,20,1
2021,Middlesbrough 011A,E01012018,645,249,128,121,4,4,170,58,112,220,138,82,2
2021,Middlesbrough 011B,E01012019,557,79,36,43,1,1,451,125,326,25,24,1,1
2021,Middlesbrough 011C,E01012020,595,291,151,140,2,2,209,110,99,93,77,16,0
2021,Middlesbrough 011D,E01012021,531,194,86,108,1,1,229,110,119,103,88,15,4
2021,Middlesbrough 015A,E01012022,1160,962,308,654,8,8,63,13,50,127,104,23,0
2021,Middlesbrough 015B,E01012023,748,650,476,174,3,3,15,3,12,80,63,17,0
2021,Middlesbrough 015C,E01012024,689,589,347,242,4,4,4,1,3,90,74,16,2
2021,Middlesbrough 015D,E01012025,523,463,294,169,4,4,5,3,2,51,42,9,0
2021,Middlesbrough 006A,E01012026,819,634,294,340,5,5,52,17,35,128,110,18,0
2021,Middlesbrough 006B,E01012027,889,308,120,188,16,16,449,251,198,111,98,13,5
2021,Middlesbrough 019A,E01012030,632,494,256,238,12,12,78,5,73,48,43,5,0
2021,Middlesbrough 019B,E01012031,751,351,167,184,5,5,297,128,169,96,87,9,2
2021,Middlesbrough 019C,E01012032,621,522,238,284,21,21,25,12,13,53,48,5,0
2021,Middlesbrough 019D,E01012033,626,212,98,114,5,5,345,125,220,59,48,11,5
2021,Middlesbrough 019E,E01012034,553,342,174,168,2,2,176,15,161,33,22,11,0
2021,Middlesbrough 019F,E01012035,603,296,158,138,0,0,236,95,141,71,64,7,0
2021,Middlesbrough 003A,E01012036,624,150,116,34,1,1,67,12,55,404,382,22,2
2021,Middlesbrough 003B,E01012037,652,191,112,79,4,4,98,21,77,358,330,28,1
2021,Middlesbrough 003C,E01012038,601,202,121,81,0,0,47,13,34,351,335,16,1
2021,Middlesbrough 003D,E01012039,586,108,76,32,2,2,63,30,33,410,393,17,3
2021,Middlesbrough 003E,E01012040,573,147,91,56,0,0,59,16,43,367,342,25,0
2021,Middlesbrough 003F,E01012041,611,88,58,30,5,5,439,255,184,68,64,4,11
2021,Middlesbrough 018A,E01012042,721,292,150,142,2,2,348,55,293,79,59,20,0
2021,Middlesbrough 018B,E01012043,608,487,305,182,0,0,52,27,25,68,52,16,1
2021,Middlesbrough 018C,E01012044,652,128,42,86,0,0,463,149,314,60,55,5,1
2021,Middlesbrough 018D,E01012045,612,144,74,70,3,3,373,219,154,91,77,14,1
2021,Middlesbrough 013A,E01012046,946,797,462,335,0,0,15,8,7,134,114,20,0
2021,Middlesbrough 013B,E01012047,580,482,239,243,1,1,39,8,31,58,50,8,0
2021,Middlesbrough 013C,E01012048,756,674,403,271,0,0,9,4,5,72,54,18,1
2021,Middlesbrough 014A,E01012049,611,473,287,186,7,7,25,11,14,106,89,17,0
2021,Middlesbrough 014B,E01012050,614,249,139,110,2,2,204,127,77,159,144,15,0
2021,Middlesbrough 014C,E01012051,499,242,130,112,1,1,137,82,55,116,104,12,3
2021,Middlesbrough 014D,E01012052,530,411,271,140,0,0,50,33,17,69,63,6,0
2021,Middlesbrough 009A,E01012053,634,513,260,253,14,14,13,4,9,94,81,13,0
2021,Middlesbrough 009B,E01012054,635,476,260,216,0,0,26,3,23,133,115,18,0
2021,Middlesbrough 009C,E01012055,768,584,337,247,7,7,14,6,8,161,138,23,2
2021,Middlesbrough 009D,E01012056,992,484,199,285,8,8,82,38,44,416,391,25,2
2021,Middlesbrough 009E,E01012057,748,491,242,249,22,22,37,9,28,198,172,26,0
2021,Middlesbrough 002A,E01012058,773,227,156,71,2,2,83,36,47,459,417,42,2
2021,Middlesbrough 002B,E01012059,776,230,127,103,6,6,236,80,156,297,271,26,7
2021,Middlesbrough 002C,E01012060,691,217,105,112,0,0,342,248,94,131,124,7,1
2021,Middlesbrough 002D,E01012061,501,236,103,133,0,0,161,116,45,103,89,14,1
2021,Middlesbrough 020A,E01012062,765,699,355,344,10,10,8,5,3,48,39,9,0
2021,Middlesbrough 020B,E01012063,646,537,335,202,2,2,45,3,42,62,48,14,0
2021,Middlesbrough 017A,E01012065,836,701,398,303,9,9,43,8,35,83,71,12,0
2021,Middlesbrough 017B,E01012066,729,635,288,347,13,13,8,5,3,73,65,8,0
2021,Middlesbrough 017C,E01012067,740,646,428,218,3,3,46,7,39,45,36,9,0
2021,Middlesbrough 001A,E01012068,699,79,47,32,1,1,183,35,148,433,409,24,3
2021,Middlesbrough 020D,E01012071,570,552,368,184,0,0,8,6,2,10,7,3,0
2021,Middlesbrough 020E,E01012073,593,514,296,218,4,4,9,3,6,63,49,14,3
2021,Middlesbrough 004A,E01012074,625,327,160,167,3,3,184,135,49,111,95,16,0
2021,Middlesbrough 004B,E01012075,624,224,122,102,1,1,263,192,71,132,120,12,4
2021,Middlesbrough 004C,E01012076,512,140,65,75,0,0,271,199,72,97,89,8,4
2021,Middlesbrough 004D,E01012077,652,306,168,138,2,2,259,161,98,82,67,15,3
2021,Middlesbrough 005A,E01012078,632,223,115,108,1,1,76,11,65,328,313,15,4
2021,Middlesbrough 005B,E01012079,538,401,191,210,2,2,23,10,13,112,88,24,0
2021,Middlesbrough 005C,E01012080,503,359,189,170,0,0,34,18,16,110,93,17,0
2021,Middlesbrough 005D,E01012081,661,413,210,203,5,5,47,20,27,194,174,20,2
2021,Middlesbrough 010A,E01012082,643,305,168,137,0,0,227,162,65,109,98,11,2
2021,Middlesbrough 010B,E01012083,641,238,100,138,14,14,253,169,84,134,122,12,2
2021,Middlesbrough 010C,E01012084,723,208,115,93,2,2,382,214,168,129,121,8,2
2021,Middlesbrough 010D,E01012085,636,241,130,111,0,0,260,184,76,133,122,11,2
2021,Middlesbrough 004E,E01012088,655,319,96,223,9,9,237,137,100,88,80,8,2
2021,Middlesbrough 007D,E01012089,661,173,99,74,2,2,392,264,128,90,84,6,4
2021,Middlesbrough 007E,E01012090,688,169,74,95,1,1,429,245,184,86,74,12,3
2021,Middlesbrough 007F,E01012091,712,257,108,149,1,1,375,265,110,79,72,7,0
2021,Middlesbrough 001D,E01012092,630,142,109,33,3,3,203,46,157,280,268,12,2
2021,Middlesbrough 001E,E01012093,690,185,104,81,2,2,68,28,40,435,394,41,0
2021,Redcar and Cleveland 010A,E01012095,528,480,297,183,0,0,2,1,1,46,39,7,0
2021,Redcar and Cleveland 013A,E01012096,672,392,252,140,0,0,99,26,73,181,159,22,0
2021,Redcar and Cleveland 010B,E01012097,508,396,272,124,1,1,81,27,54,30,23,7,0
2021,Redcar and Cleveland 010C,E01012098,679,495,245,250,5,5,83,30,53,96,85,11,0
2021,Redcar and Cleveland 010D,E01012099,666,292,168,124,0,0,183,64,119,191,178,13,0
2021,Redcar and Cleveland 001A,E01012100,848,237,137,100,4,4,136,37,99,471,440,31,0
2021,Redcar and Cleveland 001B,E01012101,693,404,250,154,1,1,75,8,67,213,190,23,0
2021,Redcar and Cleveland 001C,E01012102,979,480,227,253,3,3,28,10,18,466,411,55,2
2021,Redcar and Cleveland 002A,E01012105,594,421,199,222,6,6,82,36,46,85,69,16,0
2021,Redcar and Cleveland 003C,E01012106,593,443,254,189,3,3,49,23,26,98,66,32,0
2021,Redcar and Cleveland 003D,E01012107,653,251,127,124,3,3,296,110,186,103,90,13,0
2021,Redcar and Cleveland 011A,E01012108,614,309,154,155,2,2,215,135,80,87,75,12,1
2021,Redcar and Cleveland 011B,E01012109,612,442,239,203,1,1,53,23,30,116,98,18,0
2021,Redcar and Cleveland 011C,E01012110,611,440,241,199,5,5,24,8,16,142,125,17,0
2021,Redcar and Cleveland 011D,E01012111,627,259,131,128,7,7,273,92,181,87,73,14,1
2021,Redcar and Cleveland 015A,E01012112,715,156,80,76,0,0,433,235,198,125,116,9,1
2021,Redcar and Cleveland 009A,E01012113,542,160,79,81,0,0,311,198,113,71,67,4,0
2021,Redcar and Cleveland 009B,E01012114,640,123,63,60,7,7,419,189,230,89,85,4,2
2021,Redcar and Cleveland 018A,E01012117,1052,529,266,263,23,23,243,75,168,257,233,24,0
2021,Redcar and Cleveland 018B,E01012118,657,427,264,163,1,1,30,13,17,199,174,25,0
2021,Redcar and Cleveland 018C,E01012119,890,515,260,255,8,8,217,107,110,147,127,20,3
2021,Redcar and Cleveland 020A,E01012120,594,486,343,143,1,1,20,8,12,87,74,13,0
2021,Redcar and Cleveland 018D,E01012121,630,246,124,122,0,0,299,144,155,85,75,10,0
2021,Redcar and Cleveland 020B,E01012124,687,626,405,221,6,6,19,9,10,36,27,9,0
2021,Redcar and Cleveland 005A,E01012127,521,99,42,57,1,1,372,146,226,49,47,2,0
2021,Redcar and Cleveland 005B,E01012128,635,180,94,86,3,3,374,180,194,74,65,9,4
2021,Redcar and Cleveland 005C,E01012129,1009,704,336,368,1,1,208,72,136,93,71,22,3
2021,Redcar and Cleveland 005D,E01012130,586,476,296,180,5,5,34,8,26,71,63,8,0
2021,Redcar and Cleveland 005E,E01012131,644,219,135,84,1,1,375,185,190,48,40,8,1
2021,Redcar and Cleveland 016A,E01012132,885,502,330,172,0,0,242,91,151,139,127,12,2
2021,Redcar and Cleveland 016B,E01012134,698,407,274,133,2,2,201,86,115,88,64,24,0
2021,Redcar and Cleveland 013D,E01012136,635,405,240,165,1,1,40,15,25,189,167,22,0
2021,Redcar and Cleveland 016C,E01012137,590,455,276,179,1,1,60,31,29,74,63,11,0
2021,Redcar and Cleveland 006A,E01012138,1169,976,431,545,36,36,40,12,28,117,92,25,0
2021,Redcar and Cleveland 006B,E01012139,771,719,438,281,0,0,8,2,6,43,31,12,1
2021,Redcar and Cleveland 006C,E01012140,601,403,240,163,2,2,53,13,40,143,129,14,0
2021,Redcar and Cleveland 006D,E01012141,487,435,285,150,0,0,10,8,2,42,36,6,0
2021,Redcar and Cleveland 002B,E01012142,709,471,233,238,2,2,146,69,77,88,65,23,2
2021,Redcar and Cleveland 002C,E01012143,643,254,75,179,25,25,282,108,174,82,76,6,0
2021,Redcar and Cleveland 002D,E01012144,617,485,278,207,3,3,34,17,17,95,78,17,0
2021,Redcar and Cleveland 015B,E01012145,659,397,213,184,3,3,103,56,47,156,138,18,0
2021,Redcar and Cleveland 022A,E01012146,526,477,309,168,2,2,5,2,3,42,29,13,0
2021,Redcar and Cleveland 015C,E01012147,741,668,372,296,0,0,19,4,15,54,40,14,0
2021,Redcar and Cleveland 021A,E01012148,652,241,120,121,4,4,325,157,168,81,72,9,1
2021,Redcar and Cleveland 015D,E01012149,499,448,298,150,0,0,13,7,6,38,29,9,0
2021,Redcar and Cleveland 021B,E01012150,722,283,156,127,0,0,306,158,148,131,120,11,2
2021,Redcar and Cleveland 021C,E01012151,640,554,370,184,0,0,16,10,6,70,52,18,0
2021,Redcar and Cleveland 021D,E01012152,760,687,345,342,3,3,12,7,5,58,35,23,0
2021,Redcar and Cleveland 006E,E01012154,588,505,382,123,0,0,16,8,8,67,52,15,0
2021,Redcar and Cleveland 006F,E01012155,874,485,239,246,9,9,261,89,172,119,100,19,0
2021,Redcar and Cleveland 006G,E01012156,720,644,436,208,1,1,18,9,9,57,42,15,0
2021,Redcar and Cleveland 006H,E01012157,741,472,288,184,0,0,105,31,74,163,140,23,1
2021,Redcar and Cleveland 007A,E01012158,647,562,402,160,0,0,36,15,21,49,39,10,0
2021,Redcar and Cleveland 007B,E01012159,819,339,211,128,2,2,166,19,147,312,286,26,0
2021,Redcar and Cleveland 007C,E01012160,731,551,364,187,1,1,104,34,70,75,60,15,0
2021,Redcar and Cleveland 007D,E01012161,668,469,278,191,1,1,27,8,19,170,150,20,1
2021,Redcar and Cleveland 012A,E01012162,623,443,249,194,10,10,18,9,9,152,140,12,0
2021,Redcar and Cleveland 012B,E01012163,963,845,435,410,1,1,15,5,10,102,90,12,0
2021,Redcar and Cleveland 012C,E01012164,741,500,319,181,1,1,73,30,43,167,156,11,0
2021,Redcar and Cleveland 012D,E01012165,1062,455,191,264,2,2,432,212,220,173,153,20,0
2021,Redcar and Cleveland 022B,E01012167,824,622,232,390,17,17,77,39,38,108,88,20,0
2021,Redcar and Cleveland 022C,E01012168,847,479,175,304,3,3,259,136,123,106,90,16,0
2021,Redcar and Cleveland 022D,E01012170,551,190,113,77,1,1,312,185,127,48,40,8,0
2021,Redcar and Cleveland 011E,E01012171,721,367,231,136,2,2,253,132,121,97,75,22,2
2021,Redcar and Cleveland 011F,E01012172,613,484,304,180,0,0,42,25,17,86,71,15,1
2021,Redcar and Cleveland 022E,E01012173,520,431,264,167,1,1,19,4,15,69,51,18,0
2021,Redcar and Cleveland 022F,E01012174,481,431,256,175,0,0,9,4,5,41,34,7,0
2021,Redcar and Cleveland 009E,E01012175,650,181,91,90,0,0,383,223,160,86,77,9,0
2021,Redcar and Cleveland 004A,E01012176,674,589,354,235,4,4,11,6,5,70,56,14,0
2021,Redcar and Cleveland 004B,E01012177,605,506,298,208,6,6,15,5,10,78,62,16,0
2021,Redcar and Cleveland 004C,E01012178,601,506,292,214,0,0,30,7,23,65,54,11,0
2021,Redcar and Cleveland 004D,E01012179,907,781,355,426,19,19,25,11,14,82,64,18,0
2021,Redcar and Cleveland 004E,E01012180,609,552,251,301,10,10,7,1,6,40,33,7,0
2021,Redcar and Cleveland 016D,E01012181,714,435,214,221,3,3,116,43,73,160,138,22,0
2021,Redcar and Cleveland 020C,E01012182,598,550,407,143,0,0,7,3,4,41,32,9,0
2021,Redcar and Cleveland 020D,E01012183,622,541,307,234,1,1,11,4,7,69,57,12,0
2021,Redcar and Cleveland 001D,E01012184,614,439,243,196,0,0,57,30,27,118,93,25,0
2021,Redcar and Cleveland 004F,E01012185,618,401,198,203,2,2,111,51,60,104,88,16,0
2021,Redcar and Cleveland 004G,E01012186,753,615,372,243,2,2,23,6,17,112,90,22,1
2021,Stockton-on-Tees 011A,E01012187,526,446,230,216,0,0,18,7,11,62,46,16,0
2021,Stockton-on-Tees 011B,E01012188,492,435,232,203,0,0,12,5,7,45,38,7,0
2021,Stockton-on-Tees 011C,E01012189,618,556,371,185,1,1,13,4,9,48,39,9,0
2021,Stockton-on-Tees 015A,E01012190,628,526,302,224,3,3,13,6,7,86,66,20,0
2021,Stockton-on-Tees 015B,E01012191,701,453,287,166,6,6,141,61,80,99,86,13,2
2021,Stockton-on-Tees 007A,E01012192,751,525,316,209,0,0,93,44,49,133,114,19,0
2021,Stockton-on-Tees 007B,E01012193,609,334,138,196,1,1,126,96,30,146,132,14,2
2021,Stockton-on-Tees 010A,E01012194,658,344,148,196,2,2,110,25,85,202,179,23,0
2021,Stockton-on-Tees 010B,E01012195,668,147,74,73,0,0,437,193,244,83,77,6,1
2021,Stockton-on-Tees 003A,E01012196,670,435,224,211,0,0,124,91,33,110,98,12,1
2021,Stockton-on-Tees 002A,E01012197,789,434,199,235,0,0,79,45,34,276,257,19,0
2021,Stockton-on-Tees 003B,E01012198,591,282,148,134,1,1,205,143,62,103,93,10,0
2021,Stockton-on-Tees 021A,E01012199,600,525,343,182,1,1,14,8,6,60,54,6,0
2021,Stockton-on-Tees 021B,E01012200,917,660,382,278,1,1,61,35,26,194,165,29,1
2021,Stockton-on-Tees 021C,E01012201,890,781,419,362,9,9,28,11,17,72,56,16,0
2021,Stockton-on-Tees 021D,E01012202,647,424,234,190,0,0,83,46,37,140,124,16,0
2021,Stockton-on-Tees 021E,E01012203,747,630,275,355,6,6,33,9,24,78,68,10,0
2021,Stockton-on-Tees 013A,E01012204,646,583,420,163,0,0,22,6,16,41,31,10,0
2021,Stockton-on-Tees 011D,E01012205,634,484,286,198,1,1,76,38,38,73,62,11,0
2021,Stockton-on-Tees 013B,E01012206,699,428,282,146,12,12,189,101,88,70,55,15,0
2021,Stockton-on-Tees 013C,E01012207,782,634,342,292,3,3,77,43,34,68,50,18,0
2021,Stockton-on-Tees 013D,E01012208,638,588,310,278,0,0,4,2,2,46,38,8,0
2021,Stockton-on-Tees 016A,E01012209,677,521,276,245,0,0,93,43,50,63,53,10,0
2021,Stockton-on-Tees 006A,E01012210,639,578,357,221,2,2,7,5,2,52,42,10,0
2021,Stockton-on-Tees 006B,E01012211,752,660,319,341,1,1,14,6,8,77,66,11,0
2021,Stockton-on-Tees 006C,E01012212,729,616,373,243,3,3,30,10,20,80,62,18,0
2021,Stockton-on-Tees 006D,E01012213,708,497,368,129,13,13,108,6,102,90,63,27,0
2021,Stockton-on-Tees 003C,E01012214,617,410,192,218,1,1,71,48,23,135,115,20,0
2021,Stockton-on-Tees 003D,E01012215,507,209,102,107,1,1,202,160,42,94,84,10,1
2021,Stockton-on-Tees 003E,E01012216,505,258,125,133,1,1,132,84,48,114,106,8,0
2021,Stockton-on-Tees 016B,E01012217,663,241,119,122,0,0,173,31,142,248,226,22,1
2021,Stockton-on-Tees 016C,E01012218,616,510,271,239,2,2,11,3,8,93,85,8,0
2021,Stockton-on-Tees 012A,E01012219,696,569,266,303,4,4,52,36,16,71,55,16,0
2021,Stockton-on-Tees 016D,E01012223,625,566,343,223,0,0,21,5,16,38,26,12,0
2021,Stockton-on-Tees 015C,E01012224,747,662,388,274,1,1,5,3,2,79,56,23,0
2021,Stockton-on-Tees 015D,E01012225,633,564,337,227,0,0,5,2,3,64,50,14,0
2021,Stockton-on-Tees 015E,E01012226,602,559,356,203,0,0,3,3,0,40,32,8,0
2021,Stockton-on-Tees 027D,E01012227,588,423,147,276,2,2,17,5,12,145,134,11,1
2021,Stockton-on-Tees 022A,E01012228,532,448,215,233,3,3,11,6,5,70,61,9,0
2021,Stockton-on-Tees 022B,E01012230,610,490,221,269,10,10,0,0,0,110,97,13,0
2021,Stockton-on-Tees 028C,E01012231,681,583,198,385,3,3,2,2,0,93,81,12,0
2021,Stockton-on-Tees 028D,E01012232,542,465,206,259,0,0,6,2,4,71,66,5,0
2021,Stockton-on-Tees 022C,E01012233,690,628,311,317,5,5,18,8,10,38,38,0,1
2021,Stockton-on-Tees 028E,E01012234,599,560,264,296,2,2,3,1,2,34,33,1,0
2021,Stockton-on-Tees 024A,E01012235,919,759,329,430,25,25,51,11,40,84,75,9,0
2021,Stockton-on-Tees 022D,E01012236,542,442,269,173,2,2,4,2,2,94,80,14,0
2021,Stockton-on-Tees 022E,E01012237,504,471,267,204,1,1,1,1,0,31,25,6,0
2021,Stockton-on-Tees 018A,E01012238,720,290,131,159,6,6,228,163,65,193,102,91,3
2021,Stockton-on-Tees 018B,E01012239,934,437,77,360,13,13,291,87,204,191,171,20,2
2021,Stockton-on-Tees 018C,E01012240,741,475,241,234,6,6,161,61,100,97,80,17,2
2021,Stockton-on-Tees 018D,E01012241,609,518,299,219,1,1,11,3,8,79,66,13,0
2021,Stockton-on-Tees 001A,E01012242,616,544,333,211,2,2,16,11,5,54,44,10,0
2021,Stockton-on-Tees 001B,E01012243,649,545,267,278,4,4,5,3,2,95,84,11,0
2021,Stockton-on-Tees 001C,E01012244,619,538,291,247,3,3,8,5,3,70,60,10,0
2021,Stockton-on-Tees 003F,E01012245,710,279,159,120,3,3,286,198,88,140,124,16,2
2021,Stockton-on-Tees 001D,E01012246,569,492,279,213,6,6,2,2,0,69,60,9,0
2021,Stockton-on-Tees 008A,E01012247,497,268,112,156,1,1,130,92,38,98,89,9,0
2021,Stockton-on-Tees 009D,E01012248,619,320,180,140,4,4,217,128,89,77,67,10,1
2021,Stockton-on-Tees 008B,E01012249,636,307,128,179,0,0,214,149,65,114,96,18,1
2021,Stockton-on-Tees 009E,E01012250,864,359,134,225,8,8,357,199,158,140,125,15,0
2021,Stockton-on-Tees 012B,E01012251,625,344,169,175,2,2,85,39,46,189,171,18,5
2021,Stockton-on-Tees 012C,E01012252,637,129,52,77,0,0,384,187,197,124,116,8,0
2021,Stockton-on-Tees 012D,E01012253,471,301,128,173,0,0,97,68,29,72,61,11,1
2021,Stockton-on-Tees 012E,E01012254,630,199,109,90,1,1,195,107,88,234,212,22,1
2021,Stockton-on-Tees 005A,E01012255,645,595,430,165,0,0,5,3,2,45,28,17,0
2021,Stockton-on-Tees 002B,E01012256,609,493,351,142,5,5,41,9,32,70,51,19,0
2021,Stockton-on-Tees 002C,E01012257,624,541,328,213,6,6,5,2,3,72,51,21,0
2021,Stockton-on-Tees 010C,E01012258,511,230,121,109,1,1,176,116,60,102,95,7,2
2021,Stockton-on-Tees 010D,E01012259,755,553,319,234,0,0,40,13,27,162,141,21,0
2021,Stockton-on-Tees 007C,E01012260,826,595,357,238,0,0,59,9,50,171,144,27,1
2021,Stockton-on-Tees 007D,E01012261,683,501,262,239,3,3,25,5,20,154,142,12,0
2021,Stockton-on-Tees 026B,E01012262,956,331,119,212,2,2,299,142,157,320,291,29,4
2021,Stockton-on-Tees 025C,E01012267,838,213,135,78,0,0,404,199,205,219,183,36,2
2021,Stockton-on-Tees 010E,E01012268,979,448,179,269,21,21,225,97,128,285,260,25,0
2021,Stockton-on-Tees 005B,E01012269,660,594,365,229,0,0,18,5,13,48,33,15,0
2021,Stockton-on-Tees 021F,E01012270,589,425,237,188,5,5,49,30,19,110,87,23,0
2021,Stockton-on-Tees 008C,E01012271,596,228,103,125,0,0,263,163,100,105,95,10,0
2021,Stockton-on-Tees 008D,E01012272,494,425,275,150,1,1,10,3,7,58,52,6,0
2021,Stockton-on-Tees 008E,E01012273,633,223,97,126,0,0,290,201,89,118,108,10,2
2021,Stockton-on-Tees 008F,E01012274,511,263,96,167,1,1,172,133,39,74,64,10,1
2021,Stockton-on-Tees 002D,E01012275,629,368,164,204,0,0,138,94,44,123,110,13,0
2021,Stockton-on-Tees 002E,E01012276,921,392,175,217,5,5,367,190,177,155,133,22,2
2021,Stockton-on-Tees 002F,E01012277,687,422,212,210,0,0,110,78,32,153,137,16,2
2021,Stockton-on-Tees 004A,E01012278,494,288,132,156,0,0,128,71,57,75,67,8,3
2021,Stockton-on-Tees 004B,E01012279,634,467,226,241,1,1,21,9,12,145,137,8,0
2021,Stockton-on-Tees 004C,E01012280,686,419,216,203,1,1,160,106,54,106,97,9,0
2021,Stockton-on-Tees 004D,E01012281,632,265,140,125,2,2,254,143,111,110,101,9,1
2021,Stockton-on-Tees 020A,E01012282,495,311,188,123,0,0,104,73,31,79,68,11,1
2021,Stockton-on-Tees 020B,E01012283,532,235,118,117,1,1,207,151,56,87,76,11,2
2021,Stockton-on-Tees 020C,E01012284,638,198,111,87,12,12,330,230,100,96,90,6,2
2021,Stockton-on-Tees 020D,E01012285,630,411,262,149,2,2,149,16,133,68,52,16,0
2021,Stockton-on-Tees 017A,E01012286,540,142,75,67,0,0,218,70,148,178,167,11,2
2021,Stockton-on-Tees 017B,E01012287,1039,232,69,163,0,0,361,133,228,444,427,17,2
2021,Stockton-on-Tees 017C,E01012288,548,170,100,70,2,2,153,30,123,221,197,24,2
2021,Stockton-on-Tees 017D,E01012289,502,335,190,145,0,0,60,29,31,107,98,9,0
2021,Stockton-on-Tees 019A,E01012290,884,691,419,272,3,3,93,50,43,95,80,15,2
2021,Stockton-on-Tees 019B,E01012291,738,403,185,218,1,1,181,113,68,153,132,21,0
2021,Stockton-on-Tees 019C,E01012292,862,494,198,296,1,1,138,80,58,228,205,23,1
2021,Stockton-on-Tees 005D,E01012294,555,483,273,210,1,1,25,8,17,46,36,10,0
2021,Stockton-on-Tees 005E,E01012295,561,385,171,214,1,1,122,58,64,53,42,11,0
2021,Stockton-on-Tees 001E,E01012296,598,428,239,189,3,3,96,48,48,70,58,12,1
2021,Stockton-on-Tees 001F,E01012297,987,855,405,450,2,2,54,23,31,76,67,9,0
2021,Stockton-on-Tees 024B,E01012298,553,522,332,190,0,0,5,1,4,26,19,7,0
2021,Stockton-on-Tees 024C,E01012299,702,437,261,176,0,0,7,5,2,258,229,29,0
2021,Stockton-on-Tees 024D,E01012300,726,372,212,160,2,2,242,79,163,110,92,18,0
2021,Stockton-on-Tees 024E,E01012301,558,492,310,182,4,4,2,0,2,60,54,6,0
2021,Stockton-on-Tees 024F,E01012302,507,416,238,178,2,2,4,2,2,85,68,17,0
2021,Stockton-on-Tees 024G,E01012303,928,767,361,406,27,27,52,24,28,82,73,9,0
2021,Darlington 012A,E01012304,632,157,77,80,0,0,248,193,55,227,212,15,0
2021,Darlington 012B,E01012305,585,236,138,98,1,1,64,3,61,284,269,15,0
2021,Darlington 012C,E01012306,595,414,241,173,1,1,40,11,29,140,121,19,0
2021,Darlington 009A,E01012307,1038,446,263,183,0,0,260,71,189,332,308,24,0
2021,Darlington 006A,E01012309,852,692,292,400,30,30,32,9,23,98,78,20,0
2021,Darlington 006B,E01012310,986,749,383,366,1,1,129,91,38,107,95,12,0
2021,Darlington 006C,E01012311,626,331,156,175,0,0,233,23,210,62,52,10,0
2021,Darlington 006D,E01012312,612,205,85,120,1,1,335,274,61,71,57,14,0
2021,Darlington 006E,E01012313,657,355,192,163,2,2,170,163,7,130,113,17,0
2021,Darlington 006F,E01012314,623,250,138,112,1,1,283,269,14,89,78,11,0
2021,Darlington 010A,E01012315,711,642,385,257,1,1,5,4,1,63,49,14,0
2021,Darlington 013A,E01012317,634,492,292,200,1,1,41,15,26,100,80,20,0
2021,Darlington 013B,E01012318,977,339,112,227,5,5,419,371,48,214,195,19,0
2021,Darlington 013C,E01012319,1089,696,314,382,1,1,163,151,12,229,206,23,0
2021,Darlington 002C,E01012323,658,499,239,260,0,0,17,11,6,142,130,12,0
2021,Darlington 002D,E01012324,639,492,286,206,2,2,25,5,20,120,89,31,0
2021,Darlington 005A,E01012325,657,492,282,210,4,4,60,46,14,101,92,9,0
2021,Darlington 005B,E01012326,493,295,133,162,3,3,148,144,4,47,38,9,0
2021,Darlington 009B,E01012327,676,192,87,105,8,8,414,363,51,61,60,1,1
2021,Darlington 003A,E01012328,751,397,223,174,0,0,241,88,153,111,98,13,2
2021,Darlington 003B,E01012329,774,686,451,235,3,3,7,1,6,78,59,19,0
2021,Darlington 003C,E01012330,449,402,241,161,3,3,4,4,0,40,36,4,0
2021,Darlington 003D,E01012331,500,383,222,161,2,2,19,17,2,96,88,8,0
2021,Darlington 005C,E01012332,613,309,146,163,1,1,236,230,6,66,58,8,1
2021,Darlington 005D,E01012333,709,426,241,185,2,2,199,90,109,82,71,11,0
2021,Darlington 001B,E01012334,1077,869,418,451,8,8,35,25,10,164,141,23,1
2021,Darlington 001C,E01012335,696,583,344,239,3,3,60,42,18,50,38,12,0
2021,Darlington 011A,E01012336,748,594,420,174,1,1,115,40,75,38,26,12,0
2021,Darlington 011B,E01012337,751,688,433,255,1,1,13,8,5,49,38,11,0
2021,Darlington 015A,E01012338,924,638,361,277,9,9,119,57,62,158,138,20,0
2021,Darlington 015B,E01012339,828,732,425,307,0,0,24,5,19,72,60,12,0
2021,Darlington 012D,E01012340,1033,594,282,312,1,1,139,80,59,299,279,20,0
2021,Darlington 012E,E01012341,759,272,127,145,2,2,369,332,37,115,101,14,1
2021,Darlington 009C,E01012342,1180,637,239,398,13,13,339,189,150,190,171,19,1
2021,Darlington 015C,E01012344,653,400,190,210,4,4,110,62,48,138,124,14,1
2021,Darlington 015D,E01012345,644,571,362,209,2,2,13,2,11,58,47,11,0
2021,Darlington 015E,E01012346,923,808,292,516,1,1,30,28,2,83,72,11,1
2021,Darlington 011C,E01012347,782,645,412,233,4,4,59,5,54,74,70,4,0
2021,Darlington 011D,E01012348,982,882,552,330,2,2,10,5,5,88,62,26,0
2021,Darlington 004A,E01012349,789,188,90,98,0,0,222,145,77,376,354,22,3
2021,Darlington 004B,E01012350,748,389,199,190,2,2,135,108,27,222,199,23,0
2021,Darlington 004C,E01012351,555,442,227,215,2,2,51,11,40,60,45,15,0
2021,Darlington 004D,E01012352,763,276,134,142,0,0,243,200,43,243,226,17,1
2021,Darlington 016E,E01012353,755,276,136,140,2,2,37,10,27,440,418,22,0
2021,Darlington 016F,E01012354,688,246,128,118,0,0,67,41,26,375,349,26,0
2021,Darlington 016G,E01012355,699,270,155,115,2,2,142,40,102,284,271,13,1
2021,Darlington 014A,E01012356,785,494,223,271,2,2,26,6,20,263,241,22,0
2021,Darlington 014B,E01012357,602,349,180,169,2,2,27,10,17,224,209,15,0
2021,Darlington 014C,E01012358,717,420,229,191,3,3,172,118,54,121,102,19,1
2021,Darlington 014D,E01012359,691,161,50,111,1,1,476,419,57,52,49,3,1
2021,Darlington 010C,E01012360,794,577,356,221,5,5,112,20,92,100,86,14,0
2021,Darlington 011E,E01012361,799,745,444,301,0,0,8,2,6,45,33,12,1
2021,Darlington 016A,E01012362,648,293,151,142,2,2,25,8,17,328,310,18,0
2021,Darlington 016B,E01012363,678,380,177,203,0,0,17,4,13,281,261,20,0
2021,Darlington 016D,E01012364,705,416,211,205,4,4,19,11,8,265,245,20,1
2021,Darlington 016C,E01012365,540,450,262,188,0,0,20,6,14,70,61,9,0
2021,Darlington 001D,E01012366,890,724,435,289,0,0,48,41,7,118,92,26,0
2021,Halton 007A,E01012367,906,274,119,155,18,18,354,110,244,258,243,15,2
2021,Halton 003A,E01012368,907,526,237,289,1,1,191,53,138,188,176,12,1
2021,Halton 005A,E01012369,741,497,226,271,3,3,157,42,115,82,66,16,2
2021,Halton 007B,E01012370,899,406,203,203,0,0,101,21,80,391,368,23,1
2021,Halton 016A,E01012371,528,449,238,211,0,0,10,3,7,69,50,19,0
2021,Halton 016B,E01012372,506,447,266,181,1,1,7,1,6,51,44,7,0
2021,Halton 016C,E01012373,533,483,306,177,14,14,8,1,7,28,24,4,0
2021,Halton 002A,E01012374,1093,926,395,531,3,3,26,6,20,138,125,13,0
2021,Halton 002B,E01012375,566,536,306,230,0,0,8,2,6,22,19,3,0
2021,Halton 002C,E01012376,991,865,286,579,1,1,26,4,22,99,96,3,0
2021,Halton 004A,E01012377,743,420,236,184,2,2,262,94,168,59,51,8,0
2021,Halton 006A,E01012378,670,533,321,212,3,3,78,17,61,56,43,13,0
2021,Halton 006B,E01012379,769,435,203,232,27,27,129,35,94,177,162,15,1
2021,Halton 006C,E01012380,611,237,120,117,1,1,303,105,198,70,62,8,0
2021,Halton 010A,E01012381,794,158,59,99,41,41,547,66,481,47,40,7,1
2021,Halton 010B,E01012382,743,182,122,60,24,24,474,55,419,62,52,10,1
2021,Halton 013A,E01012383,704,435,240,195,10,10,165,22,143,94,81,13,0
2021,Halton 010C,E01012384,759,443,254,189,4,4,229,28,201,83,71,12,0
2021,Halton 009A,E01012385,762,664,258,406,3,3,32,2,30,63,49,14,0
2021,Halton 009B,E01012386,994,911,276,635,17,17,10,2,8,56,51,5,0
2021,Halton 009C,E01012387,494,456,300,156,0,0,13,3,10,25,18,7,0
2021,Halton 006D,E01012388,728,396,171,225,3,3,237,79,158,89,82,7,3
2021,Halton 008A,E01012389,738,679,427,252,2,2,10,3,7,47,30,17,0
2021,Halton 004B,E01012390,660,428,228,200,0,0,152,43,109,80,66,14,0
2021,Halton 008B,E01012391,972,556,282,274,7,7,253,104,149,156,139,17,0
2021,Halton 001A,E01012392,1161,1006,360,646,0,0,35,7,28,120,103,17,0
2021,Halton 001B,E01012393,1153,1007,468,539,1,1,25,7,18,120,101,19,0
2021,Halton 005B,E01012394,838,553,251,302,3,3,170,52,118,111,93,18,1
2021,Halton 001C,E01012395,671,623,388,235,1,1,15,5,10,32,25,7,0
2021,Halton 013B,E01012396,590,250,134,116,1,1,243,61,182,96,81,15,0
2021,Halton 013C,E01012397,720,236,98,138,1,1,390,94,296,91,80,11,2
2021,Halton 011A,E01012398,493,347,181,166,3,3,95,30,65,48,37,11,0
2021,Halton 013D,E01012399,626,288,137,151,2,2,257,68,189,77,71,6,2
2021,Halton 011B,E01012400,511,404,208,196,0,0,42,14,28,65,50,15,0
2021,Halton 008C,E01012401,796,690,420,270,1,1,46,24,22,59,48,11,0
2021,Halton 011C,E01012402,637,302,146,156,4,4,238,51,187,91,82,9,2
2021,Halton 013E,E01012403,726,286,136,150,3,3,324,56,268,112,99,13,1
2021,Halton 011D,E01012404,569,431,217,214,4,4,74,17,57,60,47,13,0
2021,Halton 011E,E01012405,902,599,320,279,1,1,175,36,139,126,113,13,1
2021,Halton 015A,E01012406,619,337,183,154,1,1,235,18,217,46,42,4,0
2021,Halton 015B,E01012407,892,204,103,101,1,1,458,58,400,228,213,15,1
2021,Halton 013F,E01012408,708,183,86,97,6,6,428,48,380,91,78,13,0
2021,Halton 015C,E01012409,607,326,194,132,1,1,188,21,167,92,67,25,0
2021,Halton 003B,E01012410,512,446,262,184,0,0,13,3,10,53,45,8,0
2021,Halton 001D,E01012411,602,493,291,202,1,1,46,12,34,62,54,8,0
2021,Halton 003C,E01012412,830,376,159,217,52,52,230,55,175,172,152,20,0
2021,Halton 003D,E01012413,658,305,152,153,1,1,245,52,193,105,87,18,2
2021,Halton 003E,E01012414,494,438,258,180,3,3,10,2,8,43,33,10,0
2021,Halton 016D,E01012415,534,495,290,205,1,1,8,2,6,30,22,8,0
2021,Halton 012A,E01012416,773,583,305,278,0,0,116,17,99,74,61,13,0
2021,Halton 012B,E01012417,557,403,198,205,0,0,38,5,33,116,105,11,0
2021,Halton 016E,E01012418,625,584,386,198,3,3,11,1,10,27,20,7,0
2021,Halton 004C,E01012419,486,204,103,101,0,0,230,68,162,50,46,4,2
2021,Halton 004D,E01012420,709,171,92,79,0,0,479,92,387,55,48,7,4
2021,Halton 002D,E01012421,530,484,287,197,0,0,4,1,3,42,36,6,0
2021,Halton 004E,E01012422,639,244,124,120,2,2,299,74,225,93,79,14,1
2021,Halton 002E,E01012423,624,473,273,200,5,5,69,10,59,76,64,12,1
2021,Halton 007C,E01012424,755,250,133,117,5,5,381,148,233,119,107,12,0
2021,Halton 005C,E01012425,668,352,195,157,0,0,198,71,127,117,101,16,1
2021,Halton 005D,E01012426,565,458,265,193,1,1,37,15,22,69,51,18,0
2021,Halton 005E,E01012427,687,490,182,308,0,0,124,43,81,73,62,11,0
2021,Halton 012D,E01012429,625,360,176,184,2,2,185,65,120,77,66,11,1
2021,Halton 012E,E01012430,865,222,118,104,1,1,297,41,256,344,318,26,1
2021,Halton 012F,E01012431,1121,535,228,307,0,0,75,11,64,510,482,28,1
2021,Halton 014A,E01012432,637,386,185,201,37,37,105,14,91,109,99,10,0
2021,Halton 014B,E01012433,721,312,197,115,0,0,304,39,265,105,97,8,0
2021,Halton 009D,E01012434,604,518,250,268,22,22,12,1,11,52,32,20,0
2021,Halton 009E,E01012435,774,684,326,358,33,33,38,2,36,19,14,5,0
2021,Halton 014C,E01012436,502,175,96,79,1,1,272,33,239,53,43,10,1
2021,Halton 015D,E01012437,530,210,115,95,0,0,248,26,222,71,62,9,1
2021,Halton 014D,E01012438,495,136,80,56,0,0,301,41,260,57,55,2,1
2021,Halton 015E,E01012439,613,273,142,131,0,0,286,25,261,53,45,8,1
2021,Halton 014E,E01012440,515,443,231,212,13,13,10,1,9,48,41,7,1
2021,Halton 007D,E01012441,1128,350,180,170,5,5,443,114,329,328,305,23,2
2021,Halton 006E,E01012442,604,221,118,103,1,1,322,96,226,60,57,3,0
2021,Halton 008D,E01012443,579,393,175,218,1,1,71,22,49,114,97,17,0
2021,Halton 010D,E01012444,564,208,62,146,0,0,322,41,281,34,31,3,0
2021,Halton 010E,E01012445,524,117,62,55,0,0,378,59,319,29,27,2,0
2021,Warrington 025A,E01012446,524,500,323,177,0,0,7,4,3,17,13,4,0
2021,Warrington 025B,E01012447,490,474,266,208,0,0,6,4,2,10,10,0,0
2021,Warrington 024A,E01012448,550,489,263,226,9,9,18,5,13,34,31,3,0
2021,Warrington 025C,E01012449,636,603,411,192,0,0,7,2,5,26,19,7,0
2021,Warrington 023A,E01012450,635,518,307,211,26,26,39,19,20,52,48,4,0
2021,Warrington 023B,E01012451,617,393,199,194,0,0,150,76,74,74,56,18,0
2021,Warrington 025D,E01012452,728,691,425,266,0,0,4,1,3,33,31,2,0
2021,Warrington 013A,E01012453,701,260,98,162,1,1,367,173,194,68,60,8,5
2021,Warrington 013B,E01012454,1110,560,205,355,13,13,210,87,123,327,310,17,0
2021,Warrington 013C,E01012455,882,283,134,149,0,0,418,206,212,180,165,15,1
2021,Warrington 013D,E01012457,836,313,167,146,3,3,157,57,100,363,348,15,0
2021,Warrington 018B,E01012458,1144,631,240,391,7,7,171,42,129,335,311,24,0
2021,Warrington 005A,E01012459,720,242,118,124,5,5,345,39,306,127,119,8,1
2021,Warrington 004A,E01012460,627,309,154,155,1,1,219,31,188,97,85,12,1
2021,Warrington 005B,E01012461,542,481,279,202,8,8,5,2,3,48,41,7,0
2021,Warrington 004B,E01012462,641,389,202,187,31,31,95,13,82,126,116,10,0
2021,Warrington 004C,E01012463,499,464,331,133,2,2,3,2,1,30,24,6,0
2021,Warrington 004D,E01012464,600,354,195,159,1,1,172,26,146,73,62,11,0
2021,Warrington 005C,E01012465,602,414,217,197,5,5,91,23,68,92,82,10,0
2021,Warrington 005D,E01012466,734,195,88,107,6,6,424,82,342,108,103,5,1
2021,Warrington 003A,E01012467,519,485,356,129,0,0,5,3,2,29,20,9,0
2021,Warrington 003B,E01012468,942,816,392,424,10,10,41,21,20,75,55,20,0
2021,Warrington 003C,E01012469,615,473,253,220,3,3,38,18,20,101,87,14,0
2021,Warrington 003D,E01012470,501,342,190,152,1,1,109,68,41,49,34,15,0
2021,Warrington 001A,E01012471,530,488,294,194,0,0,6,3,3,36,27,9,0
2021,Warrington 001B,E01012472,750,631,370,261,0,0,65,13,52,54,43,11,0
2021,Warrington 002A,E01012473,686,623,413,210,3,3,31,15,16,29,22,7,0
2021,Warrington 002B,E01012474,630,375,191,184,1,1,162,91,71,91,75,16,1
2021,Warrington 002C,E01012475,656,491,266,225,2,2,61,32,29,102,85,17,0
2021,Warrington 001C,E01012476,709,554,312,242,1,1,64,34,30,89,71,18,1
2021,Warrington 001D,E01012477,645,579,307,272,3,3,11,2,9,52,49,3,0
2021,Warrington 012A,E01012478,939,675,247,428,9,9,134,36,98,121,107,14,0
2021,Warrington 017A,E01012479,805,325,153,172,8,8,231,84,147,240,218,22,1
2021,Warrington 017B,E01012480,1086,358,174,184,14,14,278,85,193,431,398,33,5
2021,Warrington 011A,E01012481,714,398,170,228,1,1,126,14,112,189,166,23,0
2021,Warrington 011B,E01012482,868,365,181,184,17,17,287,67,220,197,169,28,2
2021,Warrington 018C,E01012483,881,239,137,102,1,1,427,181,246,213,195,18,1
2021,Warrington 022A,E01012485,676,507,265,242,9,9,118,10,108,42,33,9,0
2021,Warrington 022B,E01012486,642,576,305,271,3,3,9,3,6,54,44,10,0
2021,Warrington 022C,E01012487,641,561,285,276,3,3,25,10,15,52,42,10,0
2021,Warrington 024B,E01012488,738,666,401,265,0,0,12,4,8,60,44,16,0
2021,Warrington 022D,E01012489,669,621,316,305,1,1,11,5,6,36,29,7,0
2021,Warrington 022E,E01012490,635,589,378,211,1,1,4,1,3,41,31,10,0
2021,Warrington 015A,E01012491,611,451,258,193,1,1,121,36,85,37,28,9,1
2021,Warrington 015B,E01012492,598,551,336,215,2,2,8,3,5,37,27,10,0
2021,Warrington 015C,E01012493,660,590,311,279,13,13,5,1,4,52,42,10,0
2021,Warrington 015D,E01012494,783,706,291,415,4,4,5,0,5,68,62,6,0
2021,Warrington 016A,E01012495,644,530,220,310,4,4,6,3,3,104,96,8,0
2021,Warrington 016B,E01012496,581,503,274,229,3,3,32,7,25,43,32,11,0
2021,Warrington 016C,E01012497,515,277,141,136,1,1,180,11,169,57,50,7,0
2021,Warrington 016D,E01012498,659,345,163,182,3,3,218,37,181,88,75,13,5
2021,Warrington 016E,E01012499,736,611,265,346,13,13,20,4,16,92,81,11,0
2021,Warrington 015E,E01012500,590,542,329,213,0,0,1,0,1,47,41,6,0
2021,Warrington 016F,E01012501,594,489,241,248,8,8,8,3,5,89,81,8,0
2021,Warrington 024C,E01012502,639,578,310,268,2,2,9,4,5,50,35,15,0
2021,Warrington 024D,E01012503,712,611,250,361,1,1,31,16,15,69,62,7,0
2021,Warrington 020B,E01012505,663,357,175,182,0,0,199,68,131,107,91,16,0
2021,Warrington 020C,E01012506,664,275,113,162,3,3,240,138,102,145,134,11,1
2021,Warrington 020D,E01012507,986,395,191,204,3,3,166,53,113,421,399,22,1
2021,Warrington 020E,E01012508,776,309,132,177,24,24,334,187,147,106,90,16,3
2021,Warrington 018D,E01012509,1125,810,456,354,0,0,56,13,43,257,227,30,2
2021,Warrington 017D,E01012510,1087,517,246,271,3,3,192,73,119,373,339,34,2
2021,Warrington 017E,E01012511,803,419,213,206,2,2,49,23,26,333,300,33,0
2021,Warrington 018E,E01012512,730,607,391,216,2,2,8,1,7,113,94,19,0
2021,Warrington 021A,E01012513,828,662,349,313,4,4,55,31,24,107,94,13,0
2021,Warrington 021B,E01012514,757,634,347,287,2,2,40,7,33,81,75,6,0
2021,Warrington 021C,E01012515,675,468,268,200,1,1,106,58,48,100,84,16,0
2021,Warrington 021D,E01012516,585,440,267,173,2,2,58,23,35,85,74,11,0
2021,Warrington 021E,E01012517,934,769,369,400,13,13,22,7,15,129,121,8,1
2021,Warrington 021F,E01012518,896,692,349,343,19,19,76,36,40,109,87,22,0
2021,Warrington 021G,E01012519,628,537,315,222,0,0,45,22,23,45,38,7,1
2021,Warrington 011C,E01012520,649,284,145,139,2,2,280,144,136,83,75,8,0
2021,Warrington 008A,E01012521,662,492,315,177,1,1,95,48,47,74,65,9,0
2021,Warrington 008B,E01012522,637,358,167,191,0,0,208,126,82,70,60,10,1
2021,Warrington 011D,E01012523,647,402,189,213,2,2,53,34,19,189,163,26,1
2021,Warrington 011E,E01012524,635,562,299,263,3,3,10,7,3,60,50,10,0
2021,Warrington 011F,E01012525,649,408,201,207,2,2,92,53,39,147,130,17,0
2021,Warrington 006A,E01012526,657,235,95,140,0,0,339,201,138,81,74,7,2
2021,Warrington 019A,E01012527,625,529,277,252,1,1,39,20,19,56,46,10,0
2021,Warrington 019B,E01012528,499,464,315,149,1,1,5,1,4,29,21,8,0
2021,Warrington 019C,E01012529,647,504,297,207,0,0,65,29,36,78,65,13,0
2021,Warrington 019D,E01012530,525,477,250,227,1,1,8,3,5,39,34,5,0
2021,Warrington 019E,E01012531,665,591,342,249,1,1,20,10,10,53,36,17,0
2021,Warrington 019F,E01012532,600,557,355,202,1,1,8,1,7,34,20,14,0
2021,Warrington 008C,E01012533,558,159,93,66,1,1,336,162,174,62,52,10,0
2021,Warrington 006B,E01012534,641,282,121,161,6,6,276,147,129,76,71,5,1
2021,Warrington 006C,E01012535,741,360,137,223,3,3,288,175,113,90,84,6,0
2021,Warrington 008D,E01012536,644,356,127,229,7,7,207,114,93,74,64,10,0
2021,Warrington 006D,E01012537,724,318,134,184,4,4,301,186,115,98,87,11,3
2021,Warrington 007A,E01012538,615,536,282,254,10,10,2,2,0,67,59,8,0
2021,Warrington 006E,E01012539,688,377,191,186,0,0,234,137,97,75,53,22,2
2021,Warrington 007B,E01012540,579,475,261,214,2,2,48,6,42,54,45,9,0
2021,Warrington 007C,E01012541,507,370,194,176,3,3,89,10,79,45,41,4,0
2021,Warrington 007D,E01012542,634,432,255,177,4,4,134,10,124,64,49,15,0
2021,Warrington 007E,E01012543,590,490,299,191,3,3,30,7,23,66,51,15,1
2021,Warrington 007F,E01012544,586,433,269,164,1,1,100,10,90,51,46,5,1
2021,Warrington 008E,E01012545,686,184,86,98,2,2,443,172,271,57,54,3,0
2021,Warrington 008F,E01012546,676,131,34,97,0,0,499,74,425,44,38,6,2
2021,Warrington 012B,E01012547,677,575,294,281,2,2,31,16,15,69,52,17,0
2021,Warrington 012C,E01012548,739,576,295,281,3,3,105,22,83,55,43,12,0
2021,Warrington 012D,E01012549,761,700,395,305,1,1,12,4,8,48,38,10,0
2021,Warrington 012E,E01012550,732,675,387,288,1,1,9,2,7,47,37,10,0
2021,Warrington 014A,E01012551,606,555,307,248,0,0,8,3,5,43,28,15,0
2021,Warrington 014B,E01012552,618,449,240,209,1,1,84,44,40,84,76,8,0
2021,Warrington 014C,E01012553,502,474,282,192,0,0,3,1,2,25,20,5,0
2021,Warrington 002D,E01012554,880,735,411,324,5,5,63,25,38,77,63,14,0
2021,Warrington 014D,E01012555,519,476,265,211,0,0,5,2,3,38,32,6,0
2021,Warrington 014E,E01012556,628,548,361,187,0,0,22,10,12,58,38,20,0
2021,Warrington 023C,E01012557,753,537,258,279,0,0,35,17,18,181,167,14,0
2021,Warrington 023D,E01012558,751,616,304,312,0,0,10,2,8,125,106,19,0
2021,Warrington 023E,E01012559,591,532,270,262,0,0,24,4,20,35,26,9,0
2021,Warrington 023F,E01012560,635,458,236,222,2,2,126,25,101,48,38,10,1
2021,Warrington 009A,E01012561,672,421,205,216,56,56,77,8,69,117,104,13,1
2021,Warrington 009B,E01012562,820,703,265,438,12,12,29,4,25,76,66,10,0
2021,Warrington 010A,E01012563,676,625,354,271,10,10,10,0,10,31,19,12,0
2021,Warrington 010B,E01012564,523,430,222,208,24,24,7,2,5,62,57,5,0
2021,Warrington 010D,E01012566,727,603,245,358,17,17,11,3,8,96,85,11,0
2021,Warrington 010E,E01012569,708,577,281,296,7,7,34,6,28,90,79,11,0
2021,Warrington 010F,E01012570,595,275,172,103,1,1,260,29,231,59,44,15,0
2021,Blackburn with Darwen 007A,E01012571,481,239,157,82,12,12,142,38,104,85,64,21,3
2021,Blackburn with Darwen 007B,E01012572,484,201,152,49,0,0,238,62,176,43,37,6,2
2021,Blackburn with Darwen 007C,E01012573,472,324,267,57,4,4,51,12,39,92,68,24,1
2021,Blackburn with Darwen 003A,E01012574,545,219,123,96,1,1,253,49,204,72,58,14,0
2021,Blackburn with Darwen 007D,E01012575,513,170,134,36,1,1,257,51,206,83,67,16,2
2021,Blackburn with Darwen 008A,E01012576,587,258,147,111,3,3,197,47,150,129,110,19,0
2021,Blackburn with Darwen 003B,E01012577,522,311,194,117,2,2,81,7,74,128,112,16,0
2021,Blackburn with Darwen 003C,E01012578,562,298,204,94,6,6,121,18,103,134,110,24,3
2021,Blackburn with Darwen 004A,E01012579,547,280,178,102,0,0,201,59,142,64,50,14,2
2021,Blackburn with Darwen 004B,E01012580,550,371,303,68,3,3,54,10,44,122,98,24,0
2021,Blackburn with Darwen 002A,E01012581,499,442,265,177,2,2,7,3,4,48,39,9,0
2021,Blackburn with Darwen 002B,E01012582,511,458,276,182,1,1,10,2,8,40,29,11,2
2021,Blackburn with Darwen 002C,E01012583,715,636,364,272,0,0,9,3,6,70,57,13,0
2021,Blackburn with Darwen 010A,E01012584,545,447,277,170,1,1,17,0,17,80,66,14,0
2021,Blackburn with Darwen 005A,E01012585,473,338,199,139,0,0,34,11,23,101,79,22,0
2021,Blackburn with Darwen 005B,E01012586,497,286,171,115,1,1,67,6,61,141,127,14,2
2021,Blackburn with Darwen 002D,E01012587,661,495,241,254,0,0,14,2,12,152,121,31,0
2021,Blackburn with Darwen 002E,E01012588,610,436,229,207,3,3,11,0,11,158,129,29,2
2021,Blackburn with Darwen 014A,E01012589,643,324,169,155,1,1,61,15,46,255,242,13,2
2021,Blackburn with Darwen 014B,E01012590,608,350,178,172,10,10,100,28,72,148,129,19,0
2021,Blackburn with Darwen 014C,E01012591,694,354,172,182,0,0,260,76,184,80,72,8,0
2021,Blackburn with Darwen 018A,E01012592,818,714,411,303,2,2,10,2,8,91,67,24,1
2021,Blackburn with Darwen 013A,E01012593,713,513,255,258,2,2,19,3,16,179,163,16,0
2021,Blackburn with Darwen 012A,E01012594,618,241,137,104,6,6,250,86,164,120,108,12,1
2021,Blackburn with Darwen 009A,E01012595,968,387,161,226,0,0,223,44,179,358,330,28,0
2021,Blackburn with Darwen 009B,E01012596,826,350,203,147,20,20,105,21,84,351,322,29,0
2021,Blackburn with Darwen 013B,E01012597,667,585,262,323,1,1,4,1,3,77,66,11,0
2021,Blackburn with Darwen 013C,E01012598,1025,939,302,637,4,4,11,1,10,71,58,13,0
2021,Blackburn with Darwen 013D,E01012599,531,425,181,244,0,0,5,2,3,101,83,18,0
2021,Blackburn with Darwen 011A,E01012600,627,251,130,121,2,2,310,73,237,64,58,6,0
2021,Blackburn with Darwen 011B,E01012601,575,163,77,86,0,0,357,118,239,55,44,11,0
2021,Blackburn with Darwen 011C,E01012602,660,552,212,340,0,0,4,1,3,104,86,18,0
2021,Blackburn with Darwen 011D,E01012603,695,223,116,107,1,1,361,72,289,110,97,13,0
2021,Blackburn with Darwen 011E,E01012604,612,408,175,233,6,6,68,31,37,130,123,7,0
2021,Blackburn with Darwen 003D,E01012605,665,451,287,164,7,7,62,6,56,144,108,36,1
2021,Blackburn with Darwen 003E,E01012606,473,293,209,84,1,1,74,13,61,105,84,21,0
2021,Blackburn with Darwen 001A,E01012607,644,449,299,150,3,3,102,40,62,88,73,15,2
2021,Blackburn with Darwen 001B,E01012608,811,426,184,242,1,1,225,70,155,158,136,22,1
2021,Blackburn with Darwen 010B,E01012609,678,631,376,255,0,0,11,1,10,36,29,7,0
2021,Blackburn with Darwen 010C,E01012610,525,417,216,201,0,0,73,12,61,35,28,7,0
2021,Blackburn with Darwen 010D,E01012611,485,399,234,165,1,1,12,3,9,72,61,11,1
2021,Blackburn with Darwen 010E,E01012612,616,564,361,203,0,0,6,2,4,46,34,12,0
2021,Blackburn with Darwen 010F,E01012613,735,654,309,345,1,1,10,2,8,70,57,13,0
2021,Blackburn with Darwen 017A,E01012614,672,569,276,293,1,1,30,10,20,72,63,9,0
2021,Blackburn with Darwen 017B,E01012615,712,392,246,146,1,1,187,28,159,131,118,13,1
2021,Blackburn with Darwen 017C,E01012616,865,654,277,377,1,1,100,17,83,110,104,6,0
2021,Blackburn with Darwen 015A,E01012617,599,398,223,175,2,2,26,3,23,173,153,20,0
2021,Blackburn with Darwen 012B,E01012618,664,524,293,231,15,15,27,8,19,98,79,19,0
2021,Blackburn with Darwen 012C,E01012619,545,213,118,95,0,0,268,103,165,64,59,5,0
2021,Blackburn with Darwen 012D,E01012620,670,569,365,204,1,1,40,3,37,60,47,13,0
2021,Blackburn with Darwen 012E,E01012621,640,354,177,177,4,4,175,45,130,106,92,14,1
2021,Blackburn with Darwen 009C,E01012622,725,121,68,53,7,7,391,133,258,205,191,14,1
2021,Blackburn with Darwen 009D,E01012623,632,351,165,186,1,1,76,20,56,204,178,26,0
2021,Blackburn with Darwen 009E,E01012624,698,313,167,146,10,10,126,11,115,249,229,20,0
2021,Blackburn with Darwen 009F,E01012625,855,384,185,199,1,1,161,13,148,309,282,27,0
2021,Blackburn with Darwen 018D,E01012628,500,442,242,200,2,2,9,1,8,47,37,10,0
2021,Blackburn with Darwen 006A,E01012629,505,228,119,109,5,5,80,11,69,192,171,21,0
2021,Blackburn with Darwen 007E,E01012630,593,369,270,99,4,4,75,16,59,145,122,23,0
2021,Blackburn with Darwen 006B,E01012631,613,111,65,46,3,3,436,59,377,63,51,12,0
2021,Blackburn with Darwen 011F,E01012632,786,441,245,196,14,14,152,43,109,179,156,23,0
2021,Blackburn with Darwen 001C,E01012633,722,508,279,229,1,1,94,25,69,117,98,19,2
2021,Blackburn with Darwen 001D,E01012634,608,449,206,243,1,1,41,12,29,117,104,13,0
2021,Blackburn with Darwen 001E,E01012635,585,512,286,226,1,1,5,1,4,67,59,8,0
2021,Blackburn with Darwen 001F,E01012636,750,649,372,277,0,0,28,7,21,73,61,12,0
2021,Blackburn with Darwen 008B,E01012637,664,163,83,80,0,0,422,138,284,78,70,8,1
2021,Blackburn with Darwen 008C,E01012638,680,231,115,116,2,2,354,115,239,92,81,11,1
2021,Blackburn with Darwen 008D,E01012639,735,206,111,95,1,1,420,128,292,108,94,14,0
2021,Blackburn with Darwen 008E,E01012640,749,404,231,173,1,1,96,30,66,248,211,37,0
2021,Blackburn with Darwen 008F,E01012641,568,238,127,111,2,2,193,56,137,133,123,10,2
2021,Blackburn with Darwen 004C,E01012642,514,322,213,109,5,5,89,15,74,98,76,22,0
2021,Blackburn with Darwen 006C,E01012643,604,239,176,63,3,3,240,43,197,122,105,17,0
2021,Blackburn with Darwen 006D,E01012644,699,473,374,99,2,2,16,5,11,208,160,48,0
2021,Blackburn with Darwen 004D,E01012645,595,486,304,182,4,4,5,1,4,100,80,20,0
2021,Blackburn with Darwen 015B,E01012646,735,329,166,163,1,1,168,40,128,237,212,25,0
2021,Blackburn with Darwen 015C,E01012647,703,376,193,183,1,1,223,79,144,103,89,14,0
2021,Blackburn with Darwen 014D,E01012648,539,285,144,141,4,4,19,5,14,231,214,17,0
2021,Blackburn with Darwen 016A,E01012649,746,254,128,126,4,4,268,53,215,218,203,15,2
2021,Blackburn with Darwen 015D,E01012650,606,307,178,129,0,0,44,14,30,255,234,21,0
2021,Blackburn with Darwen 016B,E01012651,670,486,238,248,8,8,8,2,6,168,152,16,0
2021,Blackburn with Darwen 014E,E01012652,630,543,306,237,0,0,29,7,22,58,46,12,0
2021,Blackburn with Darwen 016C,E01012653,643,384,185,199,32,32,82,17,65,145,126,19,0
2021,Blackburn with Darwen 016D,E01012654,836,381,194,187,1,1,148,37,111,306,288,18,0
2021,Blackburn with Darwen 006E,E01012655,1001,64,37,27,3,3,737,155,582,196,183,13,1
2021,Blackburn with Darwen 005C,E01012656,660,249,160,89,0,0,186,49,137,224,193,31,1
2021,Blackburn with Darwen 005D,E01012657,673,315,196,119,7,7,162,34,128,187,155,32,2
2021,Blackburn with Darwen 005E,E01012658,740,463,223,240,17,17,34,7,27,226,196,30,0
2021,Blackburn with Darwen 017D,E01012659,572,456,234,222,1,1,11,2,9,104,87,17,0
2021,Blackburn with Darwen 017E,E01012660,473,426,249,177,1,1,4,0,4,42,33,9,0
2021,Blackburn with Darwen 017F,E01012661,723,467,220,247,23,23,12,3,9,221,195,26,0
2021,Blackpool 002A,E01012662,825,502,348,154,6,6,155,125,30,159,140,19,3
2021,Blackpool 001A,E01012663,745,531,320,211,0,0,11,4,7,202,180,22,1
2021,Blackpool 001B,E01012664,710,539,298,241,3,3,3,0,3,165,143,22,0
2021,Blackpool 001C,E01012665,871,649,449,200,2,2,22,12,10,198,169,29,0
2021,Blackpool 003A,E01012666,665,376,218,158,1,1,28,13,15,260,236,24,0
2021,Blackpool 003B,E01012667,653,558,308,250,1,1,9,2,7,85,70,15,0
2021,Blackpool 003C,E01012668,722,536,302,234,0,0,10,4,6,176,150,26,0
2021,Blackpool 003D,E01012669,875,550,340,210,1,1,20,8,12,304,273,31,0
2021,Blackpool 011A,E01012670,615,158,96,62,1,1,54,13,41,402,383,19,0
2021,Blackpool 013A,E01012671,638,205,143,62,6,6,39,10,29,387,369,18,1
2021,Blackpool 013B,E01012672,662,192,124,68,16,16,96,18,78,358,341,17,0
2021,Blackpool 010A,E01012673,624,129,71,58,0,0,174,103,71,319,304,15,2
2021,Blackpool 013C,E01012674,761,325,144,181,11,11,54,7,47,371,358,13,0
2021,Blackpool 010B,E01012675,707,228,124,104,3,3,68,12,56,408,386,22,0
2021,Blackpool 009A,E01012676,626,389,200,189,2,2,52,21,31,183,167,16,0
2021,Blackpool 009B,E01012677,640,434,219,215,0,0,9,5,4,197,178,19,0
2021,Blackpool 008A,E01012678,467,128,65,63,2,2,210,153,57,122,114,8,5
2021,Blackpool 008B,E01012679,635,173,88,85,3,3,155,47,108,304,288,16,0
2021,Blackpool 008C,E01012680,754,331,151,180,5,5,116,57,59,299,283,16,3
2021,Blackpool 006A,E01012681,857,171,110,61,4,4,138,27,111,544,522,22,0
2021,Blackpool 008D,E01012682,799,215,132,83,4,4,183,102,81,395,376,19,2
2021,Blackpool 006B,E01012683,652,185,95,90,0,0,59,6,53,408,387,21,0
2021,Blackpool 008E,E01012684,672,244,114,130,2,2,152,75,77,273,260,13,1
2021,Blackpool 016A,E01012685,634,416,183,233,1,1,3,2,1,214,198,16,0
2021,Blackpool 014A,E01012686,630,239,122,117,2,2,309,223,86,78,65,13,2
2021,Blackpool 014B,E01012687,548,229,97,132,0,0,228,191,37,91,82,9,0
2021,Blackpool 014C,E01012688,620,369,250,119,0,0,107,69,38,141,120,21,3
2021,Blackpool 014D,E01012689,677,464,239,225,1,1,47,36,11,164,151,13,1
2021,Blackpool 004A,E01012690,733,533,273,260,0,0,9,4,5,191,168,23,0
2021,Blackpool 004B,E01012691,804,555,274,281,2,2,71,56,15,176,153,23,0
2021,Blackpool 004C,E01012692,813,407,198,209,17,17,217,141,76,169,160,9,3
2021,Blackpool 005A,E01012693,725,541,309,232,3,3,12,5,7,169,154,15,0
2021,Blackpool 016B,E01012694,615,380,188,192,2,2,47,4,43,186,163,23,0
2021,Blackpool 015A,E01012695,618,332,142,190,2,2,40,23,17,243,219,24,1
2021,Blackpool 016C,E01012696,664,382,173,209,3,3,13,4,9,266,239,27,0
2021,Blackpool 016D,E01012697,656,433,277,156,1,1,68,51,17,152,137,15,2
2021,Blackpool 016E,E01012698,649,285,150,135,0,0,203,143,60,160,150,10,1
2021,Blackpool 019A,E01012699,752,552,308,244,1,1,33,27,6,166,147,19,0
2021,Blackpool 019B,E01012700,777,590,326,264,0,0,9,4,5,178,151,27,0
2021,Blackpool 018A,E01012701,634,473,264,209,2,2,5,4,1,154,136,18,0
2021,Blackpool 019C,E01012702,753,373,243,130,2,2,220,142,78,155,137,18,3
2021,Blackpool 002B,E01012703,697,533,350,183,9,9,29,14,15,126,110,16,0
2021,Blackpool 002C,E01012704,1110,335,156,179,2,2,594,391,203,171,149,22,8
2021,Blackpool 004D,E01012705,718,431,218,213,4,4,132,65,67,150,137,13,1
2021,Blackpool 002D,E01012706,703,547,264,283,3,3,9,7,2,144,131,13,0
2021,Blackpool 007A,E01012707,630,318,184,134,1,1,101,69,32,208,198,10,2
2021,Blackpool 009C,E01012708,602,401,204,197,0,0,4,0,4,197,171,26,0
2021,Blackpool 009D,E01012709,740,358,197,161,0,0,12,7,5,370,345,25,0
2021,Blackpool 009E,E01012710,479,394,200,194,0,0,2,2,0,83,79,4,0
2021,Blackpool 005B,E01012711,620,397,198,199,0,0,40,36,4,183,161,22,0
2021,Blackpool 012A,E01012712,701,554,265,289,0,0,6,3,3,141,118,23,0
2021,Blackpool 012B,E01012713,812,563,274,289,0,0,9,5,4,240,210,30,0
2021,Blackpool 014E,E01012714,902,674,339,335,1,1,44,27,17,183,165,18,0
2021,Blackpool 012C,E01012715,703,491,268,223,1,1,13,3,10,198,181,17,0
2021,Blackpool 001D,E01012716,631,518,297,221,1,1,16,9,7,96,87,9,0
2021,Blackpool 002E,E01012717,708,613,369,244,0,0,4,1,3,91,77,14,0
2021,Blackpool 003E,E01012718,742,639,431,208,2,2,4,2,2,96,77,19,1
2021,Blackpool 001E,E01012719,623,506,310,196,0,0,5,2,3,112,100,12,0
2021,Blackpool 007B,E01012720,656,241,120,121,6,6,305,231,74,98,86,12,6
2021,Blackpool 007C,E01012721,768,126,61,65,1,1,571,400,171,65,59,6,5
2021,Blackpool 009F,E01012722,510,364,164,200,0,0,4,2,2,142,116,26,0
2021,Blackpool 004E,E01012723,643,461,247,214,3,3,29,12,17,150,129,21,0
2021,Blackpool 007D,E01012724,667,208,121,87,7,7,351,287,64,93,86,7,8
2021,Blackpool 019D,E01012725,581,453,239,214,3,3,8,6,2,117,99,18,0
2021,Blackpool 017A,E01012726,798,558,311,247,0,0,59,27,32,181,153,28,0
2021,Blackpool 019E,E01012727,665,578,341,237,1,1,6,0,6,80,66,14,0
2021,Blackpool 017B,E01012728,688,370,200,170,1,1,11,5,6,306,284,22,0
2021,Blackpool 018B,E01012729,767,629,381,248,4,4,6,1,5,128,110,18,0
2021,Blackpool 018C,E01012730,849,706,355,351,1,1,8,1,7,134,116,18,0
2021,Blackpool 018D,E01012731,726,506,277,229,3,3,16,11,5,201,176,25,0
2021,Blackpool 018E,E01012732,924,549,331,218,3,3,193,79,114,178,155,23,1
2021,Blackpool 011B,E01012733,470,223,117,106,1,1,16,2,14,230,218,12,0
2021,Blackpool 011C,E01012734,634,359,175,184,0,0,10,3,7,265,248,17,0
2021,Blackpool 010C,E01012735,672,261,140,121,3,3,24,6,18,384,369,15,0
2021,Blackpool 010D,E01012736,688,208,142,66,2,2,20,6,14,457,435,22,1
2021,Blackpool 010E,E01012737,701,190,131,59,3,3,46,10,36,462,447,15,0
2021,Blackpool 011D,E01012738,570,228,121,107,0,0,34,15,19,306,285,21,2
2021,Blackpool 011E,E01012739,580,303,137,166,2,2,84,73,11,191,170,21,0
2021,Blackpool 012D,E01012740,676,429,246,183,1,1,21,15,6,225,210,15,0
2021,Blackpool 012E,E01012741,610,454,232,222,1,1,3,1,2,152,130,22,0
2021,Blackpool 011F,E01012742,522,346,188,158,3,3,22,15,7,151,135,16,0
2021,Blackpool 015B,E01012743,747,360,193,167,1,1,12,1,11,374,347,27,0
2021,Blackpool 015C,E01012744,752,332,161,171,1,1,143,59,84,276,258,18,0
2021,Blackpool 015D,E01012745,744,478,271,207,4,4,10,5,5,251,226,25,1
2021,Blackpool 015E,E01012746,767,439,225,214,0,0,24,19,5,304,286,18,0
2021,Blackpool 005C,E01012747,623,555,283,272,0,0,4,1,3,63,53,10,1
2021,Blackpool 006C,E01012748,736,321,173,148,1,1,31,10,21,383,357,26,0
2021,Blackpool 006D,E01012749,691,336,193,143,3,3,17,8,9,335,305,30,0
2021,Blackpool 005D,E01012750,739,551,276,275,2,2,2,0,2,184,162,22,0
2021,Blackpool 013D,E01012751,775,154,95,59,7,7,68,29,39,546,517,29,0
2021,Blackpool 017C,E01012752,590,306,159,147,0,0,30,3,27,254,239,15,0
2021,Blackpool 017D,E01012753,470,359,175,184,1,1,5,3,2,105,96,9,0
2021,Blackpool 017E,E01012754,562,280,143,137,0,0,19,5,14,263,252,11,0
2021,Blackpool 017F,E01012755,624,434,226,208,1,1,16,2,14,173,155,18,0
2021,Kingston upon Hull 025A,E01012756,715,479,245,234,2,2,12,5,7,219,195,24,3
2021,Kingston upon Hull 025B,E01012757,639,360,155,205,1,1,23,4,19,255,226,29,0
2021,Kingston upon Hull 018A,E01012758,703,454,237,217,1,1,48,11,37,199,190,9,1
2021,Kingston upon Hull 025C,E01012759,797,411,213,198,7,7,39,25,14,338,317,21,2
2021,Kingston upon Hull 025D,E01012760,720,351,168,183,1,1,17,8,9,351,326,25,0
2021,Kingston upon Hull 015A,E01012761,858,149,87,62,28,28,231,110,121,448,428,20,2
2021,Kingston upon Hull 018B,E01012762,592,391,186,205,1,1,36,18,18,164,153,11,0
2021,Kingston upon Hull 018C,E01012763,868,271,139,132,2,2,76,9,67,519,498,21,0
2021,Kingston upon Hull 005A,E01012764,562,462,308,154,1,1,16,5,11,83,65,18,0
2021,Kingston upon Hull 005B,E01012765,620,479,218,261,3,3,7,3,4,131,112,19,0
2021,Kingston upon Hull 012A,E01012766,550,456,205,251,0,0,8,5,3,86,74,12,0
2021,Kingston upon Hull 012B,E01012767,550,307,148,159,3,3,44,8,36,196,187,9,0
2021,Kingston upon Hull 005C,E01012768,692,527,322,205,2,2,8,1,7,154,137,17,1
2021,Kingston upon Hull 005D,E01012769,682,559,399,160,3,3,11,4,7,109,88,21,0
2021,Kingston upon Hull 028A,E01012770,591,538,269,269,0,0,16,3,13,37,32,5,0
2021,Kingston upon Hull 028B,E01012771,634,507,282,225,3,3,48,45,3,75,69,6,1
2021,Kingston upon Hull 028C,E01012772,659,474,227,247,0,0,15,10,5,169,153,16,1
2021,Kingston upon Hull 027A,E01012773,748,542,243,299,0,0,16,7,9,190,169,21,0
2021,Kingston upon Hull 019A,E01012774,641,367,163,204,1,1,152,133,19,119,112,7,2
2021,Kingston upon Hull 028D,E01012775,723,396,163,233,0,0,202,194,8,122,112,10,3
2021,Kingston upon Hull 027B,E01012776,668,468,224,244,3,3,30,19,11,166,149,17,1
2021,Kingston upon Hull 028E,E01012777,794,336,179,157,1,1,366,225,141,85,71,14,6
2021,Kingston upon Hull 004A,E01012778,519,170,66,104,0,0,277,267,10,69,66,3,3
2021,Kingston upon Hull 034A,E01012779,501,136,68,68,0,0,300,47,253,65,60,5,0
2021,Kingston upon Hull 034D,E01012780,694,206,106,100,0,0,389,75,314,98,94,4,1
2021,Kingston upon Hull 034B,E01012781,470,146,83,63,0,0,276,72,204,47,38,9,1
2021,Kingston upon Hull 002A,E01012782,556,158,79,79,0,0,348,263,85,50,46,4,0
2021,Kingston upon Hull 004B,E01012783,534,122,51,71,0,0,333,301,32,77,73,4,2
2021,Kingston upon Hull 004C,E01012784,761,445,143,302,2,2,186,174,12,125,110,15,3
2021,Kingston upon Hull 002B,E01012785,550,119,61,58,0,0,382,359,23,47,41,6,2
2021,Kingston upon Hull 002C,E01012786,520,242,133,109,0,0,201,198,3,71,62,9,6
2021,Kingston upon Hull 002D,E01012787,633,190,104,86,0,0,352,335,17,86,74,12,5
2021,Kingston upon Hull 002E,E01012788,580,188,87,101,0,0,324,257,67,66,59,7,2
2021,Kingston upon Hull 002F,E01012789,544,235,123,112,0,0,247,238,9,59,54,5,3
2021,Kingston upon Hull 004D,E01012790,600,265,153,112,0,0,274,261,13,59,51,8,2
2021,Kingston upon Hull 014A,E01012791,665,588,333,255,2,2,5,3,2,70,63,7,0
2021,Kingston upon Hull 014B,E01012792,631,479,237,242,1,1,56,5,51,95,82,13,0
2021,Kingston upon Hull 014C,E01012793,616,429,263,166,11,11,97,6,91,79,70,9,0
2021,Kingston upon Hull 014D,E01012794,621,489,239,250,0,0,5,3,2,127,115,12,0
2021,Kingston upon Hull 019B,E01012795,890,476,224,252,2,2,297,267,30,111,95,16,4
2021,Kingston upon Hull 023A,E01012796,580,465,233,232,0,0,30,27,3,85,74,11,0
2021,Kingston upon Hull 019C,E01012797,619,375,181,194,1,1,130,51,79,112,101,11,1
2021,Kingston upon Hull 019D,E01012798,815,252,112,140,7,7,460,326,134,88,79,9,8
2021,Kingston upon Hull 023B,E01012799,602,336,140,196,0,0,17,6,11,249,236,13,0
2021,Kingston upon Hull 023C,E01012800,745,457,220,237,1,1,82,77,5,203,187,16,2
2021,Kingston upon Hull 019E,E01012801,644,440,239,201,1,1,82,72,10,121,105,16,0
2021,Kingston upon Hull 023D,E01012802,643,423,209,214,0,0,31,26,5,189,172,17,0
2021,Kingston upon Hull 023E,E01012803,647,389,199,190,2,2,39,34,5,216,205,11,1
2021,Kingston upon Hull 016A,E01012804,775,613,261,352,3,3,20,12,8,138,127,11,1
2021,Kingston upon Hull 026A,E01012805,669,240,124,116,2,2,135,106,29,289,250,39,3
2021,Kingston upon Hull 016B,E01012806,703,310,153,157,0,0,83,55,28,309,297,12,1
2021,Kingston upon Hull 016C,E01012807,600,410,215,195,1,1,73,42,31,116,106,10,0
2021,Kingston upon Hull 026B,E01012808,832,233,124,109,1,1,352,276,76,203,185,18,43
2021,Kingston upon Hull 026C,E01012809,891,308,161,147,1,1,114,49,65,468,445,23,0
2021,Kingston upon Hull 026D,E01012810,913,470,214,256,1,1,212,62,150,228,212,16,2
2021,Kingston upon Hull 026E,E01012811,830,411,186,225,0,0,94,8,86,325,309,16,0
2021,Kingston upon Hull 013A,E01012812,514,475,259,216,2,2,4,2,2,33,28,5,0
2021,Kingston upon Hull 013B,E01012813,671,578,323,255,1,1,18,12,6,74,65,9,0
2021,Kingston upon Hull 013C,E01012814,609,552,316,236,0,0,15,15,0,42,34,8,0
2021,Kingston upon Hull 013D,E01012815,664,537,273,264,1,1,20,17,3,103,95,8,3
2021,Kingston upon Hull 020A,E01012816,602,383,196,187,3,3,48,24,24,168,161,7,0
2021,Kingston upon Hull 016D,E01012817,688,395,184,211,1,1,24,9,15,268,249,19,0
2021,Kingston upon Hull 013E,E01012818,501,419,229,190,0,0,12,11,1,69,57,12,1
2021,Kingston upon Hull 016E,E01012819,600,435,226,209,2,2,24,19,5,139,125,14,0
2021,Kingston upon Hull 022A,E01012820,540,373,168,205,2,2,12,6,6,153,137,16,0
2021,Kingston upon Hull 011A,E01012821,869,355,136,219,38,38,433,240,193,39,33,6,4
2021,Kingston upon Hull 007A,E01012822,657,452,228,224,3,3,86,67,19,114,104,10,2
2021,Kingston upon Hull 010A,E01012824,768,562,240,322,4,4,146,139,7,54,47,7,2
2021,Kingston upon Hull 010B,E01012825,669,519,310,209,1,1,91,82,9,57,33,24,1
2021,Kingston upon Hull 011D,E01012827,764,434,218,216,4,4,257,48,209,67,55,12,2
2021,Kingston upon Hull 011E,E01012828,655,413,188,225,2,2,144,134,10,96,80,16,0
2021,Kingston upon Hull 006A,E01012829,858,668,314,354,2,2,48,8,40,140,119,21,0
2021,Kingston upon Hull 006B,E01012830,608,509,287,222,1,1,9,5,4,89,80,9,0
2021,Kingston upon Hull 034E,E01012832,758,501,128,373,10,10,152,33,119,94,84,10,1
2021,Kingston upon Hull 009A,E01012833,653,231,111,120,0,0,320,284,36,100,90,10,2
2021,Kingston upon Hull 010C,E01012834,636,247,111,136,1,1,270,262,8,114,98,16,4
2021,Kingston upon Hull 009B,E01012835,516,463,306,157,1,1,8,5,3,44,33,11,0
2021,Kingston upon Hull 009C,E01012836,729,239,117,122,4,4,409,400,9,74,66,8,3
2021,Kingston upon Hull 010D,E01012837,695,289,130,159,0,0,326,286,40,78,66,12,2
2021,Kingston upon Hull 010E,E01012838,614,223,80,143,0,0,300,286,14,90,82,8,1
2021,Kingston upon Hull 009D,E01012839,542,372,210,162,0,0,99,93,6,68,64,4,3
2021,Kingston upon Hull 009E,E01012840,632,235,118,117,0,0,278,274,4,114,105,9,5
2021,Kingston upon Hull 017A,E01012841,634,113,42,71,1,1,469,205,264,48,45,3,3
2021,Kingston upon Hull 021A,E01012842,568,218,89,129,3,3,262,221,41,82,79,3,3
2021,Kingston upon Hull 021B,E01012843,636,169,78,91,18,18,359,169,190,88,79,9,2
2021,Kingston upon Hull 017B,E01012844,590,101,40,61,26,26,408,273,135,53,45,8,2
2021,Kingston upon Hull 021C,E01012845,607,217,108,109,0,0,283,271,12,104,96,8,3
2021,Kingston upon Hull 021D,E01012846,565,214,106,108,1,1,240,206,34,107,100,7,3
2021,Kingston upon Hull 021E,E01012847,485,176,87,89,1,1,225,213,12,83,78,5,0
2021,Kingston upon Hull 020B,E01012848,591,251,105,146,0,0,123,90,33,217,200,17,0
2021,Kingston upon Hull 017C,E01012849,670,308,146,162,2,2,299,293,6,56,47,9,5
2021,Kingston upon Hull 024A,E01012850,780,161,76,85,3,3,253,108,145,361,339,22,2
2021,Kingston upon Hull 024B,E01012852,762,220,112,108,5,5,297,259,38,237,223,14,3
2021,Kingston upon Hull 029C,E01012854,1153,179,105,74,8,8,735,541,194,216,192,24,15
2021,Kingston upon Hull 029D,E01012855,898,149,75,74,22,22,606,415,191,111,100,11,10
2021,Kingston upon Hull 024C,E01012856,784,180,88,92,0,0,493,403,90,102,96,6,9
2021,Kingston upon Hull 024D,E01012857,796,169,82,87,7,7,391,291,100,220,208,12,9
2021,Kingston upon Hull 031A,E01012858,874,334,109,225,1,1,404,274,130,132,124,8,3
2021,Kingston upon Hull 030A,E01012859,710,235,161,74,6,6,102,28,74,364,347,17,3
2021,Kingston upon Hull 031B,E01012860,1035,619,206,413,3,3,202,94,108,205,186,19,6
2021,Kingston upon Hull 025E,E01012862,603,218,124,94,0,0,198,180,18,180,158,22,7
2021,Kingston upon Hull 027C,E01012863,991,616,216,400,4,4,95,10,85,275,251,24,1
2021,Kingston upon Hull 027D,E01012864,754,273,143,130,1,1,46,15,31,434,395,39,0
2021,Kingston upon Hull 027E,E01012865,547,228,122,106,15,15,53,30,23,248,229,19,3
2021,Kingston upon Hull 018D,E01012866,751,292,122,170,8,8,24,3,21,427,403,24,0
2021,Kingston upon Hull 024E,E01012867,726,134,72,62,0,0,201,126,75,389,371,18,2
2021,Kingston upon Hull 015B,E01012868,657,153,87,66,1,1,80,40,40,421,408,13,2
2021,Kingston upon Hull 015C,E01012869,641,152,86,66,1,1,90,21,69,395,379,16,3
2021,Kingston upon Hull 018E,E01012870,691,196,100,96,4,4,33,7,26,458,435,23,0
2021,Kingston upon Hull 015D,E01012871,738,244,117,127,2,2,69,15,54,422,405,17,1
2021,Kingston upon Hull 015E,E01012872,635,138,91,47,4,4,115,22,93,378,366,12,0
2021,Kingston upon Hull 008A,E01012873,625,135,57,78,2,2,424,265,159,61,53,8,3
2021,Kingston upon Hull 008B,E01012874,631,207,102,105,1,1,356,335,21,63,52,11,4
2021,Kingston upon Hull 003A,E01012875,593,89,44,45,2,2,447,313,134,51,44,7,4
2021,Kingston upon Hull 003B,E01012876,630,192,114,78,1,1,371,357,14,59,51,8,7
2021,Kingston upon Hull 003C,E01012877,550,133,77,56,0,0,359,348,11,58,54,4,0
2021,Kingston upon Hull 003D,E01012878,731,201,104,97,4,4,455,355,100,69,62,7,2
2021,Kingston upon Hull 003E,E01012879,566,121,58,63,3,3,377,335,42,63,58,5,2
2021,Kingston upon Hull 008C,E01012880,699,164,75,89,0,0,438,322,116,94,87,7,3
2021,Kingston upon Hull 008D,E01012881,629,197,97,100,1,1,328,255,73,100,87,13,3
2021,Kingston upon Hull 033A,E01012882,673,523,253,270,21,21,17,0,17,112,106,6,0
2021,Kingston upon Hull 033B,E01012883,800,415,247,168,54,54,210,22,188,120,111,9,1
2021,Kingston upon Hull 033C,E01012884,832,401,196,205,2,2,302,283,19,116,104,12,11
2021,Kingston upon Hull 031D,E01012886,707,329,159,170,3,3,289,156,133,83,75,8,3
2021,Kingston upon Hull 033D,E01012887,707,224,104,120,15,15,361,352,9,104,96,8,3
2021,Kingston upon Hull 031E,E01012888,758,223,128,95,1,1,87,48,39,444,432,12,3
2021,Kingston upon Hull 030B,E01012889,756,163,100,63,0,0,296,239,57,295,284,11,2
2021,Kingston upon Hull 030C,E01012891,1012,184,114,70,11,11,258,92,166,553,525,28,6
2021,Kingston upon Hull 030D,E01012892,775,275,163,112,5,5,93,18,75,392,381,11,10
2021,Kingston upon Hull 030E,E01012893,746,177,99,78,1,1,271,232,39,291,258,33,6
2021,Kingston upon Hull 020C,E01012894,841,406,167,239,12,12,366,303,63,54,45,9,3
2021,Kingston upon Hull 020D,E01012896,789,523,223,300,23,23,127,65,62,116,102,14,0
2021,Kingston upon Hull 017F,E01012898,764,222,110,112,0,0,457,248,209,82,75,7,3
2021,Kingston upon Hull 022B,E01012899,664,437,228,209,1,1,57,28,29,169,161,8,0
2021,Kingston upon Hull 022C,E01012900,750,253,129,124,4,4,160,68,92,329,314,15,4
2021,Kingston upon Hull 020E,E01012901,614,449,227,222,2,2,51,20,31,110,94,16,2
2021,Kingston upon Hull 022D,E01012902,606,477,231,246,1,1,16,7,9,112,84,28,0
2021,Kingston upon Hull 022E,E01012903,819,341,179,162,2,2,123,36,87,353,335,18,0
2021,Kingston upon Hull 007B,E01012904,551,373,198,175,2,2,73,28,45,102,85,17,1
2021,Kingston upon Hull 006C,E01012905,573,271,159,112,0,0,234,232,2,63,61,2,5
2021,Kingston upon Hull 004E,E01012906,663,217,91,126,0,0,349,336,13,95,87,8,2
2021,Kingston upon Hull 007C,E01012907,752,398,217,181,2,2,259,143,116,91,79,12,2
2021,Kingston upon Hull 004F,E01012908,444,217,99,118,2,2,177,171,6,44,34,10,4
2021,Kingston upon Hull 007D,E01012909,580,436,211,225,4,4,22,0,22,118,106,12,0
2021,Kingston upon Hull 006D,E01012910,464,380,182,198,0,0,16,4,12,68,61,7,0
2021,Kingston upon Hull 007E,E01012911,486,417,238,179,3,3,13,2,11,53,44,9,0
2021,Kingston upon Hull 006E,E01012912,743,648,392,256,1,1,6,2,4,86,74,12,2
2021,Kingston upon Hull 014E,E01012913,827,410,194,216,1,1,175,167,8,237,223,14,4
2021,Kingston upon Hull 012C,E01012914,569,87,40,47,7,7,71,18,53,404,390,14,0
2021,Kingston upon Hull 008E,E01012915,637,243,129,114,2,2,290,250,40,101,87,14,1
2021,Kingston upon Hull 012D,E01012916,743,443,252,191,0,0,53,8,45,247,231,16,0
2021,Kingston upon Hull 008F,E01012917,765,252,123,129,0,0,403,230,173,108,102,6,2
2021,Kingston upon Hull 008G,E01012918,623,223,102,121,1,1,264,216,48,132,118,14,3
2021,East Riding of Yorkshire 020A,E01012919,530,445,274,171,0,0,27,21,6,58,45,13,0
2021,East Riding of Yorkshire 020B,E01012921,492,394,247,147,1,1,28,23,5,68,57,11,1
2021,East Riding of Yorkshire 013A,E01012922,674,534,316,218,0,0,34,28,6,106,89,17,0
2021,East Riding of Yorkshire 013B,E01012923,609,336,187,149,0,0,29,18,11,244,145,99,0
2021,East Riding of Yorkshire 014A,E01012924,713,617,360,257,3,3,19,12,7,74,55,19,0
2021,East Riding of Yorkshire 013C,E01012925,543,453,259,194,0,0,9,7,2,80,63,17,1
2021,East Riding of Yorkshire 014B,E01012926,1063,914,591,323,0,0,30,26,4,116,88,28,3
2021,East Riding of Yorkshire 013D,E01012927,646,615,390,225,0,0,2,2,0,29,28,1,0
2021,East Riding of Yorkshire 003A,E01012928,745,259,168,91,3,3,359,343,16,113,100,13,11
2021,East Riding of Yorkshire 002A,E01012929,805,478,242,236,2,2,103,56,47,221,203,18,1
2021,East Riding of Yorkshire 002B,E01012930,628,511,334,177,1,1,15,6,9,101,89,12,0
2021,East Riding of Yorkshire 003B,E01012931,788,268,175,93,4,4,355,257,98,153,134,19,8
2021,East Riding of Yorkshire 003C,E01012932,772,389,262,127,2,2,150,124,26,229,202,27,2
2021,East Riding of Yorkshire 001A,E01012933,488,414,310,104,2,2,19,18,1,53,41,12,0
2021,East Riding of Yorkshire 001B,E01012934,812,567,378,189,4,4,90,83,7,150,127,23,1
2021,East Riding of Yorkshire 002C,E01012935,624,568,430,138,0,0,10,3,7,45,31,14,1
2021,East Riding of Yorkshire 004A,E01012936,641,387,325,62,3,3,45,9,36,206,186,20,0
2021,East Riding of Yorkshire 002D,E01012937,1056,822,648,174,3,3,74,66,8,156,131,25,1
2021,East Riding of Yorkshire 001D,E01012939,842,747,530,217,2,2,13,3,10,80,67,13,0
2021,East Riding of Yorkshire 001E,E01012940,846,685,506,179,1,1,11,8,3,149,130,19,0
2021,East Riding of Yorkshire 001F,E01012941,722,572,456,116,0,0,39,8,31,111,98,13,0
2021,East Riding of Yorkshire 002E,E01012942,647,552,451,101,0,0,5,5,0,90,71,19,0
2021,East Riding of Yorkshire 004B,E01012943,759,396,221,175,23,23,60,23,37,280,242,38,0
2021,East Riding of Yorkshire 005A,E01012944,727,215,147,68,1,1,26,9,17,485,463,22,0
2021,East Riding of Yorkshire 004C,E01012945,705,354,211,143,0,0,62,40,22,288,274,14,1
2021,East Riding of Yorkshire 003D,E01012946,702,233,121,112,1,1,369,337,32,88,78,10,11
2021,East Riding of Yorkshire 005B,E01012947,621,456,292,164,0,0,23,5,18,142,121,21,0
2021,East Riding of Yorkshire 005C,E01012948,698,226,148,78,0,0,93,22,71,379,357,22,0
2021,East Riding of Yorkshire 003E,E01012949,628,302,171,131,5,5,189,179,10,124,114,10,8
2021,East Riding of Yorkshire 006A,E01012950,585,505,354,151,0,0,2,1,1,78,66,12,0
2021,East Riding of Yorkshire 005D,E01012951,541,300,219,81,0,0,17,14,3,224,210,14,0
2021,East Riding of Yorkshire 004D,E01012952,720,351,225,126,4,4,25,5,20,340,313,27,0
2021,East Riding of Yorkshire 023A,E01012953,594,511,269,242,3,3,8,5,3,72,57,15,0
2021,East Riding of Yorkshire 022A,E01012954,641,513,310,203,2,2,54,35,19,72,53,19,0
2021,East Riding of Yorkshire 023B,E01012955,723,622,342,280,0,0,21,9,12,80,71,9,0
2021,East Riding of Yorkshire 022B,E01012956,483,391,226,165,1,1,53,32,21,38,34,4,0
2021,East Riding of Yorkshire 025A,E01012957,777,482,318,164,5,5,95,85,10,195,173,22,0
2021,East Riding of Yorkshire 022C,E01012958,494,463,332,131,1,1,8,8,0,22,17,5,0
2021,East Riding of Yorkshire 023C,E01012959,662,549,311,238,2,2,10,7,3,101,92,9,0
2021,East Riding of Yorkshire 025B,E01012960,733,574,385,189,1,1,46,6,40,112,104,8,0
2021,East Riding of Yorkshire 022D,E01012961,933,728,374,354,14,14,119,98,21,71,54,17,1
2021,East Riding of Yorkshire 023D,E01012962,507,429,268,161,1,1,9,6,3,67,64,3,1
2021,East Riding of Yorkshire 025C,E01012963,745,346,212,134,1,1,311,303,8,83,67,16,4
2021,East Riding of Yorkshire 023E,E01012964,754,514,276,238,1,1,149,145,4,86,75,11,4
2021,East Riding of Yorkshire 022E,E01012966,590,502,342,160,2,2,36,32,4,49,36,13,1
2021,East Riding of Yorkshire 024C,E01012967,687,595,369,226,3,3,22,16,6,67,53,14,0
2021,East Riding of Yorkshire 024D,E01012968,705,623,401,222,13,13,1,0,1,68,59,9,0
2021,East Riding of Yorkshire 024E,E01012969,464,346,189,157,2,2,57,54,3,58,51,7,1
2021,East Riding of Yorkshire 032A,E01012970,787,642,348,294,2,2,67,64,3,76,62,14,0
2021,East Riding of Yorkshire 032C,E01012972,622,563,323,240,1,1,13,13,0,45,36,9,0
2021,East Riding of Yorkshire 032E,E01012974,682,521,278,243,2,2,61,59,2,96,72,24,2
2021,East Riding of Yorkshire 044A,E01012975,743,633,415,218,3,3,24,3,21,83,67,16,0
2021,East Riding of Yorkshire 045A,E01012976,588,362,222,140,0,0,141,130,11,84,72,12,1
2021,East Riding of Yorkshire 008A,E01012978,760,669,443,226,12,12,11,4,7,68,56,12,0
2021,East Riding of Yorkshire 045B,E01012979,816,561,351,210,9,9,23,10,13,223,197,26,0
2021,East Riding of Yorkshire 045C,E01012980,821,443,246,197,1,1,141,107,34,234,210,24,2
2021,East Riding of Yorkshire 008B,E01012981,595,354,224,130,5,5,60,56,4,176,140,36,0
2021,East Riding of Yorkshire 045D,E01012982,798,528,349,179,0,0,20,11,9,250,229,21,0
2021,East Riding of Yorkshire 008C,E01012983,772,633,343,290,8,8,10,6,4,121,95,26,0
2021,East Riding of Yorkshire 044C,E01012984,789,657,417,240,7,7,28,16,12,97,75,22,0
2021,East Riding of Yorkshire 044D,E01012985,781,592,361,231,1,1,68,58,10,119,95,24,1
2021,East Riding of Yorkshire 010A,E01012986,714,530,383,147,0,0,67,52,15,117,94,23,0
2021,East Riding of Yorkshire 010B,E01012987,746,623,399,224,0,0,25,20,5,97,73,24,1
2021,East Riding of Yorkshire 010C,E01012988,685,518,276,242,1,1,32,31,1,134,99,35,0
2021,East Riding of Yorkshire 008D,E01012989,792,611,387,224,4,4,56,39,17,120,92,28,1
2021,East Riding of Yorkshire 006B,E01012990,615,440,276,164,0,0,49,39,10,126,96,30,0
2021,East Riding of Yorkshire 006C,E01012991,711,540,337,203,2,2,78,68,10,88,68,20,3
2021,East Riding of Yorkshire 006D,E01012992,638,406,280,126,1,1,58,42,16,171,143,28,2
2021,East Riding of Yorkshire 040A,E01012993,636,501,311,190,2,2,66,65,1,65,55,10,2
2021,East Riding of Yorkshire 041A,E01012994,812,474,227,247,1,1,203,199,4,124,106,18,10
2021,East Riding of Yorkshire 041B,E01012995,794,423,197,226,1,1,239,230,9,126,122,4,5
2021,East Riding of Yorkshire 037A,E01012996,720,632,355,277,3,3,13,12,1,72,59,13,0
2021,East Riding of Yorkshire 040B,E01012997,904,296,156,140,4,4,99,33,66,504,483,21,1
2021,East Riding of Yorkshire 037B,E01012998,943,809,418,391,1,1,25,24,1,108,97,11,0
2021,East Riding of Yorkshire 040C,E01012999,711,228,124,104,2,2,57,40,17,424,408,16,0
2021,East Riding of Yorkshire 041C,E01013000,1064,318,146,172,4,4,223,190,33,518,489,29,1
2021,East Riding of Yorkshire 040D,E01013001,778,540,332,208,1,1,85,76,9,151,129,22,1
2021,East Riding of Yorkshire 041D,E01013002,761,368,191,177,0,0,197,185,12,196,183,13,0
2021,East Riding of Yorkshire 038A,E01013003,670,423,269,154,2,2,170,120,50,70,58,12,5
2021,East Riding of Yorkshire 041E,E01013004,679,351,176,175,0,0,103,89,14,224,218,6,1
2021,East Riding of Yorkshire 036A,E01013005,760,631,313,318,8,8,39,2,37,82,67,15,0
2021,East Riding of Yorkshire 043A,E01013006,657,452,201,251,1,1,61,51,10,143,137,6,0
2021,East Riding of Yorkshire 036B,E01013007,652,480,274,206,1,1,48,43,5,120,106,14,3
2021,East Riding of Yorkshire 034A,E01013008,663,433,208,225,3,3,9,5,4,217,195,22,1
2021,East Riding of Yorkshire 034B,E01013009,762,390,194,196,1,1,207,142,65,161,147,14,3
2021,East Riding of Yorkshire 043B,E01013010,637,435,217,218,3,3,78,78,0,121,108,13,0
2021,East Riding of Yorkshire 036C,E01013011,674,464,209,255,0,0,101,83,18,108,92,16,1
2021,East Riding of Yorkshire 036D,E01013012,711,637,295,342,3,3,43,1,42,28,24,4,0
2021,East Riding of Yorkshire 034C,E01013013,675,486,232,254,2,2,10,8,2,177,159,18,0
2021,East Riding of Yorkshire 034D,E01013014,604,443,218,225,2,2,70,68,2,83,67,16,6
2021,East Riding of Yorkshire 037C,E01013015,816,582,343,239,1,1,26,19,7,206,193,13,1
2021,East Riding of Yorkshire 037D,E01013016,773,697,414,283,1,1,2,1,1,73,51,22,0
2021,East Riding of Yorkshire 038B,E01013017,851,558,285,273,13,13,154,134,20,120,104,16,6
2021,East Riding of Yorkshire 026A,E01013018,824,601,305,296,0,0,95,69,26,128,109,19,0
2021,East Riding of Yorkshire 026B,E01013019,490,399,239,160,2,2,27,24,3,62,50,12,0
2021,East Riding of Yorkshire 038C,E01013020,787,653,365,288,3,3,25,23,2,105,94,11,1
2021,East Riding of Yorkshire 026C,E01013021,647,538,336,202,0,0,9,9,0,100,86,14,0
2021,East Riding of Yorkshire 018A,E01013022,824,677,374,303,13,13,60,32,28,74,54,20,0
2021,East Riding of Yorkshire 018B,E01013023,784,669,407,262,0,0,12,9,3,103,72,31,0
2021,East Riding of Yorkshire 018C,E01013024,801,595,316,279,13,13,100,47,53,90,74,16,3
2021,East Riding of Yorkshire 026D,E01013025,613,462,283,179,0,0,84,45,39,64,54,10,3
2021,East Riding of Yorkshire 026E,E01013026,719,548,305,243,7,7,63,62,1,99,77,22,2
2021,East Riding of Yorkshire 014C,E01013027,791,582,360,222,3,3,107,76,31,98,81,17,1
2021,East Riding of Yorkshire 031A,E01013028,659,548,313,235,0,0,37,34,3,74,64,10,0
2021,East Riding of Yorkshire 021A,E01013029,653,464,308,156,0,0,69,65,4,119,95,24,1
2021,East Riding of Yorkshire 021B,E01013030,656,492,319,173,0,0,59,51,8,102,84,18,3
2021,East Riding of Yorkshire 021C,E01013031,619,550,364,186,1,1,11,9,2,57,43,14,0
2021,East Riding of Yorkshire 021D,E01013032,616,532,325,207,0,0,19,14,5,65,45,20,0
2021,East Riding of Yorkshire 033A,E01013033,675,541,265,276,0,0,61,55,6,71,55,16,2
2021,East Riding of Yorkshire 014D,E01013034,739,597,343,254,0,0,30,17,13,112,93,19,0
2021,East Riding of Yorkshire 021E,E01013035,630,567,333,234,2,2,21,14,7,40,34,6,0
2021,East Riding of Yorkshire 019A,E01013036,793,382,215,167,0,0,162,70,92,243,221,22,6
2021,East Riding of Yorkshire 019B,E01013037,672,475,238,237,0,0,7,6,1,190,169,21,0
2021,East Riding of Yorkshire 017A,E01013038,615,233,118,115,11,11,323,276,47,46,42,4,2
2021,East Riding of Yorkshire 020C,E01013039,876,695,370,325,14,14,91,75,16,75,61,14,1
2021,East Riding of Yorkshire 019C,E01013040,1071,678,356,322,2,2,77,41,36,313,285,28,1
2021,East Riding of Yorkshire 019D,E01013041,930,471,329,142,21,21,219,86,133,216,197,19,3
2021,East Riding of Yorkshire 020D,E01013042,669,592,369,223,4,4,21,1,20,52,46,6,0
2021,East Riding of Yorkshire 020E,E01013043,550,437,258,179,0,0,48,2,46,65,59,6,0
2021,East Riding of Yorkshire 020F,E01013044,793,678,365,313,7,7,30,1,29,78,71,7,0
2021,East Riding of Yorkshire 017B,E01013045,683,291,136,155,1,1,286,274,12,94,77,17,11
2021,East Riding of Yorkshire 012A,E01013046,768,649,483,166,4,4,8,7,1,107,86,21,0
2021,East Riding of Yorkshire 012B,E01013047,707,442,304,138,2,2,127,68,59,134,111,23,2
2021,East Riding of Yorkshire 010D,E01013048,993,755,441,314,1,1,88,46,42,149,120,29,0
2021,East Riding of Yorkshire 012C,E01013049,790,493,332,161,2,2,113,63,50,181,163,18,1
2021,East Riding of Yorkshire 012D,E01013050,761,647,450,197,1,1,9,1,8,104,83,21,0
2021,East Riding of Yorkshire 012E,E01013051,685,420,257,163,1,1,131,115,16,132,110,22,1
2021,East Riding of Yorkshire 011B,E01013053,814,710,465,245,9,9,28,26,2,67,54,13,0
2021,East Riding of Yorkshire 011C,E01013054,876,642,354,288,2,2,24,2,22,208,185,23,0
2021,East Riding of Yorkshire 011D,E01013055,818,586,285,301,2,2,101,98,3,129,110,19,0
2021,East Riding of Yorkshire 011E,E01013056,836,393,189,204,1,1,210,147,63,231,213,18,1
2021,East Riding of Yorkshire 009A,E01013057,673,577,312,265,4,4,18,11,7,74,57,17,0
2021,East Riding of Yorkshire 011F,E01013058,660,463,299,164,1,1,100,98,2,93,73,20,3
2021,East Riding of Yorkshire 009B,E01013059,692,591,349,242,4,4,42,31,11,55,40,15,0
2021,East Riding of Yorkshire 009C,E01013060,1022,851,464,387,10,10,50,6,44,111,89,22,0
2021,East Riding of Yorkshire 009D,E01013061,707,559,351,208,8,8,90,74,16,50,43,7,0
2021,East Riding of Yorkshire 019E,E01013062,902,504,356,148,5,5,96,76,20,295,268,27,2
2021,East Riding of Yorkshire 019F,E01013063,732,599,413,186,0,0,62,53,9,70,62,8,1
2021,East Riding of Yorkshire 016A,E01013064,520,464,221,243,0,0,3,3,0,53,46,7,0
2021,East Riding of Yorkshire 016B,E01013065,733,614,383,231,4,4,52,19,33,63,49,14,0
2021,East Riding of Yorkshire 016C,E01013066,697,603,389,214,3,3,6,5,1,85,73,12,0
2021,East Riding of Yorkshire 016D,E01013067,693,598,347,251,3,3,2,1,1,90,82,8,0
2021,East Riding of Yorkshire 016E,E01013068,997,831,490,341,16,16,63,26,37,87,71,16,0
2021,East Riding of Yorkshire 017C,E01013069,697,507,263,244,0,0,76,75,1,114,98,16,0
2021,East Riding of Yorkshire 016F,E01013070,686,588,386,202,1,1,11,6,5,86,64,22,0
2021,East Riding of Yorkshire 017D,E01013071,792,282,139,143,8,8,342,301,41,147,128,19,13
2021,East Riding of Yorkshire 042A,E01013072,729,494,262,232,2,2,127,104,23,103,86,17,3
2021,East Riding of Yorkshire 042B,E01013073,761,599,307,292,3,3,53,40,13,105,89,16,1
2021,East Riding of Yorkshire 040E,E01013074,701,582,352,230,0,0,19,18,1,99,87,12,1
2021,East Riding of Yorkshire 042C,E01013075,581,512,308,204,6,6,17,17,0,46,36,10,0
2021,East Riding of Yorkshire 038D,E01013076,652,470,256,214,1,1,89,80,9,91,69,22,1
2021,East Riding of Yorkshire 042D,E01013077,849,695,363,332,1,1,75,67,8,77,61,16,1
2021,East Riding of Yorkshire 031B,E01013078,631,512,332,180,0,0,55,52,3,64,48,16,0
2021,East Riding of Yorkshire 039A,E01013079,693,571,404,167,4,4,8,7,1,110,86,24,0
2021,East Riding of Yorkshire 039B,E01013080,617,332,225,107,1,1,86,81,5,198,177,21,0
2021,East Riding of Yorkshire 031C,E01013081,672,504,290,214,1,1,41,38,3,124,97,27,2
2021,East Riding of Yorkshire 031D,E01013082,735,566,384,182,0,0,12,5,7,157,138,19,0
2021,East Riding of Yorkshire 039C,E01013083,625,338,235,103,2,2,53,35,18,232,212,20,0
2021,East Riding of Yorkshire 039D,E01013084,629,260,181,79,1,1,242,222,20,119,101,18,7
2021,East Riding of Yorkshire 031E,E01013085,735,571,332,239,1,1,64,59,5,98,84,14,1
2021,East Riding of Yorkshire 039E,E01013086,662,405,247,158,3,3,144,114,30,110,95,15,0
2021,East Riding of Yorkshire 039F,E01013087,560,436,285,151,0,0,69,68,1,54,38,16,1
2021,East Riding of Yorkshire 035A,E01013088,742,683,408,275,3,3,24,4,20,32,25,7,0
2021,East Riding of Yorkshire 035B,E01013089,725,613,360,253,2,2,10,2,8,100,85,15,0
2021,East Riding of Yorkshire 035C,E01013090,593,501,270,231,1,1,35,34,1,55,43,12,1
2021,East Riding of Yorkshire 035D,E01013091,661,521,302,219,1,1,53,29,24,86,80,6,0
2021,East Riding of Yorkshire 032F,E01013092,1083,852,344,508,5,5,91,67,24,132,119,13,3
2021,East Riding of Yorkshire 035E,E01013093,681,593,379,214,3,3,18,7,11,67,60,7,0
2021,East Riding of Yorkshire 029A,E01013094,572,431,271,160,0,0,72,71,1,67,60,7,2
2021,East Riding of Yorkshire 029B,E01013095,671,492,311,181,1,1,27,7,20,151,140,11,0
2021,East Riding of Yorkshire 029C,E01013096,771,589,279,310,1,1,62,62,0,117,98,19,2
2021,East Riding of Yorkshire 029D,E01013097,655,486,309,177,1,1,4,2,2,164,139,25,0
2021,East Riding of Yorkshire 033B,E01013098,940,746,404,342,3,3,18,17,1,173,156,17,0
2021,East Riding of Yorkshire 033C,E01013099,671,398,263,135,25,25,173,112,61,74,57,17,1
2021,East Riding of Yorkshire 033D,E01013100,688,604,346,258,1,1,17,12,5,66,54,12,0
2021,East Riding of Yorkshire 033E,E01013101,725,585,303,282,1,1,69,45,24,70,53,17,0
2021,East Riding of Yorkshire 029E,E01013102,689,552,354,198,0,0,29,21,8,106,87,19,2
2021,East Riding of Yorkshire 043C,E01013103,601,526,335,191,1,1,7,4,3,67,51,16,0
2021,East Riding of Yorkshire 043D,E01013104,562,491,318,173,2,2,2,1,1,67,59,8,0
2021,East Riding of Yorkshire 027A,E01013105,627,432,238,194,0,0,120,119,1,73,61,12,2
2021,East Riding of Yorkshire 043E,E01013106,463,307,144,163,0,0,113,106,7,42,37,5,1
2021,East Riding of Yorkshire 034E,E01013107,1032,592,285,307,2,2,268,245,23,170,146,24,0
2021,East Riding of Yorkshire 028A,E01013108,692,632,384,248,2,2,10,1,9,48,40,8,0
2021,East Riding of Yorkshire 027B,E01013110,662,525,243,282,1,1,61,50,11,75,65,10,0
2021,East Riding of Yorkshire 027C,E01013111,633,525,305,220,0,0,7,4,3,101,90,11,0
2021,East Riding of Yorkshire 025D,E01013112,642,604,427,177,0,0,7,5,2,29,19,10,2
2021,East Riding of Yorkshire 028B,E01013113,698,621,406,215,2,2,9,7,2,66,46,20,0
2021,East Riding of Yorkshire 028C,E01013114,632,597,368,229,1,1,2,1,1,32,24,8,0
2021,East Riding of Yorkshire 027D,E01013115,646,521,298,223,1,1,11,9,2,112,95,17,1
2021,East Riding of Yorkshire 028D,E01013116,733,642,321,321,11,11,23,4,19,57,47,10,0
2021,East Riding of Yorkshire 027E,E01013117,599,543,322,221,0,0,6,4,2,50,46,4,0
2021,East Riding of Yorkshire 028E,E01013118,644,590,352,238,3,3,13,13,0,37,26,11,1
2021,East Riding of Yorkshire 011G,E01013119,636,344,202,142,3,3,36,20,16,253,199,54,0
2021,East Riding of Yorkshire 015A,E01013120,899,741,446,295,2,2,35,14,21,121,106,15,0
2021,East Riding of Yorkshire 015B,E01013121,904,702,339,363,8,8,57,39,18,136,106,30,1
2021,East Riding of Yorkshire 018D,E01013122,610,531,327,204,1,1,15,11,4,63,33,30,0
2021,East Riding of Yorkshire 015C,E01013123,874,651,331,320,18,18,66,33,33,138,127,11,1
2021,East Riding of Yorkshire 015D,E01013124,1092,615,347,268,9,9,230,179,51,235,208,27,3
2021,East Riding of Yorkshire 008E,E01013125,755,558,336,222,0,0,89,77,12,108,83,25,0
2021,East Riding of Yorkshire 009E,E01013126,754,624,311,313,3,3,38,15,23,89,73,16,0
2021,East Riding of Yorkshire 018E,E01013127,650,554,337,217,1,1,22,15,7,72,41,31,1
2021,North East Lincolnshire 024E,E01013128,606,302,168,134,3,3,37,9,28,264,245,19,0
2021,North East Lincolnshire 024D,E01013129,683,262,135,127,0,0,34,6,28,387,371,16,0
2021,North East Lincolnshire 018A,E01013130,595,310,149,161,14,14,197,50,147,74,54,20,0
2021,North East Lincolnshire 014A,E01013131,762,342,159,183,2,2,150,32,118,267,251,16,1
2021,North East Lincolnshire 014B,E01013132,648,479,247,232,1,1,59,15,44,108,92,16,1
2021,North East Lincolnshire 014C,E01013133,743,409,209,200,0,0,49,2,47,285,268,17,0
2021,North East Lincolnshire 014D,E01013134,680,437,267,170,3,3,134,38,96,106,86,20,0
2021,North East Lincolnshire 018B,E01013135,754,451,310,141,2,2,214,61,153,85,72,13,2
2021,North East Lincolnshire 002A,E01013136,722,77,45,32,1,1,453,143,310,187,175,12,4
2021,North East Lincolnshire 006A,E01013138,607,150,91,59,1,1,152,58,94,304,295,9,0
2021,North East Lincolnshire 006B,E01013140,576,223,122,101,1,1,62,11,51,290,278,12,0
2021,North East Lincolnshire 006C,E01013141,623,309,140,169,0,0,49,11,38,263,250,13,2
2021,North East Lincolnshire 002D,E01013142,757,215,112,103,10,10,176,46,130,352,335,17,4
2021,North East Lincolnshire 006D,E01013143,573,301,141,160,2,2,28,1,27,242,231,11,0
2021,North East Lincolnshire 004A,E01013144,786,169,94,75,2,2,483,197,286,126,115,11,6
2021,North East Lincolnshire 004B,E01013145,501,456,255,201,0,0,4,0,4,41,35,6,0
2021,North East Lincolnshire 004C,E01013146,699,514,240,274,6,6,59,16,43,120,107,13,0
2021,North East Lincolnshire 009A,E01013147,582,327,166,161,0,0,129,47,82,122,104,18,4
2021,North East Lincolnshire 004D,E01013148,575,520,297,223,1,1,3,0,3,51,40,11,0
2021,North East Lincolnshire 013A,E01013149,481,424,255,169,0,0,9,3,6,48,40,8,0
2021,North East Lincolnshire 013B,E01013150,515,456,242,214,1,1,7,1,6,51,44,7,0
2021,North East Lincolnshire 024G,E01013151,512,465,275,190,0,0,6,1,5,41,31,10,0
2021,North East Lincolnshire 024F,E01013152,661,596,384,212,3,3,9,2,7,52,40,12,1
2021,North East Lincolnshire 020A,E01013153,633,566,429,137,1,1,6,1,5,60,48,12,0
2021,North East Lincolnshire 018C,E01013154,610,556,372,184,0,0,6,1,5,48,39,9,0
2021,North East Lincolnshire 024H,E01013155,602,547,348,199,0,0,3,1,2,52,40,12,0
2021,North East Lincolnshire 018D,E01013156,685,346,244,102,2,2,238,69,169,98,92,6,1
2021,North East Lincolnshire 020B,E01013157,726,618,319,299,4,4,5,1,4,99,82,17,0
2021,North East Lincolnshire 012A,E01013158,594,413,215,198,1,1,57,19,38,121,98,23,2
2021,North East Lincolnshire 011A,E01013159,645,234,105,129,1,1,61,14,47,348,331,17,1
2021,North East Lincolnshire 012B,E01013160,639,533,280,253,0,0,6,1,5,100,89,11,0
2021,North East Lincolnshire 011B,E01013161,543,239,108,131,2,2,30,6,24,270,257,13,2
2021,North East Lincolnshire 011C,E01013162,648,307,144,163,5,5,37,8,29,299,288,11,0
2021,North East Lincolnshire 012C,E01013163,588,522,342,180,0,0,14,5,9,52,40,12,0
2021,North East Lincolnshire 012D,E01013164,711,447,181,266,11,11,107,38,69,145,130,15,1
2021,North East Lincolnshire 011D,E01013165,580,231,132,99,2,2,85,13,72,262,249,13,0
2021,North East Lincolnshire 020D,E01013167,801,729,474,255,6,6,6,2,4,60,41,19,0
2021,North East Lincolnshire 022B,E01013170,662,530,321,209,2,2,52,11,41,77,65,12,1
2021,North East Lincolnshire 022C,E01013171,697,644,286,358,5,5,14,1,13,34,26,8,0
2021,North East Lincolnshire 022D,E01013172,692,578,378,200,1,1,34,7,27,79,64,15,0
2021,North East Lincolnshire 007A,E01013173,580,456,262,194,2,2,50,9,41,72,57,15,0
2021,North East Lincolnshire 001A,E01013174,551,187,86,101,0,0,262,112,150,102,95,7,0
2021,North East Lincolnshire 001B,E01013175,757,624,276,348,1,1,32,6,26,100,91,9,0
2021,North East Lincolnshire 001C,E01013176,598,458,262,196,5,5,14,2,12,121,115,6,0
2021,North East Lincolnshire 001D,E01013177,647,251,140,111,0,0,282,75,207,114,103,11,0
2021,North East Lincolnshire 001E,E01013178,623,505,319,186,2,2,14,2,12,102,93,9,0
2021,North East Lincolnshire 001F,E01013179,664,452,228,224,0,0,108,29,79,102,85,17,2
2021,North East Lincolnshire 001G,E01013180,610,465,274,191,1,1,44,19,25,100,77,23,0
2021,North East Lincolnshire 016A,E01013181,603,248,116,132,2,2,28,4,24,325,315,10,0
2021,North East Lincolnshire 016B,E01013182,618,542,345,197,3,3,9,1,8,64,60,4,0
2021,North East Lincolnshire 016C,E01013183,644,475,247,228,3,3,46,12,34,120,107,13,0
2021,North East Lincolnshire 016D,E01013184,641,405,201,204,3,3,14,2,12,219,206,13,0
2021,North East Lincolnshire 016E,E01013185,566,442,230,212,3,3,36,18,18,85,70,15,0
2021,North East Lincolnshire 016F,E01013186,600,512,228,284,6,6,17,6,11,65,57,8,0
2021,North East Lincolnshire 008A,E01013187,788,267,166,101,3,3,260,31,229,258,241,17,0
2021,North East Lincolnshire 008B,E01013188,687,562,327,235,0,0,6,0,6,119,104,15,0
2021,North East Lincolnshire 021A,E01013189,713,626,358,268,3,3,21,4,17,63,56,7,0
2021,North East Lincolnshire 021C,E01013191,657,597,357,240,3,3,7,1,6,50,34,16,0
2021,North East Lincolnshire 021D,E01013192,701,339,152,187,2,2,253,66,187,106,96,10,1
2021,North East Lincolnshire 022E,E01013193,725,680,423,257,0,0,4,1,3,41,30,11,0
2021,North East Lincolnshire 021E,E01013194,680,590,386,204,2,2,7,0,7,81,63,18,0
2021,North East Lincolnshire 005A,E01013195,595,302,144,158,0,0,42,7,35,251,223,28,0
2021,North East Lincolnshire 005B,E01013196,549,236,127,109,2,2,23,2,21,288,273,15,0
2021,North East Lincolnshire 012E,E01013197,512,381,186,195,0,0,12,3,9,119,103,16,0
2021,North East Lincolnshire 024A,E01013198,623,402,195,207,5,5,40,7,33,176,163,13,0
2021,North East Lincolnshire 024B,E01013199,482,235,120,115,1,1,23,3,20,223,208,15,0
2021,North East Lincolnshire 024C,E01013200,502,445,207,238,0,0,4,0,4,53,44,9,0
2021,North East Lincolnshire 005C,E01013201,643,248,145,103,0,0,51,14,37,344,327,17,0
2021,North East Lincolnshire 005D,E01013202,601,332,168,164,4,4,12,6,6,253,223,30,0
2021,North East Lincolnshire 005E,E01013203,692,238,132,106,1,1,59,12,47,394,376,18,0
2021,North East Lincolnshire 019A,E01013204,581,307,166,141,1,1,175,61,114,98,85,13,0
2021,North East Lincolnshire 019B,E01013205,499,161,83,78,2,2,249,84,165,87,83,4,0
2021,North East Lincolnshire 015A,E01013206,570,323,180,143,4,4,156,53,103,87,81,6,0
2021,North East Lincolnshire 015B,E01013207,602,439,256,183,2,2,60,17,43,101,79,22,0
2021,North East Lincolnshire 019C,E01013208,518,122,73,49,2,2,329,96,233,65,63,2,0
2021,North East Lincolnshire 019D,E01013209,661,231,123,108,0,0,335,145,190,92,84,8,3
2021,North East Lincolnshire 019E,E01013210,514,200,100,100,2,2,224,106,118,85,77,8,3
2021,North East Lincolnshire 015C,E01013211,636,491,252,239,4,4,8,3,5,133,123,10,0
2021,North East Lincolnshire 015D,E01013212,556,121,55,66,2,2,369,141,228,62,57,5,2
2021,North East Lincolnshire 023A,E01013213,605,329,187,142,4,4,174,28,146,98,87,11,0
2021,North East Lincolnshire 023B,E01013214,662,587,407,180,0,0,19,1,18,56,40,16,0
2021,North East Lincolnshire 023C,E01013215,684,614,382,232,1,1,1,0,1,68,57,11,0
2021,North East Lincolnshire 023D,E01013216,499,449,245,204,2,2,5,2,3,43,38,5,0
2021,North East Lincolnshire 023E,E01013217,628,541,325,216,1,1,29,7,22,57,46,11,0
2021,North East Lincolnshire 003A,E01013218,584,288,157,131,1,1,39,12,27,256,236,20,0
2021,North East Lincolnshire 003B,E01013219,682,343,163,180,0,0,73,21,52,266,243,23,0
2021,North East Lincolnshire 003C,E01013220,742,265,149,116,3,3,94,15,79,379,362,17,1
2021,North East Lincolnshire 003D,E01013221,949,247,138,109,4,4,295,77,218,403,379,24,0
2021,North East Lincolnshire 003E,E01013222,692,291,155,136,4,4,30,5,25,367,353,14,0
2021,North East Lincolnshire 007C,E01013224,856,672,328,344,5,5,88,22,66,90,73,17,1
2021,North East Lincolnshire 023F,E01013225,455,362,215,147,3,3,12,2,10,78,55,23,0
2021,North East Lincolnshire 007D,E01013226,621,529,309,220,3,3,19,6,13,70,56,14,0
2021,North East Lincolnshire 013C,E01013227,727,534,322,212,1,1,96,38,58,96,78,18,0
2021,North East Lincolnshire 013D,E01013228,667,512,229,283,1,1,12,3,9,142,122,20,0
2021,North East Lincolnshire 013E,E01013229,578,310,133,177,0,0,152,74,78,115,106,9,1
2021,North East Lincolnshire 008C,E01013231,698,407,217,190,1,1,23,6,17,267,240,27,0
2021,North East Lincolnshire 008D,E01013233,597,386,180,206,2,2,8,0,8,201,187,14,0
2021,North East Lincolnshire 009D,E01013234,659,463,256,207,7,7,36,3,33,152,138,14,1
2021,North Lincolnshire 017A,E01013236,736,532,309,223,0,0,97,28,69,107,89,18,0
2021,North Lincolnshire 018B,E01013237,641,280,126,154,0,0,267,143,124,93,77,16,1
2021,North Lincolnshire 015A,E01013238,775,370,176,194,1,1,210,86,124,190,176,14,4
2021,North Lincolnshire 017B,E01013239,700,448,277,171,2,2,37,17,20,213,195,18,0
2021,North Lincolnshire 020A,E01013241,745,571,415,156,0,0,42,13,29,132,102,30,0
2021,North Lincolnshire 020B,E01013242,733,659,365,294,2,2,12,5,7,59,47,12,1
2021,North Lincolnshire 020C,E01013243,933,758,435,323,8,8,53,24,29,113,86,27,1
2021,North Lincolnshire 020D,E01013244,839,530,283,247,4,4,201,80,121,102,91,11,2
2021,North Lincolnshire 006A,E01013245,607,372,188,184,1,1,134,59,75,100,91,9,0
2021,North Lincolnshire 006B,E01013246,645,492,266,226,1,1,79,33,46,73,55,18,0
2021,North Lincolnshire 006C,E01013247,727,587,332,255,1,1,35,12,23,104,86,18,0
2021,North Lincolnshire 006D,E01013248,793,641,390,251,3,3,24,11,13,125,107,18,0
2021,North Lincolnshire 006E,E01013249,793,476,231,245,0,0,196,89,107,118,108,10,3
2021,North Lincolnshire 023A,E01013250,722,545,339,206,1,1,109,48,61,67,47,20,0
2021,North Lincolnshire 023B,E01013251,778,699,438,261,4,4,19,9,10,56,43,13,0
2021,North Lincolnshire 023C,E01013252,685,608,370,238,0,0,8,3,5,69,56,13,0
2021,North Lincolnshire 023D,E01013253,846,646,368,278,0,0,107,43,64,93,80,13,0
2021,North Lincolnshire 001A,E01013254,854,484,296,188,1,1,189,82,107,179,169,10,1
2021,North Lincolnshire 001B,E01013255,1017,703,383,320,2,2,40,14,26,272,246,26,0
2021,North Lincolnshire 001C,E01013256,1101,844,413,431,8,8,26,7,19,223,199,24,0
2021,North Lincolnshire 001D,E01013257,848,727,433,294,2,2,26,6,20,93,66,27,0
2021,North Lincolnshire 001E,E01013258,709,430,210,220,1,1,172,77,95,106,88,18,0
2021,North Lincolnshire 001F,E01013259,834,527,305,222,6,6,226,77,149,75,64,11,0
2021,North Lincolnshire 019A,E01013260,660,586,380,206,2,2,15,3,12,56,46,10,1
2021,North Lincolnshire 018C,E01013261,638,587,382,205,1,1,7,1,6,43,37,6,0
2021,North Lincolnshire 018D,E01013262,598,528,351,177,1,1,21,10,11,48,40,8,0
2021,North Lincolnshire 018E,E01013263,656,554,362,192,0,0,35,15,20,67,48,19,0
2021,North Lincolnshire 019B,E01013264,828,661,313,348,2,2,51,7,44,114,103,11,0
2021,North Lincolnshire 019C,E01013265,734,672,426,246,1,1,4,0,4,57,47,10,0
2021,North Lincolnshire 019D,E01013266,836,683,388,295,7,7,2,0,2,144,125,19,0
2021,North Lincolnshire 011A,E01013267,526,398,240,158,1,1,49,12,37,78,55,23,0
2021,North Lincolnshire 011B,E01013268,569,399,242,157,0,0,64,22,42,102,89,13,4
2021,North Lincolnshire 011C,E01013269,747,619,379,240,3,3,75,17,58,50,43,7,0
2021,North Lincolnshire 004A,E01013270,850,602,350,252,2,2,79,25,54,166,146,20,1
2021,North Lincolnshire 011D,E01013271,813,478,237,241,4,4,168,74,94,160,142,18,3
2021,North Lincolnshire 011E,E01013272,865,403,279,124,2,2,214,79,135,245,219,26,1
2021,North Lincolnshire 011F,E01013273,754,642,418,224,0,0,15,10,5,97,80,17,0
2021,North Lincolnshire 013A,E01013274,832,585,314,271,2,2,31,6,25,214,188,26,0
2021,North Lincolnshire 013B,E01013275,649,558,305,253,1,1,32,12,20,57,48,9,1
2021,North Lincolnshire 013C,E01013276,743,499,304,195,1,1,133,44,89,109,94,15,1
2021,North Lincolnshire 013D,E01013277,638,524,313,211,0,0,16,5,11,98,74,24,0
2021,North Lincolnshire 016A,E01013278,658,128,59,69,0,0,445,257,188,85,82,3,0
2021,North Lincolnshire 012A,E01013279,724,179,87,92,2,2,464,221,243,76,62,14,3
2021,North Lincolnshire 016B,E01013280,607,459,277,182,2,2,65,38,27,81,76,5,0
2021,North Lincolnshire 016C,E01013281,519,233,114,119,2,2,204,129,75,80,73,7,0
2021,North Lincolnshire 017C,E01013282,650,409,187,222,0,0,155,78,77,84,71,13,2
2021,North Lincolnshire 016D,E01013283,539,246,130,116,0,0,225,128,97,67,57,10,1
2021,North Lincolnshire 017D,E01013284,637,291,143,148,3,3,253,154,99,88,73,15,2
2021,North Lincolnshire 012B,E01013285,519,439,270,169,0,0,31,17,14,49,41,8,0
2021,North Lincolnshire 005A,E01013286,1189,732,509,223,6,6,221,75,146,230,196,34,0
2021,North Lincolnshire 005B,E01013287,692,549,321,228,4,4,35,20,15,101,84,17,3
2021,North Lincolnshire 003A,E01013288,679,551,330,221,5,5,16,5,11,107,85,22,0
2021,North Lincolnshire 005C,E01013289,714,527,279,248,4,4,21,6,15,162,149,13,0
2021,North Lincolnshire 005D,E01013290,749,594,372,222,0,0,35,15,20,120,102,18,0
2021,North Lincolnshire 003B,E01013291,622,279,153,126,1,1,252,117,135,90,75,15,0
2021,North Lincolnshire 003C,E01013292,767,640,393,247,2,2,11,4,7,114,93,21,0
2021,North Lincolnshire 005E,E01013293,673,572,379,193,0,0,33,15,18,68,53,15,0
2021,North Lincolnshire 003D,E01013294,681,544,343,201,3,3,59,17,42,75,57,18,0
2021,North Lincolnshire 009A,E01013295,608,514,321,193,0,0,30,14,16,64,49,15,0
2021,North Lincolnshire 008A,E01013296,655,178,95,83,6,6,111,60,51,359,331,28,1
2021,North Lincolnshire 007A,E01013297,1008,623,260,363,8,8,131,36,95,246,228,18,0
2021,North Lincolnshire 008B,E01013298,566,221,103,118,0,0,237,142,95,107,97,10,1
2021,North Lincolnshire 008C,E01013299,647,172,75,97,0,0,392,243,149,81,72,9,2
2021,North Lincolnshire 007B,E01013300,612,181,99,82,1,1,101,42,59,329,307,22,0
2021,North Lincolnshire 009B,E01013301,657,487,257,230,0,0,38,26,12,132,114,18,0
2021,North Lincolnshire 007C,E01013302,565,448,262,186,0,0,38,14,24,79,68,11,0
2021,North Lincolnshire 002A,E01013303,585,385,213,172,2,2,66,23,43,131,109,22,1
2021,North Lincolnshire 002B,E01013304,684,562,306,256,4,4,32,6,26,86,74,12,0
2021,North Lincolnshire 002C,E01013305,671,564,322,242,2,2,12,8,4,93,74,19,0
2021,North Lincolnshire 004B,E01013306,691,501,300,201,0,0,98,37,61,92,67,25,0
2021,North Lincolnshire 002D,E01013307,794,582,319,263,2,2,85,34,51,124,108,16,1
2021,North Lincolnshire 004C,E01013308,803,544,303,241,1,1,128,52,76,129,110,19,1
2021,North Lincolnshire 004D,E01013309,706,500,286,214,4,4,59,25,34,143,124,19,0
2021,North Lincolnshire 010A,E01013310,622,382,219,163,1,1,141,70,71,97,80,17,1
2021,North Lincolnshire 015C,E01013311,761,239,113,126,0,0,415,238,177,106,90,16,1
2021,North Lincolnshire 010B,E01013312,840,253,123,130,1,1,336,146,190,248,232,16,2
2021,North Lincolnshire 010C,E01013313,674,473,251,222,0,0,41,14,27,160,147,13,0
2021,North Lincolnshire 010D,E01013314,646,440,218,222,1,1,117,48,69,88,77,11,0
2021,North Lincolnshire 014A,E01013315,778,296,166,130,3,3,367,175,192,109,96,13,3
2021,North Lincolnshire 012C,E01013316,581,527,322,205,1,1,7,3,4,46,41,5,0
2021,North Lincolnshire 014B,E01013317,549,429,221,208,1,1,56,33,23,63,47,16,0
2021,North Lincolnshire 014C,E01013318,608,437,220,217,3,3,64,24,40,104,90,14,0
2021,North Lincolnshire 014D,E01013319,895,419,199,220,6,6,283,130,153,187,175,12,0
2021,North Lincolnshire 015D,E01013320,599,385,202,183,1,1,95,37,58,114,100,14,4
2021,North Lincolnshire 012D,E01013321,672,554,286,268,2,2,33,5,28,82,64,18,1
2021,North Lincolnshire 022A,E01013322,917,688,359,329,6,6,73,28,45,150,138,12,0
2021,North Lincolnshire 022B,E01013323,682,473,293,180,1,1,81,25,56,127,98,29,0
2021,North Lincolnshire 021A,E01013324,615,510,316,194,0,0,34,10,24,71,51,20,0
2021,North Lincolnshire 022C,E01013325,650,560,365,195,2,2,15,5,10,73,55,18,0
2021,North Lincolnshire 021B,E01013326,705,565,361,204,1,1,69,26,43,70,61,9,0
2021,North Lincolnshire 021C,E01013327,689,532,365,167,2,2,55,23,32,100,81,19,0
2021,North Lincolnshire 021D,E01013328,515,453,271,182,0,0,19,6,13,43,35,8,0
2021,North Lincolnshire 022D,E01013329,815,560,309,251,4,4,135,62,73,116,104,12,0
2021,North Lincolnshire 008D,E01013330,825,207,119,88,4,4,178,83,95,434,413,21,2
2021,North Lincolnshire 007D,E01013331,817,230,111,119,0,0,381,216,165,201,183,18,5
2021,North Lincolnshire 008E,E01013332,671,288,151,137,8,8,89,36,53,284,261,23,2
2021,North Lincolnshire 009C,E01013333,603,407,214,193,0,0,29,6,23,167,135,32,0
2021,North Lincolnshire 009D,E01013334,660,443,222,221,0,0,41,18,23,176,164,12,0
2021,York 012A,E01013335,638,324,160,164,0,0,260,236,24,51,42,9,3
2021,York 012B,E01013336,661,473,257,216,1,1,113,49,64,73,62,11,1
2021,York 012C,E01013337,760,591,329,262,4,4,47,38,9,118,104,14,0
2021,York 012D,E01013338,923,699,319,380,10,10,94,48,46,120,105,15,0
2021,York 012E,E01013339,644,585,317,268,1,1,21,18,3,37,34,3,0
2021,York 024A,E01013340,515,463,282,181,2,2,3,2,1,46,34,12,1
2021,York 024B,E01013341,613,483,306,177,3,3,60,51,9,66,51,15,1
2021,York 024C,E01013342,689,614,447,167,1,1,14,5,9,60,49,11,0
2021,York 009A,E01013343,783,379,214,165,3,3,35,18,17,366,347,19,0
2021,York 007A,E01013344,612,378,225,153,2,2,25,17,8,207,187,20,0
2021,York 009B,E01013345,806,427,214,213,3,3,81,24,57,293,270,23,2
2021,York 007B,E01013346,809,532,339,193,2,2,106,34,72,169,150,19,0
2021,York 009C,E01013347,641,242,92,150,0,0,305,262,43,91,84,7,3
2021,York 010A,E01013348,631,294,135,159,4,4,60,6,54,273,261,12,0
2021,York 009D,E01013349,529,209,84,125,1,1,266,212,54,53,47,6,0
2021,York 009E,E01013350,677,281,123,158,13,13,253,225,28,125,115,10,5
2021,York 020A,E01013351,792,692,485,207,6,6,17,2,15,77,53,24,0
2021,York 020B,E01013352,771,619,407,212,1,1,73,62,11,77,61,16,1
2021,York 022A,E01013353,716,417,168,249,3,3,212,206,6,81,66,15,3
2021,York 022B,E01013354,602,548,328,220,1,1,8,3,5,45,40,5,0
2021,York 022C,E01013355,885,696,451,245,7,7,47,14,33,135,119,16,0
2021,York 022D,E01013356,660,535,349,186,13,13,53,6,47,59,47,12,0
2021,York 021A,E01013357,919,794,455,339,1,1,56,10,46,68,58,10,0
2021,York 021B,E01013358,673,556,322,234,1,1,10,2,8,105,96,9,1
2021,York 022E,E01013359,658,430,196,234,1,1,152,145,7,72,62,10,3
2021,York 019A,E01013360,631,383,191,192,2,2,11,4,7,235,124,111,0
2021,York 019B,E01013361,737,427,251,176,9,9,33,14,19,268,249,19,0
2021,York 019C,E01013362,771,519,348,171,1,1,45,22,23,205,181,24,1
2021,York 019D,E01013363,880,258,146,112,23,23,171,60,111,427,387,40,1
2021,York 019E,E01013364,835,266,152,114,6,6,133,75,58,430,408,22,0
2021,York 013A,E01013366,916,247,149,98,3,3,240,188,52,425,382,43,1
2021,York 010B,E01013368,914,424,239,185,2,2,45,22,23,443,421,22,0
2021,York 013C,E01013369,930,341,243,98,2,2,179,106,73,406,380,26,2
2021,York 002A,E01013370,755,581,390,191,0,0,83,16,67,91,80,11,0
2021,York 003A,E01013371,584,539,338,201,0,0,2,1,1,43,36,7,0
2021,York 003B,E01013372,788,689,490,199,5,5,21,10,11,73,62,11,0
2021,York 002B,E01013373,642,484,287,197,2,2,103,17,86,53,42,11,0
2021,York 003C,E01013374,594,535,302,233,3,3,7,4,3,49,43,6,0
2021,York 002C,E01013375,594,537,366,171,1,1,7,5,2,49,39,10,0
2021,York 002D,E01013376,626,578,395,183,2,2,26,3,23,20,18,2,0
2021,York 003D,E01013377,670,594,354,240,1,1,18,4,14,57,45,12,0
2021,York 023B,E01013378,445,243,180,63,9,9,50,20,30,143,109,34,0
2021,York 008A,E01013379,598,493,294,199,0,0,38,8,30,67,59,8,0
2021,York 008B,E01013380,671,424,265,159,3,3,69,59,10,174,155,19,1
2021,York 014A,E01013381,638,500,227,273,5,5,34,28,6,99,88,11,0
2021,York 010C,E01013382,763,407,227,180,4,4,197,173,24,154,134,20,1
2021,York 010D,E01013383,1064,379,170,209,27,27,261,151,110,395,366,29,2
2021,York 015A,E01013384,639,284,132,152,4,4,188,169,19,159,148,11,4
2021,York 008C,E01013385,626,323,171,152,1,1,230,203,27,69,55,14,3
2021,York 010E,E01013386,769,315,129,186,27,27,309,281,28,114,104,10,4
2021,York 008D,E01013387,688,640,442,198,3,3,5,3,2,40,31,9,0
2021,York 008E,E01013388,503,436,317,119,1,1,6,3,3,60,48,12,0
2021,York 008F,E01013389,508,451,272,179,1,1,8,2,6,48,38,10,0
2021,York 017A,E01013390,777,339,146,193,8,8,67,26,41,362,340,22,1
2021,York 017B,E01013391,984,467,202,265,6,6,80,27,53,430,410,20,1
2021,York 012F,E01013392,665,521,250,271,15,15,35,6,29,94,87,7,0
2021,York 016A,E01013393,708,445,201,244,10,10,92,18,74,161,147,14,0
2021,York 016B,E01013394,699,285,142,143,5,5,332,312,20,72,70,2,5
2021,York 016C,E01013395,625,471,243,228,0,0,37,10,27,117,113,4,0
2021,York 016D,E01013396,746,548,342,206,7,7,70,33,37,121,112,9,0
2021,York 017C,E01013397,637,497,248,249,5,5,35,10,25,100,89,11,0
2021,York 015B,E01013398,566,286,146,140,0,0,130,125,5,149,141,8,1
2021,York 015C,E01013399,678,163,69,94,2,2,385,363,22,124,105,19,4
2021,York 015D,E01013400,784,215,97,118,6,6,73,42,31,488,466,22,2
2021,York 015E,E01013401,566,303,157,146,6,6,57,38,19,200,186,14,0
2021,York 014B,E01013402,634,459,314,145,1,1,9,2,7,165,154,11,0
2021,York 015F,E01013403,635,283,172,111,3,3,60,40,20,288,276,12,1
2021,York 004A,E01013404,725,307,175,132,59,59,307,17,290,52,35,17,0
2021,York 005A,E01013405,606,545,335,210,2,2,10,8,2,49,41,8,0
2021,York 005B,E01013406,921,520,261,259,28,28,190,14,176,183,168,15,0
2021,York 004B,E01013407,671,530,367,163,27,27,70,7,63,44,36,8,0
2021,York 004C,E01013408,614,561,416,145,3,3,5,3,2,45,31,14,0
2021,York 005C,E01013409,805,597,334,263,7,7,120,17,103,81,54,27,0
2021,York 004D,E01013410,582,120,44,76,16,16,412,22,390,34,28,6,0
2021,York 005D,E01013411,690,611,408,203,3,3,6,3,3,70,58,12,0
2021,York 021C,E01013412,1120,628,314,314,5,5,87,15,72,400,374,26,0
2021,York 017D,E01013413,682,527,275,252,2,2,18,8,10,135,123,12,0
2021,York 021D,E01013414,799,513,275,238,1,1,52,10,42,233,220,13,0
2021,York 013E,E01013416,762,260,117,143,4,4,290,249,41,206,184,22,2
2021,York 017E,E01013417,839,547,318,229,2,2,48,39,9,240,227,13,2
2021,York 019F,E01013418,772,388,201,187,17,17,126,103,23,241,221,20,0
2021,York 014C,E01013419,1129,785,412,373,68,68,185,30,155,91,68,23,0
2021,York 014D,E01013420,838,654,407,247,3,3,30,3,27,151,130,21,0
2021,York 011A,E01013421,542,451,280,171,3,3,33,26,7,55,33,22,0
2021,York 011B,E01013422,680,555,304,251,4,4,38,10,28,83,73,10,0
2021,York 024D,E01013423,558,512,349,163,4,4,2,0,2,40,32,8,0
2021,York 024E,E01013424,511,469,286,183,0,0,12,5,7,30,26,4,0
2021,York 024F,E01013425,691,551,315,236,3,3,48,37,11,87,77,10,2
2021,York 011C,E01013426,722,585,373,212,12,12,67,56,11,57,45,12,1
2021,York 011D,E01013427,596,550,361,189,3,3,8,2,6,35,29,6,0
2021,York 006A,E01013428,744,526,224,302,6,6,123,11,112,89,81,8,0
2021,York 006B,E01013429,802,600,252,348,8,8,51,7,44,143,130,13,0
2021,York 006C,E01013430,709,546,312,234,1,1,106,5,101,56,48,8,0
2021,York 006D,E01013431,951,721,242,479,3,3,51,21,30,176,157,19,0
2021,York 007C,E01013432,856,706,347,359,8,8,32,6,26,110,97,13,0
2021,York 007D,E01013433,630,577,383,194,0,0,6,4,2,47,40,7,0
2021,York 007E,E01013434,638,545,313,232,1,1,15,2,13,77,67,10,0
2021,York 006E,E01013435,620,516,308,208,1,1,51,10,41,51,45,6,1
2021,York 001A,E01013436,642,466,276,190,2,2,23,6,17,151,52,99,0
2021,York 008G,E01013437,557,419,272,147,2,2,41,6,35,95,79,16,0
2021,York 001B,E01013438,823,600,297,303,1,1,141,19,122,81,66,15,0
2021,York 001C,E01013439,539,481,237,244,2,2,4,1,3,52,48,4,0
2021,York 001D,E01013440,782,678,402,276,5,5,8,3,5,91,81,10,0
2021,York 016E,E01013441,731,497,261,236,4,4,30,21,9,199,181,18,1
2021,York 018A,E01013442,632,470,239,231,1,1,122,100,22,37,27,10,2
2021,York 018B,E01013443,774,277,124,153,2,2,421,320,101,70,59,11,4
2021,York 018C,E01013444,600,311,115,196,2,2,233,213,20,51,40,11,3
2021,York 016F,E01013445,794,409,212,197,6,6,240,227,13,139,118,21,0
2021,York 018D,E01013446,713,437,194,243,5,5,176,131,45,93,82,11,2
2021,York 018E,E01013447,626,315,123,192,2,2,230,220,10,75,69,6,4
2021,York 018F,E01013448,632,265,93,172,7,7,274,194,80,84,75,9,2
2021,York 022F,E01013449,700,488,287,201,8,8,140,18,122,64,51,13,0
2021,York 023C,E01013450,506,426,256,170,0,0,19,18,1,60,48,12,1
2021,York 020C,E01013451,496,407,216,191,7,7,27,2,25,55,47,8,0
2021,York 020D,E01013452,645,569,326,243,2,2,34,24,10,40,30,10,0
2021,Derby 013A,E01013453,1130,248,102,146,20,20,290,50,240,570,547,23,2
2021,Derby 013B,E01013454,546,204,91,113,3,3,139,86,53,200,189,11,0
2021,Derby 017A,E01013455,821,464,248,216,3,3,176,123,53,174,151,23,4
2021,Derby 013C,E01013456,934,159,80,79,11,11,374,156,218,385,373,12,5
2021,Derby 013D,E01013457,826,318,151,167,6,6,121,23,98,381,355,26,0
2021,Derby 017B,E01013458,573,385,243,142,1,1,63,37,26,122,114,8,2
2021,Derby 020A,E01013459,594,431,232,199,0,0,29,9,20,134,121,13,0
2021,Derby 013E,E01013460,876,171,93,78,6,6,90,20,70,609,593,16,0
2021,Derby 001A,E01013461,734,622,396,226,28,28,14,5,9,70,60,10,0
2021,Derby 001B,E01013462,623,527,272,255,1,1,44,36,8,49,40,9,2
2021,Derby 001C,E01013463,612,555,343,212,0,0,3,2,1,54,45,9,0
2021,Derby 001D,E01013464,625,540,337,203,2,2,33,27,6,50,42,8,0
2021,Derby 002A,E01013465,693,633,401,232,2,2,17,5,12,40,34,6,1
2021,Derby 002B,E01013466,642,609,383,226,0,0,6,5,1,27,16,11,0
2021,Derby 002C,E01013467,595,543,338,205,1,1,3,1,2,47,38,9,1
2021,Derby 002D,E01013468,690,628,410,218,3,3,6,4,2,53,44,9,0
2021,Derby 002E,E01013469,707,525,422,103,2,2,27,17,10,153,135,18,0
2021,Derby 024A,E01013470,593,388,195,193,33,33,114,63,51,57,52,5,1
2021,Derby 025A,E01013471,847,425,222,203,2,2,123,54,69,293,267,26,4
2021,Derby 026A,E01013472,985,310,136,174,2,2,511,263,248,160,154,6,2
2021,Derby 025B,E01013473,703,323,117,206,2,2,184,130,54,194,181,13,0
2021,Derby 024B,E01013474,730,366,203,163,6,6,228,155,73,126,114,12,4
2021,Derby 025C,E01013475,579,280,107,173,0,0,222,204,18,74,65,9,3
2021,Derby 024C,E01013476,729,519,275,244,3,3,66,44,22,139,132,7,2
2021,Derby 025D,E01013477,772,453,256,197,1,1,98,63,35,219,201,18,1
2021,Derby 016A,E01013480,1080,153,80,73,4,4,374,162,212,546,521,25,3
2021,Derby 018A,E01013481,571,227,159,68,1,1,137,18,119,205,180,25,1
2021,Derby 016B,E01013483,636,349,185,164,1,1,50,16,34,236,209,27,0
2021,Derby 018C,E01013484,725,246,156,90,3,3,217,130,87,259,215,44,0
2021,Derby 016C,E01013485,642,305,149,156,0,0,87,35,52,249,232,17,1
2021,Derby 018D,E01013486,598,271,162,109,4,4,110,19,91,212,177,35,1
2021,Derby 018E,E01013487,814,301,180,121,11,11,158,53,105,338,311,27,6
2021,Derby 022A,E01013488,576,489,307,182,3,3,2,2,0,82,67,15,0
2021,Derby 022B,E01013489,627,521,337,184,1,1,5,3,2,100,87,13,0
2021,Derby 022C,E01013490,584,448,258,190,2,2,81,69,12,52,46,6,1
2021,Derby 022D,E01013491,582,459,253,206,1,1,31,28,3,90,81,9,1
2021,Derby 027A,E01013492,589,500,302,198,1,1,14,11,3,74,61,13,0
2021,Derby 027B,E01013493,637,387,227,160,14,14,115,54,61,120,112,8,1
2021,Derby 027C,E01013494,798,411,214,197,18,18,234,146,88,133,124,9,2
2021,Derby 027D,E01013495,703,505,254,251,0,0,82,62,20,116,102,14,0
2021,Derby 028A,E01013496,663,251,134,117,2,2,340,51,289,70,59,11,0
2021,Derby 026B,E01013497,643,320,128,192,0,0,210,168,42,105,96,9,8
2021,Derby 028B,E01013498,615,470,262,208,1,1,76,61,15,68,58,10,0
2021,Derby 028C,E01013499,647,376,191,185,2,2,202,160,42,63,52,11,4
2021,Derby 028D,E01013500,714,536,331,205,1,1,108,90,18,67,53,14,2
2021,Derby 028E,E01013501,634,491,286,205,1,1,68,48,20,73,63,10,1
2021,Derby 025E,E01013502,616,355,173,182,0,0,158,141,17,102,94,8,1
2021,Derby 025F,E01013503,617,479,221,258,0,0,34,21,13,104,86,18,0
2021,Derby 026C,E01013504,706,341,156,185,1,1,212,192,20,148,135,13,4
2021,Derby 006A,E01013505,616,530,245,285,2,2,24,19,5,60,45,15,0
2021,Derby 006B,E01013506,688,527,345,182,4,4,95,81,14,62,48,14,0
2021,Derby 012A,E01013507,645,533,284,249,2,2,42,36,6,66,55,11,2
2021,Derby 012B,E01013508,489,273,132,141,2,2,148,130,18,64,60,4,2
2021,Derby 012C,E01013509,705,549,299,250,0,0,54,42,12,101,88,13,1
2021,Derby 012D,E01013510,621,358,163,195,2,2,190,175,15,69,58,11,2
2021,Derby 012E,E01013511,655,586,350,236,0,0,6,6,0,63,52,11,0
2021,Derby 012F,E01013512,625,308,176,132,1,1,218,179,39,96,81,15,2
2021,Derby 006C,E01013513,513,332,162,170,1,1,120,113,7,59,46,13,1
2021,Derby 031A,E01013514,676,525,294,231,2,2,46,31,15,102,90,12,1
2021,Derby 031B,E01013515,807,486,191,295,4,4,258,105,153,56,43,13,3
2021,Derby 030B,E01013517,661,452,291,161,3,3,113,86,27,91,77,14,2
2021,Derby 030C,E01013518,668,531,291,240,0,0,50,31,19,87,74,13,0
2021,Derby 031C,E01013519,600,381,144,237,18,18,136,6,130,65,61,4,0
2021,Derby 031D,E01013520,822,680,366,314,23,23,43,10,33,76,74,2,0
2021,Derby 030D,E01013521,701,312,174,138,21,21,286,124,162,81,75,6,1
2021,Derby 008A,E01013522,932,207,124,83,31,31,332,211,121,362,335,27,0
2021,Derby 008B,E01013523,1044,222,109,113,12,12,472,233,239,336,319,17,2
2021,Derby 008C,E01013524,617,130,54,76,14,14,215,111,104,258,247,11,0
2021,Derby 008D,E01013525,1022,469,207,262,47,47,183,44,139,322,302,20,1
2021,Derby 005A,E01013526,744,559,334,225,1,1,58,23,35,126,117,9,0
2021,Derby 005B,E01013527,655,564,307,257,9,9,16,6,10,66,59,7,0
2021,Derby 005C,E01013528,736,458,258,200,5,5,135,77,58,136,124,12,2
2021,Derby 005D,E01013529,1039,540,241,299,7,7,180,15,165,312,290,22,0
2021,Derby 004A,E01013530,731,435,149,286,8,8,116,80,36,172,156,16,0
2021,Derby 004B,E01013531,610,372,191,181,2,2,138,110,28,96,86,10,2
2021,Derby 004C,E01013532,613,404,184,220,1,1,146,130,16,61,52,9,1
2021,Derby 007A,E01013533,693,206,93,113,1,1,420,349,71,56,45,11,10
2021,Derby 006D,E01013534,670,479,244,235,1,1,115,69,46,75,62,13,0
2021,Derby 007B,E01013535,537,155,60,95,0,0,341,317,24,39,32,7,2
2021,Derby 007C,E01013536,679,204,100,104,2,2,381,345,36,87,79,8,5
2021,Derby 007D,E01013537,738,528,305,223,1,1,87,74,13,118,103,15,4
2021,Derby 007E,E01013538,627,365,199,166,2,2,76,55,21,184,170,14,0
2021,Derby 021A,E01013539,713,624,265,359,11,11,19,3,16,59,52,7,0
2021,Derby 019A,E01013540,659,537,311,226,4,4,39,12,27,79,64,15,0
2021,Derby 021B,E01013541,656,334,136,198,31,31,128,14,114,163,156,7,0
2021,Derby 017C,E01013542,958,545,235,310,18,18,184,85,99,209,173,36,2
2021,Derby 021C,E01013543,623,534,297,237,0,0,8,5,3,81,73,8,0
2021,Derby 021D,E01013544,674,581,331,250,3,3,4,3,1,86,79,7,0
2021,Derby 021E,E01013545,709,421,249,172,2,2,157,10,147,129,119,10,0
2021,Derby 017D,E01013546,660,540,326,214,2,2,5,2,3,113,106,7,0
2021,Derby 011A,E01013547,846,264,138,126,3,3,89,28,61,488,468,20,2
2021,Derby 009A,E01013548,744,422,235,187,11,11,198,100,98,111,99,12,2
2021,Derby 009B,E01013549,645,417,216,201,1,1,158,144,14,67,47,20,2
2021,Derby 011B,E01013550,527,241,125,116,4,4,205,187,18,75,59,16,2
2021,Derby 011C,E01013551,656,173,84,89,3,3,90,21,69,390,375,15,0
2021,Derby 009C,E01013552,732,328,166,162,0,0,318,278,40,83,64,19,3
2021,Derby 009D,E01013553,631,406,209,197,1,1,158,142,16,66,61,5,0
2021,Derby 011D,E01013554,795,172,94,78,10,10,271,88,183,339,325,14,3
2021,Derby 009E,E01013555,1006,718,234,484,17,17,171,113,58,98,82,16,2
2021,Derby 015A,E01013556,611,525,332,193,2,2,13,7,6,71,64,7,0
2021,Derby 015B,E01013557,605,552,379,173,1,1,10,10,0,42,33,9,0
2021,Derby 015C,E01013558,1055,778,409,369,8,8,113,24,89,156,144,12,0
2021,Derby 015D,E01013559,574,473,293,180,1,1,14,7,7,86,80,6,0
2021,Derby 019B,E01013560,578,514,341,173,1,1,7,4,3,56,48,8,0
2021,Derby 019C,E01013561,667,591,377,214,3,3,12,10,2,61,55,6,0
2021,Derby 019D,E01013562,707,437,291,146,2,2,161,82,79,105,94,11,2
2021,Derby 019E,E01013563,620,514,322,192,2,2,15,9,6,89,77,12,0
2021,Derby 015E,E01013564,1069,885,451,434,25,25,73,18,55,86,80,6,0
2021,Derby 016D,E01013565,542,294,150,144,0,0,31,10,21,217,199,18,0
2021,Derby 016E,E01013566,735,306,166,140,2,2,126,49,77,298,269,29,3
2021,Derby 020B,E01013567,635,233,129,104,11,11,101,28,73,289,263,26,1
2021,Derby 020C,E01013568,735,293,143,150,2,2,113,32,81,324,276,48,3
2021,Derby 020D,E01013569,543,313,184,129,1,1,33,12,21,195,177,18,1
2021,Derby 023A,E01013570,685,281,137,144,3,3,140,86,54,259,242,17,2
2021,Derby 023B,E01013571,671,311,141,170,2,2,137,97,40,216,200,16,5
2021,Derby 023C,E01013572,679,426,224,202,6,6,137,71,66,110,87,23,0
2021,Derby 023D,E01013573,870,291,123,168,2,2,468,361,107,104,91,13,5
2021,Derby 003A,E01013574,760,641,311,330,10,10,66,13,53,43,37,6,0
2021,Derby 003B,E01013575,646,486,245,241,0,0,21,7,14,139,129,10,0
2021,Derby 003C,E01013576,562,468,260,208,1,1,10,1,9,83,74,9,0
2021,Derby 003D,E01013577,601,513,255,258,2,2,10,4,6,76,73,3,0
2021,Derby 003E,E01013578,557,464,223,241,0,0,8,4,4,85,80,5,0
2021,Derby 003F,E01013579,627,480,293,187,1,1,13,4,9,133,124,9,0
2021,Derby 003G,E01013580,717,490,242,248,3,3,22,18,4,202,187,15,0
2021,Derby 004D,E01013581,613,306,122,184,15,15,215,147,68,76,70,6,1
2021,Derby 006E,E01013582,690,461,243,218,2,2,105,97,8,120,107,13,2
2021,Derby 026D,E01013583,573,217,97,120,0,0,232,206,26,124,113,11,0
2021,Derby 029A,E01013584,631,231,107,124,0,0,331,273,58,66,52,14,3
2021,Derby 029B,E01013585,733,332,124,208,0,0,291,255,36,106,95,11,4
2021,Derby 029C,E01013586,692,193,88,105,14,14,366,135,231,117,106,11,2
2021,Derby 029D,E01013587,595,451,240,211,0,0,28,26,2,115,100,15,1
2021,Derby 029E,E01013588,650,341,196,145,4,4,188,107,81,115,103,12,2
2021,Derby 029F,E01013589,684,566,288,278,1,1,37,27,10,79,69,10,1
2021,Derby 026E,E01013590,779,274,64,210,0,0,375,344,31,128,117,11,2
2021,Derby 026F,E01013591,841,230,103,127,7,7,274,165,109,329,307,22,1
2021,Derby 010A,E01013592,652,508,305,203,4,4,27,10,17,113,91,22,0
2021,Derby 014A,E01013593,612,545,316,229,0,0,20,16,4,47,37,10,0
2021,Derby 010B,E01013594,612,528,348,180,2,2,38,8,30,44,32,12,0
2021,Derby 014B,E01013595,1051,669,321,348,30,30,163,62,101,189,178,11,0
2021,Derby 010C,E01013596,697,579,384,195,6,6,47,34,13,65,58,7,0
2021,Derby 014C,E01013597,722,363,226,137,2,2,278,178,100,77,67,10,2
2021,Derby 014D,E01013598,629,407,181,226,4,4,133,123,10,84,77,7,1
2021,Derby 010D,E01013599,640,570,348,222,0,0,9,2,7,61,47,14,0
2021,Leicester 003A,E01013600,749,251,125,126,3,3,401,344,57,90,84,6,4
2021,Leicester 003B,E01013601,645,334,150,184,0,0,237,232,5,71,56,15,3
2021,Leicester 003C,E01013602,788,293,131,162,2,2,333,298,35,152,143,9,8
2021,Leicester 003D,E01013603,751,203,102,101,1,1,473,303,170,73,69,4,1
2021,Leicester 003E,E01013604,614,248,89,159,4,4,257,226,31,99,88,11,6
2021,Leicester 003F,E01013605,802,365,190,175,8,8,126,18,108,303,284,19,0
2021,Leicester 008A,E01013606,673,518,298,220,3,3,15,12,3,137,120,17,0
2021,Leicester 034A,E01013608,610,491,253,238,6,6,6,5,1,106,92,14,1
2021,Leicester 034B,E01013609,731,508,287,221,3,3,93,13,80,127,109,18,0
2021,Leicester 034C,E01013610,727,385,174,211,4,4,248,202,46,86,74,12,4
2021,Leicester 034D,E01013611,627,384,196,188,2,2,149,131,18,91,73,18,1
2021,Leicester 034E,E01013612,751,527,260,267,2,2,45,10,35,177,162,15,0
2021,Leicester 031A,E01013613,869,346,158,188,2,2,87,29,58,434,414,20,0
2021,Leicester 031B,E01013614,765,414,201,213,1,1,54,22,32,295,271,24,1
2021,Leicester 001A,E01013615,635,493,210,283,11,11,44,7,37,87,81,6,0
2021,Leicester 001B,E01013616,670,370,167,203,10,10,161,66,95,128,112,16,1
2021,Leicester 004A,E01013617,976,510,220,290,1,1,166,128,38,298,238,60,1
2021,Leicester 001C,E01013618,692,411,216,195,2,2,164,154,10,113,102,11,2
2021,Leicester 001D,E01013619,649,213,108,105,2,2,359,350,9,66,58,8,9
2021,Leicester 004B,E01013620,659,143,51,92,7,7,429,240,189,77,64,13,3
2021,Leicester 004C,E01013621,839,243,69,174,18,18,501,334,167,74,67,7,3
2021,Leicester 004D,E01013622,671,177,95,82,2,2,386,197,189,104,102,2,2
2021,Leicester 004E,E01013623,795,563,283,280,3,3,67,15,52,161,144,17,1
2021,Leicester 007A,E01013624,555,197,97,100,0,0,267,14,253,91,82,9,0
2021,Leicester 006A,E01013625,684,229,141,88,4,4,189,29,160,261,242,19,1
2021,Leicester 007B,E01013626,588,237,153,84,1,1,171,19,152,179,168,11,0
2021,Leicester 007C,E01013627,402,297,213,84,2,2,8,2,6,95,85,10,0
2021,Leicester 006B,E01013628,684,227,138,89,0,0,250,164,86,198,184,14,9
2021,Leicester 007D,E01013629,546,289,169,120,2,2,93,15,78,162,144,18,0
2021,Leicester 007E,E01013630,583,260,147,113,1,1,83,11,72,239,217,22,0
2021,Leicester 026A,E01013631,542,266,104,162,5,5,220,127,93,51,43,8,0
2021,Leicester 026B,E01013632,722,157,70,87,0,0,492,470,22,69,56,13,4
2021,Leicester 028A,E01013633,650,251,95,156,5,5,321,214,107,72,57,15,1
2021,Leicester 028B,E01013634,597,242,106,136,1,1,283,263,20,67,54,13,4
2021,Leicester 029A,E01013635,588,392,260,132,2,2,22,17,5,168,156,12,4
2021,Leicester 029B,E01013636,495,411,253,158,0,0,5,5,0,79,71,8,0
2021,Leicester 028C,E01013637,775,302,129,173,6,6,383,332,51,78,70,8,6
2021,Leicester 026C,E01013638,672,154,64,90,0,0,460,339,121,52,43,9,6
2021,Leicester 028D,E01013639,524,264,83,181,3,3,180,112,68,77,72,5,0
2021,Leicester 026D,E01013640,669,150,60,90,1,1,476,299,177,40,39,1,2
2021,Leicester 028E,E01013641,598,249,129,120,1,1,57,51,6,289,278,11,2
2021,Leicester 030A,E01013642,785,326,196,130,4,4,29,13,16,426,408,18,0
2021,Leicester 030B,E01013643,731,308,157,151,6,6,20,6,14,397,376,21,0
2021,Leicester 040C,E01013648,769,109,66,43,1,1,157,30,127,501,475,26,1
2021,Leicester 030C,E01013649,674,239,156,83,1,1,52,27,25,381,366,15,1
2021,Leicester 030D,E01013650,725,259,134,125,4,4,19,11,8,443,420,23,0
2021,Leicester 011A,E01013651,675,294,120,174,2,2,237,188,49,141,132,9,1
2021,Leicester 011B,E01013652,599,267,106,161,2,2,219,202,17,108,96,12,3
2021,Leicester 011C,E01013653,877,402,157,245,2,2,352,310,42,117,102,15,4
2021,Leicester 017A,E01013654,821,220,102,118,2,2,299,193,106,281,264,17,19
2021,Leicester 011D,E01013655,747,315,130,185,1,1,147,102,45,284,261,23,0
2021,Leicester 017B,E01013656,520,220,114,106,3,3,58,9,49,239,205,34,0
2021,Leicester 017C,E01013657,525,228,144,84,2,2,121,43,78,173,158,15,1
2021,Leicester 017D,E01013658,635,266,101,165,3,3,85,22,63,281,258,23,0
2021,Leicester 017E,E01013659,611,212,136,76,1,1,98,17,81,296,274,22,4
2021,Leicester 019A,E01013660,639,318,157,161,3,3,109,53,56,208,186,22,1
2021,Leicester 019B,E01013661,619,213,102,111,1,1,304,152,152,100,92,8,1
2021,Leicester 021A,E01013662,547,303,190,113,2,2,53,7,46,187,165,22,2
2021,Leicester 021B,E01013663,507,351,218,133,4,4,45,31,14,107,91,16,0
2021,Leicester 019C,E01013664,735,262,128,134,4,4,346,331,15,118,108,10,5
2021,Leicester 019D,E01013665,714,373,226,147,23,23,145,68,77,171,146,25,2
2021,Leicester 025A,E01013666,582,523,328,195,0,0,5,3,2,54,48,6,0
2021,Leicester 019E,E01013667,664,311,159,152,9,9,255,237,18,74,68,6,15
2021,Leicester 019F,E01013668,498,316,196,120,1,1,60,33,27,121,108,13,0
2021,Leicester 025B,E01013669,468,406,250,156,0,0,8,4,4,53,48,5,1
2021,Leicester 025C,E01013670,713,516,313,203,2,2,81,71,10,112,95,17,2
2021,Leicester 025D,E01013671,592,440,235,205,1,1,56,52,4,94,78,16,1
2021,Leicester 025E,E01013672,510,435,283,152,0,0,22,17,5,53,48,5,0
2021,Leicester 036A,E01013673,616,296,125,171,1,1,253,239,14,64,56,8,2
2021,Leicester 036B,E01013674,741,236,123,113,2,2,426,388,38,67,58,9,10
2021,Leicester 036C,E01013675,672,309,147,162,0,0,254,243,11,104,90,14,5
2021,Leicester 036D,E01013676,820,330,134,196,2,2,330,287,43,154,142,12,4
2021,Leicester 036E,E01013677,686,295,121,174,3,3,292,254,38,91,87,4,5
2021,Leicester 035A,E01013678,666,369,186,183,3,3,167,131,36,125,110,15,2
2021,Leicester 035B,E01013679,508,203,80,123,1,1,238,228,10,66,60,6,0
2021,Leicester 008C,E01013680,819,527,256,271,6,6,49,13,36,237,217,20,0
2021,Leicester 016A,E01013681,827,200,101,99,4,4,129,27,102,493,462,31,1
2021,Leicester 016B,E01013682,768,261,140,121,8,8,108,47,61,389,369,20,2
2021,Leicester 016C,E01013683,970,232,124,108,7,7,130,29,101,598,559,39,3
2021,Leicester 016D,E01013684,919,176,108,68,4,4,194,125,69,540,498,42,5
2021,Leicester 008D,E01013685,614,499,256,243,6,6,14,8,6,95,80,15,0
2021,Leicester 008E,E01013686,706,539,331,208,0,0,14,6,8,153,140,13,0
2021,Leicester 031C,E01013687,729,280,113,167,1,1,61,27,34,387,366,21,0
2021,Leicester 031D,E01013688,879,281,114,167,31,31,200,87,113,366,342,24,1
2021,Leicester 038A,E01013689,539,196,93,103,3,3,52,36,16,288,274,14,0
2021,Leicester 038B,E01013690,894,398,160,238,1,1,233,148,85,260,244,16,2
2021,Leicester 035C,E01013691,599,167,68,99,0,0,379,344,35,50,43,7,3
2021,Leicester 035D,E01013692,495,109,41,68,1,1,343,290,53,35,31,4,7
2021,Leicester 035E,E01013693,526,100,44,56,1,1,393,235,158,31,26,5,1
2021,Leicester 013A,E01013694,819,302,122,180,7,7,335,253,82,169,152,17,6
2021,Leicester 043D,E01013696,828,500,222,278,3,3,120,34,86,204,187,17,1
2021,Leicester 037B,E01013698,572,379,174,205,1,1,134,131,3,58,50,8,0
2021,Leicester 043C,E01013699,679,436,242,194,8,8,69,32,37,165,137,28,1
2021,Leicester 013B,E01013700,603,413,208,205,1,1,107,99,8,79,67,12,3
2021,Leicester 030E,E01013702,630,459,264,195,0,0,18,9,9,153,140,13,0
2021,Leicester 032A,E01013703,519,418,233,185,0,0,9,8,1,92,81,11,0
2021,Leicester 032B,E01013704,627,449,244,205,2,2,7,3,4,169,161,8,0
2021,Leicester 038C,E01013705,648,414,231,183,2,2,145,22,123,87,77,10,0
2021,Leicester 032C,E01013706,646,567,302,265,0,0,5,3,2,74,71,3,0
2021,Leicester 032D,E01013707,595,493,258,235,1,1,30,14,16,71,59,12,0
2021,Leicester 038D,E01013709,552,441,239,202,2,2,6,5,1,102,92,10,1
2021,Leicester 030F,E01013710,689,353,209,144,0,0,43,13,30,292,271,21,1
2021,Leicester 030G,E01013711,718,314,172,142,3,3,108,21,87,293,277,16,0
2021,Leicester 032E,E01013712,560,390,263,127,2,2,29,15,14,139,129,10,0
2021,Leicester 010A,E01013713,520,246,159,87,0,0,65,19,46,207,188,19,2
2021,Leicester 010B,E01013714,510,308,204,104,0,0,27,7,20,175,156,19,0
2021,Leicester 006C,E01013715,450,247,189,58,0,0,45,8,37,158,142,16,0
2021,Leicester 010C,E01013717,506,261,137,124,4,4,95,17,78,144,122,22,2
2021,Leicester 010D,E01013718,561,246,153,93,1,1,113,26,87,199,177,22,2
2021,Leicester 010E,E01013719,540,206,156,50,4,4,111,10,101,219,205,14,0
2021,Leicester 010F,E01013720,650,187,117,70,4,4,301,238,63,150,143,7,8
2021,Leicester 012A,E01013721,661,384,233,151,9,9,152,146,6,108,93,15,8
2021,Leicester 039A,E01013722,616,278,132,146,1,1,242,225,17,86,78,8,9
2021,Leicester 012B,E01013723,462,191,78,113,0,0,208,203,5,62,55,7,1
2021,Leicester 012C,E01013725,570,138,52,86,1,1,308,290,18,122,116,6,1
2021,Leicester 012D,E01013726,848,137,68,69,7,7,608,530,78,86,72,14,10
2021,Leicester 039B,E01013727,642,273,118,155,3,3,270,244,26,91,81,10,5
2021,Leicester 012E,E01013728,552,226,106,120,1,1,263,193,70,56,48,8,6
2021,Leicester 020A,E01013729,533,365,178,187,0,0,79,67,12,89,79,10,0
2021,Leicester 039C,E01013730,736,217,89,128,4,4,419,392,27,90,86,4,6
2021,Leicester 039D,E01013731,634,251,111,140,24,24,264,20,244,95,86,9,0
2021,Leicester 005A,E01013732,790,496,242,254,2,2,34,13,21,258,227,31,0
2021,Leicester 002A,E01013733,713,519,173,346,11,11,32,4,28,151,141,10,0
2021,Leicester 002B,E01013734,517,376,274,102,0,0,48,13,35,93,85,8,0
2021,Leicester 002C,E01013735,458,362,266,96,0,0,8,2,6,88,76,12,0
2021,Leicester 002D,E01013736,890,616,318,298,10,10,49,20,29,215,197,18,0
2021,Leicester 002E,E01013737,458,340,211,129,0,0,7,1,6,111,101,10,0
2021,Leicester 006E,E01013738,473,397,275,122,0,0,10,6,4,66,55,11,0
2021,Leicester 005B,E01013739,570,332,209,123,0,0,113,107,6,119,103,16,6
2021,Leicester 005C,E01013740,496,362,239,123,1,1,19,1,18,114,101,13,0
2021,Leicester 005D,E01013741,530,383,217,166,0,0,8,4,4,139,127,12,0
2021,Leicester 018A,E01013742,455,223,169,54,0,0,97,8,89,135,117,18,0
2021,Leicester 017F,E01013743,492,295,173,122,0,0,55,17,38,142,134,8,0
2021,Leicester 018B,E01013744,464,313,216,97,4,4,26,5,21,121,102,19,0
2021,Leicester 017G,E01013745,427,230,176,54,1,1,33,7,26,163,148,15,0
2021,Leicester 018C,E01013746,660,144,113,31,1,1,420,340,80,89,81,8,6
2021,Leicester 021C,E01013747,527,328,209,119,1,1,15,8,7,183,170,13,0
2021,Leicester 018D,E01013748,575,176,118,58,4,4,317,177,140,76,58,18,2
2021,Leicester 021D,E01013749,426,286,161,125,3,3,40,35,5,96,90,6,1
2021,Leicester 021E,E01013750,408,269,174,95,0,0,7,5,2,132,122,10,0
2021,Leicester 022A,E01013751,520,278,201,77,1,1,43,10,33,197,179,18,1
2021,Leicester 022B,E01013752,434,242,165,77,0,0,36,13,23,156,141,15,0
2021,Leicester 022C,E01013753,512,205,135,70,0,0,97,29,68,209,188,21,1
2021,Leicester 018E,E01013754,732,174,105,69,0,0,414,357,57,136,126,10,8
2021,Leicester 018F,E01013755,725,177,101,76,3,3,474,411,63,68,61,7,3
2021,Leicester 027A,E01013756,662,336,214,122,3,3,67,23,44,254,230,24,2
2021,Leicester 027B,E01013757,482,346,238,108,1,1,20,9,11,114,104,10,1
2021,Leicester 021F,E01013758,425,295,204,91,0,0,5,3,2,124,107,17,1
2021,Leicester 027C,E01013759,530,448,304,144,0,0,7,4,3,75,63,12,0
2021,Leicester 022D,E01013760,671,137,78,59,1,1,193,81,112,338,314,24,2
2021,Leicester 022E,E01013761,589,159,80,79,1,1,245,37,208,184,175,9,0
2021,Leicester 022F,E01013762,551,224,158,66,1,1,94,20,74,230,207,23,2
2021,Leicester 027D,E01013763,852,123,78,45,4,4,192,47,145,533,516,17,0
2021,Leicester 027E,E01013764,461,354,249,105,0,0,7,5,2,100,81,19,0
2021,Leicester 027F,E01013765,567,181,117,64,1,1,60,36,24,323,303,20,2
2021,Leicester 027G,E01013766,493,388,256,132,2,2,19,5,14,84,70,14,0
2021,Leicester 037C,E01013767,550,441,232,209,0,0,64,60,4,43,39,4,2
2021,Leicester 037D,E01013768,717,352,176,176,5,5,266,244,22,86,70,16,8
2021,Leicester 013C,E01013770,539,377,189,188,3,3,79,70,9,76,70,6,4
2021,Leicester 013D,E01013771,517,431,224,207,3,3,7,2,5,76,71,5,0
2021,Leicester 037E,E01013772,593,322,141,181,1,1,170,165,5,95,68,27,5
2021,Leicester 013E,E01013773,557,332,144,188,9,9,160,144,16,54,41,13,2
2021,Leicester 023A,E01013774,738,154,94,60,3,3,56,27,29,522,500,22,3
2021,Leicester 023B,E01013776,680,140,69,71,2,2,55,28,27,483,465,18,0
2021,Leicester 029D,E01013777,752,247,120,127,3,3,26,13,13,476,444,32,0
2021,Leicester 023D,E01013779,903,162,97,65,4,4,64,15,49,673,652,21,0
2021,Leicester 020B,E01013780,633,471,258,213,1,1,18,11,7,143,131,12,0
2021,Leicester 023E,E01013781,768,196,125,71,0,0,65,32,33,505,496,9,2
2021,Leicester 023F,E01013782,664,280,142,138,6,6,92,15,77,285,272,13,1
2021,Leicester 020C,E01013783,608,490,261,229,2,2,13,8,5,103,86,17,0
2021,Leicester 023G,E01013784,529,236,150,86,6,6,11,9,2,276,266,10,0
2021,Leicester 020D,E01013785,543,474,232,242,0,0,12,6,6,57,49,8,0
2021,Leicester 020E,E01013786,734,422,231,191,1,1,68,37,31,242,214,28,1
2021,Rutland 005A,E01013787,575,454,281,173,3,3,44,13,31,74,58,16,0
2021,Rutland 001A,E01013788,1084,638,384,254,4,4,109,20,89,333,108,225,0
2021,Rutland 001B,E01013789,624,418,286,132,15,15,49,9,40,142,118,24,0
2021,Rutland 001C,E01013790,601,468,278,190,8,8,46,8,38,79,53,26,0
2021,Rutland 004A,E01013791,498,347,207,140,3,3,91,17,74,57,52,5,0
2021,Rutland 004B,E01013792,716,579,361,218,10,10,41,7,34,86,70,16,0
2021,Rutland 002A,E01013793,635,537,350,187,9,9,29,9,20,60,51,9,0
2021,Rutland 005B,E01013794,600,495,316,179,2,2,26,4,22,75,62,13,2
2021,Rutland 005C,E01013795,518,375,247,128,2,2,46,11,35,95,74,21,0
2021,Rutland 001D,E01013796,566,344,211,133,19,19,48,5,43,155,87,68,0
2021,Rutland 004C,E01013797,757,582,353,229,10,10,41,6,35,124,87,37,0
2021,Rutland 003A,E01013798,580,466,293,173,5,5,20,2,18,89,80,9,0
2021,Rutland 003B,E01013799,622,270,161,109,10,10,146,25,121,196,155,41,0
2021,Rutland 002B,E01013800,645,508,310,198,8,8,79,25,54,49,41,8,1
2021,Rutland 003D,E01013803,1019,768,519,249,13,13,122,21,101,115,100,15,1
2021,Rutland 004D,E01013804,688,569,342,227,7,7,40,5,35,72,57,15,0
2021,Rutland 004E,E01013805,545,376,212,164,3,3,99,14,85,67,53,14,0
2021,Rutland 005D,E01013806,513,355,231,124,6,6,45,14,31,107,79,28,0
2021,Rutland 005E,E01013807,616,410,272,138,8,8,90,11,79,107,95,12,1
2021,Rutland 005F,E01013808,748,444,261,183,16,16,188,24,164,99,74,25,1
2021,Rutland 002D,E01013809,538,428,291,137,2,2,57,12,45,48,40,8,3
2021,Nottingham 018A,E01013810,641,219,82,137,3,3,153,123,30,264,251,13,2
2021,Nottingham 018B,E01013811,526,86,47,39,2,2,170,118,52,265,254,11,3
2021,Nottingham 018C,E01013812,553,126,57,69,2,2,170,94,76,255,236,19,0
2021,Nottingham 022A,E01013813,578,55,27,28,3,3,353,16,337,167,160,7,0
2021,Nottingham 022B,E01013814,715,130,41,89,10,10,106,25,81,468,446,22,1
2021,Nottingham 022C,E01013815,601,81,44,37,4,4,135,25,110,381,373,8,0
2021,Nottingham 022D,E01013816,779,98,58,40,3,3,183,30,153,494,478,16,1
2021,Nottingham 011A,E01013817,641,169,71,98,0,0,332,316,16,138,126,12,2
2021,Nottingham 011B,E01013818,531,159,59,100,1,1,309,285,24,62,51,11,0
2021,Nottingham 013A,E01013819,710,259,119,140,1,1,302,257,45,145,137,8,3
2021,Nottingham 013B,E01013820,648,243,88,155,0,0,294,282,12,110,102,8,1
2021,Nottingham 013C,E01013821,627,261,78,183,1,1,222,208,14,142,119,23,1
2021,Nottingham 011C,E01013822,631,190,87,103,0,0,346,328,18,91,84,7,4
2021,Nottingham 013D,E01013823,641,302,125,177,2,2,209,202,7,125,116,9,3
2021,Nottingham 013E,E01013824,587,279,96,183,4,4,204,188,16,99,93,6,1
2021,Nottingham 011D,E01013825,692,331,123,208,1,1,222,215,7,137,118,19,1
2021,Nottingham 011E,E01013826,664,201,82,119,0,0,316,302,14,146,115,31,1
2021,Nottingham 008A,E01013827,589,307,128,179,1,1,188,168,20,92,79,13,1
2021,Nottingham 008B,E01013828,819,411,185,226,12,12,96,14,82,297,276,21,3
2021,Nottingham 009A,E01013829,797,367,142,225,1,1,196,127,69,232,191,41,1
2021,Nottingham 009B,E01013830,649,441,233,208,6,6,97,78,19,104,91,13,1
2021,Nottingham 009C,E01013831,667,517,272,245,17,17,32,18,14,100,87,13,1
2021,Nottingham 009D,E01013832,758,314,152,162,3,3,228,89,139,211,194,17,2
2021,Nottingham 009E,E01013833,542,275,108,167,0,0,185,178,7,79,70,9,3
2021,Nottingham 008C,E01013834,633,267,122,145,0,0,248,238,10,114,103,11,4
2021,Nottingham 008D,E01013835,730,317,134,183,1,1,303,187,116,106,92,14,3
2021,Nottingham 008E,E01013836,907,354,142,212,0,0,241,133,108,311,289,22,1
2021,Nottingham 012A,E01013837,732,540,235,305,1,1,19,7,12,172,159,13,0
2021,Nottingham 012B,E01013838,705,541,235,306,4,4,21,9,12,139,130,9,0
2021,Nottingham 012C,E01013839,916,240,109,131,6,6,275,65,210,393,375,18,2
2021,Nottingham 012D,E01013840,993,602,257,345,4,4,13,1,12,371,343,28,3
2021,Nottingham 012E,E01013841,702,243,98,145,4,4,152,43,109,301,281,20,2
2021,Nottingham 018D,E01013842,703,172,70,102,10,10,135,50,85,385,359,26,1
2021,Nottingham 017A,E01013843,788,227,130,97,2,2,45,6,39,513,502,11,1
2021,Nottingham 017B,E01013844,662,179,86,93,0,0,133,26,107,348,333,15,2
2021,Nottingham 017C,E01013845,627,235,108,127,4,4,71,23,48,314,295,19,3
2021,Nottingham 018E,E01013846,655,154,78,76,1,1,121,29,92,378,369,9,1
2021,Nottingham 017D,E01013847,441,203,114,89,3,3,42,1,41,193,171,22,0
2021,Nottingham 038A,E01013849,675,275,141,134,1,1,301,255,46,96,86,10,2
2021,Nottingham 038B,E01013850,683,311,155,156,1,1,278,229,49,90,81,9,3
2021,Nottingham 038C,E01013851,718,204,105,99,0,0,405,326,79,104,93,11,5
2021,Nottingham 038D,E01013852,756,367,161,206,0,0,284,215,69,102,88,14,3
2021,Nottingham 006A,E01013853,650,402,210,192,2,2,145,121,24,100,83,17,1
2021,Nottingham 006B,E01013854,605,316,138,178,1,1,211,191,20,72,66,6,5
2021,Nottingham 006C,E01013855,606,193,92,101,0,0,311,292,19,96,89,7,6
2021,Nottingham 006D,E01013856,624,343,145,198,1,1,176,161,15,102,91,11,2
2021,Nottingham 025A,E01013858,570,330,166,164,3,3,143,132,11,93,78,15,1
2021,Nottingham 020A,E01013859,717,328,176,152,4,4,288,274,14,93,84,9,4
2021,Nottingham 025B,E01013860,709,344,176,168,2,2,260,211,49,96,79,17,7
2021,Nottingham 020B,E01013861,694,218,109,109,3,3,406,366,40,63,51,12,4
2021,Nottingham 025C,E01013862,606,228,100,128,0,0,315,231,84,63,56,7,0
2021,Nottingham 025D,E01013863,585,427,183,244,0,0,82,77,5,76,64,12,0
2021,Nottingham 014A,E01013864,892,459,122,337,2,2,323,127,196,106,90,16,2
2021,Nottingham 014B,E01013865,703,362,203,159,4,4,232,194,38,101,78,23,4
2021,Nottingham 014C,E01013866,594,291,131,160,1,1,239,205,34,63,46,17,0
2021,Nottingham 014D,E01013867,571,250,112,138,1,1,228,212,16,89,79,10,3
2021,Nottingham 020C,E01013868,595,219,103,116,2,2,320,269,51,49,43,6,5
2021,Nottingham 040A,E01013870,1090,296,168,128,8,8,456,359,97,327,306,21,3
2021,Nottingham 040B,E01013871,832,251,131,120,0,0,465,361,104,113,97,16,3
2021,Nottingham 040C,E01013872,774,358,180,178,13,13,211,178,33,187,168,19,5
2021,Nottingham 040D,E01013873,627,272,118,154,2,2,102,65,37,251,234,17,0
2021,Nottingham 039A,E01013874,773,396,199,197,4,4,57,22,35,316,297,19,0
2021,Nottingham 005A,E01013875,513,441,259,182,3,3,9,5,4,60,47,13,0
2021,Nottingham 005B,E01013876,731,255,103,152,5,5,257,193,64,211,191,20,3
2021,Nottingham 005C,E01013877,692,161,82,79,2,2,397,346,51,125,112,13,7
2021,Nottingham 005D,E01013878,521,217,103,114,0,0,259,228,31,42,37,5,3
2021,Nottingham 002A,E01013879,564,236,87,149,4,4,245,181,64,76,71,5,3
2021,Nottingham 002B,E01013880,668,257,127,130,0,0,312,284,28,98,88,10,1
2021,Nottingham 002C,E01013881,637,256,123,133,0,0,275,249,26,104,97,7,2
2021,Nottingham 002D,E01013882,639,295,165,130,4,4,157,121,36,181,170,11,2
2021,Nottingham 005E,E01013883,664,314,160,154,0,0,259,205,54,88,73,15,3
2021,Nottingham 005F,E01013884,632,255,134,121,0,0,263,236,27,113,103,10,1
2021,Nottingham 002E,E01013885,776,241,122,119,0,0,218,157,61,315,291,24,2
2021,Nottingham 004A,E01013886,654,363,205,158,2,2,158,102,56,130,116,14,1
2021,Nottingham 001A,E01013887,653,564,346,218,0,0,36,32,4,53,39,14,0
2021,Nottingham 004B,E01013888,710,464,234,230,0,0,92,73,19,153,138,15,1
2021,Nottingham 004C,E01013889,723,547,320,227,4,4,65,42,23,107,100,7,0
2021,Nottingham 004D,E01013890,659,461,227,234,1,1,17,12,5,179,165,14,1
2021,Nottingham 004E,E01013891,771,363,174,189,3,3,219,177,42,184,169,15,2
2021,Nottingham 001B,E01013892,597,532,334,198,1,1,19,5,14,45,37,8,0
2021,Nottingham 001C,E01013893,619,250,105,145,13,13,274,151,123,82,76,6,0
2021,Nottingham 001D,E01013894,649,552,326,226,1,1,37,19,18,58,43,15,1
2021,Nottingham 034A,E01013895,635,565,354,211,0,0,9,5,4,61,49,12,0
2021,Nottingham 034B,E01013896,569,225,113,112,0,0,263,206,57,78,71,7,3
2021,Nottingham 035A,E01013897,620,325,178,147,0,0,167,161,6,127,110,17,1
2021,Nottingham 035B,E01013898,415,202,94,108,0,0,90,86,4,123,114,9,0
2021,Nottingham 035C,E01013899,496,279,140,139,1,1,115,110,5,101,88,13,0
2021,Nottingham 035D,E01013900,659,326,168,158,0,0,185,175,10,144,130,14,4
2021,Nottingham 034C,E01013901,630,522,258,264,4,4,7,3,4,97,84,13,0
2021,Nottingham 034D,E01013902,850,654,314,340,8,8,39,13,26,149,129,20,0
2021,Nottingham 035E,E01013903,498,372,212,160,2,2,69,57,12,55,49,6,0
2021,Nottingham 037A,E01013904,604,350,162,188,1,1,137,118,19,115,104,11,1
2021,Nottingham 036A,E01013905,615,303,140,163,6,6,196,180,16,107,97,10,3
2021,Nottingham 037B,E01013906,680,379,177,202,0,0,179,152,27,122,105,17,0
2021,Nottingham 035F,E01013907,736,289,152,137,3,3,294,239,55,144,123,21,6
2021,Nottingham 036B,E01013908,687,315,190,125,60,60,204,159,45,103,89,14,5
2021,Nottingham 036C,E01013909,743,242,140,102,60,60,341,187,154,99,88,11,1
2021,Nottingham 037C,E01013910,638,356,170,186,1,1,141,130,11,140,123,17,0
2021,Nottingham 037D,E01013911,679,376,209,167,2,2,192,185,7,106,92,14,3
2021,Nottingham 036D,E01013912,626,494,281,213,1,1,52,45,7,79,66,13,0
2021,Nottingham 024A,E01013913,671,515,293,222,2,2,58,54,4,95,82,13,1
2021,Nottingham 024B,E01013914,611,515,304,211,0,0,6,4,2,89,70,19,1
2021,Nottingham 024C,E01013915,651,512,285,227,0,0,57,49,8,78,60,18,4
2021,Nottingham 024D,E01013916,588,287,106,181,3,3,209,198,11,86,76,10,3
2021,Nottingham 024E,E01013917,767,410,171,239,4,4,175,134,41,175,159,16,3
2021,Nottingham 029A,E01013918,740,292,128,164,0,0,69,34,35,378,353,25,1
2021,Nottingham 029B,E01013919,813,280,131,149,2,2,98,28,70,430,405,25,3
2021,Nottingham 029C,E01013920,1148,279,111,168,6,6,533,359,174,325,307,18,5
2021,Nottingham 029D,E01013921,817,192,74,118,0,0,244,108,136,380,353,27,1
2021,Nottingham 031G,E01013928,529,84,51,33,3,3,61,20,41,380,368,12,1
2021,Nottingham 020D,E01013929,752,499,237,262,16,16,101,45,56,134,121,13,2
2021,Nottingham 019A,E01013930,690,385,175,210,0,0,91,62,29,214,204,10,0
2021,Nottingham 019B,E01013931,741,572,295,277,16,16,67,8,59,86,67,19,0
2021,Nottingham 019C,E01013932,899,672,262,410,2,2,64,59,5,161,142,19,0
2021,Nottingham 019D,E01013933,714,288,123,165,2,2,256,232,24,166,153,13,2
2021,Nottingham 019E,E01013934,625,377,192,185,15,15,134,86,48,97,87,10,2
2021,Nottingham 010A,E01013935,714,510,326,184,6,6,21,12,9,176,166,10,1
2021,Nottingham 016A,E01013936,1053,575,265,310,7,7,124,46,78,347,321,26,0
2021,Nottingham 015A,E01013937,770,458,225,233,9,9,61,40,21,242,228,14,0
2021,Nottingham 015B,E01013938,696,428,221,207,3,3,55,27,28,210,200,10,0
2021,Nottingham 016B,E01013939,742,469,251,218,12,12,47,13,34,214,191,23,0
2021,Nottingham 016C,E01013940,798,228,77,151,4,4,380,180,200,185,164,21,1
2021,Nottingham 015C,E01013941,882,359,198,161,14,14,75,43,32,434,419,15,0
2021,Nottingham 016D,E01013942,910,273,107,166,1,1,460,218,242,173,152,21,3
2021,Nottingham 015D,E01013943,834,210,105,105,4,4,94,22,72,526,506,20,0
2021,Nottingham 026A,E01013944,637,329,163,166,5,5,54,39,15,247,225,22,2
2021,Nottingham 026B,E01013945,641,100,50,50,2,2,179,92,87,357,324,33,3
2021,Nottingham 026D,E01013947,643,129,68,61,4,4,188,104,84,319,303,16,3
2021,Nottingham 026E,E01013948,678,58,37,21,1,1,521,424,97,96,86,10,2
2021,Nottingham 026F,E01013953,584,124,61,63,4,4,32,12,20,424,414,10,0
2021,Nottingham 021A,E01013954,829,321,125,196,2,2,289,173,116,214,193,21,3
2021,Nottingham 029E,E01013957,646,282,129,153,2,2,175,146,29,180,158,22,7
2021,Nottingham 023C,E01013958,772,231,125,106,3,3,414,357,57,120,104,16,4
2021,Nottingham 021B,E01013959,804,244,119,125,1,1,382,357,25,164,148,16,13
2021,Nottingham 021C,E01013960,849,251,132,119,2,2,443,389,54,148,141,7,5
2021,Nottingham 023D,E01013961,882,133,73,60,0,0,260,140,120,487,478,9,2
2021,Nottingham 021D,E01013962,887,350,173,177,11,11,316,237,79,206,188,18,4
2021,Nottingham 007A,E01013963,679,357,182,175,3,3,225,197,28,90,71,19,4
2021,Nottingham 007B,E01013964,699,499,230,269,0,0,118,98,20,82,71,11,0
2021,Nottingham 007C,E01013965,612,398,198,200,1,1,123,116,7,89,79,10,1
2021,Nottingham 007D,E01013966,545,348,156,192,0,0,116,110,6,80,73,7,1
2021,Nottingham 007E,E01013967,538,334,178,156,0,0,67,35,32,135,119,16,2
2021,Nottingham 010B,E01013968,667,395,237,158,3,3,198,165,33,69,61,8,2
2021,Nottingham 010C,E01013969,817,431,210,221,0,0,38,15,23,347,321,26,1
2021,Nottingham 010D,E01013970,700,421,191,230,2,2,43,12,31,231,210,21,3
2021,Nottingham 010E,E01013971,789,383,154,229,1,1,103,9,94,302,291,11,0
2021,Nottingham 015E,E01013972,700,315,142,173,1,1,95,47,48,288,274,14,1
2021,Nottingham 041D,E01013977,747,571,326,245,0,0,70,24,46,106,94,12,0
2021,Nottingham 041A,E01013978,674,455,201,254,3,3,99,45,54,114,99,15,3
2021,Nottingham 041C,E01013979,605,498,266,232,2,2,5,3,2,100,90,10,0
2021,Nottingham 030A,E01013980,676,584,329,255,0,0,10,7,3,82,76,6,0
2021,Nottingham 041B,E01013981,697,560,315,245,5,5,36,15,21,96,90,6,0
2021,Nottingham 030B,E01013982,628,559,333,226,0,0,24,20,4,44,40,4,1
2021,Nottingham 030C,E01013983,604,243,134,109,3,3,258,48,210,100,95,5,0
2021,Nottingham 030D,E01013984,624,570,401,169,0,0,6,6,0,48,38,10,0
2021,Nottingham 030E,E01013985,698,578,393,185,0,0,25,14,11,94,81,13,1
2021,Herefordshire 012A,E01013986,735,274,151,123,11,11,302,60,242,148,132,16,0
2021,Herefordshire 011A,E01013987,685,541,356,185,1,1,38,10,28,105,89,16,0
2021,Herefordshire 011B,E01013988,931,623,416,207,10,10,95,10,85,203,175,28,0
2021,Herefordshire 012B,E01013989,615,285,130,155,10,10,218,80,138,100,87,13,2
2021,Herefordshire 018A,E01013990,887,656,409,247,24,24,86,25,61,120,105,15,1
2021,Herefordshire 018B,E01013991,546,366,235,131,3,3,81,11,70,96,80,16,0
2021,Herefordshire 017A,E01013992,639,288,127,161,9,9,209,51,158,133,105,28,0
2021,Herefordshire 017B,E01013993,609,319,168,151,8,8,222,74,148,60,54,6,0
2021,Herefordshire 017C,E01013994,602,269,129,140,3,3,263,107,156,65,50,15,2
2021,Herefordshire 017D,E01013995,782,268,110,158,4,4,451,183,268,57,45,12,2
2021,Herefordshire 016A,E01013996,684,465,249,216,11,11,11,3,8,197,175,22,0
2021,Herefordshire 016B,E01013997,822,560,281,279,11,11,43,13,30,208,196,12,0
2021,Herefordshire 001A,E01013998,649,540,411,129,5,5,38,2,36,66,46,20,0
2021,Herefordshire 004A,E01013999,697,537,388,149,9,9,34,6,28,117,91,26,0
2021,Herefordshire 005A,E01014000,588,459,319,140,9,9,33,3,30,87,64,23,0
2021,Herefordshire 005B,E01014001,740,548,376,172,8,8,59,5,54,124,90,34,1
2021,Herefordshire 005C,E01014002,645,546,385,161,1,1,5,1,4,93,73,20,0
2021,Herefordshire 005D,E01014003,648,410,247,163,14,14,106,9,97,118,91,27,0
2021,Herefordshire 005E,E01014004,632,471,329,142,8,8,53,10,43,100,79,21,0
2021,Herefordshire 005F,E01014005,903,362,230,132,20,20,306,30,276,215,192,23,0
2021,Herefordshire 007A,E01014006,671,542,366,176,13,13,49,11,38,67,50,17,0
2021,Herefordshire 006A,E01014008,718,523,362,161,2,2,67,6,61,126,93,33,0
2021,Herefordshire 006B,E01014009,684,534,399,135,5,5,45,5,40,100,68,32,0
2021,Herefordshire 012C,E01014010,1062,253,187,66,6,6,224,40,184,579,531,48,0
2021,Herefordshire 012D,E01014011,668,315,175,140,2,2,133,35,98,218,198,20,0
2021,Herefordshire 007B,E01014012,719,577,372,205,4,4,36,5,31,101,83,18,1
2021,Herefordshire 007C,E01014013,686,383,203,180,18,18,134,25,109,151,66,85,0
2021,Herefordshire 018C,E01014014,769,571,377,194,3,3,41,4,37,153,127,26,1
2021,Herefordshire 005G,E01014015,702,537,345,192,8,8,45,3,42,112,82,30,0
2021,Herefordshire 007D,E01014016,718,454,341,113,8,8,132,4,128,124,99,25,0
2021,Herefordshire 004B,E01014017,638,496,340,156,2,2,14,0,14,126,98,28,0
2021,Herefordshire 020A,E01014018,661,514,367,147,2,2,33,7,26,112,84,28,0
2021,Herefordshire 020B,E01014019,673,468,317,151,4,4,91,18,73,110,91,19,0
2021,Herefordshire 020C,E01014020,656,537,397,140,2,2,12,1,11,105,77,28,0
2021,Herefordshire 020D,E01014021,633,435,314,121,7,7,67,27,40,123,94,29,1
2021,Herefordshire 008A,E01014022,953,761,412,349,27,27,45,8,37,120,90,30,0
2021,Herefordshire 008B,E01014023,816,555,312,243,22,22,127,25,102,112,96,16,0
2021,Herefordshire 004C,E01014024,566,425,292,133,3,3,35,2,33,103,86,17,0
2021,Herefordshire 004D,E01014025,654,493,342,151,15,15,69,1,68,77,52,25,0
2021,Herefordshire 021A,E01014026,886,685,445,240,5,5,64,23,41,132,103,29,0
2021,Herefordshire 009A,E01014027,564,407,279,128,1,1,59,7,52,97,83,14,0
2021,Herefordshire 009B,E01014028,657,543,386,157,4,4,22,4,18,88,60,28,0
2021,Herefordshire 009C,E01014029,684,478,347,131,10,10,109,11,98,87,71,16,0
2021,Herefordshire 009D,E01014030,628,506,330,176,9,9,59,4,55,54,42,12,0
2021,Herefordshire 023A,E01014031,656,530,323,207,1,1,46,19,27,79,63,16,0
2021,Herefordshire 023B,E01014032,666,530,350,180,1,1,45,10,35,90,59,31,0
2021,Herefordshire 006C,E01014033,833,536,388,148,9,9,90,10,80,198,164,34,0
2021,Herefordshire 006D,E01014034,689,314,204,110,10,10,136,9,127,229,198,31,0
2021,Herefordshire 019A,E01014035,833,342,217,125,15,15,258,36,222,218,207,11,0
2021,Herefordshire 019B,E01014036,790,569,412,157,10,10,21,3,18,190,165,25,0
2021,Herefordshire 019C,E01014037,734,554,445,109,9,9,56,11,45,115,95,20,0
2021,Herefordshire 019D,E01014038,632,397,261,136,10,10,134,19,115,91,78,13,0
2021,Herefordshire 019E,E01014039,728,512,289,223,17,17,32,1,31,167,150,17,0
2021,Herefordshire 019F,E01014040,754,530,396,134,6,6,83,20,63,134,117,17,1
2021,Herefordshire 002A,E01014041,707,486,333,153,6,6,55,10,45,160,144,16,0
2021,Herefordshire 002B,E01014042,677,235,126,109,8,8,290,42,248,143,124,19,1
2021,Herefordshire 002C,E01014043,507,415,327,88,1,1,9,0,9,82,66,16,0
2021,Herefordshire 002D,E01014044,624,392,226,166,3,3,104,21,83,125,114,11,0
2021,Herefordshire 003A,E01014045,753,476,303,173,17,17,55,10,45,205,184,21,0
2021,Herefordshire 003B,E01014046,658,528,356,172,5,5,48,7,41,77,57,20,0
2021,Herefordshire 003C,E01014047,650,330,205,125,7,7,206,24,182,107,98,9,0
2021,Herefordshire 003D,E01014048,877,273,172,101,4,4,213,16,197,387,356,31,0
2021,Herefordshire 023C,E01014049,695,539,368,171,1,1,21,6,15,134,110,24,0
2021,Herefordshire 023D,E01014050,743,615,388,227,3,3,25,6,19,100,75,25,0
2021,Herefordshire 001B,E01014051,791,531,347,184,7,7,108,13,95,145,113,32,0
2021,Herefordshire 001C,E01014052,664,467,344,123,2,2,14,2,12,181,149,32,0
2021,Herefordshire 023E,E01014053,752,522,339,183,5,5,61,25,36,164,127,37,0
2021,Herefordshire 018D,E01014054,588,412,290,122,2,2,62,11,51,112,88,24,0
2021,Herefordshire 004E,E01014055,760,523,343,180,12,12,96,11,85,129,86,43,0
2021,Herefordshire 006E,E01014056,632,472,350,122,3,3,24,3,21,133,88,45,0
2021,Herefordshire 023F,E01014057,852,610,390,220,13,13,124,33,91,105,85,20,0
2021,Herefordshire 023G,E01014058,743,643,477,166,3,3,10,3,7,87,59,28,0
2021,Herefordshire 021B,E01014059,807,643,447,196,1,1,23,6,17,140,111,29,0
2021,Herefordshire 021C,E01014060,674,523,353,170,1,1,35,10,25,115,78,37,0
2021,Herefordshire 022A,E01014061,818,650,457,193,15,15,80,13,67,72,61,11,1
2021,Herefordshire 022B,E01014062,970,487,339,148,6,6,109,31,78,368,336,32,0
2021,Herefordshire 022C,E01014063,778,515,363,152,16,16,155,51,104,90,69,21,2
2021,Herefordshire 022D,E01014064,769,332,204,128,8,8,305,107,198,124,107,17,0
2021,Herefordshire 022E,E01014065,654,425,263,162,4,4,61,18,43,164,151,13,0
2021,Herefordshire 022F,E01014066,612,338,221,117,0,0,93,12,81,181,165,16,0
2021,Herefordshire 022G,E01014067,593,519,342,177,2,2,3,2,1,69,54,15,0
2021,Herefordshire 015A,E01014068,592,419,241,178,6,6,100,44,56,67,53,14,0
2021,Herefordshire 021D,E01014069,808,467,204,263,13,13,122,43,79,206,190,16,0
2021,Herefordshire 015B,E01014070,940,662,315,347,19,19,127,41,86,132,113,19,0
2021,Herefordshire 017E,E01014071,634,261,142,119,7,7,268,90,178,97,88,9,1
2021,Herefordshire 015C,E01014072,822,470,231,239,12,12,212,86,126,128,99,29,0
2021,Herefordshire 015D,E01014073,797,274,119,155,7,7,313,111,202,201,81,120,2
2021,Herefordshire 015E,E01014074,739,262,147,115,1,1,338,125,213,134,122,12,4
2021,Herefordshire 013A,E01014075,739,546,310,236,3,3,46,10,36,144,130,14,0
2021,Herefordshire 013B,E01014076,1037,577,307,270,6,6,85,5,80,369,341,28,0
2021,Herefordshire 013C,E01014077,731,579,365,214,4,4,33,12,21,115,99,16,0
2021,Herefordshire 013D,E01014078,597,376,175,201,11,11,120,30,90,90,75,15,0
2021,Herefordshire 016C,E01014079,666,481,317,164,4,4,93,33,60,87,68,19,1
2021,Herefordshire 016D,E01014080,676,494,297,197,19,19,106,44,62,56,45,11,1
2021,Herefordshire 008C,E01014081,633,504,330,174,4,4,45,1,44,80,61,19,0
2021,Herefordshire 008D,E01014082,767,587,381,206,12,12,77,20,57,91,70,21,0
2021,Herefordshire 010A,E01014083,703,584,389,195,14,14,11,1,10,93,80,13,1
2021,Herefordshire 010B,E01014084,753,401,207,194,5,5,171,30,141,176,152,24,0
2021,Herefordshire 010C,E01014085,654,375,202,173,13,13,162,54,108,102,88,14,2
2021,Herefordshire 012E,E01014086,752,227,117,110,19,19,257,47,210,249,230,19,0
2021,Herefordshire 010D,E01014087,717,449,268,181,4,4,19,3,16,245,227,18,0
2021,Herefordshire 010E,E01014088,724,409,240,169,12,12,97,19,78,205,192,13,1
2021,Herefordshire 010F,E01014089,574,403,236,167,4,4,85,33,52,82,68,14,0
2021,Herefordshire 014A,E01014090,597,526,316,210,4,4,7,2,5,60,48,12,0
2021,Herefordshire 014B,E01014091,639,558,377,181,1,1,18,6,12,62,49,13,0
2021,Herefordshire 012F,E01014092,893,572,355,217,5,5,54,13,41,262,227,35,0
2021,Herefordshire 014C,E01014093,610,430,271,159,2,2,119,18,101,59,51,8,0
2021,Herefordshire 014D,E01014094,574,479,278,201,5,5,28,8,20,62,48,14,0
2021,Herefordshire 011D,E01014095,572,367,211,156,5,5,99,38,61,101,85,16,0
2021,Herefordshire 001D,E01014096,669,537,373,164,0,0,25,2,23,107,84,23,0
2021,Herefordshire 004F,E01014097,598,450,331,119,3,3,44,3,41,101,75,26,0
2021,Herefordshire 021E,E01014098,669,405,217,188,19,19,157,43,114,88,67,21,0
2021,Herefordshire 021F,E01014099,741,553,379,174,2,2,41,9,32,145,110,35,0
2021,Herefordshire 007E,E01014100,763,565,378,187,17,17,70,13,57,110,87,23,1
2021,Herefordshire 007F,E01014101,445,279,190,89,1,1,20,1,19,145,124,21,0
2021,Telford and Wrekin 007A,E01014102,785,668,361,307,12,12,16,0,16,89,78,11,0
2021,Telford and Wrekin 007B,E01014103,482,385,205,180,1,1,45,15,30,51,45,6,0
2021,Telford and Wrekin 011A,E01014104,649,415,193,222,4,4,108,48,60,122,106,16,0
2021,Telford and Wrekin 011B,E01014105,816,370,135,235,3,3,222,93,129,220,207,13,1
2021,Telford and Wrekin 020A,E01014106,619,358,191,167,2,2,105,31,74,154,140,14,0
2021,Telford and Wrekin 020B,E01014107,478,432,249,183,0,0,6,1,5,40,33,7,0
2021,Telford and Wrekin 020C,E01014108,634,149,80,69,0,0,133,53,80,351,343,8,1
2021,Telford and Wrekin 020D,E01014109,470,318,169,149,1,1,49,10,39,101,91,10,1
2021,Telford and Wrekin 020E,E01014110,557,155,67,88,3,3,159,57,102,240,231,9,0
2021,Telford and Wrekin 004A,E01014111,677,513,296,217,3,3,59,9,50,102,83,19,0
2021,Telford and Wrekin 002A,E01014112,727,591,328,263,6,6,43,16,27,87,69,18,0
2021,Telford and Wrekin 011C,E01014113,737,255,138,117,2,2,184,62,122,295,266,29,1
2021,Telford and Wrekin 011D,E01014114,669,436,302,134,0,0,87,33,54,146,133,13,0
2021,Telford and Wrekin 023A,E01014115,607,264,144,120,2,2,129,43,86,212,195,17,0
2021,Telford and Wrekin 023B,E01014116,803,287,205,82,1,1,282,99,183,229,209,20,4
2021,Telford and Wrekin 023C,E01014117,495,430,290,140,0,0,7,3,4,58,51,7,0
2021,Telford and Wrekin 023D,E01014118,486,166,97,69,7,7,68,21,47,245,236,9,0
2021,Telford and Wrekin 019A,E01014119,686,493,273,220,0,0,102,57,45,88,69,19,3
2021,Telford and Wrekin 019B,E01014120,809,284,136,148,5,5,415,134,281,103,88,15,2
2021,Telford and Wrekin 019C,E01014121,634,428,245,183,5,5,119,45,74,80,67,13,2
2021,Telford and Wrekin 019D,E01014122,740,381,179,202,3,3,66,21,45,289,279,10,1
2021,Telford and Wrekin 019E,E01014123,619,477,246,231,16,16,10,2,8,116,105,11,0
2021,Telford and Wrekin 017A,E01014124,767,306,173,133,6,6,218,79,139,236,221,15,1
2021,Telford and Wrekin 005A,E01014125,575,299,148,151,1,1,164,71,93,111,96,15,0
2021,Telford and Wrekin 005B,E01014126,642,362,206,156,1,1,133,59,74,145,128,17,1
2021,Telford and Wrekin 005C,E01014127,655,238,113,125,1,1,261,136,125,154,150,4,1
2021,Telford and Wrekin 005D,E01014128,932,473,181,292,0,0,247,108,139,211,151,60,1
2021,Telford and Wrekin 006A,E01014129,540,282,164,118,8,8,180,68,112,69,61,8,1
2021,Telford and Wrekin 006B,E01014130,651,469,276,193,0,0,61,21,40,121,110,11,0
2021,Telford and Wrekin 002B,E01014131,759,576,355,221,3,3,68,19,49,112,80,32,0
2021,Telford and Wrekin 002C,E01014132,459,379,245,134,1,1,29,9,20,49,38,11,1
2021,Telford and Wrekin 012A,E01014133,958,637,352,285,11,11,151,53,98,159,144,15,0
2021,Telford and Wrekin 012B,E01014134,737,624,382,242,0,0,62,21,41,50,39,11,1
2021,Telford and Wrekin 002D,E01014135,513,399,232,167,6,6,25,7,18,83,62,21,0
2021,Telford and Wrekin 010A,E01014136,773,522,297,225,3,3,120,35,85,128,106,22,0
2021,Telford and Wrekin 009A,E01014137,752,590,220,370,3,3,71,13,58,88,69,19,0
2021,Telford and Wrekin 007C,E01014138,688,434,215,219,0,0,162,42,120,91,80,11,1
2021,Telford and Wrekin 009B,E01014139,516,298,139,159,3,3,107,47,60,108,99,9,0
2021,Telford and Wrekin 007D,E01014140,614,269,123,146,3,3,142,62,80,199,193,6,1
2021,Telford and Wrekin 009D,E01014142,452,145,63,82,1,1,160,86,74,146,132,14,0
2021,Telford and Wrekin 009E,E01014143,665,266,127,139,2,2,203,94,109,192,169,23,2
2021,Telford and Wrekin 012C,E01014144,795,374,192,182,3,3,238,91,147,175,170,5,5
2021,Telford and Wrekin 012D,E01014145,1012,333,165,168,7,7,333,89,244,337,313,24,2
2021,Telford and Wrekin 010B,E01014148,734,562,326,236,8,8,37,12,25,126,110,16,1
2021,Telford and Wrekin 010C,E01014149,488,395,188,207,1,1,32,13,19,60,46,14,0
2021,Telford and Wrekin 014A,E01014150,711,547,296,251,3,3,34,16,18,127,120,7,0
2021,Telford and Wrekin 014B,E01014151,625,282,144,138,1,1,214,112,102,127,117,10,1
2021,Telford and Wrekin 014C,E01014152,817,513,247,266,12,12,188,74,114,103,94,9,1
2021,Telford and Wrekin 014D,E01014153,905,484,271,213,2,2,204,54,150,213,195,18,2
2021,Telford and Wrekin 014E,E01014154,746,435,179,256,13,13,154,55,99,141,128,13,3
2021,Telford and Wrekin 014F,E01014155,847,451,196,255,21,21,231,64,167,143,128,15,1
2021,Telford and Wrekin 024C,E01014157,516,426,184,242,1,1,2,2,0,87,77,10,0
2021,Telford and Wrekin 024E,E01014158,822,430,178,252,0,0,263,89,174,129,114,15,0
2021,Telford and Wrekin 022A,E01014159,609,341,185,156,0,0,173,74,99,94,84,10,1
2021,Telford and Wrekin 022B,E01014160,528,411,241,170,7,7,30,10,20,80,74,6,0
2021,Telford and Wrekin 022C,E01014161,490,308,179,129,3,3,108,40,68,71,63,8,0
2021,Telford and Wrekin 022D,E01014162,940,318,159,159,1,1,369,162,207,248,228,20,4
2021,Telford and Wrekin 017B,E01014163,780,285,98,187,3,3,263,119,144,228,219,9,1
2021,Telford and Wrekin 017C,E01014164,704,171,83,88,8,8,398,197,201,121,113,8,6
2021,Telford and Wrekin 017D,E01014165,612,213,96,117,2,2,213,98,115,182,169,13,2
2021,Telford and Wrekin 017E,E01014166,640,413,215,198,2,2,77,29,48,147,135,12,1
2021,Telford and Wrekin 004B,E01014167,828,600,258,342,4,4,129,44,85,95,81,14,0
2021,Telford and Wrekin 004C,E01014168,515,437,204,233,4,4,10,2,8,64,58,6,0
2021,Telford and Wrekin 005E,E01014169,752,312,128,184,7,7,194,93,101,239,224,15,0
2021,Telford and Wrekin 004D,E01014170,672,599,405,194,0,0,13,3,10,59,48,11,1
2021,Telford and Wrekin 001A,E01014171,600,345,218,127,5,5,124,46,78,126,112,14,0
2021,Telford and Wrekin 001B,E01014172,543,449,258,191,4,4,11,3,8,79,71,8,0
2021,Telford and Wrekin 001C,E01014173,800,415,237,178,12,12,191,45,146,179,162,17,3
2021,Telford and Wrekin 001D,E01014174,614,553,307,246,0,0,13,0,13,48,38,10,0
2021,Telford and Wrekin 003A,E01014175,704,460,212,248,3,3,119,34,85,120,109,11,2
2021,Telford and Wrekin 003B,E01014176,694,503,361,142,0,0,44,16,28,147,134,13,0
2021,Telford and Wrekin 003C,E01014177,861,633,340,293,12,12,74,25,49,142,125,17,0
2021,Telford and Wrekin 003D,E01014178,843,357,209,148,11,11,135,26,109,340,317,23,0
2021,Telford and Wrekin 006C,E01014179,495,425,262,163,1,1,11,5,6,58,51,7,0
2021,Telford and Wrekin 006D,E01014180,592,414,245,169,2,2,81,33,48,95,78,17,0
2021,Telford and Wrekin 015A,E01014181,822,658,239,419,9,9,53,15,38,102,90,12,0
2021,Telford and Wrekin 015B,E01014182,571,477,232,245,5,5,19,4,15,70,65,5,0
2021,Telford and Wrekin 015C,E01014183,759,560,343,217,19,19,102,31,71,78,73,5,0
2021,Telford and Wrekin 015D,E01014184,854,512,214,298,9,9,154,30,124,179,108,71,0
2021,Telford and Wrekin 013A,E01014185,789,285,172,113,5,5,361,112,249,136,130,6,2
2021,Telford and Wrekin 013B,E01014186,625,377,192,185,3,3,86,32,54,159,141,18,0
2021,Telford and Wrekin 013C,E01014187,682,426,221,205,3,3,99,47,52,152,137,15,2
2021,Telford and Wrekin 013D,E01014188,614,463,241,222,13,13,17,13,4,121,110,11,0
2021,Telford and Wrekin 006E,E01014189,594,394,195,199,3,3,76,25,51,121,104,17,0
2021,Telford and Wrekin 006F,E01014190,603,536,257,279,1,1,1,0,1,65,55,10,0
2021,Telford and Wrekin 018A,E01014191,715,229,121,108,4,4,82,24,58,400,379,21,0
2021,Telford and Wrekin 018B,E01014192,581,255,145,110,1,1,68,20,48,257,246,11,0
2021,Telford and Wrekin 018C,E01014193,619,340,179,161,0,0,136,49,87,141,131,10,2
2021,Telford and Wrekin 018D,E01014194,628,332,150,182,0,0,128,69,59,168,155,13,0
2021,Telford and Wrekin 018E,E01014195,568,470,245,225,2,2,30,15,15,66,57,9,0
2021,Telford and Wrekin 018F,E01014196,648,272,145,127,0,0,265,63,202,111,105,6,0
2021,Telford and Wrekin 021A,E01014197,677,226,127,99,2,2,174,68,106,274,263,11,1
2021,Telford and Wrekin 021B,E01014198,547,161,72,89,0,0,221,66,155,165,159,6,0
2021,Telford and Wrekin 021C,E01014199,621,253,124,129,5,5,107,34,73,256,237,19,0
2021,Telford and Wrekin 021D,E01014200,484,177,86,91,0,0,104,54,50,201,193,8,2
2021,Telford and Wrekin 021E,E01014201,442,150,90,60,1,1,74,24,50,217,214,3,0
2021,Telford and Wrekin 010D,E01014202,1079,783,377,406,25,25,89,26,63,182,167,15,0
2021,Telford and Wrekin 010E,E01014203,654,553,333,220,1,1,29,10,19,71,62,9,0
2021,Telford and Wrekin 010F,E01014204,824,665,379,286,5,5,34,4,30,116,96,20,4
2021,Telford and Wrekin 008A,E01014205,590,504,315,189,0,0,10,2,8,76,69,7,0
2021,Telford and Wrekin 008B,E01014206,541,325,180,145,2,2,74,35,39,140,127,13,0
2021,Telford and Wrekin 008C,E01014207,513,362,218,144,1,1,28,7,21,120,110,10,2
2021,Telford and Wrekin 008D,E01014208,590,283,168,115,2,2,179,74,105,126,115,11,0
2021,Telford and Wrekin 008E,E01014209,643,373,230,143,1,1,167,52,115,102,88,14,0
2021,Stoke-on-Trent 012A,E01014210,633,322,181,141,4,4,235,209,26,69,58,11,3
2021,Stoke-on-Trent 012B,E01014211,640,189,98,91,1,1,408,194,214,42,37,5,0
2021,Stoke-on-Trent 012C,E01014212,902,355,133,222,7,7,488,287,201,47,43,4,5
2021,Stoke-on-Trent 012D,E01014213,555,279,152,127,0,0,194,165,29,81,72,9,1
2021,Stoke-on-Trent 007A,E01014214,633,575,368,207,0,0,8,4,4,50,41,9,0
2021,Stoke-on-Trent 007B,E01014215,614,510,293,217,3,3,18,15,3,83,71,12,0
2021,Stoke-on-Trent 007C,E01014216,622,516,340,176,1,1,44,39,5,59,49,10,2
2021,Stoke-on-Trent 012E,E01014217,634,199,98,101,3,3,350,231,119,73,61,12,9
2021,Stoke-on-Trent 014A,E01014218,627,240,132,108,0,0,310,281,29,71,57,14,6
2021,Stoke-on-Trent 014B,E01014219,596,418,264,154,0,0,78,71,7,98,83,15,2
2021,Stoke-on-Trent 017A,E01014220,702,207,111,96,1,1,391,263,128,101,91,10,2
2021,Stoke-on-Trent 017B,E01014221,646,218,106,112,0,0,337,183,154,90,78,12,1
2021,Stoke-on-Trent 017C,E01014222,656,169,95,74,2,2,408,245,163,77,71,6,0
2021,Stoke-on-Trent 017D,E01014223,783,194,110,84,1,1,477,220,257,106,81,25,5
2021,Stoke-on-Trent 017E,E01014224,666,222,138,84,2,2,360,259,101,77,65,12,5
2021,Stoke-on-Trent 014C,E01014225,680,587,369,218,0,0,16,13,3,77,64,13,0
2021,Stoke-on-Trent 014D,E01014226,697,352,194,158,1,1,247,150,97,94,70,24,3
2021,Stoke-on-Trent 014E,E01014228,549,502,356,146,2,2,13,6,7,32,22,10,0
2021,Stoke-on-Trent 017F,E01014229,797,228,93,135,11,11,469,183,286,88,69,19,1
2021,Stoke-on-Trent 014F,E01014230,727,406,233,173,1,1,166,115,51,151,136,15,3
2021,Stoke-on-Trent 026A,E01014233,623,503,333,170,0,0,59,57,2,61,49,12,0
2021,Stoke-on-Trent 026B,E01014234,549,253,114,139,0,0,231,227,4,61,52,9,4
2021,Stoke-on-Trent 032A,E01014235,727,339,209,130,1,1,258,231,27,123,108,15,6
2021,Stoke-on-Trent 032C,E01014237,724,280,138,142,1,1,359,335,24,80,72,8,4
2021,Stoke-on-Trent 032D,E01014238,665,212,104,108,1,1,375,353,22,74,66,8,3
2021,Stoke-on-Trent 026C,E01014239,597,515,278,237,0,0,48,44,4,34,26,8,0
2021,Stoke-on-Trent 026D,E01014240,618,399,203,196,3,3,128,124,4,88,78,10,0
2021,Stoke-on-Trent 006A,E01014241,650,403,206,197,3,3,102,85,17,142,125,17,0
2021,Stoke-on-Trent 006B,E01014242,647,298,158,140,1,1,262,233,29,80,73,7,6
2021,Stoke-on-Trent 006C,E01014243,599,480,280,200,2,2,39,20,19,78,62,16,0
2021,Stoke-on-Trent 006D,E01014244,589,206,118,88,0,0,316,308,8,66,63,3,1
2021,Stoke-on-Trent 006E,E01014245,693,484,250,234,5,5,33,20,13,171,158,13,0
2021,Stoke-on-Trent 008A,E01014246,744,332,169,163,0,0,220,149,71,184,167,17,8
2021,Stoke-on-Trent 009A,E01014247,758,332,211,121,3,3,101,60,41,320,294,26,2
2021,Stoke-on-Trent 006F,E01014248,616,312,164,148,0,0,67,36,31,236,221,15,1
2021,Stoke-on-Trent 011A,E01014249,754,258,171,87,2,2,148,53,95,341,319,22,5
2021,Stoke-on-Trent 009B,E01014250,584,200,115,85,2,2,218,124,94,161,151,10,3
2021,Stoke-on-Trent 009D,E01014252,724,366,182,184,0,0,90,41,49,268,251,17,0
2021,Stoke-on-Trent 011B,E01014253,658,482,235,247,0,0,96,86,10,76,66,10,4
2021,Stoke-on-Trent 011C,E01014254,719,272,163,109,6,6,121,57,64,317,288,29,3
2021,Stoke-on-Trent 009E,E01014255,706,274,122,152,0,0,259,178,81,169,149,20,4
2021,Stoke-on-Trent 011D,E01014256,871,407,177,230,10,10,234,182,52,216,194,22,4
2021,Stoke-on-Trent 001A,E01014257,635,427,263,164,0,0,141,122,19,63,51,12,4
2021,Stoke-on-Trent 001B,E01014258,550,493,238,255,2,2,7,5,2,48,41,7,0
2021,Stoke-on-Trent 001C,E01014259,758,472,296,176,1,1,191,93,98,91,81,10,3
2021,Stoke-on-Trent 001D,E01014260,622,326,209,117,1,1,229,214,15,63,53,10,3
2021,Stoke-on-Trent 003A,E01014261,666,195,98,97,0,0,393,318,75,75,68,7,3
2021,Stoke-on-Trent 003B,E01014262,528,304,152,152,1,1,171,146,25,50,42,8,2
2021,Stoke-on-Trent 003C,E01014263,610,289,135,154,0,0,233,230,3,85,77,8,3
2021,Stoke-on-Trent 001E,E01014264,791,619,302,317,1,1,67,64,3,99,82,17,5
2021,Stoke-on-Trent 007D,E01014265,677,596,368,228,2,2,19,16,3,60,54,6,0
2021,Stoke-on-Trent 008B,E01014266,597,290,146,144,0,0,125,118,7,177,166,11,5
2021,Stoke-on-Trent 007E,E01014267,1013,694,348,346,2,2,112,99,13,202,182,20,3
2021,Stoke-on-Trent 008C,E01014268,1169,613,185,428,0,0,364,280,84,186,170,16,6
2021,Stoke-on-Trent 010A,E01014269,666,234,107,127,2,2,338,329,9,87,79,8,5
2021,Stoke-on-Trent 008D,E01014270,653,563,315,248,0,0,25,22,3,65,51,14,0
2021,Stoke-on-Trent 008E,E01014271,606,457,230,227,1,1,59,50,9,88,72,16,1
2021,Stoke-on-Trent 007F,E01014272,664,532,323,209,1,1,14,9,5,117,104,13,0
2021,Stoke-on-Trent 035A,E01014273,597,209,119,90,3,3,39,17,22,346,321,25,0
2021,Stoke-on-Trent 020A,E01014274,810,378,200,178,4,4,223,209,14,201,182,19,4
2021,Stoke-on-Trent 020B,E01014275,721,205,105,100,0,0,286,174,112,201,189,12,29
2021,Stoke-on-Trent 020C,E01014276,755,393,201,192,0,0,92,63,29,269,251,18,1
2021,Stoke-on-Trent 020D,E01014277,697,456,274,182,3,3,66,47,19,171,143,28,1
2021,Stoke-on-Trent 035C,E01014278,553,351,231,120,2,2,67,34,33,133,124,9,0
2021,Stoke-on-Trent 020E,E01014279,808,388,187,201,0,0,82,23,59,338,318,20,0
2021,Stoke-on-Trent 035B,E01014280,588,492,295,197,4,4,29,21,8,63,55,8,0
2021,Stoke-on-Trent 015A,E01014281,556,208,110,98,3,3,126,46,80,215,199,16,4
2021,Stoke-on-Trent 016D,E01014282,412,147,81,66,0,0,157,18,139,106,99,7,2
2021,Stoke-on-Trent 016E,E01014283,777,200,106,94,6,6,74,18,56,495,476,19,2
2021,Stoke-on-Trent 016F,E01014284,430,74,43,31,0,0,35,10,25,321,309,12,0
2021,Stoke-on-Trent 015B,E01014285,928,449,190,259,3,3,160,80,80,313,270,43,3
2021,Stoke-on-Trent 015C,E01014286,552,206,104,102,0,0,119,50,69,225,209,16,2
2021,Stoke-on-Trent 015D,E01014287,887,172,101,71,4,4,324,81,243,384,363,21,3
2021,Stoke-on-Trent 018A,E01014288,715,384,198,186,6,6,31,19,12,293,278,15,1
2021,Stoke-on-Trent 018B,E01014289,671,452,273,179,5,5,20,13,7,194,184,10,0
2021,Stoke-on-Trent 018C,E01014290,657,349,188,161,6,6,93,24,69,209,190,19,0
2021,Stoke-on-Trent 018D,E01014291,823,466,180,286,2,2,176,67,109,178,165,13,1
2021,Stoke-on-Trent 018E,E01014292,674,436,250,186,0,0,25,13,12,213,193,20,0
2021,Stoke-on-Trent 019A,E01014293,741,278,127,151,0,0,86,26,60,372,353,19,5
2021,Stoke-on-Trent 018F,E01014294,617,271,131,140,7,7,162,124,38,174,155,19,3
2021,Stoke-on-Trent 019B,E01014295,799,476,285,191,3,3,144,104,40,174,162,12,2
2021,Stoke-on-Trent 035H,E01014296,613,410,241,169,0,0,117,88,29,82,67,15,4
2021,Stoke-on-Trent 035D,E01014297,481,429,228,201,1,1,6,5,1,45,37,8,0
2021,Stoke-on-Trent 035G,E01014298,654,325,157,168,1,1,249,231,18,73,61,12,6
2021,Stoke-on-Trent 025A,E01014299,598,521,272,249,8,8,7,5,2,62,51,11,0
2021,Stoke-on-Trent 035F,E01014300,618,286,150,136,1,1,190,148,42,137,121,16,4
2021,Stoke-on-Trent 025B,E01014301,657,545,208,337,6,6,51,44,7,55,43,12,0
2021,Stoke-on-Trent 035E,E01014302,954,399,226,173,1,1,364,231,133,181,154,27,9
2021,Stoke-on-Trent 025C,E01014303,658,553,258,295,7,7,17,11,6,80,65,15,1
2021,Stoke-on-Trent 025D,E01014304,652,554,318,236,0,0,23,18,5,75,62,13,0
2021,Stoke-on-Trent 029A,E01014305,504,302,141,161,2,2,39,23,16,160,132,28,1
2021,Stoke-on-Trent 029B,E01014306,559,250,136,114,3,3,108,65,43,197,170,27,1
2021,Stoke-on-Trent 029C,E01014307,497,244,122,122,7,7,76,21,55,166,141,25,4
2021,Stoke-on-Trent 027A,E01014308,753,617,424,193,3,3,67,38,29,65,54,11,1
2021,Stoke-on-Trent 027B,E01014309,577,287,149,138,3,3,169,157,12,113,103,10,5
2021,Stoke-on-Trent 031A,E01014310,793,663,308,355,0,0,49,7,42,81,64,17,0
2021,Stoke-on-Trent 027C,E01014311,615,378,229,149,0,0,106,89,17,127,114,13,4
2021,Stoke-on-Trent 029D,E01014312,601,421,245,176,4,4,51,16,35,125,106,19,0
2021,Stoke-on-Trent 027D,E01014313,756,333,198,135,0,0,309,296,13,104,92,12,10
2021,Stoke-on-Trent 031B,E01014314,537,495,229,266,0,0,3,3,0,39,31,8,0
2021,Stoke-on-Trent 033A,E01014315,597,559,384,175,1,1,5,2,3,32,18,14,0
2021,Stoke-on-Trent 031C,E01014316,645,212,103,109,1,1,346,297,49,83,75,8,3
2021,Stoke-on-Trent 031D,E01014317,703,252,111,141,3,3,371,291,80,73,62,11,4
2021,Stoke-on-Trent 033B,E01014318,597,533,316,217,4,4,12,11,1,48,39,9,0
2021,Stoke-on-Trent 033C,E01014319,571,450,200,250,1,1,66,63,3,53,44,9,1
2021,Stoke-on-Trent 033D,E01014320,494,430,223,207,1,1,7,5,2,56,49,7,0
2021,Stoke-on-Trent 028A,E01014321,643,464,253,211,1,1,21,11,10,157,142,15,0
2021,Stoke-on-Trent 031E,E01014322,655,378,199,179,0,0,142,116,26,133,116,17,2
2021,Stoke-on-Trent 013A,E01014323,641,306,160,146,2,2,58,42,16,274,246,28,1
2021,Stoke-on-Trent 010B,E01014324,688,558,384,174,1,1,18,9,9,111,88,23,0
2021,Stoke-on-Trent 010C,E01014325,537,501,269,232,3,3,3,3,0,30,22,8,0
2021,Stoke-on-Trent 010D,E01014326,577,533,314,219,4,4,11,8,3,29,23,6,0
2021,Stoke-on-Trent 013B,E01014327,676,373,186,187,3,3,39,24,15,261,243,18,0
2021,Stoke-on-Trent 013C,E01014328,680,299,166,133,1,1,131,62,69,248,223,25,1
2021,Stoke-on-Trent 013D,E01014329,746,396,189,207,2,2,143,128,15,202,178,24,3
2021,Stoke-on-Trent 013E,E01014330,670,149,72,77,3,3,317,244,73,196,183,13,5
2021,Stoke-on-Trent 004A,E01014331,629,300,153,147,0,0,230,222,8,94,73,21,5
2021,Stoke-on-Trent 004B,E01014332,785,568,379,189,1,1,143,130,13,71,53,18,2
2021,Stoke-on-Trent 003D,E01014333,612,523,294,229,9,9,22,15,7,57,42,15,1
2021,Stoke-on-Trent 003E,E01014334,732,435,308,127,0,0,251,54,197,45,38,7,1
2021,Stoke-on-Trent 004C,E01014335,752,581,299,282,0,0,62,54,8,109,87,22,0
2021,Stoke-on-Trent 004D,E01014336,713,276,139,137,0,0,329,278,51,104,96,8,4
2021,Stoke-on-Trent 004E,E01014337,728,421,236,185,4,4,199,183,16,99,86,13,5
2021,Stoke-on-Trent 023A,E01014338,602,432,231,201,1,1,50,31,19,119,104,15,0
2021,Stoke-on-Trent 019C,E01014339,897,407,189,218,7,7,87,15,72,396,376,20,0
2021,Stoke-on-Trent 019D,E01014340,961,452,192,260,14,14,242,108,134,252,231,21,1
2021,Stoke-on-Trent 023B,E01014341,753,365,181,184,1,1,206,114,92,180,168,12,1
2021,Stoke-on-Trent 023C,E01014342,587,218,92,126,1,1,302,117,185,61,54,7,5
2021,Stoke-on-Trent 023D,E01014343,886,414,200,214,3,3,122,41,81,347,330,17,0
2021,Stoke-on-Trent 023E,E01014344,596,367,169,198,2,2,164,148,16,63,56,7,0
2021,Stoke-on-Trent 019E,E01014345,922,294,151,143,1,1,266,152,114,360,333,27,1
2021,Stoke-on-Trent 030A,E01014346,720,641,439,202,2,2,20,14,6,57,46,11,0
2021,Stoke-on-Trent 034A,E01014347,577,529,304,225,4,4,7,7,0,37,32,5,0
2021,Stoke-on-Trent 030B,E01014348,617,563,373,190,3,3,13,13,0,38,29,9,0
2021,Stoke-on-Trent 030C,E01014349,640,575,368,207,2,2,11,7,4,52,42,10,0
2021,Stoke-on-Trent 034B,E01014350,549,515,302,213,0,0,7,4,3,27,20,7,0
2021,Stoke-on-Trent 034C,E01014351,559,477,272,205,1,1,5,4,1,76,66,10,0
2021,Stoke-on-Trent 034D,E01014352,574,517,304,213,1,1,26,6,20,30,24,6,0
2021,Stoke-on-Trent 030D,E01014353,695,396,160,236,0,0,225,197,28,69,58,11,5
2021,Stoke-on-Trent 005A,E01014354,820,291,159,132,4,4,282,149,133,240,223,17,3
2021,Stoke-on-Trent 005B,E01014355,756,436,213,223,2,2,65,16,49,252,237,15,1
2021,Stoke-on-Trent 005C,E01014356,753,427,242,185,2,2,39,7,32,283,263,20,2
2021,Stoke-on-Trent 002A,E01014357,701,364,205,159,1,1,200,179,21,130,113,17,6
2021,Stoke-on-Trent 002B,E01014358,545,224,123,101,0,0,243,212,31,71,63,8,7
2021,Stoke-on-Trent 002C,E01014359,780,492,250,242,1,1,170,161,9,115,105,10,2
2021,Stoke-on-Trent 002D,E01014360,1069,878,258,620,0,0,33,27,6,157,136,21,1
2021,Stoke-on-Trent 005D,E01014361,713,247,131,116,0,0,77,19,58,388,372,16,1
2021,Stoke-on-Trent 025E,E01014362,580,534,328,206,1,1,6,4,2,38,30,8,1
2021,Stoke-on-Trent 024A,E01014363,616,536,388,148,0,0,39,36,3,41,38,3,0
2021,Stoke-on-Trent 024B,E01014364,623,435,236,199,3,3,90,76,14,91,81,10,4
2021,Stoke-on-Trent 024C,E01014365,640,512,317,195,3,3,80,75,5,44,37,7,1
2021,Stoke-on-Trent 028B,E01014366,769,295,181,114,0,0,378,351,27,92,85,7,4
2021,Stoke-on-Trent 028C,E01014367,771,270,114,156,0,0,379,348,31,115,103,12,7
2021,Stoke-on-Trent 028D,E01014368,762,314,148,166,15,15,242,125,117,190,155,35,1
2021,Stoke-on-Trent 024D,E01014369,729,546,258,288,23,23,114,15,99,46,43,3,0
2021,Bath and North East Somerset 007A,E01014370,1009,229,165,64,21,21,308,42,266,450,407,43,1
2021,Bath and North East Somerset 007B,E01014371,1045,391,276,115,11,11,111,18,93,532,493,39,0
2021,Bath and North East Somerset 007C,E01014372,1043,294,188,106,3,3,172,15,157,574,545,29,0
2021,Bath and North East Somerset 010A,E01014373,661,447,236,211,0,0,110,35,75,104,86,18,0
2021,Bath and North East Somerset 010B,E01014374,665,466,248,218,0,0,142,30,112,57,45,12,0
2021,Bath and North East Somerset 010C,E01014375,531,445,276,169,1,1,4,3,1,81,59,22,0
2021,Bath and North East Somerset 010D,E01014376,650,583,353,230,1,1,6,3,3,60,56,4,0
2021,Bath and North East Somerset 010E,E01014377,638,554,351,203,3,3,14,5,9,67,56,11,0
2021,Bath and North East Somerset 012A,E01014380,607,514,377,137,7,7,23,2,21,63,52,11,0
2021,Bath and North East Somerset 012B,E01014381,666,485,352,133,4,4,23,8,15,154,138,16,0
2021,Bath and North East Somerset 021A,E01014382,1000,810,498,312,9,9,68,9,59,112,89,23,1
2021,Bath and North East Somerset 021B,E01014383,453,368,216,152,1,1,33,7,26,50,37,13,1
2021,Bath and North East Somerset 021C,E01014384,625,500,276,224,11,11,56,10,46,58,43,15,0
2021,Bath and North East Somerset 020A,E01014385,566,441,258,183,5,5,62,20,42,58,46,12,0
2021,Bath and North East Somerset 020B,E01014386,465,381,191,190,0,0,41,8,33,43,36,7,0
2021,Bath and North East Somerset 018A,E01014387,680,416,211,205,18,18,133,44,89,110,97,13,3
2021,Bath and North East Somerset 018B,E01014388,553,474,314,160,0,0,9,4,5,70,54,16,0
2021,Bath and North East Somerset 018C,E01014389,825,548,294,254,15,15,146,34,112,115,104,11,1
2021,Bath and North East Somerset 018D,E01014390,602,176,92,84,0,0,356,125,231,68,54,14,2
2021,Bath and North East Somerset 016A,E01014391,730,568,323,245,9,9,72,22,50,81,68,13,0
2021,Bath and North East Somerset 016B,E01014392,437,351,238,113,1,1,34,10,24,51,43,8,0
2021,Bath and North East Somerset 023A,E01014393,541,475,273,202,4,4,19,9,10,43,35,8,0
2021,Bath and North East Somerset 023B,E01014394,699,558,317,241,2,2,83,26,57,56,42,14,0
2021,Bath and North East Somerset 003A,E01014395,548,513,344,169,1,1,4,1,3,30,25,5,0
2021,Bath and North East Somerset 003B,E01014396,682,507,306,201,3,3,35,3,32,137,128,9,0
2021,Bath and North East Somerset 003C,E01014397,525,497,285,212,2,2,5,0,5,21,15,6,0
2021,Bath and North East Somerset 003D,E01014398,727,558,302,256,6,6,80,26,54,82,64,18,1
2021,Bath and North East Somerset 001A,E01014399,1043,771,413,358,30,30,144,41,103,98,83,15,0
2021,Bath and North East Somerset 001B,E01014400,1142,756,378,378,15,15,132,39,93,238,211,27,1
2021,Bath and North East Somerset 001C,E01014401,673,380,187,193,3,3,216,72,144,73,57,16,1
2021,Bath and North East Somerset 002B,E01014403,929,576,356,220,2,2,211,53,158,139,127,12,1
2021,Bath and North East Somerset 002C,E01014404,886,478,225,253,19,19,309,100,209,77,72,5,3
2021,Bath and North East Somerset 009A,E01014405,837,581,306,275,6,6,31,2,29,219,206,13,0
2021,Bath and North East Somerset 009C,E01014407,569,92,48,44,1,1,240,43,197,235,222,13,1
2021,Bath and North East Somerset 004A,E01014409,750,435,263,172,4,4,204,51,153,107,95,12,0
2021,Bath and North East Somerset 004B,E01014410,729,591,347,244,1,1,35,14,21,102,91,11,0
2021,Bath and North East Somerset 004C,E01014411,978,699,389,310,15,15,38,11,27,226,204,22,0
2021,Bath and North East Somerset 007D,E01014412,625,422,241,181,1,1,23,2,21,178,164,14,1
2021,Bath and North East Somerset 007E,E01014413,920,727,408,319,19,19,48,10,38,126,101,25,0
2021,Bath and North East Somerset 007F,E01014414,824,283,164,119,4,4,221,56,165,316,301,15,0
2021,Bath and North East Somerset 017A,E01014415,771,580,330,250,3,3,20,1,19,168,157,11,0
2021,Bath and North East Somerset 017B,E01014416,725,492,274,218,13,13,122,11,111,98,87,11,0
2021,Bath and North East Somerset 017C,E01014417,734,624,369,255,2,2,23,7,16,85,76,9,0
2021,Bath and North East Somerset 021D,E01014418,604,479,289,190,3,3,54,17,37,68,52,16,0
2021,Bath and North East Somerset 020C,E01014419,599,438,203,235,15,15,93,27,66,51,43,8,2
2021,Bath and North East Somerset 025A,E01014420,697,487,224,263,3,3,63,29,34,144,130,14,0
2021,Bath and North East Somerset 025B,E01014421,586,532,287,245,2,2,22,7,15,30,24,6,0
2021,Bath and North East Somerset 025C,E01014422,720,625,358,267,6,6,35,7,28,54,46,8,0
2021,Bath and North East Somerset 025D,E01014423,658,447,261,186,6,6,30,7,23,175,156,19,0
2021,Bath and North East Somerset 027A,E01014424,864,706,418,288,16,16,57,4,53,85,68,17,0
2021,Bath and North East Somerset 027B,E01014425,964,732,447,285,13,13,117,17,100,101,91,10,1
2021,Bath and North East Somerset 027C,E01014426,634,359,213,146,0,0,191,64,127,82,67,15,2
2021,Bath and North East Somerset 008A,E01014427,561,289,148,141,6,6,87,10,77,179,170,9,0
2021,Bath and North East Somerset 008B,E01014428,527,350,178,172,1,1,63,6,57,113,101,12,0
2021,Bath and North East Somerset 008C,E01014429,619,464,239,225,16,16,60,19,41,79,71,8,0
2021,Bath and North East Somerset 008D,E01014430,720,452,273,179,2,2,170,30,140,92,76,16,4
2021,Bath and North East Somerset 019A,E01014431,493,328,176,152,2,2,91,33,58,70,62,8,2
2021,Bath and North East Somerset 019B,E01014432,559,326,174,152,11,11,100,34,66,122,113,9,0
2021,Bath and North East Somerset 019C,E01014433,549,269,123,146,11,11,154,17,137,115,105,10,0
2021,Bath and North East Somerset 019D,E01014434,761,550,299,251,11,11,54,11,43,146,124,22,0
2021,Bath and North East Somerset 014A,E01014435,537,221,125,96,6,6,4,2,2,306,293,13,0
2021,Bath and North East Somerset 014B,E01014436,618,309,191,118,1,1,108,40,68,200,195,5,0
2021,Bath and North East Somerset 014C,E01014437,638,312,165,147,2,2,226,61,165,97,83,14,1
2021,Bath and North East Somerset 014D,E01014438,486,276,128,148,3,3,134,41,93,73,65,8,0
2021,Bath and North East Somerset 023C,E01014439,741,485,274,211,0,0,187,74,113,67,57,10,2
2021,Bath and North East Somerset 023D,E01014440,1055,757,341,416,35,35,83,20,63,180,161,19,0
2021,Bath and North East Somerset 023E,E01014441,913,719,388,331,22,22,46,6,40,126,104,22,0
2021,Bath and North East Somerset 022B,E01014442,708,549,292,257,1,1,40,8,32,118,108,10,0
2021,Bath and North East Somerset 022C,E01014443,681,582,319,263,2,2,18,3,15,79,68,11,0
2021,Bath and North East Somerset 022D,E01014444,650,534,254,280,6,6,19,8,11,91,83,8,0
2021,Bath and North East Somerset 022E,E01014445,714,358,177,181,17,17,234,82,152,103,92,11,2
2021,Bath and North East Somerset 020D,E01014446,478,365,203,162,4,4,33,8,25,75,67,8,1
2021,Bath and North East Somerset 020E,E01014447,779,574,265,309,23,23,113,20,93,69,53,16,0
2021,Bath and North East Somerset 024A,E01014448,653,399,208,191,1,1,160,49,111,91,81,10,2
2021,Bath and North East Somerset 024B,E01014449,585,455,200,255,1,1,34,3,31,95,85,10,0
2021,Bath and North East Somerset 024C,E01014450,584,323,148,175,5,5,193,65,128,63,53,10,0
2021,Bath and North East Somerset 024D,E01014451,729,485,199,286,8,8,105,38,67,131,122,9,0
2021,Bath and North East Somerset 016C,E01014452,660,488,301,187,2,2,129,36,93,41,32,9,0
2021,Bath and North East Somerset 016D,E01014453,535,488,288,200,0,0,10,2,8,37,29,8,0
2021,Bath and North East Somerset 016E,E01014454,522,502,297,205,2,2,5,2,3,13,10,3,0
2021,Bath and North East Somerset 015A,E01014455,566,323,166,157,1,1,142,46,96,99,86,13,1
2021,Bath and North East Somerset 015B,E01014456,636,457,255,202,6,6,74,19,55,99,88,11,0
2021,Bath and North East Somerset 015C,E01014457,627,508,330,178,2,2,25,4,21,89,77,12,3
2021,Bath and North East Somerset 015D,E01014458,508,165,95,70,6,6,265,105,160,70,65,5,2
2021,Bath and North East Somerset 016F,E01014459,635,386,226,160,2,2,149,46,103,98,79,19,0
2021,Bath and North East Somerset 016G,E01014460,502,447,296,151,1,1,10,3,7,44,36,8,0
2021,Bath and North East Somerset 011A,E01014461,471,245,115,130,0,0,144,54,90,82,76,6,0
2021,Bath and North East Somerset 011B,E01014462,598,203,107,96,6,6,321,92,229,68,58,10,0
2021,Bath and North East Somerset 011C,E01014463,666,230,122,108,7,7,328,109,219,100,93,7,1
2021,Bath and North East Somerset 011D,E01014464,656,184,95,89,8,8,300,110,190,158,145,13,6
2021,Bath and North East Somerset 006A,E01014465,668,495,247,248,1,1,47,15,32,125,112,13,0
2021,Bath and North East Somerset 006B,E01014466,592,244,141,103,5,5,232,75,157,111,100,11,0
2021,Bath and North East Somerset 006C,E01014467,781,434,256,178,0,0,40,3,37,307,290,17,0
2021,Bath and North East Somerset 006D,E01014468,738,366,214,152,1,1,39,3,36,332,313,19,0
2021,Bath and North East Somerset 026A,E01014469,531,341,173,168,13,13,141,63,78,35,28,7,1
2021,Bath and North East Somerset 026B,E01014470,680,539,272,267,11,11,37,8,29,93,80,13,0
2021,Bath and North East Somerset 026C,E01014471,658,467,233,234,3,3,54,20,34,134,123,11,0
2021,Bath and North East Somerset 026D,E01014472,739,568,285,283,19,19,79,15,64,73,59,14,0
2021,Bath and North East Somerset 013A,E01014473,588,318,164,154,4,4,16,6,10,249,244,5,1
2021,Bath and North East Somerset 013B,E01014474,527,262,133,129,4,4,104,35,69,156,145,11,1
2021,Bath and North East Somerset 013D,E01014476,549,312,161,151,2,2,10,3,7,225,219,6,0
2021,Bath and North East Somerset 005A,E01014477,624,544,320,224,1,1,16,2,14,63,57,6,0
2021,Bath and North East Somerset 005B,E01014478,488,237,118,119,3,3,194,59,135,53,42,11,1
2021,Bath and North East Somerset 005C,E01014479,617,458,289,169,2,2,18,2,16,139,131,8,0
2021,Bath and North East Somerset 005D,E01014480,635,337,187,150,15,15,153,34,119,130,116,14,0
2021,Bath and North East Somerset 012C,E01014481,571,288,163,125,5,5,22,2,20,256,244,12,0
2021,Bath and North East Somerset 012D,E01014482,484,403,247,156,6,6,5,3,2,70,66,4,0
2021,Bath and North East Somerset 012E,E01014483,624,339,218,121,10,10,102,23,79,173,156,17,0
2021,Bath and North East Somerset 012F,E01014484,636,278,136,142,3,3,25,3,22,330,316,14,0
2021,Bristol 058A,E01014485,822,500,244,256,8,8,100,48,52,209,175,34,5
2021,Bristol 058C,E01014486,1130,387,165,222,7,7,324,113,211,408,381,27,4
2021,Bristol 020A,E01014487,760,358,170,188,3,3,30,6,24,369,353,16,0
2021,Bristol 058B,E01014488,854,432,194,238,2,2,157,67,90,262,234,28,1
2021,Bristol 059A,E01014489,1153,355,137,218,1,1,314,60,254,482,446,36,1
2021,Bristol 020B,E01014491,777,513,223,290,1,1,23,11,12,240,222,18,0
2021,Bristol 008A,E01014492,783,368,191,177,2,2,303,242,61,106,90,16,4
2021,Bristol 008B,E01014493,649,369,163,206,5,5,158,139,19,116,103,13,1
2021,Bristol 008C,E01014494,652,521,274,247,1,1,40,32,8,90,79,11,0
2021,Bristol 008D,E01014495,755,490,245,245,7,7,129,94,35,126,109,17,3
2021,Bristol 008E,E01014496,805,409,163,246,0,0,88,70,18,306,293,13,2
2021,Bristol 003A,E01014497,685,333,124,209,0,0,268,253,15,83,71,12,1
2021,Bristol 003B,E01014498,658,334,155,179,1,1,271,246,25,49,44,5,3
2021,Bristol 008F,E01014499,615,375,164,211,1,1,152,144,8,85,75,10,2
2021,Bristol 039A,E01014500,822,502,219,283,3,3,60,26,34,253,233,20,4
2021,Bristol 041A,E01014501,889,582,275,307,1,1,212,204,8,93,77,16,1
2021,Bristol 039B,E01014502,877,528,216,312,11,11,187,139,48,149,130,19,2
2021,Bristol 041B,E01014504,696,485,197,288,2,2,24,16,8,185,169,16,0
2021,Bristol 041C,E01014505,829,544,205,339,3,3,38,31,7,244,226,18,0
2021,Bristol 041D,E01014506,619,539,261,278,1,1,20,18,2,59,53,6,0
2021,Bristol 016A,E01014507,714,459,188,271,1,1,24,9,15,230,219,11,0
2021,Bristol 016B,E01014508,666,395,167,228,3,3,25,9,16,243,230,13,0
2021,Bristol 016C,E01014509,1030,644,216,428,3,3,50,29,21,333,306,27,0
2021,Bristol 010A,E01014510,766,532,205,327,5,5,8,3,5,221,206,15,0
2021,Bristol 016D,E01014511,524,395,181,214,2,2,14,4,10,113,103,10,0
2021,Bristol 016E,E01014512,618,426,228,198,11,11,56,7,49,125,112,13,0
2021,Bristol 016F,E01014513,621,516,245,271,0,0,8,6,2,97,84,13,0
2021,Bristol 016G,E01014514,848,512,244,268,4,4,14,8,6,318,300,18,0
2021,Bristol 050A,E01014515,643,372,210,162,6,6,189,143,46,75,60,15,1
2021,Bristol 050B,E01014516,599,200,103,97,3,3,338,276,62,54,45,9,4
2021,Bristol 050C,E01014517,510,209,94,115,3,3,236,219,17,61,52,9,1
2021,Bristol 046A,E01014518,775,511,217,294,0,0,78,66,12,185,167,18,1
2021,Bristol 046B,E01014519,558,377,175,202,2,2,108,90,18,66,55,11,5
2021,Bristol 046C,E01014520,688,585,329,256,2,2,34,23,11,64,51,13,3
2021,Bristol 046D,E01014521,530,388,191,197,9,9,67,56,11,65,56,9,1
2021,Bristol 050D,E01014522,747,393,162,231,1,1,253,187,66,98,85,13,2
2021,Bristol 038A,E01014523,684,504,230,274,1,1,69,43,26,110,97,13,0
2021,Bristol 038B,E01014524,624,494,229,265,2,2,48,47,1,80,66,14,0
2021,Bristol 038C,E01014525,678,514,218,296,0,0,23,21,2,141,127,14,0
2021,Bristol 038D,E01014526,660,336,178,158,3,3,235,232,3,81,70,11,5
2021,Bristol 038E,E01014527,654,361,172,189,3,3,150,135,15,139,128,11,1
2021,Bristol 035A,E01014528,718,513,189,324,2,2,38,13,25,165,153,12,0
2021,Bristol 035B,E01014529,604,311,100,211,4,4,211,202,9,76,64,12,2
2021,Bristol 035C,E01014530,676,404,161,243,8,8,56,51,5,207,193,14,1
2021,Bristol 035D,E01014531,963,649,206,443,2,2,25,13,12,287,273,14,0
2021,Bristol 035E,E01014532,630,440,159,281,3,3,77,11,66,110,102,8,0
2021,Bristol 043A,E01014533,663,453,219,234,20,20,28,6,22,161,146,15,1
2021,Bristol 043B,E01014534,680,481,215,266,1,1,30,7,23,168,152,16,0
2021,Bristol 043C,E01014535,744,610,297,313,1,1,40,19,21,92,82,10,1
2021,Bristol 043D,E01014536,738,425,207,218,1,1,238,229,9,71,58,13,3
2021,Bristol 035F,E01014537,762,424,179,245,18,18,163,31,132,157,142,15,0
2021,Bristol 060A,E01014538,606,139,66,73,1,1,27,8,19,439,418,21,0
2021,Bristol 025A,E01014539,786,350,201,149,3,3,67,36,31,365,346,19,1
2021,Bristol 030A,E01014544,545,319,208,111,0,0,7,3,4,219,197,22,0
2021,Bristol 030B,E01014545,772,323,195,128,1,1,68,18,50,380,357,23,0
2021,Bristol 030C,E01014546,745,254,154,100,6,6,12,5,7,473,450,23,0
2021,Bristol 030D,E01014547,814,391,229,162,1,1,21,14,7,401,379,22,0
2021,Bristol 034A,E01014548,783,314,170,144,3,3,91,69,22,370,358,12,5
2021,Bristol 034B,E01014549,532,200,95,105,3,3,153,124,29,174,161,13,2
2021,Bristol 034C,E01014550,866,494,284,210,21,21,39,5,34,312,295,17,0
2021,Bristol 026A,E01014551,823,219,95,124,3,3,35,12,23,566,539,27,0
2021,Bristol 026B,E01014552,767,276,140,136,3,3,41,8,33,447,428,19,0
2021,Bristol 026C,E01014553,764,289,141,148,4,4,11,4,7,460,443,17,0
2021,Bristol 026D,E01014554,794,313,126,187,0,0,38,9,29,443,424,19,0
2021,Bristol 034D,E01014555,665,183,76,107,2,2,114,8,106,366,357,9,0
2021,Bristol 026E,E01014556,836,427,231,196,2,2,23,14,9,384,358,26,0
2021,Bristol 022A,E01014557,611,319,153,166,3,3,35,8,27,254,244,10,0
2021,Bristol 022B,E01014558,748,194,82,112,3,3,55,13,42,496,485,11,0
2021,Bristol 022C,E01014559,791,408,220,188,6,6,38,16,22,339,326,13,0
2021,Bristol 022D,E01014560,740,291,149,142,0,0,42,8,34,406,392,14,1
2021,Bristol 025C,E01014561,760,348,154,194,2,2,45,12,33,364,350,14,1
2021,Bristol 022E,E01014562,605,240,101,139,3,3,15,4,11,347,334,13,0
2021,Bristol 025D,E01014563,807,291,106,185,3,3,57,27,30,455,426,29,1
2021,Bristol 055A,E01014564,722,431,196,235,2,2,102,52,50,186,169,17,1
2021,Bristol 029A,E01014565,810,396,138,258,7,7,151,108,43,252,233,19,4
2021,Bristol 029B,E01014566,819,435,151,284,5,5,57,33,24,321,304,17,1
2021,Bristol 029C,E01014567,877,479,177,302,5,5,56,24,32,337,318,19,0
2021,Bristol 057A,E01014568,1029,446,178,268,8,8,194,82,112,380,347,33,1
2021,Bristol 057B,E01014569,862,501,240,261,3,3,93,20,73,263,239,24,2
2021,Bristol 057C,E01014570,783,535,194,341,1,1,53,27,26,194,175,19,0
2021,Bristol 012A,E01014571,643,336,190,146,1,1,195,77,118,110,92,18,1
2021,Bristol 019A,E01014572,850,411,159,252,8,8,46,14,32,379,354,25,6
2021,Bristol 019B,E01014573,839,522,254,268,7,7,25,13,12,283,258,25,2
2021,Bristol 057D,E01014574,982,379,149,230,15,15,183,107,76,399,373,26,6
2021,Bristol 019C,E01014575,659,334,158,176,2,2,119,29,90,202,183,19,2
2021,Bristol 019D,E01014576,904,627,274,353,8,8,106,75,31,162,147,15,1
2021,Bristol 012B,E01014577,654,478,269,209,4,4,6,3,3,166,149,17,0
2021,Bristol 044A,E01014578,661,391,172,219,21,21,166,145,21,82,77,5,1
2021,Bristol 045A,E01014579,606,375,159,216,0,0,95,76,19,134,122,12,2
2021,Bristol 045B,E01014580,665,236,116,120,0,0,340,318,22,82,72,10,7
2021,Bristol 045C,E01014581,628,233,94,139,1,1,318,240,78,68,57,11,8
2021,Bristol 045D,E01014582,501,261,110,151,6,6,175,170,5,53,45,8,6
2021,Bristol 044B,E01014583,653,332,110,222,25,25,231,228,3,61,57,4,4
2021,Bristol 045E,E01014584,517,253,99,154,2,2,215,190,25,42,37,5,5
2021,Bristol 044C,E01014585,699,171,70,101,26,26,418,326,92,79,69,10,5
2021,Bristol 012C,E01014586,702,472,290,182,1,1,125,121,4,100,89,11,4
2021,Bristol 012D,E01014587,613,328,159,169,2,2,159,151,8,121,110,11,3
2021,Bristol 013A,E01014588,942,537,255,282,15,15,134,19,115,256,239,17,0
2021,Bristol 013B,E01014589,640,191,71,120,5,5,375,333,42,62,51,11,7
2021,Bristol 013C,E01014590,920,516,230,286,16,16,136,63,73,251,228,23,1
2021,Bristol 013D,E01014591,804,617,346,271,2,2,35,31,4,149,124,25,1
2021,Bristol 013E,E01014592,709,401,181,220,10,10,105,40,65,192,171,21,1
2021,Bristol 051A,E01014593,546,195,91,104,1,1,306,234,72,41,38,3,3
2021,Bristol 048A,E01014594,636,214,103,111,1,1,357,305,52,60,52,8,4
2021,Bristol 051B,E01014595,621,304,154,150,9,9,247,167,80,60,50,10,1
2021,Bristol 051C,E01014596,614,295,132,163,7,7,243,206,37,68,51,17,1
2021,Bristol 051D,E01014597,598,281,144,137,4,4,252,194,58,61,49,12,0
2021,Bristol 048B,E01014598,1066,665,345,320,83,83,38,4,34,279,260,19,1
2021,Bristol 048C,E01014599,527,436,203,233,0,0,13,12,1,78,66,12,0
2021,Bristol 048D,E01014600,646,380,177,203,17,17,157,70,87,91,73,18,1
2021,Bristol 001A,E01014601,746,474,232,242,5,5,187,151,36,77,65,12,3
2021,Bristol 001B,E01014602,827,353,163,190,6,6,373,343,30,95,85,10,0
2021,Bristol 001C,E01014603,1068,604,260,344,27,27,195,146,49,242,216,26,0
2021,Bristol 001E,E01014605,835,237,101,136,1,1,473,425,48,120,109,11,4
2021,Bristol 047A,E01014607,678,487,248,239,31,31,62,8,54,98,81,17,0
2021,Bristol 047B,E01014608,738,380,159,221,4,4,254,155,99,96,82,14,4
2021,Bristol 047C,E01014609,721,438,190,248,4,4,179,144,35,94,81,13,6
2021,Bristol 047D,E01014610,735,288,122,166,12,12,281,124,157,147,141,6,7
2021,Bristol 052A,E01014611,573,501,314,187,0,0,24,15,9,47,40,7,1
2021,Bristol 052B,E01014612,631,481,286,195,2,2,69,54,15,78,66,12,1
2021,Bristol 047E,E01014613,664,483,252,231,15,15,48,40,8,116,107,9,2
2021,Bristol 047F,E01014614,539,462,252,210,5,5,25,16,9,47,36,11,0
2021,Bristol 011A,E01014615,603,542,322,220,2,2,11,7,4,48,37,11,0
2021,Bristol 006A,E01014616,685,494,309,185,6,6,56,41,15,128,104,24,1
2021,Bristol 011B,E01014617,525,475,265,210,2,2,7,4,3,41,38,3,0
2021,Bristol 011C,E01014618,670,612,371,241,0,0,5,5,0,53,43,10,0
2021,Bristol 017A,E01014619,584,428,237,191,0,0,12,4,8,144,136,8,0
2021,Bristol 011D,E01014620,648,567,332,235,0,0,19,10,9,62,52,10,0
2021,Bristol 017B,E01014621,594,390,175,215,1,1,71,37,34,131,121,10,1
2021,Bristol 021A,E01014622,657,422,190,232,2,2,53,27,26,180,159,21,0
2021,Bristol 021B,E01014623,674,436,181,255,7,7,92,54,38,138,123,15,1
2021,Bristol 018A,E01014624,652,408,177,231,2,2,146,126,20,95,78,17,1
2021,Bristol 021C,E01014626,1110,579,207,372,16,16,263,147,116,251,227,24,1
2021,Bristol 021D,E01014627,930,577,258,319,24,24,59,30,29,270,245,25,0
2021,Bristol 018D,E01014629,552,308,128,180,1,1,155,152,3,83,70,13,5
2021,Bristol 005A,E01014630,873,218,97,121,21,21,399,134,265,235,222,13,0
2021,Bristol 004A,E01014631,531,308,166,142,2,2,108,67,41,109,96,13,4
2021,Bristol 004B,E01014632,871,447,204,243,5,5,135,101,34,282,262,20,2
2021,Bristol 004C,E01014633,734,490,233,257,2,2,78,73,5,163,151,12,1
2021,Bristol 005B,E01014634,718,382,179,203,1,1,19,12,7,315,309,6,1
2021,Bristol 010B,E01014635,781,480,238,242,14,14,41,27,14,246,235,11,0
2021,Bristol 004D,E01014636,635,285,150,135,3,3,262,252,10,84,75,9,1
2021,Bristol 010C,E01014637,568,355,170,185,3,3,17,7,10,193,183,10,0
2021,Bristol 003C,E01014638,791,245,128,117,4,4,435,308,127,101,88,13,6
2021,Bristol 003D,E01014639,615,146,76,70,2,2,415,348,67,44,34,10,8
2021,Bristol 003E,E01014640,607,315,138,177,1,1,225,201,24,62,53,9,4
2021,Bristol 007A,E01014641,641,476,250,226,2,2,107,106,1,53,44,9,3
2021,Bristol 007B,E01014642,632,435,220,215,0,0,126,101,25,69,53,16,2
2021,Bristol 007C,E01014643,580,285,154,131,4,4,253,214,39,36,31,5,2
2021,Bristol 007D,E01014644,640,397,186,211,5,5,180,175,5,52,43,9,6
2021,Bristol 042A,E01014645,719,436,234,202,2,2,138,54,84,142,124,18,1
2021,Bristol 042B,E01014646,669,445,223,222,26,26,100,81,19,98,87,11,0
2021,Bristol 044D,E01014647,634,308,136,172,4,4,256,251,5,65,59,6,1
2021,Bristol 042C,E01014648,653,476,202,274,3,3,35,8,27,139,129,10,0
2021,Bristol 042D,E01014649,692,545,257,288,1,1,28,13,15,118,105,13,0
2021,Bristol 044E,E01014650,641,458,206,252,11,11,97,86,11,74,67,7,1
2021,Bristol 042E,E01014651,713,558,233,325,0,0,20,7,13,135,122,13,0
2021,Bristol 055B,E01014653,1065,202,96,106,13,13,602,488,114,231,211,20,17
2021,Bristol 056A,E01014654,937,250,117,133,20,20,376,281,95,286,261,25,5
2021,Bristol 055C,E01014655,1096,344,150,194,4,4,259,80,179,484,443,41,5
2021,Bristol 056B,E01014658,850,105,49,56,0,0,675,492,183,63,57,6,7
2021,Bristol 005C,E01014659,867,244,97,147,21,21,353,147,206,246,232,14,3
2021,Bristol 014A,E01014660,865,391,150,241,16,16,314,204,110,139,123,16,5
2021,Bristol 005D,E01014661,605,326,151,175,3,3,161,158,3,112,102,10,3
2021,Bristol 010D,E01014662,622,371,148,223,1,1,89,83,6,158,141,17,3
2021,Bristol 014B,E01014663,605,277,130,147,4,4,236,223,13,85,81,4,3
2021,Bristol 014C,E01014664,646,372,163,209,0,0,145,135,10,124,113,11,5
2021,Bristol 014D,E01014665,782,572,275,297,1,1,24,7,17,185,168,17,0
2021,Bristol 017C,E01014666,670,539,252,287,2,2,38,8,30,91,83,8,0
2021,Bristol 017D,E01014667,635,450,203,247,1,1,5,2,3,179,170,9,0
2021,Bristol 020C,E01014668,620,418,196,222,1,1,12,9,3,189,178,11,0
2021,Bristol 020D,E01014669,666,353,162,191,5,5,16,7,9,292,279,13,0
2021,Bristol 020E,E01014670,587,332,155,177,1,1,14,3,11,239,228,11,1
2021,Bristol 020F,E01014671,697,334,142,192,2,2,65,9,56,295,286,9,1
2021,Bristol 017E,E01014672,960,490,272,218,1,1,56,13,43,413,386,27,0
2021,Bristol 027A,E01014673,841,480,194,286,0,0,75,24,51,286,264,22,0
2021,Bristol 027B,E01014674,683,424,194,230,6,6,95,80,15,158,142,16,0
2021,Bristol 027C,E01014675,756,499,221,278,1,1,46,34,12,210,189,21,0
2021,Bristol 027D,E01014676,673,428,200,228,8,8,146,68,78,88,72,16,3
2021,Bristol 033A,E01014677,720,494,200,294,3,3,35,13,22,188,177,11,0
2021,Bristol 033B,E01014678,723,495,241,254,2,2,45,21,24,181,167,14,0
2021,Bristol 033C,E01014679,678,502,252,250,3,3,34,17,17,138,121,17,1
2021,Bristol 033D,E01014680,536,468,226,242,2,2,5,3,2,61,48,13,0
2021,Bristol 029D,E01014681,1194,621,217,404,6,6,170,87,83,395,355,40,2
2021,Bristol 028A,E01014682,732,480,202,278,3,3,49,14,35,198,181,17,2
2021,Bristol 028B,E01014683,909,392,148,244,2,2,236,102,134,277,260,17,2
2021,Bristol 029E,E01014684,949,495,134,361,2,2,39,14,25,413,387,26,0
2021,Bristol 028C,E01014685,634,354,124,230,6,6,165,151,14,106,98,8,3
2021,Bristol 028D,E01014686,774,501,213,288,5,5,111,95,16,155,133,22,2
2021,Bristol 028E,E01014687,725,453,178,275,1,1,92,83,9,175,159,16,4
2021,Bristol 002A,E01014688,655,247,112,135,4,4,247,229,18,150,140,10,7
2021,Bristol 002B,E01014689,606,144,61,83,2,2,386,339,47,70,64,6,4
2021,Bristol 002C,E01014690,786,374,134,240,10,10,257,194,63,143,133,10,2
2021,Bristol 002D,E01014691,835,454,252,202,12,12,259,211,48,107,95,12,3
2021,Bristol 002E,E01014692,623,267,110,157,6,6,193,154,39,155,141,14,2
2021,Bristol 002F,E01014693,644,509,277,232,6,6,8,8,0,118,98,20,3
2021,Bristol 002G,E01014694,662,357,174,183,0,0,191,184,7,106,94,12,8
2021,Bristol 036A,E01014695,975,399,157,242,7,7,329,264,65,239,224,15,1
2021,Bristol 036B,E01014696,730,509,189,320,4,4,16,3,13,200,188,12,1
2021,Bristol 036C,E01014698,871,515,199,316,5,5,53,16,37,297,276,21,1
2021,Bristol 036D,E01014699,772,319,125,194,8,8,181,130,51,262,249,13,2
2021,Bristol 036E,E01014700,658,500,247,253,2,2,6,4,2,150,131,19,0
2021,Bristol 036F,E01014701,737,418,156,262,1,1,52,23,29,266,250,16,0
2021,Bristol 049A,E01014702,606,528,280,248,0,0,34,23,11,44,35,9,0
2021,Bristol 049B,E01014703,660,346,144,202,0,0,230,223,7,77,71,6,7
2021,Bristol 049C,E01014704,725,483,234,249,8,8,138,99,39,96,83,13,0
2021,Bristol 049D,E01014705,610,474,278,196,0,0,94,20,74,41,28,13,1
2021,Bristol 049E,E01014706,700,288,145,143,8,8,324,190,134,77,63,14,3
2021,Bristol 049F,E01014707,643,517,306,211,4,4,48,16,32,74,66,8,0
2021,Bristol 049G,E01014708,723,558,304,254,5,5,76,63,13,84,67,17,0
2021,Bristol 015A,E01014709,596,464,274,190,1,1,13,4,9,118,108,10,0
2021,Bristol 015B,E01014710,539,397,229,168,1,1,8,3,5,133,117,16,0
2021,Bristol 015C,E01014711,532,482,284,198,1,1,14,11,3,35,29,6,0
2021,Bristol 015D,E01014712,508,386,210,176,2,2,76,70,6,44,40,4,0
2021,Bristol 015E,E01014713,577,496,311,185,4,4,17,11,6,59,50,9,1
2021,Bristol 015F,E01014714,535,473,284,189,1,1,11,7,4,50,37,13,0
2021,Bristol 009A,E01014715,620,537,298,239,1,1,25,21,4,57,52,5,0
2021,Bristol 009B,E01014716,612,553,306,247,0,0,8,4,4,50,40,10,1
2021,Bristol 009C,E01014717,630,471,283,188,11,11,102,10,92,46,36,10,0
2021,Bristol 009D,E01014718,642,523,289,234,0,0,14,10,4,105,96,9,0
2021,Bristol 006B,E01014719,642,451,230,221,4,4,34,8,26,151,138,13,2
2021,Bristol 006C,E01014720,749,475,231,244,3,3,171,140,31,99,83,16,1
2021,Bristol 006D,E01014721,667,514,297,217,3,3,83,60,23,67,51,16,0
2021,Bristol 052C,E01014722,627,550,309,241,5,5,14,2,12,58,55,3,0
2021,Bristol 052D,E01014723,539,473,267,206,3,3,9,7,2,54,43,11,0
2021,Bristol 052E,E01014725,615,560,352,208,2,2,10,4,6,43,31,12,0
2021,Bristol 053B,E01014726,669,176,95,81,2,2,441,361,80,41,34,7,9
2021,Bristol 053C,E01014727,597,236,106,130,1,1,313,268,45,44,36,8,3
2021,Bristol 040A,E01014729,705,304,102,202,11,11,252,189,63,135,124,11,3
2021,Bristol 037A,E01014730,871,329,115,214,58,58,144,20,124,340,318,22,0
2021,Bristol 037B,E01014731,754,411,126,285,1,1,90,34,56,252,238,14,0
2021,Bristol 037C,E01014732,772,437,149,288,1,1,53,11,42,281,267,14,0
2021,Bristol 040B,E01014733,747,484,170,314,0,0,92,67,25,170,159,11,1
2021,Bristol 040C,E01014734,669,443,162,281,1,1,77,71,6,148,138,10,0
2021,Bristol 037D,E01014735,757,567,227,340,2,2,47,18,29,139,123,16,2
2021,Bristol 040D,E01014736,875,433,186,247,24,24,207,136,71,210,195,15,1
2021,North Somerset 011A,E01014737,603,560,333,227,1,1,3,1,2,39,32,7,0
2021,North Somerset 011B,E01014738,586,442,208,234,0,0,65,7,58,79,72,7,0
2021,North Somerset 011C,E01014739,640,518,308,210,4,4,41,8,33,77,64,13,0
2021,North Somerset 011D,E01014740,567,480,250,230,1,1,24,10,14,62,50,12,0
2021,North Somerset 024A,E01014741,681,503,331,172,4,4,57,13,44,117,102,15,0
2021,North Somerset 024B,E01014742,635,571,396,175,2,2,14,6,8,48,34,14,0
2021,North Somerset 023A,E01014744,672,588,397,191,1,1,10,1,9,73,63,10,0
2021,North Somerset 024C,E01014745,739,606,392,214,8,8,66,16,50,59,43,16,0
2021,North Somerset 023B,E01014746,662,473,262,211,4,4,102,32,70,83,74,9,0
2021,North Somerset 024D,E01014747,608,448,261,187,4,4,60,15,45,96,82,14,0
2021,North Somerset 024E,E01014748,548,370,188,182,15,15,66,10,56,96,81,15,1
2021,North Somerset 024F,E01014749,543,458,269,189,7,7,16,3,13,62,52,10,0
2021,North Somerset 007A,E01014750,801,507,274,233,3,3,108,8,100,183,168,15,0
2021,North Somerset 007B,E01014751,712,427,233,194,22,22,158,35,123,105,90,15,0
2021,North Somerset 005A,E01014752,670,565,301,264,1,1,8,1,7,96,78,18,0
2021,North Somerset 007C,E01014753,836,511,282,229,5,5,160,42,118,157,137,20,3
2021,North Somerset 005B,E01014754,720,463,309,154,5,5,19,1,18,233,212,21,0
2021,North Somerset 007D,E01014755,750,458,281,177,1,1,93,3,90,198,177,21,0
2021,North Somerset 010A,E01014756,767,520,300,220,7,7,52,5,47,188,175,13,0
2021,North Somerset 010B,E01014757,612,499,272,227,4,4,23,8,15,86,79,7,0
2021,North Somerset 005C,E01014758,507,448,286,162,0,0,7,1,6,52,46,6,0
2021,North Somerset 005D,E01014759,611,564,370,194,1,1,3,2,1,43,36,7,0
2021,North Somerset 007E,E01014760,618,510,301,209,5,5,59,19,40,44,41,3,0
2021,North Somerset 010C,E01014761,727,581,347,234,3,3,9,1,8,134,122,12,0
2021,North Somerset 010D,E01014762,626,541,303,238,1,1,5,2,3,79,69,10,0
2021,North Somerset 010E,E01014763,724,499,230,269,5,5,81,26,55,139,124,15,0
2021,North Somerset 014A,E01014764,777,577,331,246,4,4,133,27,106,63,56,7,0
2021,North Somerset 014B,E01014765,784,633,401,232,1,1,31,7,24,119,106,13,0
2021,North Somerset 004A,E01014766,584,491,286,205,0,0,9,2,7,84,69,15,0
2021,North Somerset 004B,E01014767,575,524,323,201,2,2,2,0,2,47,36,11,0
2021,North Somerset 023D,E01014770,632,566,394,172,1,1,11,3,8,54,44,10,0
2021,North Somerset 023E,E01014771,643,560,365,195,1,1,32,5,27,50,42,8,0
2021,North Somerset 023F,E01014772,672,568,376,192,3,3,20,7,13,81,68,13,0
2021,North Somerset 014C,E01014773,671,528,241,287,0,0,6,0,6,137,125,12,0
2021,North Somerset 014D,E01014774,864,683,445,238,2,2,41,13,28,137,112,25,1
2021,North Somerset 009A,E01014775,503,454,286,168,3,3,2,1,1,44,39,5,0
2021,North Somerset 009B,E01014776,502,460,269,191,0,0,2,1,1,40,33,7,0
2021,North Somerset 009C,E01014777,614,470,274,196,0,0,14,3,11,130,118,12,0
2021,North Somerset 009D,E01014778,536,520,360,160,2,2,3,1,2,11,9,2,0
2021,North Somerset 009E,E01014779,497,381,254,127,1,1,63,4,59,52,42,10,0
2021,North Somerset 008A,E01014780,774,511,289,222,4,4,98,32,66,160,143,17,1
2021,North Somerset 008B,E01014781,819,583,359,224,2,2,148,35,113,82,68,14,4
2021,North Somerset 008C,E01014782,598,542,346,196,2,2,5,1,4,49,38,11,0
2021,North Somerset 008D,E01014783,725,494,287,207,1,1,113,13,100,115,104,11,2
2021,North Somerset 008E,E01014784,725,611,405,206,5,5,20,6,14,89,73,16,0
2021,North Somerset 008F,E01014785,603,556,384,172,1,1,9,2,7,37,31,6,0
2021,North Somerset 004C,E01014786,748,401,203,198,3,3,236,84,152,105,84,21,3
2021,North Somerset 004D,E01014787,823,630,329,301,2,2,79,23,56,111,96,15,1
2021,North Somerset 002A,E01014789,616,535,353,182,0,0,4,1,3,77,68,9,0
2021,North Somerset 001B,E01014790,639,534,295,239,1,1,52,5,47,52,42,10,0
2021,North Somerset 003B,E01014792,872,686,467,219,2,2,73,19,54,111,86,25,0
2021,North Somerset 002B,E01014793,656,562,332,230,4,4,4,0,4,86,77,9,0
2021,North Somerset 002C,E01014794,755,656,403,253,6,6,59,6,53,34,26,8,0
2021,North Somerset 001C,E01014795,655,424,219,205,1,1,143,32,111,86,77,9,1
2021,North Somerset 003C,E01014796,788,684,429,255,2,2,23,9,14,79,70,9,0
2021,North Somerset 001D,E01014797,785,545,293,252,9,9,138,36,102,91,82,9,2
2021,North Somerset 002D,E01014798,588,538,306,232,2,2,11,2,9,37,29,8,0
2021,North Somerset 020A,E01014799,899,353,176,177,5,5,72,4,68,469,441,28,0
2021,North Somerset 020B,E01014800,931,285,150,135,2,2,109,15,94,535,515,20,0
2021,North Somerset 020C,E01014801,873,382,283,99,3,3,77,11,66,411,392,19,0
2021,North Somerset 020D,E01014802,812,334,183,151,0,0,68,12,56,410,385,25,0
2021,North Somerset 025A,E01014803,661,531,348,183,7,7,28,4,24,95,76,19,0
2021,North Somerset 022A,E01014804,639,428,283,145,1,1,84,4,80,126,110,16,0
2021,North Somerset 025B,E01014805,721,675,456,219,1,1,10,0,10,35,28,7,0
2021,North Somerset 022B,E01014806,784,408,242,166,3,3,39,1,38,334,305,29,0
2021,North Somerset 022C,E01014807,785,414,222,192,2,2,40,4,36,329,307,22,0
2021,North Somerset 022D,E01014808,589,480,246,234,1,1,15,3,12,93,79,14,0
2021,North Somerset 020E,E01014809,876,524,214,310,20,20,77,6,71,255,233,22,0
2021,North Somerset 020F,E01014811,795,458,228,230,1,1,175,62,113,161,147,14,0
2021,North Somerset 017A,E01014812,684,562,358,204,7,7,27,5,22,88,74,14,0
2021,North Somerset 017B,E01014813,745,577,296,281,2,2,39,10,29,127,109,18,0
2021,North Somerset 017C,E01014815,597,364,191,173,5,5,127,38,89,101,93,8,0
2021,North Somerset 017D,E01014816,639,568,335,233,0,0,6,2,4,65,57,8,0
2021,North Somerset 016A,E01014817,716,588,353,235,5,5,21,3,18,102,87,15,0
2021,North Somerset 017E,E01014818,754,688,407,281,1,1,2,0,2,63,52,11,0
2021,North Somerset 017F,E01014819,729,632,414,218,2,2,11,7,4,83,75,8,1
2021,North Somerset 016B,E01014820,725,487,320,167,3,3,138,20,118,97,81,16,0
2021,North Somerset 015A,E01014821,491,354,152,202,2,2,4,0,4,131,120,11,0
2021,North Somerset 015B,E01014822,534,484,238,246,4,4,0,0,0,46,36,10,0
2021,North Somerset 015C,E01014823,492,432,212,220,3,3,4,0,4,53,43,10,0
2021,North Somerset 015D,E01014824,637,500,261,239,3,3,49,3,46,85,68,17,0
2021,North Somerset 015E,E01014825,485,418,242,176,2,2,4,1,3,61,50,11,0
2021,North Somerset 015F,E01014826,630,450,182,268,4,4,7,1,6,169,161,8,0
2021,North Somerset 015G,E01014827,591,338,147,191,3,3,112,38,74,138,123,15,0
2021,North Somerset 025C,E01014828,602,297,157,140,0,0,171,53,118,132,122,10,2
2021,North Somerset 021A,E01014829,887,270,132,138,16,16,398,88,310,199,182,17,4
2021,North Somerset 021B,E01014830,664,399,186,213,4,4,45,2,43,215,195,20,1
2021,North Somerset 021C,E01014831,601,130,54,76,1,1,420,157,263,45,38,7,5
2021,North Somerset 021D,E01014832,652,205,99,106,1,1,388,150,238,56,47,9,2
2021,North Somerset 021E,E01014833,654,199,98,101,0,0,374,138,236,71,64,7,10
2021,North Somerset 025D,E01014834,612,306,149,157,2,2,194,84,110,110,94,16,0
2021,North Somerset 016C,E01014835,697,384,232,152,22,22,176,47,129,115,91,24,0
2021,North Somerset 016D,E01014836,655,470,307,163,2,2,43,10,33,140,125,15,0
2021,North Somerset 016E,E01014838,602,504,302,202,6,6,16,1,15,76,66,10,0
2021,North Somerset 026A,E01014839,648,450,196,254,5,5,46,11,35,147,136,11,0
2021,North Somerset 016F,E01014840,610,460,299,161,5,5,44,2,42,101,82,19,0
2021,North Somerset 018A,E01014841,1032,490,287,203,3,3,28,4,24,510,481,29,1
2021,North Somerset 018B,E01014842,872,427,262,165,0,0,14,3,11,431,401,30,0
2021,North Somerset 018C,E01014843,650,434,253,181,0,0,25,8,17,191,170,21,0
2021,North Somerset 018D,E01014844,854,287,164,123,0,0,88,13,75,479,438,41,0
2021,North Somerset 018E,E01014845,596,493,306,187,9,9,27,4,23,67,56,11,0
2021,North Somerset 018F,E01014846,658,475,276,199,1,1,27,9,18,155,142,13,0
2021,North Somerset 013A,E01014847,704,612,312,300,6,6,19,1,18,67,54,13,0
2021,North Somerset 013B,E01014848,560,463,276,187,1,1,40,7,33,56,42,14,0
2021,North Somerset 006B,E01014849,787,718,466,252,0,0,15,3,12,53,45,8,1
2021,North Somerset 006C,E01014850,853,706,359,347,5,5,65,13,52,76,59,17,1
2021,North Somerset 006D,E01014851,1093,816,376,440,11,11,120,22,98,146,116,30,0
2021,North Somerset 006E,E01014852,629,518,285,233,4,4,50,10,40,57,42,15,0
2021,North Somerset 013C,E01014853,759,564,313,251,3,3,62,14,48,130,116,14,0
2021,North Somerset 013D,E01014854,583,493,292,201,6,6,1,1,0,82,66,16,1
2021,North Somerset 012A,E01014855,603,534,312,222,1,1,4,1,3,64,55,9,0
2021,North Somerset 012B,E01014856,885,668,300,368,21,21,137,29,108,59,51,8,0
2021,North Somerset 012C,E01014857,622,494,293,201,5,5,65,8,57,58,50,8,0
2021,North Somerset 012D,E01014858,733,560,294,266,14,14,13,4,9,146,127,19,0
2021,North Somerset 012E,E01014859,662,557,321,236,1,1,38,3,35,66,59,7,0
2021,North Somerset 012F,E01014860,637,472,253,219,4,4,112,31,81,49,44,5,0
2021,South Gloucestershire 005A,E01014861,958,715,363,352,18,18,117,30,87,108,86,22,0
2021,South Gloucestershire 005B,E01014862,1111,887,461,426,18,18,92,9,83,114,103,11,0
2021,South Gloucestershire 004A,E01014863,661,524,335,189,0,0,89,19,70,48,34,14,0
2021,South Gloucestershire 004B,E01014864,658,568,391,177,1,1,13,2,11,76,60,16,0
2021,South Gloucestershire 024A,E01014865,891,626,305,321,6,6,148,18,130,111,91,20,0
2021,South Gloucestershire 032A,E01014866,643,560,319,241,1,1,30,3,27,51,45,6,1
2021,South Gloucestershire 019A,E01014867,542,405,262,143,1,1,96,14,82,40,28,12,0
2021,South Gloucestershire 024B,E01014869,684,521,318,203,3,3,53,8,45,107,81,26,0
2021,South Gloucestershire 024C,E01014870,647,518,324,194,1,1,44,7,37,84,65,19,0
2021,South Gloucestershire 024D,E01014871,521,418,251,167,0,0,64,13,51,39,32,7,0
2021,South Gloucestershire 009A,E01014872,683,364,129,235,2,2,13,0,13,304,291,13,0
2021,South Gloucestershire 012A,E01014873,555,477,230,247,0,0,6,2,4,72,69,3,0
2021,South Gloucestershire 009B,E01014874,598,413,158,255,1,1,3,0,3,181,168,13,0
2021,South Gloucestershire 012B,E01014875,781,369,133,236,1,1,10,1,9,400,376,24,1
2021,South Gloucestershire 009C,E01014876,736,393,128,265,3,3,11,2,9,329,317,12,0
2021,South Gloucestershire 009D,E01014877,596,428,160,268,3,3,4,2,2,161,148,13,0
2021,South Gloucestershire 012C,E01014878,851,565,209,356,0,0,7,0,7,279,257,22,0
2021,South Gloucestershire 009E,E01014879,754,592,369,223,1,1,4,0,4,157,149,8,0
2021,South Gloucestershire 012D,E01014880,773,494,181,313,4,4,69,3,66,206,197,9,0
2021,South Gloucestershire 009F,E01014881,708,508,145,363,1,1,10,0,10,189,181,8,0
2021,South Gloucestershire 012E,E01014882,850,354,120,234,4,4,230,7,223,262,242,20,0
2021,South Gloucestershire 012F,E01014883,536,377,180,197,5,5,19,2,17,135,131,4,0
2021,South Gloucestershire 003A,E01014884,616,429,215,214,12,12,75,15,60,100,87,13,0
2021,South Gloucestershire 003B,E01014885,916,774,373,401,13,13,66,5,61,63,51,12,0
2021,South Gloucestershire 008A,E01014886,827,511,320,191,2,2,191,53,138,123,110,13,0
2021,South Gloucestershire 008B,E01014887,611,535,354,181,2,2,10,0,10,64,57,7,0
2021,South Gloucestershire 008C,E01014888,855,710,449,261,23,23,49,7,42,73,61,12,0
2021,South Gloucestershire 008D,E01014889,587,527,275,252,1,1,7,1,6,52,44,8,0
2021,South Gloucestershire 024E,E01014890,857,671,407,264,3,3,68,13,55,115,87,28,0
2021,South Gloucestershire 024F,E01014891,696,444,289,155,0,0,41,10,31,211,164,47,0
2021,South Gloucestershire 014A,E01014892,747,473,190,283,6,6,92,19,73,175,160,15,1
2021,South Gloucestershire 014B,E01014893,621,495,232,263,1,1,15,1,14,110,93,17,0
2021,South Gloucestershire 014C,E01014894,487,422,223,199,1,1,1,0,1,63,55,8,0
2021,South Gloucestershire 014D,E01014895,530,430,181,249,1,1,6,1,5,93,84,9,0
2021,South Gloucestershire 014E,E01014896,476,390,150,240,0,0,7,1,6,79,73,6,0
2021,South Gloucestershire 022A,E01014897,604,547,308,239,3,3,6,1,5,48,43,5,0
2021,South Gloucestershire 022B,E01014898,751,609,322,287,4,4,53,8,45,85,71,14,0
2021,South Gloucestershire 022C,E01014899,761,556,301,255,1,1,78,11,67,126,107,19,0
2021,South Gloucestershire 022D,E01014900,636,469,240,229,2,2,69,16,53,95,86,9,1
2021,South Gloucestershire 020A,E01014901,655,591,295,296,1,1,13,1,12,50,43,7,0
2021,South Gloucestershire 020B,E01014902,532,504,284,220,1,1,2,0,2,25,19,6,0
2021,South Gloucestershire 020C,E01014903,642,567,332,235,0,0,32,9,23,43,37,6,0
2021,South Gloucestershire 018A,E01014904,643,380,249,131,10,10,109,19,90,144,134,10,0
2021,South Gloucestershire 018B,E01014905,670,483,235,248,4,4,11,1,10,172,163,9,0
2021,South Gloucestershire 018C,E01014906,793,330,194,136,22,22,307,38,269,133,120,13,1
2021,South Gloucestershire 018D,E01014907,663,372,210,162,3,3,44,8,36,242,226,16,2
2021,South Gloucestershire 018E,E01014908,565,457,242,215,2,2,3,0,3,103,90,13,0
2021,South Gloucestershire 018F,E01014909,597,328,168,160,3,3,12,0,12,254,244,10,0
2021,South Gloucestershire 018G,E01014910,657,365,152,213,5,5,128,30,98,158,148,10,1
2021,South Gloucestershire 013A,E01014911,575,515,324,191,1,1,17,4,13,42,33,9,0
2021,South Gloucestershire 013B,E01014912,740,656,372,284,5,5,7,0,7,72,66,6,0
2021,South Gloucestershire 013C,E01014913,659,608,349,259,1,1,12,3,9,38,33,5,0
2021,South Gloucestershire 013D,E01014914,848,506,206,300,18,18,273,46,227,51,43,8,0
2021,South Gloucestershire 028A,E01014915,699,486,253,233,3,3,98,23,75,111,95,16,1
2021,South Gloucestershire 031A,E01014916,696,473,217,256,2,2,92,16,76,126,110,16,3
2021,South Gloucestershire 031B,E01014917,683,524,265,259,7,7,82,15,67,69,60,9,1
2021,South Gloucestershire 031C,E01014918,654,562,348,214,1,1,20,5,15,71,53,18,0
2021,South Gloucestershire 031D,E01014919,540,481,291,190,2,2,15,1,14,42,38,4,0
2021,South Gloucestershire 031E,E01014920,568,472,284,188,3,3,53,12,41,40,30,10,0
2021,South Gloucestershire 031F,E01014921,700,547,305,242,14,14,82,4,78,57,53,4,0
2021,South Gloucestershire 026A,E01014922,552,462,229,233,1,1,11,3,8,78,71,7,0
2021,South Gloucestershire 026B,E01014923,626,428,210,218,0,0,108,24,84,90,78,12,0
2021,South Gloucestershire 026C,E01014924,809,473,200,273,7,7,50,9,41,277,255,22,2
2021,South Gloucestershire 027A,E01014925,619,475,245,230,2,2,80,11,69,62,55,7,0
2021,South Gloucestershire 027B,E01014926,686,313,169,144,2,2,299,44,255,72,63,9,0
2021,South Gloucestershire 027C,E01014927,893,514,216,298,6,6,169,31,138,201,184,17,3
2021,South Gloucestershire 027D,E01014928,624,384,212,172,1,1,175,40,135,64,52,12,0
2021,South Gloucestershire 003C,E01014929,917,730,384,346,6,6,67,13,54,114,80,34,0
2021,South Gloucestershire 003D,E01014930,813,636,315,321,10,10,104,16,88,63,45,18,0
2021,South Gloucestershire 032B,E01014931,717,587,349,238,15,15,34,5,29,81,69,12,0
2021,South Gloucestershire 032C,E01014932,734,631,394,237,1,1,24,2,22,78,68,10,0
2021,South Gloucestershire 032D,E01014933,610,511,287,224,0,0,10,0,10,89,82,7,0
2021,South Gloucestershire 032E,E01014934,513,480,292,188,2,2,1,0,1,30,15,15,0
2021,South Gloucestershire 032F,E01014935,644,536,282,254,8,8,11,3,8,89,76,13,0
2021,South Gloucestershire 030A,E01014936,559,417,219,198,0,0,79,9,70,63,57,6,0
2021,South Gloucestershire 032G,E01014937,545,501,306,195,3,3,5,1,4,36,29,7,0
2021,South Gloucestershire 030B,E01014938,652,499,246,253,3,3,73,8,65,77,66,11,0
2021,South Gloucestershire 030C,E01014939,500,350,152,198,1,1,59,5,54,90,79,11,0
2021,South Gloucestershire 030D,E01014940,514,447,226,221,3,3,23,2,21,41,35,6,0
2021,South Gloucestershire 030E,E01014941,651,322,151,171,3,3,272,66,206,51,44,7,3
2021,South Gloucestershire 030F,E01014942,642,395,200,195,1,1,187,45,142,57,52,5,2
2021,South Gloucestershire 029A,E01014943,795,548,214,334,2,2,44,1,43,201,182,19,0
2021,South Gloucestershire 029B,E01014944,698,581,273,308,6,6,9,0,9,102,92,10,0
2021,South Gloucestershire 030G,E01014945,698,530,282,248,1,1,89,11,78,78,63,15,0
2021,South Gloucestershire 033C,E01014946,622,411,176,235,0,0,126,31,95,83,71,12,2
2021,South Gloucestershire 033B,E01014947,625,543,350,193,2,2,23,8,15,56,47,9,1
2021,South Gloucestershire 033A,E01014948,782,313,143,170,0,0,367,85,282,102,93,9,0
2021,South Gloucestershire 033D,E01014950,630,467,192,275,3,3,19,5,14,141,127,14,0
2021,South Gloucestershire 034B,E01014951,603,342,148,194,6,6,155,21,134,100,92,8,0
2021,South Gloucestershire 005C,E01014953,810,673,346,327,1,1,19,2,17,117,101,16,0
2021,South Gloucestershire 005D,E01014954,688,526,293,233,0,0,49,11,38,111,102,9,2
2021,South Gloucestershire 025A,E01014955,566,503,289,214,4,4,12,1,11,47,40,7,0
2021,South Gloucestershire 025B,E01014956,641,550,309,241,1,1,30,5,25,60,49,11,0
2021,South Gloucestershire 025C,E01014957,498,446,256,190,1,1,7,2,5,44,38,6,0
2021,South Gloucestershire 027E,E01014958,495,288,140,148,3,3,142,25,117,62,57,5,0
2021,South Gloucestershire 023A,E01014959,543,410,197,213,1,1,74,17,57,58,50,8,0
2021,South Gloucestershire 023B,E01014960,701,472,211,261,2,2,134,34,100,92,78,14,1
2021,South Gloucestershire 023C,E01014961,644,386,197,189,3,3,202,34,168,53,45,8,0
2021,South Gloucestershire 004C,E01014962,685,556,344,212,0,0,8,1,7,120,107,13,1
2021,South Gloucestershire 004D,E01014963,782,672,412,260,2,2,27,2,25,81,65,16,0
2021,South Gloucestershire 021A,E01014964,674,589,306,283,1,1,12,0,12,72,67,5,0
2021,South Gloucestershire 020D,E01014965,615,548,308,240,0,0,29,8,21,38,28,10,0
2021,South Gloucestershire 021C,E01014967,815,645,297,348,1,1,18,0,18,151,125,26,0
2021,South Gloucestershire 023D,E01014968,782,399,193,206,4,4,296,37,259,82,65,17,1
2021,South Gloucestershire 021D,E01014969,637,545,284,261,1,1,7,1,6,84,71,13,0
2021,South Gloucestershire 029C,E01014972,711,576,330,246,3,3,61,7,54,71,58,13,0
2021,South Gloucestershire 026D,E01014973,652,411,215,196,8,8,162,31,131,71,59,12,0
2021,South Gloucestershire 025D,E01014974,762,589,332,257,7,7,65,14,51,101,86,15,0
2021,South Gloucestershire 026E,E01014975,785,506,230,276,3,3,49,6,43,227,207,20,0
2021,South Gloucestershire 026F,E01014976,816,444,208,236,21,21,158,25,133,192,167,25,1
2021,South Gloucestershire 025E,E01014977,715,204,97,107,3,3,306,53,253,202,182,20,0
2021,South Gloucestershire 036A,E01014978,580,469,204,265,1,1,33,11,22,77,69,8,0
2021,South Gloucestershire 015A,E01014979,656,527,291,236,5,5,3,0,3,121,117,4,0
2021,South Gloucestershire 015B,E01014980,638,554,321,233,1,1,9,0,9,73,60,13,1
2021,South Gloucestershire 015C,E01014982,627,482,239,243,2,2,53,12,41,90,80,10,0
2021,South Gloucestershire 015D,E01014983,642,367,178,189,5,5,186,45,141,83,75,8,1
2021,South Gloucestershire 015E,E01014984,614,425,204,221,9,9,92,11,81,88,75,13,0
2021,South Gloucestershire 001A,E01014985,634,515,339,176,3,3,6,1,5,110,102,8,0
2021,South Gloucestershire 001B,E01014986,716,490,324,166,0,0,158,43,115,67,54,13,1
2021,South Gloucestershire 001C,E01014987,954,784,319,465,20,20,61,15,46,89,71,18,0
2021,South Gloucestershire 001D,E01014988,688,569,305,264,15,15,50,4,46,54,46,8,0
2021,South Gloucestershire 001E,E01014989,769,586,266,320,14,14,78,14,64,91,78,13,0
2021,South Gloucestershire 002A,E01014990,643,587,380,207,0,0,5,0,5,51,46,5,0
2021,South Gloucestershire 002B,E01014991,1027,526,295,231,3,3,333,78,255,165,143,22,0
2021,South Gloucestershire 002C,E01014992,581,510,281,229,2,2,14,1,13,55,52,3,0
2021,South Gloucestershire 002D,E01014993,658,547,320,227,9,9,30,0,30,72,63,9,0
2021,South Gloucestershire 019D,E01014994,802,639,396,243,9,9,72,14,58,81,61,20,1
2021,South Gloucestershire 019E,E01014995,699,636,399,237,2,2,5,2,3,54,43,11,2
2021,South Gloucestershire 036D,E01014996,739,591,354,237,3,3,14,0,14,131,116,15,0
2021,South Gloucestershire 016A,E01014998,642,481,282,199,1,1,103,25,78,57,45,12,0
2021,South Gloucestershire 016B,E01014999,655,603,369,234,0,0,5,0,5,47,34,13,0
2021,South Gloucestershire 016C,E01015000,665,454,260,194,0,0,111,25,86,98,86,12,2
2021,South Gloucestershire 016D,E01015001,643,546,293,253,4,4,31,6,25,62,54,8,0
2021,South Gloucestershire 029D,E01015002,627,466,239,227,6,6,58,9,49,97,90,7,0
2021,South Gloucestershire 028B,E01015003,657,575,309,266,1,1,17,2,15,64,57,7,0
2021,South Gloucestershire 029E,E01015004,701,520,264,256,6,6,63,12,51,112,98,14,0
2021,South Gloucestershire 028C,E01015005,985,584,223,361,30,30,109,8,101,262,232,30,0
2021,South Gloucestershire 029F,E01015006,671,479,261,218,9,9,112,25,87,67,58,9,4
2021,South Gloucestershire 028D,E01015007,890,461,228,233,48,48,181,24,157,199,175,24,1
2021,South Gloucestershire 028E,E01015008,688,513,226,287,0,0,85,19,66,89,74,15,1
2021,South Gloucestershire 010A,E01015009,583,482,288,194,0,0,36,5,31,65,50,15,0
2021,South Gloucestershire 010B,E01015010,555,451,229,222,4,4,21,1,20,79,68,11,0
2021,South Gloucestershire 010C,E01015011,764,500,273,227,5,5,160,26,134,98,86,12,1
2021,South Gloucestershire 010D,E01015012,769,602,332,270,16,16,88,13,75,63,58,5,0
2021,South Gloucestershire 010E,E01015013,513,415,183,232,4,4,9,1,8,85,78,7,0
2021,South Gloucestershire 006A,E01015014,1194,913,330,583,45,45,176,11,165,60,50,10,0
2021,South Gloucestershire 006B,E01015015,640,463,200,263,7,7,18,3,15,152,142,10,0
2021,South Gloucestershire 006C,E01015016,450,440,274,166,0,0,2,0,2,8,7,1,0
2021,South Gloucestershire 006D,E01015017,585,442,273,169,0,0,58,13,45,85,73,12,0
2021,South Gloucestershire 006E,E01015018,570,429,218,211,11,11,81,3,78,49,43,6,0
2021,South Gloucestershire 007A,E01015019,733,469,199,270,4,4,124,33,91,136,120,16,0
2021,South Gloucestershire 007B,E01015020,644,395,181,214,2,2,119,27,92,128,111,17,0
2021,South Gloucestershire 007C,E01015021,644,548,292,256,0,0,21,2,19,75,69,6,0
2021,South Gloucestershire 007D,E01015022,694,496,256,240,1,1,52,14,38,145,136,9,0
2021,Plymouth 003A,E01015023,744,375,187,188,19,19,275,128,147,73,62,11,2
2021,Plymouth 004A,E01015024,649,469,248,221,3,3,56,32,24,121,112,9,0
2021,Plymouth 001A,E01015025,699,631,413,218,10,10,19,4,15,39,33,6,0
2021,Plymouth 003B,E01015026,756,314,140,174,13,13,284,135,149,141,128,13,4
2021,Plymouth 002A,E01015027,653,499,252,247,5,5,95,27,68,54,47,7,0
2021,Plymouth 003C,E01015028,718,220,96,124,28,28,387,180,207,79,70,9,4
2021,Plymouth 008A,E01015029,781,420,180,240,6,6,150,39,111,205,92,113,0
2021,Plymouth 007A,E01015030,770,254,131,123,9,9,416,187,229,79,70,9,12
2021,Plymouth 023A,E01015031,663,329,139,190,1,1,16,4,12,317,300,17,0
2021,Plymouth 023B,E01015032,790,185,100,85,5,5,20,6,14,580,561,19,0
2021,Plymouth 016A,E01015033,629,553,274,279,2,2,14,5,9,60,53,7,0
2021,Plymouth 016B,E01015034,535,431,225,206,0,0,34,4,30,70,60,10,0
2021,Plymouth 012A,E01015035,625,541,265,276,2,2,6,1,5,76,66,10,0
2021,Plymouth 016C,E01015036,668,440,207,233,2,2,121,14,107,105,68,37,0
2021,Plymouth 012B,E01015037,600,416,207,209,2,2,116,12,104,65,51,14,1
2021,Plymouth 016D,E01015038,719,578,280,298,5,5,27,9,18,109,95,14,0
2021,Plymouth 014A,E01015039,473,262,134,128,2,2,56,3,53,153,144,9,0
2021,Plymouth 014B,E01015040,604,280,135,145,2,2,215,119,96,106,94,12,1
2021,Plymouth 014C,E01015041,668,385,153,232,1,1,55,13,42,227,194,33,0
2021,Plymouth 020A,E01015042,654,366,152,214,2,2,34,7,27,252,236,16,0
2021,Plymouth 026A,E01015043,686,190,88,102,3,3,292,133,159,201,194,7,0
2021,Plymouth 020B,E01015044,706,350,166,184,5,5,50,15,35,301,286,15,0
2021,Plymouth 026B,E01015045,729,150,79,71,14,14,288,97,191,277,267,10,0
2021,Plymouth 026C,E01015046,892,166,66,100,26,26,538,204,334,160,141,19,2
2021,Plymouth 026D,E01015047,930,291,150,141,21,21,373,124,249,243,212,31,2
2021,Plymouth 026E,E01015048,1104,361,118,243,32,32,399,112,287,312,289,23,0
2021,Plymouth 023C,E01015049,574,263,130,133,3,3,13,3,10,294,283,11,1
2021,Plymouth 023D,E01015050,670,96,49,47,4,4,26,1,25,543,525,18,1
2021,Plymouth 023E,E01015051,511,193,96,97,5,5,23,4,19,290,272,18,0
2021,Plymouth 028A,E01015052,809,139,76,63,2,2,147,18,129,521,501,20,0
2021,Plymouth 027A,E01015053,591,117,57,60,2,2,124,34,90,348,329,19,0
2021,Plymouth 027B,E01015054,562,77,34,43,7,7,131,15,116,347,329,18,0
2021,Plymouth 021A,E01015055,594,302,140,162,11,11,211,96,115,69,53,16,1
2021,Plymouth 021B,E01015056,790,463,227,236,3,3,148,52,96,175,122,53,1
2021,Plymouth 021C,E01015057,734,296,132,164,16,16,328,62,266,94,84,10,0
2021,Plymouth 012C,E01015058,624,258,111,147,6,6,286,119,167,74,65,9,0
2021,Plymouth 021D,E01015059,646,410,157,253,12,12,71,23,48,153,128,25,0
2021,Plymouth 021E,E01015060,645,406,195,211,3,3,126,31,95,107,91,16,3
2021,Plymouth 025A,E01015061,658,291,118,173,1,1,97,39,58,268,246,22,1
2021,Plymouth 025B,E01015062,635,235,113,122,4,4,33,7,26,363,331,32,0
2021,Plymouth 010A,E01015063,669,358,145,213,8,8,170,86,84,133,116,17,0
2021,Plymouth 008B,E01015064,716,650,406,244,1,1,8,2,6,57,44,13,0
2021,Plymouth 008C,E01015065,617,329,203,126,2,2,150,9,141,136,31,105,0
2021,Plymouth 012D,E01015066,595,510,269,241,0,0,8,0,8,77,69,8,0
2021,Plymouth 012E,E01015067,611,575,370,205,1,1,7,2,5,28,20,8,0
2021,Plymouth 010B,E01015068,622,525,256,269,6,6,14,4,10,77,63,14,0
2021,Plymouth 010C,E01015069,659,385,182,203,2,2,160,70,90,112,99,13,0
2021,Plymouth 007B,E01015070,1183,709,284,425,30,30,219,103,116,224,200,24,1
2021,Plymouth 008D,E01015071,705,439,242,197,2,2,146,60,86,118,71,47,0
2021,Plymouth 013A,E01015072,544,313,157,156,0,0,134,66,68,96,81,15,1
2021,Plymouth 013B,E01015073,642,336,142,194,14,14,192,98,94,97,78,19,3
2021,Plymouth 011A,E01015074,670,323,155,168,0,0,271,152,119,73,61,12,3
2021,Plymouth 014D,E01015075,714,326,144,182,18,18,264,106,158,106,93,13,0
2021,Plymouth 009A,E01015076,633,506,231,275,3,3,27,4,23,97,90,7,0
2021,Plymouth 011B,E01015077,1042,686,285,401,15,15,189,82,107,147,118,29,5
2021,Plymouth 013C,E01015078,612,245,105,140,38,38,268,127,141,56,45,11,5
2021,Plymouth 011C,E01015079,690,531,278,253,12,12,106,45,61,41,33,8,0
2021,Plymouth 013D,E01015080,564,229,44,185,58,58,220,106,114,56,49,7,1
2021,Plymouth 007C,E01015081,686,347,149,198,17,17,258,122,136,62,52,10,2
2021,Plymouth 004B,E01015082,721,280,147,133,3,3,357,171,186,77,64,13,4
2021,Plymouth 004C,E01015083,729,306,161,145,12,12,317,134,183,89,75,14,5
2021,Plymouth 004D,E01015084,632,430,249,181,1,1,137,74,63,58,51,7,6
2021,Plymouth 006A,E01015085,726,534,287,247,6,6,98,42,56,85,75,10,3
2021,Plymouth 007D,E01015086,651,281,144,137,3,3,273,132,141,92,80,12,2
2021,Plymouth 006B,E01015087,570,277,122,155,4,4,234,151,83,49,37,12,6
2021,Plymouth 006C,E01015088,615,164,78,86,12,12,371,160,211,62,55,7,6
2021,Plymouth 007E,E01015089,805,475,248,227,12,12,136,63,73,181,150,31,1
2021,Plymouth 005A,E01015090,575,463,287,176,1,1,20,8,12,91,81,10,0
2021,Plymouth 005B,E01015091,612,458,305,153,1,1,120,7,113,33,27,6,0
2021,Plymouth 005C,E01015092,983,585,180,405,9,9,159,34,125,230,191,39,0
2021,Plymouth 005D,E01015093,632,338,169,169,5,5,211,103,108,73,59,14,5
2021,Plymouth 005E,E01015094,669,379,168,211,11,11,211,78,133,65,58,7,3
2021,Plymouth 010D,E01015095,627,427,242,185,4,4,120,67,53,75,54,21,1
2021,Plymouth 010E,E01015096,606,280,153,127,2,2,273,56,217,47,40,7,4
2021,Plymouth 001B,E01015097,1074,942,676,266,14,14,34,4,30,84,71,13,0
2021,Plymouth 017A,E01015098,676,483,234,249,2,2,8,2,6,183,174,9,0
2021,Plymouth 017B,E01015099,647,459,198,261,2,2,6,1,5,180,172,8,0
2021,Plymouth 017C,E01015100,625,403,179,224,1,1,17,0,17,203,187,16,1
2021,Plymouth 016E,E01015101,618,550,316,234,0,0,20,2,18,48,33,15,0
2021,Plymouth 011D,E01015102,751,511,242,269,8,8,47,17,30,184,155,29,1
2021,Plymouth 017D,E01015103,629,473,202,271,4,4,9,2,7,143,132,11,0
2021,Plymouth 011E,E01015104,583,525,258,267,1,1,10,4,6,47,40,7,0
2021,Plymouth 017E,E01015105,638,505,240,265,3,3,7,3,4,123,107,16,0
2021,Plymouth 013E,E01015106,519,372,187,185,3,3,66,42,24,78,64,14,0
2021,Plymouth 018A,E01015107,738,504,194,310,31,31,91,6,85,112,102,10,0
2021,Plymouth 022A,E01015108,767,495,245,250,1,1,37,5,32,234,136,98,0
2021,Plymouth 022B,E01015109,638,465,244,221,7,7,19,2,17,147,132,15,0
2021,Plymouth 018B,E01015110,609,525,285,240,5,5,9,4,5,70,59,11,0
2021,Plymouth 018C,E01015111,748,485,181,304,1,1,46,4,42,216,190,26,0
2021,Plymouth 019A,E01015112,658,517,226,291,20,20,43,3,40,78,65,13,0
2021,Plymouth 019B,E01015113,618,545,286,259,1,1,12,6,6,60,50,10,0
2021,Plymouth 019C,E01015114,633,491,235,256,4,4,39,7,32,99,83,16,0
2021,Plymouth 022C,E01015115,685,335,183,152,3,3,279,75,204,66,58,8,2
2021,Plymouth 022D,E01015116,602,477,274,203,3,3,57,11,46,65,56,9,0
2021,Plymouth 022E,E01015117,588,452,252,200,5,5,88,10,78,43,39,4,0
2021,Plymouth 019D,E01015118,693,616,338,278,7,7,14,5,9,55,45,10,1
2021,Plymouth 018D,E01015119,635,543,258,285,7,7,18,2,16,67,59,8,0
2021,Plymouth 015A,E01015120,620,508,285,223,5,5,55,23,32,52,45,7,0
2021,Plymouth 015B,E01015121,638,573,343,230,3,3,10,2,8,52,42,10,0
2021,Plymouth 019E,E01015122,643,556,300,256,4,4,15,6,9,68,52,16,0
2021,Plymouth 015C,E01015123,761,562,373,189,6,6,36,11,25,157,138,19,0
2021,Plymouth 015D,E01015124,679,582,361,221,1,1,18,5,13,78,59,19,0
2021,Plymouth 015E,E01015125,627,522,302,220,3,3,48,8,40,54,49,5,0
2021,Plymouth 030A,E01015126,657,586,385,201,3,3,10,1,9,58,44,14,0
2021,Plymouth 030B,E01015127,617,481,285,196,4,4,57,12,45,75,62,13,0
2021,Plymouth 032A,E01015128,751,569,343,226,4,4,43,8,35,135,121,14,0
2021,Plymouth 032B,E01015129,668,416,198,218,5,5,43,19,24,204,185,19,0
2021,Plymouth 032C,E01015130,585,439,227,212,6,6,14,3,11,126,48,78,0
2021,Plymouth 030C,E01015131,1000,817,476,341,70,70,50,11,39,63,53,10,0
2021,Plymouth 030D,E01015132,646,449,285,164,0,0,102,42,60,93,48,45,2
2021,Plymouth 030E,E01015133,647,612,386,226,2,2,3,1,2,30,25,5,0
2021,Plymouth 032D,E01015134,678,506,295,211,16,16,34,3,31,121,74,47,1
2021,Plymouth 031B,E01015136,629,494,276,218,4,4,16,2,14,115,106,9,0
2021,Plymouth 031C,E01015137,722,560,272,288,7,7,44,11,33,111,95,16,0
2021,Plymouth 031D,E01015138,872,713,406,307,15,15,28,5,23,116,105,11,0
2021,Plymouth 031E,E01015139,621,441,252,189,4,4,77,32,45,99,77,22,0
2021,Plymouth 032E,E01015140,651,492,358,134,2,2,18,2,16,139,43,96,0
2021,Plymouth 031F,E01015141,746,631,396,235,5,5,41,16,25,69,41,28,0
2021,Plymouth 009B,E01015142,648,461,261,200,5,5,34,12,22,148,132,16,0
2021,Plymouth 009C,E01015143,620,414,216,198,1,1,119,53,66,86,67,19,0
2021,Plymouth 009D,E01015144,641,322,154,168,7,7,173,86,87,139,123,16,0
2021,Plymouth 014E,E01015145,473,80,39,41,34,34,315,31,284,44,40,4,0
2021,Plymouth 009E,E01015146,726,272,106,166,0,0,308,93,215,146,127,19,0
2021,Plymouth 006D,E01015147,500,386,214,172,2,2,60,33,27,52,46,6,0
2021,Plymouth 006E,E01015148,665,352,153,199,15,15,161,86,75,133,115,18,4
2021,Plymouth 009F,E01015149,616,155,79,76,2,2,413,64,349,46,39,7,0
2021,Plymouth 009G,E01015150,644,474,277,197,1,1,93,46,47,76,62,14,0
2021,Plymouth 033A,E01015151,861,195,97,98,5,5,202,56,146,459,438,21,0
2021,Plymouth 027C,E01015152,925,142,79,63,11,11,554,197,357,218,205,13,0
2021,Plymouth 033C,E01015153,984,209,104,105,0,0,378,72,306,397,379,18,0
2021,Plymouth 034A,E01015155,957,99,59,40,3,3,617,254,363,237,226,11,1
2021,Plymouth 027E,E01015156,833,217,134,83,3,3,234,53,181,379,351,28,0
2021,Plymouth 002B,E01015159,788,458,271,187,17,17,237,104,133,74,62,12,2
2021,Plymouth 001C,E01015160,642,558,366,192,4,4,8,4,4,72,56,16,0
2021,Plymouth 002C,E01015161,722,364,193,171,40,40,218,113,105,99,86,13,1
2021,Plymouth 002D,E01015162,639,308,157,151,7,7,255,137,118,68,56,12,1
2021,Plymouth 003D,E01015163,673,450,235,215,22,22,136,65,71,63,56,7,2
2021,Plymouth 001D,E01015164,736,415,197,218,11,11,126,57,69,184,81,103,0
2021,Plymouth 003E,E01015165,653,505,195,310,2,2,13,6,7,133,114,19,0
2021,Plymouth 002E,E01015166,931,403,164,239,28,28,341,133,208,159,139,20,0
2021,Plymouth 020C,E01015167,713,425,163,262,3,3,58,7,51,227,209,18,0
2021,Plymouth 020D,E01015168,860,489,194,295,2,2,91,25,66,278,253,25,0
2021,Plymouth 024A,E01015169,673,379,199,180,4,4,62,10,52,227,207,20,1
2021,Plymouth 024B,E01015170,747,295,145,150,1,1,236,88,148,212,200,12,3
2021,Plymouth 020E,E01015171,848,374,178,196,1,1,99,11,88,374,358,16,0
2021,Plymouth 033B,E01015172,840,442,206,236,6,6,25,9,16,367,342,25,0
2021,Plymouth 024C,E01015173,737,456,232,224,24,24,39,5,34,218,197,21,0
2021,Plymouth 024D,E01015174,702,558,269,289,3,3,14,3,11,127,113,14,0
2021,Plymouth 025C,E01015175,672,360,163,197,3,3,46,11,35,263,234,29,0
2021,Plymouth 021F,E01015176,593,346,174,172,4,4,143,70,73,99,80,19,1
2021,Plymouth 025D,E01015177,732,466,193,273,2,2,10,1,9,254,228,26,0
2021,Plymouth 025E,E01015178,823,345,142,203,6,6,22,3,19,450,429,21,0
2021,Plymouth 028B,E01015179,691,278,129,149,9,9,25,3,22,379,350,29,0
2021,Plymouth 028C,E01015180,895,290,116,174,5,5,292,21,271,308,282,26,0
2021,Plymouth 028D,E01015181,1032,400,215,185,5,5,70,9,61,557,537,20,0
2021,Plymouth 028E,E01015182,899,398,187,211,26,26,207,45,162,267,234,33,1
2021,Torbay 017A,E01015183,602,432,291,141,9,9,74,9,65,87,71,16,0
2021,Torbay 017B,E01015184,617,557,423,134,7,7,9,1,8,44,34,10,0
2021,Torbay 017C,E01015185,699,430,299,131,2,2,75,5,70,192,169,23,0
2021,Torbay 017D,E01015186,681,352,245,107,7,7,34,3,31,288,255,33,0
2021,Torbay 017E,E01015187,838,635,464,171,6,6,30,2,28,167,150,17,0
2021,Torbay 017F,E01015188,690,512,372,140,2,2,41,2,39,135,120,15,0
2021,Torbay 017G,E01015189,513,330,230,100,1,1,14,1,13,168,152,16,0
2021,Torbay 013A,E01015190,837,609,378,231,17,17,86,12,74,125,109,16,0
2021,Torbay 013B,E01015191,682,415,205,210,64,64,26,1,25,177,172,5,0
2021,Torbay 013C,E01015192,615,355,172,183,1,1,147,22,125,112,99,13,0
2021,Torbay 013D,E01015193,571,412,235,177,6,6,47,5,42,106,95,11,0
2021,Torbay 013E,E01015194,606,416,257,159,5,5,117,9,108,68,64,4,0
2021,Torbay 013G,E01015196,667,253,111,142,5,5,353,58,295,55,49,6,1
2021,Torbay 016A,E01015197,629,591,426,165,1,1,1,0,1,36,28,8,0
2021,Torbay 016B,E01015198,737,651,467,184,3,3,8,0,8,75,58,17,0
2021,Torbay 016C,E01015199,625,582,434,148,1,1,7,0,7,35,26,9,0
2021,Torbay 016D,E01015200,448,351,206,145,2,2,26,0,26,69,64,5,0
2021,Torbay 016E,E01015201,588,458,322,136,2,2,41,4,37,87,80,7,0
2021,Torbay 012A,E01015202,597,497,242,255,2,2,20,2,18,78,64,14,0
2021,Torbay 012B,E01015203,539,491,305,186,0,0,8,0,8,40,36,4,0
2021,Torbay 012C,E01015204,657,411,219,192,2,2,13,6,7,230,207,23,1
2021,Torbay 012D,E01015205,641,519,278,241,4,4,14,0,14,104,85,19,0
2021,Torbay 012E,E01015206,640,450,243,207,3,3,23,2,21,164,147,17,0
2021,Torbay 019E,E01015207,662,493,248,245,1,1,24,1,23,144,125,19,0
2021,Torbay 019F,E01015208,903,787,575,212,4,4,4,0,4,108,92,16,0
2021,Torbay 019A,E01015209,729,413,259,154,1,1,30,3,27,285,269,16,0
2021,Torbay 019B,E01015210,688,339,165,174,1,1,157,21,136,191,182,9,0
2021,Torbay 019G,E01015211,602,512,288,224,1,1,6,1,5,83,74,9,0
2021,Torbay 019C,E01015212,632,393,187,206,1,1,9,2,7,229,213,16,0
2021,Torbay 019D,E01015213,578,415,214,201,4,4,52,4,48,107,96,11,0
2021,Torbay 006A,E01015214,689,349,157,192,1,1,7,1,6,331,299,32,1
2021,Torbay 006B,E01015215,618,443,211,232,5,5,12,3,9,158,141,17,0
2021,Torbay 006C,E01015216,662,350,173,177,3,3,18,1,17,291,274,17,0
2021,Torbay 008A,E01015217,860,337,184,153,3,3,104,10,94,414,400,14,2
2021,Torbay 006D,E01015218,621,402,208,194,5,5,40,2,38,174,161,13,0
2021,Torbay 015A,E01015219,709,415,284,131,0,0,128,6,122,166,154,12,0
2021,Torbay 015B,E01015220,632,529,347,182,4,4,22,0,22,77,60,17,0
2021,Torbay 015C,E01015221,707,451,270,181,17,17,94,4,90,145,124,21,0
2021,Torbay 015D,E01015222,735,535,356,179,41,41,20,0,20,139,120,19,0
2021,Torbay 015E,E01015223,511,429,248,181,17,17,2,0,2,63,56,7,0
2021,Torbay 011A,E01015224,683,511,267,244,7,7,6,0,6,159,142,17,0
2021,Torbay 011B,E01015225,603,446,253,193,0,0,55,3,52,102,80,22,0
2021,Torbay 011C,E01015226,614,542,342,200,3,3,6,0,6,63,58,5,0
2021,Torbay 011D,E01015227,634,576,329,247,2,2,5,1,4,51,45,6,0
2021,Torbay 011E,E01015228,757,474,316,158,6,6,22,4,18,255,226,29,0
2021,Torbay 014A,E01015229,689,447,304,143,4,4,55,3,52,183,156,27,0
2021,Torbay 011F,E01015230,638,581,409,172,6,6,9,2,7,42,33,9,0
2021,Torbay 014B,E01015231,958,220,127,93,15,15,193,15,178,530,495,35,0
2021,Torbay 014C,E01015232,1046,470,332,138,7,7,27,0,27,542,512,30,0
2021,Torbay 014D,E01015233,786,350,221,129,4,4,4,0,4,428,393,35,0
2021,Torbay 014E,E01015234,595,326,169,157,0,0,77,2,75,192,176,16,0
2021,Torbay 014F,E01015235,943,555,445,110,4,4,11,1,10,373,337,36,0
2021,Torbay 002A,E01015236,694,510,334,176,7,7,33,4,29,144,130,14,0
2021,Torbay 002B,E01015237,527,384,200,184,3,3,12,0,12,127,111,16,1
2021,Torbay 002C,E01015238,627,410,254,156,0,0,13,0,13,204,192,12,0
2021,Torbay 002D,E01015239,876,426,300,126,7,7,89,10,79,354,323,31,0
2021,Torbay 005A,E01015240,811,487,366,121,1,1,37,4,33,286,257,29,0
2021,Torbay 005B,E01015241,695,450,275,175,0,0,33,8,25,212,199,13,0
2021,Torbay 005C,E01015242,527,275,135,140,3,3,104,10,94,145,124,21,0
2021,Torbay 005D,E01015243,585,471,297,174,0,0,11,1,10,103,89,14,0
2021,Torbay 018A,E01015244,641,512,358,154,7,7,14,3,11,108,83,25,0
2021,Torbay 018B,E01015245,591,421,303,118,3,3,92,11,81,75,62,13,0
2021,Torbay 018C,E01015246,611,499,328,171,2,2,16,1,15,94,83,11,0
2021,Torbay 018D,E01015247,788,566,368,198,9,9,72,7,65,141,121,20,0
2021,Torbay 018E,E01015248,673,393,234,159,5,5,72,10,62,203,190,13,0
2021,Torbay 003A,E01015249,623,338,161,177,29,29,184,24,160,71,60,11,1
2021,Torbay 003B,E01015250,644,456,230,226,3,3,4,0,4,181,160,21,0
2021,Torbay 003C,E01015251,478,377,212,165,0,0,42,6,36,59,47,12,0
2021,Torbay 003E,E01015253,803,465,179,286,25,25,60,7,53,253,236,17,0
2021,Torbay 003F,E01015254,621,491,308,183,1,1,33,6,27,96,75,21,0
2021,Torbay 008B,E01015255,966,210,114,96,1,1,120,15,105,631,598,33,4
2021,Torbay 008C,E01015256,1111,375,254,121,1,1,44,5,39,691,653,38,0
2021,Torbay 004A,E01015257,628,262,139,123,5,5,221,37,184,137,122,15,3
2021,Torbay 004B,E01015258,938,524,310,214,35,35,162,12,150,217,191,26,0
2021,Torbay 004C,E01015259,651,397,180,217,3,3,22,0,22,229,200,29,0
2021,Torbay 004D,E01015260,847,371,200,171,1,1,13,0,13,462,440,22,0
2021,Torbay 008D,E01015261,1022,486,265,221,32,32,116,17,99,388,354,34,0
2021,Torbay 001A,E01015262,525,361,190,171,6,6,89,10,79,69,57,12,0
2021,Torbay 001B,E01015263,634,279,130,149,4,4,248,40,208,102,93,9,1
2021,Torbay 001C,E01015264,622,531,344,187,3,3,10,0,10,78,72,6,0
2021,Torbay 001D,E01015265,640,501,364,137,0,0,65,10,55,74,61,13,0
2021,Torbay 001E,E01015266,619,241,104,137,6,6,268,32,236,104,86,18,0
2021,Torbay 010A,E01015267,908,476,330,146,4,4,17,1,16,411,391,20,0
2021,Torbay 010B,E01015268,931,553,397,156,3,3,61,3,58,313,296,17,1
2021,Torbay 010C,E01015269,836,510,350,160,10,10,35,0,35,281,264,17,0
2021,Torbay 010D,E01015270,930,520,359,161,3,3,56,3,53,351,320,31,0
2021,Torbay 010E,E01015271,738,627,465,162,5,5,6,2,4,100,81,19,0
2021,"Bournemouth, Christchurch and Poole 035A",E01015272,838,572,389,183,2,2,18,5,13,245,219,26,1
2021,"Bournemouth, Christchurch and Poole 035B",E01015273,1013,427,171,256,7,7,94,14,80,485,470,15,0
2021,"Bournemouth, Christchurch and Poole 036A",E01015274,920,506,233,273,2,2,51,11,40,361,336,25,0
2021,"Bournemouth, Christchurch and Poole 035C",E01015275,727,375,176,199,5,5,41,2,39,305,285,20,1
2021,"Bournemouth, Christchurch and Poole 035D",E01015276,698,421,172,249,12,12,36,7,29,229,219,10,0
2021,"Bournemouth, Christchurch and Poole 035E",E01015277,862,437,178,259,14,14,81,13,68,330,311,19,0
2021,"Bournemouth, Christchurch and Poole 037A",E01015279,1014,277,105,172,5,5,74,10,64,658,625,33,0
2021,"Bournemouth, Christchurch and Poole 037B",E01015280,1024,303,97,206,10,10,87,28,59,624,604,20,0
2021,"Bournemouth, Christchurch and Poole 037C",E01015281,893,223,87,136,26,26,228,111,117,415,395,20,1
2021,"Bournemouth, Christchurch and Poole 038A",E01015286,1127,595,349,246,10,10,154,8,146,368,340,28,0
2021,"Bournemouth, Christchurch and Poole 041A",E01015288,941,183,56,127,13,13,176,89,87,569,550,19,0
2021,"Bournemouth, Christchurch and Poole 041B",E01015289,1042,393,197,196,1,1,100,65,35,546,509,37,2
2021,"Bournemouth, Christchurch and Poole 041C",E01015290,975,256,114,142,4,4,112,23,89,603,568,35,0
2021,"Bournemouth, Christchurch and Poole 041D",E01015291,1041,542,416,126,2,2,86,14,72,411,379,32,0
2021,"Bournemouth, Christchurch and Poole 025A",E01015292,768,355,126,229,2,2,84,46,38,324,303,21,3
2021,"Bournemouth, Christchurch and Poole 025B",E01015293,667,329,134,195,1,1,86,11,75,251,241,10,0
2021,"Bournemouth, Christchurch and Poole 025C",E01015294,882,333,106,227,8,8,100,26,74,440,419,21,1
2021,"Bournemouth, Christchurch and Poole 039A",E01015295,657,593,390,203,0,0,3,1,2,61,48,13,0
2021,"Bournemouth, Christchurch and Poole 039B",E01015296,1057,540,337,203,0,0,103,18,85,413,384,29,1
2021,"Bournemouth, Christchurch and Poole 036B",E01015297,751,515,314,201,3,3,20,8,12,213,189,24,0
2021,"Bournemouth, Christchurch and Poole 039C",E01015298,757,657,505,152,2,2,41,14,27,56,46,10,1
2021,"Bournemouth, Christchurch and Poole 039D",E01015299,808,668,396,272,4,4,9,6,3,127,109,18,0
2021,"Bournemouth, Christchurch and Poole 039E",E01015300,663,580,333,247,0,0,3,2,1,80,68,12,0
2021,"Bournemouth, Christchurch and Poole 003A",E01015301,685,513,307,206,5,5,61,56,5,106,91,15,0
2021,"Bournemouth, Christchurch and Poole 005A",E01015302,846,609,383,226,1,1,99,88,11,136,113,23,1
2021,"Bournemouth, Christchurch and Poole 003B",E01015303,713,538,317,221,6,6,51,34,17,117,106,11,1
2021,"Bournemouth, Christchurch and Poole 005B",E01015304,780,416,197,219,1,1,283,269,14,76,64,12,4
2021,"Bournemouth, Christchurch and Poole 003C",E01015305,634,366,192,174,4,4,202,184,18,61,52,9,1
2021,"Bournemouth, Christchurch and Poole 003D",E01015306,727,421,246,175,3,3,234,80,154,69,56,13,0
2021,"Bournemouth, Christchurch and Poole 010A",E01015307,591,237,97,140,2,2,282,265,17,67,55,12,3
2021,"Bournemouth, Christchurch and Poole 005C",E01015308,752,415,181,234,2,2,194,124,70,139,126,13,2
2021,"Bournemouth, Christchurch and Poole 010B",E01015309,585,237,108,129,3,3,264,232,32,78,73,5,3
2021,"Bournemouth, Christchurch and Poole 011A",E01015310,624,351,152,199,4,4,178,156,22,88,80,8,3
2021,"Bournemouth, Christchurch and Poole 005D",E01015311,692,630,442,188,1,1,11,9,2,49,35,14,1
2021,"Bournemouth, Christchurch and Poole 010C",E01015312,590,259,131,128,12,12,271,187,84,46,42,4,2
2021,"Bournemouth, Christchurch and Poole 010D",E01015313,516,161,60,101,1,1,315,218,97,39,32,7,0
2021,"Bournemouth, Christchurch and Poole 020A",E01015314,625,523,252,271,0,0,33,30,3,68,59,9,1
2021,"Bournemouth, Christchurch and Poole 020B",E01015315,731,676,368,308,1,1,7,1,6,47,44,3,0
2021,"Bournemouth, Christchurch and Poole 026A",E01015316,695,610,347,263,2,2,5,2,3,78,69,9,0
2021,"Bournemouth, Christchurch and Poole 026B",E01015317,707,501,231,270,8,8,82,75,7,113,97,16,3
2021,"Bournemouth, Christchurch and Poole 020C",E01015318,746,485,219,266,2,2,24,1,23,235,211,24,0
2021,"Bournemouth, Christchurch and Poole 020D",E01015319,530,385,207,178,1,1,16,4,12,128,88,40,0
2021,"Bournemouth, Christchurch and Poole 009A",E01015320,674,558,262,296,3,3,5,1,4,108,98,10,0
2021,"Bournemouth, Christchurch and Poole 015A",E01015321,751,368,134,234,2,2,144,101,43,235,219,16,2
2021,"Bournemouth, Christchurch and Poole 017A",E01015322,676,542,248,294,2,2,23,13,10,109,99,10,0
2021,"Bournemouth, Christchurch and Poole 009B",E01015323,612,505,192,313,1,1,1,0,1,105,100,5,0
2021,"Bournemouth, Christchurch and Poole 009C",E01015324,692,456,193,263,3,3,29,6,23,204,194,10,0
2021,"Bournemouth, Christchurch and Poole 009D",E01015325,676,544,229,315,2,2,6,2,4,124,113,11,0
2021,"Bournemouth, Christchurch and Poole 027A",E01015326,812,439,179,260,3,3,14,2,12,356,326,30,0
2021,"Bournemouth, Christchurch and Poole 025D",E01015327,840,393,140,253,2,2,111,12,99,334,312,22,0
2021,"Bournemouth, Christchurch and Poole 038B",E01015328,978,360,148,212,8,8,152,122,30,458,440,18,0
2021,"Bournemouth, Christchurch and Poole 025E",E01015329,682,416,159,257,0,0,20,9,11,246,228,18,0
2021,"Bournemouth, Christchurch and Poole 017B",E01015330,773,493,240,253,1,1,72,6,66,207,189,18,0
2021,"Bournemouth, Christchurch and Poole 027B",E01015331,1029,432,158,274,18,18,67,21,46,511,482,29,1
2021,"Bournemouth, Christchurch and Poole 006A",E01015332,723,597,378,219,4,4,11,3,8,111,98,13,0
2021,"Bournemouth, Christchurch and Poole 006B",E01015333,680,593,364,229,0,0,18,14,4,69,57,12,0
2021,"Bournemouth, Christchurch and Poole 006C",E01015334,722,527,303,224,5,5,122,76,46,66,54,12,2
2021,"Bournemouth, Christchurch and Poole 006D",E01015335,712,578,318,260,0,0,17,3,14,117,107,10,0
2021,"Bournemouth, Christchurch and Poole 011B",E01015336,716,525,264,261,8,8,36,13,23,147,129,18,0
2021,"Bournemouth, Christchurch and Poole 006E",E01015337,780,555,264,291,9,9,29,7,22,187,170,17,0
2021,"Bournemouth, Christchurch and Poole 012A",E01015338,811,266,144,122,11,11,445,258,187,80,69,11,9
2021,"Bournemouth, Christchurch and Poole 012B",E01015339,670,394,202,192,1,1,125,118,7,148,136,12,2
2021,"Bournemouth, Christchurch and Poole 012C",E01015340,743,601,365,236,0,0,75,71,4,67,59,8,0
2021,"Bournemouth, Christchurch and Poole 012D",E01015341,540,236,113,123,1,1,223,178,45,78,73,5,2
2021,"Bournemouth, Christchurch and Poole 017C",E01015342,643,548,283,265,2,2,14,3,11,79,65,14,0
2021,"Bournemouth, Christchurch and Poole 007A",E01015343,656,452,215,237,0,0,127,118,9,77,66,11,0
2021,"Bournemouth, Christchurch and Poole 028A",E01015344,770,573,339,234,1,1,4,1,3,192,183,9,0
2021,"Bournemouth, Christchurch and Poole 027C",E01015345,747,337,138,199,1,1,16,3,13,393,374,19,0
2021,"Bournemouth, Christchurch and Poole 028B",E01015346,681,318,168,150,1,1,109,10,99,253,234,19,0
2021,"Bournemouth, Christchurch and Poole 028C",E01015348,766,547,348,199,1,1,20,5,15,198,181,17,0
2021,"Bournemouth, Christchurch and Poole 007B",E01015349,705,482,232,250,10,10,53,23,30,160,141,19,0
2021,"Bournemouth, Christchurch and Poole 009E",E01015350,635,567,310,257,1,1,14,2,12,53,46,7,0
2021,"Bournemouth, Christchurch and Poole 007C",E01015351,612,468,240,228,2,2,3,2,1,139,133,6,0
2021,"Bournemouth, Christchurch and Poole 007D",E01015352,641,463,203,260,6,6,17,3,14,155,144,11,0
2021,"Bournemouth, Christchurch and Poole 007E",E01015353,501,345,183,162,8,8,54,10,44,93,84,9,1
2021,"Bournemouth, Christchurch and Poole 007F",E01015354,719,468,234,234,17,17,45,10,35,189,167,22,0
2021,"Bournemouth, Christchurch and Poole 011C",E01015355,709,515,283,232,3,3,31,22,9,160,146,14,0
2021,"Bournemouth, Christchurch and Poole 015B",E01015356,655,454,220,234,3,3,21,3,18,177,169,8,0
2021,"Bournemouth, Christchurch and Poole 011D",E01015357,699,356,192,164,3,3,211,172,39,129,117,12,0
2021,"Bournemouth, Christchurch and Poole 011E",E01015358,801,507,229,278,3,3,58,20,38,233,214,19,0
2021,"Bournemouth, Christchurch and Poole 010E",E01015359,764,394,203,191,6,6,213,202,11,143,124,19,8
2021,"Bournemouth, Christchurch and Poole 028D",E01015360,655,375,169,206,2,2,16,3,13,262,249,13,0
2021,"Bournemouth, Christchurch and Poole 026C",E01015361,563,390,166,224,1,1,41,26,15,131,121,10,0
2021,"Bournemouth, Christchurch and Poole 026D",E01015362,448,234,84,150,1,1,176,83,93,37,33,4,0
2021,"Bournemouth, Christchurch and Poole 026E",E01015363,681,480,185,295,3,3,18,1,17,180,163,17,0
2021,"Bournemouth, Christchurch and Poole 036C",E01015364,696,575,332,243,1,1,16,0,16,104,90,14,0
2021,"Bournemouth, Christchurch and Poole 036D",E01015365,761,348,139,209,3,3,40,13,27,370,341,29,0
2021,"Bournemouth, Christchurch and Poole 036E",E01015366,954,459,285,174,4,4,159,10,149,332,307,25,0
2021,"Bournemouth, Christchurch and Poole 045A",E01015367,1183,360,195,165,51,51,21,3,18,751,718,33,0
2021,"Bournemouth, Christchurch and Poole 045B",E01015368,1028,592,448,144,1,1,16,5,11,419,388,31,0
2021,"Bournemouth, Christchurch and Poole 045C",E01015369,959,553,368,185,3,3,48,14,34,355,316,39,0
2021,"Bournemouth, Christchurch and Poole 045D",E01015370,802,459,251,208,2,2,9,4,5,332,304,28,0
2021,"Bournemouth, Christchurch and Poole 040A",E01015371,792,259,129,130,2,2,72,37,35,458,433,25,1
2021,"Bournemouth, Christchurch and Poole 040B",E01015372,1199,520,351,169,12,12,161,88,73,506,477,29,0
2021,"Bournemouth, Christchurch and Poole 017D",E01015373,694,368,135,233,1,1,39,10,29,286,273,13,0
2021,"Bournemouth, Christchurch and Poole 015C",E01015374,996,304,140,164,3,3,93,6,87,596,576,20,0
2021,"Bournemouth, Christchurch and Poole 015D",E01015375,787,278,119,159,2,2,60,20,40,446,428,18,1
2021,"Bournemouth, Christchurch and Poole 027D",E01015376,659,340,137,203,3,3,17,3,14,299,284,15,0
2021,"Bournemouth, Christchurch and Poole 015E",E01015377,639,349,144,205,11,11,70,28,42,209,193,16,0
2021,"Bournemouth, Christchurch and Poole 017E",E01015378,651,432,161,271,0,0,8,1,7,211,194,17,0
2021,"Bournemouth, Christchurch and Poole 008A",E01015379,486,273,102,171,0,0,148,117,31,64,47,17,1
2021,"Bournemouth, Christchurch and Poole 022A",E01015380,766,652,374,278,3,3,38,31,7,73,62,11,0
2021,"Bournemouth, Christchurch and Poole 022B",E01015381,652,374,162,212,0,0,203,169,34,74,63,11,1
2021,"Bournemouth, Christchurch and Poole 022C",E01015382,791,462,163,299,12,12,97,35,62,220,196,24,0
2021,"Bournemouth, Christchurch and Poole 022D",E01015383,679,547,338,209,3,3,14,9,5,115,102,13,0
2021,"Bournemouth, Christchurch and Poole 022E",E01015384,479,189,58,131,4,4,234,170,64,52,47,5,0
2021,"Bournemouth, Christchurch and Poole 022F",E01015385,793,438,240,198,2,2,222,161,61,130,120,10,1
2021,"Bournemouth, Christchurch and Poole 029A",E01015386,828,282,129,153,7,7,234,9,225,305,286,19,0
2021,"Bournemouth, Christchurch and Poole 029B",E01015387,663,472,227,245,3,3,72,6,66,116,105,11,0
2021,"Bournemouth, Christchurch and Poole 029C",E01015388,490,362,216,146,1,1,47,1,46,80,71,9,0
2021,"Bournemouth, Christchurch and Poole 029D",E01015389,678,503,256,247,1,1,13,3,10,161,143,18,0
2021,"Bournemouth, Christchurch and Poole 032A",E01015390,776,410,167,243,8,8,116,40,76,241,220,21,1
2021,"Bournemouth, Christchurch and Poole 032B",E01015391,616,529,268,261,1,1,10,4,6,76,68,8,0
2021,"Bournemouth, Christchurch and Poole 032C",E01015392,677,482,226,256,12,12,17,8,9,166,154,12,0
2021,"Bournemouth, Christchurch and Poole 032D",E01015393,542,381,157,224,3,3,50,7,43,108,97,11,0
2021,"Bournemouth, Christchurch and Poole 032E",E01015394,652,514,220,294,2,2,14,3,11,121,108,13,1
2021,"Bournemouth, Christchurch and Poole 004A",E01015395,677,537,363,174,2,2,56,45,11,80,72,8,2
2021,"Bournemouth, Christchurch and Poole 004B",E01015396,636,592,361,231,1,1,3,0,3,40,34,6,0
2021,"Bournemouth, Christchurch and Poole 004C",E01015397,525,509,259,250,0,0,1,0,1,15,13,2,0
2021,"Bournemouth, Christchurch and Poole 004D",E01015398,511,476,269,207,0,0,6,3,3,29,24,5,0
2021,"Bournemouth, Christchurch and Poole 004E",E01015399,644,561,388,173,1,1,13,5,8,69,49,20,0
2021,"Bournemouth, Christchurch and Poole 004F",E01015400,641,607,350,257,0,0,3,1,2,31,27,4,0
2021,"Bournemouth, Christchurch and Poole 004G",E01015401,637,597,406,191,1,1,7,3,4,31,24,7,1
2021,"Bournemouth, Christchurch and Poole 048A",E01015402,865,593,412,181,3,3,50,5,45,219,195,24,0
2021,"Bournemouth, Christchurch and Poole 048B",E01015403,1061,816,671,145,3,3,22,7,15,220,194,26,0
2021,"Bournemouth, Christchurch and Poole 048C",E01015404,874,734,566,168,0,0,8,3,5,132,115,17,0
2021,"Bournemouth, Christchurch and Poole 048D",E01015405,777,638,443,195,1,1,7,1,6,131,116,15,0
2021,"Bournemouth, Christchurch and Poole 048E",E01015406,751,538,374,164,5,5,11,5,6,197,161,36,0
2021,"Bournemouth, Christchurch and Poole 016A",E01015407,631,533,288,245,5,5,7,3,4,86,76,10,0
2021,"Bournemouth, Christchurch and Poole 016B",E01015408,631,520,224,296,2,2,46,4,42,63,55,8,0
2021,"Bournemouth, Christchurch and Poole 016C",E01015409,594,264,116,148,5,5,174,7,167,151,144,7,0
2021,"Bournemouth, Christchurch and Poole 016D",E01015410,660,406,174,232,16,16,48,4,44,190,182,8,0
2021,"Bournemouth, Christchurch and Poole 016E",E01015411,539,419,207,212,3,3,16,3,13,101,90,11,0
2021,"Bournemouth, Christchurch and Poole 013A",E01015412,494,468,272,196,1,1,6,2,4,19,18,1,0
2021,"Bournemouth, Christchurch and Poole 013B",E01015413,632,407,202,205,6,6,111,50,61,108,91,17,0
2021,"Bournemouth, Christchurch and Poole 013C",E01015414,694,475,289,186,11,11,117,70,47,91,85,6,0
2021,"Bournemouth, Christchurch and Poole 013D",E01015415,534,189,73,116,3,3,224,87,137,116,108,8,2
2021,"Bournemouth, Christchurch and Poole 013E",E01015416,536,388,187,201,8,8,48,26,22,92,86,6,0
2021,"Bournemouth, Christchurch and Poole 021A",E01015417,642,423,216,207,1,1,137,79,58,81,69,12,0
2021,"Bournemouth, Christchurch and Poole 021B",E01015418,699,532,248,284,0,0,42,5,37,125,108,17,0
2021,"Bournemouth, Christchurch and Poole 021C",E01015419,790,650,381,269,5,5,11,3,8,124,108,16,0
2021,"Bournemouth, Christchurch and Poole 021D",E01015420,674,380,181,199,2,2,223,190,33,63,51,12,6
2021,"Bournemouth, Christchurch and Poole 021E",E01015421,668,543,332,211,0,0,59,47,12,64,55,9,2
2021,"Bournemouth, Christchurch and Poole 021F",E01015422,621,458,192,266,6,6,17,5,12,140,133,7,0
2021,"Bournemouth, Christchurch and Poole 046A",E01015424,625,452,249,203,2,2,19,5,14,152,136,16,0
2021,"Bournemouth, Christchurch and Poole 046B",E01015425,565,459,286,173,1,1,30,2,28,75,61,14,0
2021,"Bournemouth, Christchurch and Poole 046C",E01015426,571,336,150,186,1,1,170,133,37,64,55,9,0
2021,"Bournemouth, Christchurch and Poole 042A",E01015427,647,365,142,223,0,0,84,49,35,198,99,99,0
2021,"Bournemouth, Christchurch and Poole 042B",E01015428,1072,739,424,315,11,11,99,30,69,223,173,50,0
2021,"Bournemouth, Christchurch and Poole 042C",E01015429,691,380,183,197,0,0,175,132,43,133,116,17,3
2021,"Bournemouth, Christchurch and Poole 042D",E01015430,563,221,111,110,1,1,254,205,49,86,78,8,1
2021,"Bournemouth, Christchurch and Poole 001A",E01015431,413,369,236,133,2,2,4,2,2,38,29,9,0
2021,"Bournemouth, Christchurch and Poole 001B",E01015432,767,589,362,227,4,4,78,37,41,96,80,16,0
2021,"Bournemouth, Christchurch and Poole 001C",E01015433,624,586,378,208,0,0,4,2,2,34,28,6,0
2021,"Bournemouth, Christchurch and Poole 001D",E01015434,677,621,432,189,2,2,2,0,2,52,43,9,0
2021,"Bournemouth, Christchurch and Poole 008B",E01015435,787,526,161,365,13,13,93,67,26,154,140,14,1
2021,"Bournemouth, Christchurch and Poole 008C",E01015436,551,465,239,226,1,1,39,30,9,46,38,8,0
2021,"Bournemouth, Christchurch and Poole 008D",E01015437,515,467,257,210,2,2,14,1,13,32,25,7,0
2021,"Bournemouth, Christchurch and Poole 023A",E01015438,637,517,234,283,4,4,3,3,0,113,97,16,0
2021,"Bournemouth, Christchurch and Poole 023B",E01015439,759,468,192,276,3,3,149,112,37,136,128,8,3
2021,"Bournemouth, Christchurch and Poole 030A",E01015440,892,637,312,325,1,1,16,1,15,237,218,19,1
2021,"Bournemouth, Christchurch and Poole 023C",E01015441,908,502,228,274,11,11,140,77,63,254,238,16,1
2021,"Bournemouth, Christchurch and Poole 023D",E01015442,843,355,160,195,30,30,338,222,116,113,101,12,7
2021,"Bournemouth, Christchurch and Poole 023E",E01015443,832,573,283,290,4,4,85,42,43,168,160,8,2
2021,"Bournemouth, Christchurch and Poole 023F",E01015444,718,518,223,295,10,10,62,29,33,128,112,16,0
2021,"Bournemouth, Christchurch and Poole 034A",E01015445,780,670,373,297,10,10,12,7,5,88,68,20,0
2021,"Bournemouth, Christchurch and Poole 034B",E01015446,666,435,239,196,2,2,128,91,37,99,85,14,2
2021,"Bournemouth, Christchurch and Poole 030B",E01015447,690,609,316,293,1,1,2,0,2,77,67,10,1
2021,"Bournemouth, Christchurch and Poole 034C",E01015448,629,493,236,257,3,3,52,40,12,80,70,10,1
2021,"Bournemouth, Christchurch and Poole 030C",E01015449,748,424,170,254,0,0,202,125,77,122,114,8,0
2021,"Bournemouth, Christchurch and Poole 034D",E01015450,687,555,285,270,2,2,57,39,18,73,61,12,0
2021,"Bournemouth, Christchurch and Poole 034E",E01015451,651,594,347,247,0,0,7,2,5,50,41,9,0
2021,"Bournemouth, Christchurch and Poole 047A",E01015452,947,765,462,303,16,16,39,10,29,127,114,13,0
2021,"Bournemouth, Christchurch and Poole 047B",E01015453,1023,622,325,297,2,2,49,6,43,350,322,28,0
2021,"Bournemouth, Christchurch and Poole 047C",E01015454,952,563,247,316,2,2,45,18,27,340,316,24,2
2021,"Bournemouth, Christchurch and Poole 047D",E01015455,914,754,466,288,3,3,30,19,11,127,108,19,0
2021,"Bournemouth, Christchurch and Poole 030D",E01015456,806,383,187,196,0,0,241,111,130,182,167,15,0
2021,"Bournemouth, Christchurch and Poole 030E",E01015457,902,570,325,245,15,15,69,6,63,248,223,25,0
2021,"Bournemouth, Christchurch and Poole 043A",E01015458,671,619,382,237,1,1,6,4,2,45,38,7,0
2021,"Bournemouth, Christchurch and Poole 047E",E01015459,804,709,453,256,2,2,3,1,2,90,79,11,0
2021,"Bournemouth, Christchurch and Poole 043B",E01015460,759,462,205,257,2,2,29,12,17,266,253,13,0
2021,"Bournemouth, Christchurch and Poole 043C",E01015461,723,433,166,267,1,1,61,7,54,228,213,15,0
2021,"Bournemouth, Christchurch and Poole 043D",E01015462,701,402,176,226,0,0,67,26,41,232,221,11,0
2021,"Bournemouth, Christchurch and Poole 043E",E01015463,792,572,296,276,1,1,31,4,27,187,171,16,1
2021,"Bournemouth, Christchurch and Poole 043F",E01015464,689,609,345,264,1,1,3,3,0,76,68,8,0
2021,"Bournemouth, Christchurch and Poole 044A",E01015465,756,361,184,177,4,4,174,93,81,217,198,19,0
2021,"Bournemouth, Christchurch and Poole 044B",E01015466,786,516,309,207,2,2,79,4,75,189,172,17,0
2021,Swindon 028A,E01015471,862,702,271,431,3,3,9,4,5,147,143,4,1
2021,Swindon 008A,E01015473,765,618,324,294,12,12,58,35,23,77,64,13,0
2021,Swindon 015A,E01015475,715,380,128,252,0,0,48,34,14,287,267,20,0
2021,Swindon 015C,E01015477,730,281,112,169,5,5,92,82,10,350,332,18,2
2021,Swindon 021A,E01015478,688,423,177,246,8,8,75,56,19,181,164,17,1
2021,Swindon 017A,E01015479,877,549,216,333,14,14,65,5,60,249,233,16,0
2021,Swindon 015D,E01015480,786,382,99,283,2,2,12,5,7,390,348,42,0
2021,Swindon 013A,E01015481,758,542,263,279,24,24,75,46,29,115,102,13,2
2021,Swindon 013B,E01015482,517,463,273,190,2,2,8,2,6,44,31,13,0
2021,Swindon 013C,E01015483,636,584,407,177,1,1,10,3,7,41,32,9,0
2021,Swindon 013D,E01015484,630,548,342,206,3,3,8,2,6,70,52,18,1
2021,Swindon 013E,E01015485,655,499,219,280,1,1,15,5,10,140,122,18,0
2021,Swindon 013F,E01015486,619,474,295,179,2,2,64,32,32,79,74,5,0
2021,Swindon 023A,E01015487,598,537,316,221,0,0,4,0,4,57,50,7,0
2021,Swindon 023B,E01015488,654,340,169,171,1,1,242,54,188,71,65,6,0
2021,Swindon 023C,E01015489,552,479,269,210,2,2,24,9,15,47,41,6,0
2021,Swindon 023D,E01015490,539,399,202,197,3,3,42,35,7,93,82,11,2
2021,Swindon 023E,E01015491,701,308,153,155,3,3,323,124,199,66,53,13,1
2021,Swindon 023F,E01015492,532,339,158,181,2,2,128,108,20,63,59,4,0
2021,Swindon 017B,E01015493,736,467,196,271,0,0,5,5,0,264,239,25,0
2021,Swindon 019A,E01015494,909,347,132,215,14,14,40,8,32,508,485,23,0
2021,Swindon 019C,E01015496,830,396,149,247,14,14,19,9,10,401,371,30,0
2021,Swindon 019D,E01015497,704,418,176,242,5,5,50,17,33,231,220,11,0
2021,Swindon 021B,E01015498,759,523,250,273,2,2,14,11,3,220,205,15,0
2021,Swindon 018A,E01015499,531,456,222,234,6,6,19,4,15,50,49,1,0
2021,Swindon 018B,E01015500,650,490,241,249,4,4,20,12,8,136,126,10,0
2021,Swindon 022A,E01015501,513,445,218,227,0,0,8,0,8,60,51,9,0
2021,Swindon 022B,E01015502,621,306,119,187,5,5,199,103,96,109,89,20,2
2021,Swindon 022C,E01015503,600,252,102,150,1,1,259,189,70,85,76,9,3
2021,Swindon 018C,E01015504,514,401,189,212,33,33,40,3,37,40,34,6,0
2021,Swindon 018D,E01015505,667,383,161,222,0,0,115,17,98,168,160,8,1
2021,Swindon 007A,E01015506,631,333,166,167,0,0,210,184,26,85,72,13,3
2021,Swindon 007B,E01015507,629,169,72,97,0,0,413,355,58,44,39,5,3
2021,Swindon 010A,E01015508,633,290,126,164,0,0,259,217,42,80,71,9,4
2021,Swindon 010B,E01015509,702,459,182,277,4,4,66,28,38,172,154,18,1
2021,Swindon 010C,E01015510,852,403,163,240,1,1,153,120,33,290,253,37,5
2021,Swindon 010D,E01015511,696,449,183,266,1,1,34,7,27,212,193,19,0
2021,Swindon 028C,E01015512,606,475,194,281,1,1,7,2,5,123,113,10,0
2021,Swindon 004A,E01015513,665,495,211,284,6,6,4,3,1,160,149,11,0
2021,Swindon 004B,E01015514,521,483,329,154,4,4,9,8,1,25,18,7,0
2021,Swindon 004C,E01015515,589,525,258,267,1,1,2,1,1,61,57,4,0
2021,Swindon 004D,E01015516,611,374,227,147,0,0,169,81,88,67,64,3,1
2021,Swindon 004E,E01015517,663,602,424,178,2,2,8,3,5,51,41,10,0
2021,Swindon 028D,E01015518,535,446,159,287,1,1,5,1,4,83,75,8,0
2021,Swindon 001A,E01015519,697,333,197,136,0,0,293,225,68,67,49,18,4
2021,Swindon 001B,E01015520,583,412,262,150,4,4,47,39,8,120,107,13,0
2021,Swindon 001C,E01015521,663,580,315,265,4,4,22,9,13,57,51,6,0
2021,Swindon 001D,E01015522,627,477,277,200,1,1,59,7,52,90,79,11,0
2021,Swindon 001E,E01015523,708,564,360,204,7,7,47,33,14,88,73,15,2
2021,Swindon 001F,E01015524,470,339,163,176,1,1,67,62,5,63,57,6,0
2021,Swindon 026A,E01015525,674,552,230,322,1,1,6,3,3,115,113,2,0
2021,Swindon 006A,E01015526,604,457,179,278,0,0,44,37,7,103,89,14,0
2021,Swindon 007C,E01015527,659,420,199,221,1,1,167,114,53,68,52,16,3
2021,Swindon 006B,E01015528,912,375,163,212,23,23,412,294,118,101,89,12,1
2021,Swindon 006C,E01015529,684,492,287,205,3,3,74,69,5,114,94,20,1
2021,Swindon 006D,E01015530,818,461,171,290,10,10,263,242,21,84,75,9,0
2021,Swindon 021D,E01015532,667,432,197,235,12,12,19,5,14,204,185,19,0
2021,Swindon 024A,E01015533,670,597,392,205,0,0,10,6,4,61,51,10,2
2021,Swindon 024B,E01015534,1126,603,355,248,9,9,134,7,127,380,357,23,0
2021,Swindon 024C,E01015535,875,611,339,272,58,58,81,6,75,124,113,11,1
2021,Swindon 020A,E01015537,680,327,129,198,3,3,277,250,27,67,51,16,6
2021,Swindon 016A,E01015538,836,260,111,149,24,24,460,425,35,85,75,10,7
2021,Swindon 020B,E01015539,608,366,171,195,3,3,166,147,19,70,53,17,3
2021,Swindon 020C,E01015540,699,291,120,171,7,7,305,281,24,94,78,16,2
2021,Swindon 020D,E01015541,739,288,136,152,8,8,346,304,42,93,84,9,4
2021,Swindon 020E,E01015542,541,219,92,127,1,1,268,248,20,49,39,10,4
2021,Swindon 003A,E01015543,669,421,235,186,1,1,189,176,13,57,47,10,1
2021,Swindon 003B,E01015544,743,230,107,123,9,9,438,415,23,62,56,6,4
2021,Swindon 003C,E01015545,685,168,81,87,2,2,455,444,11,54,48,6,6
2021,Swindon 003D,E01015546,717,182,88,94,2,2,490,458,32,40,33,7,3
2021,Swindon 008C,E01015547,704,572,270,302,1,1,65,46,19,66,50,16,0
2021,Swindon 008D,E01015548,646,545,308,237,1,1,31,21,10,69,48,21,0
2021,Swindon 009A,E01015549,687,583,315,268,5,5,18,2,16,81,77,4,0
2021,Swindon 009B,E01015550,863,676,408,268,7,7,37,5,32,142,122,20,1
2021,Swindon 009C,E01015551,701,585,339,246,6,6,38,19,19,70,58,12,2
2021,Swindon 009D,E01015552,918,634,288,346,8,8,121,34,87,152,137,15,3
2021,Swindon 009E,E01015553,673,515,239,276,15,15,6,6,0,137,127,10,0
2021,Swindon 009F,E01015554,612,430,263,167,1,1,152,74,78,27,24,3,2
2021,Swindon 005A,E01015555,688,477,291,186,0,0,136,128,8,70,55,15,5
2021,Swindon 005B,E01015556,674,544,292,252,0,0,33,8,25,96,79,17,1
2021,Swindon 005C,E01015557,804,642,337,305,16,16,46,13,33,100,90,10,0
2021,Swindon 005D,E01015558,630,184,97,87,0,0,404,293,111,37,32,5,5
2021,Swindon 005E,E01015559,641,492,271,221,1,1,76,74,2,70,60,10,2
2021,Swindon 005F,E01015560,836,682,307,375,13,13,34,7,27,107,89,18,0
2021,Swindon 014A,E01015561,711,495,225,270,19,19,20,4,16,177,162,15,0
2021,Swindon 011A,E01015562,602,408,168,240,13,13,75,1,74,106,99,7,0
2021,Swindon 011B,E01015563,602,503,219,284,0,0,5,2,3,94,89,5,0
2021,Swindon 014B,E01015564,622,537,268,269,0,0,7,1,6,78,69,9,0
2021,Swindon 011C,E01015565,632,391,178,213,4,4,104,98,6,131,120,11,2
2021,Swindon 011D,E01015566,680,499,210,289,2,2,7,0,7,172,160,12,0
2021,Swindon 014C,E01015567,723,459,222,237,4,4,61,7,54,199,182,17,0
2021,Swindon 014D,E01015568,779,420,206,214,6,6,36,22,14,309,279,30,8
2021,Swindon 022D,E01015569,629,344,194,150,3,3,232,153,79,49,42,7,1
2021,Swindon 022E,E01015570,731,259,120,139,2,2,373,255,118,93,84,9,4
2021,Swindon 022F,E01015571,651,497,281,216,4,4,44,34,10,105,88,17,1
2021,Swindon 016B,E01015572,510,162,65,97,0,0,306,279,27,39,36,3,3
2021,Swindon 016C,E01015573,935,242,93,149,57,57,529,377,152,103,92,11,4
2021,Swindon 017C,E01015574,632,501,266,235,0,0,64,2,62,67,58,9,0
2021,Swindon 016D,E01015575,502,159,85,74,0,0,293,266,27,47,44,3,3
2021,Swindon 017D,E01015576,674,549,327,222,6,6,53,3,50,66,55,11,0
2021,Swindon 012B,E01015578,1035,486,189,297,7,7,100,66,34,441,427,14,1
2021,Swindon 012C,E01015579,697,481,188,293,6,6,42,7,35,168,149,19,0
2021,Swindon 007D,E01015580,633,420,226,194,1,1,164,159,5,47,39,8,1
2021,Swindon 012D,E01015581,652,540,262,278,5,5,22,11,11,85,74,11,0
2021,Swindon 012E,E01015582,871,554,232,322,9,9,55,15,40,253,243,10,0
2021,Swindon 025B,E01015584,652,545,356,189,0,0,70,67,3,37,29,8,0
2021,Swindon 025C,E01015585,827,659,332,327,14,14,83,38,45,69,60,9,2
2021,Swindon 025D,E01015586,624,569,402,167,3,3,22,15,7,30,24,6,0
2021,Swindon 025E,E01015587,854,495,288,207,6,6,245,172,73,108,91,17,0
2021,Swindon 025F,E01015588,730,533,309,224,1,1,146,130,16,50,42,8,0
2021,Peterborough 004A,E01015589,779,648,347,301,9,9,46,10,36,76,57,19,0
2021,Peterborough 004B,E01015590,640,437,246,191,12,12,106,27,79,84,67,17,1
2021,Peterborough 011A,E01015591,594,429,277,152,1,1,62,28,34,102,84,18,0
2021,Peterborough 011B,E01015592,630,325,171,154,6,6,133,45,88,165,148,17,1
2021,Peterborough 009A,E01015593,625,230,95,135,4,4,227,76,151,163,150,13,1
2021,Peterborough 011C,E01015594,922,395,198,197,27,27,187,51,136,311,296,15,2
2021,Peterborough 011D,E01015595,710,284,163,121,2,2,265,75,190,158,151,7,1
2021,Peterborough 009B,E01015596,609,247,127,120,1,1,154,57,97,204,192,12,3
2021,Peterborough 011E,E01015597,644,178,79,99,0,0,331,87,244,133,125,8,2
2021,Peterborough 015A,E01015598,637,479,282,197,0,0,75,8,67,82,74,8,1
2021,Peterborough 014A,E01015599,1115,183,93,90,24,24,264,89,175,642,601,41,2
2021,Peterborough 014B,E01015600,579,264,188,76,4,4,64,24,40,244,205,39,3
2021,Peterborough 012A,E01015601,588,312,165,147,2,2,27,12,15,247,223,24,0
2021,Peterborough 010A,E01015603,818,294,145,149,4,4,107,27,80,413,379,34,0
2021,Peterborough 010B,E01015604,533,246,102,144,1,1,51,13,38,235,205,30,0
2021,Peterborough 008A,E01015605,639,311,131,180,3,3,210,80,130,111,98,13,4
2021,Peterborough 013A,E01015606,735,486,263,223,3,3,113,36,77,133,118,15,0
2021,Peterborough 007A,E01015607,763,229,80,149,28,28,390,150,240,110,102,8,6
2021,Peterborough 008B,E01015608,645,343,172,171,8,8,160,73,87,132,115,17,2
2021,Peterborough 007B,E01015609,668,151,74,77,4,4,398,227,171,113,106,7,2
2021,Peterborough 008C,E01015610,745,306,124,182,23,23,305,132,173,111,102,9,0
2021,Peterborough 014D,E01015612,935,347,159,188,6,6,111,22,89,469,442,27,2
2021,Peterborough 013C,E01015613,656,296,186,110,2,2,225,62,163,127,114,13,6
2021,Peterborough 013D,E01015614,862,397,151,246,58,58,149,44,105,258,253,5,0
2021,Peterborough 013E,E01015615,736,394,195,199,9,9,200,65,135,133,120,13,0
2021,Peterborough 013F,E01015616,786,217,74,143,2,2,304,156,148,258,237,21,5
2021,Peterborough 005A,E01015617,632,466,234,232,2,2,23,7,16,141,114,27,0
2021,Peterborough 005B,E01015618,534,354,163,191,14,14,94,25,69,72,58,14,0
2021,Peterborough 005C,E01015619,973,495,219,276,16,16,279,77,202,180,155,25,3
2021,Peterborough 005D,E01015620,916,775,393,382,9,9,25,4,21,107,94,13,0
2021,Peterborough 016A,E01015622,1140,464,184,280,23,23,175,44,131,478,449,29,0
2021,Peterborough 017B,E01015623,772,454,245,209,1,1,119,39,80,198,178,20,0
2021,Peterborough 017C,E01015624,732,414,183,231,4,4,60,18,42,253,238,15,1
2021,Peterborough 004C,E01015626,525,190,58,132,2,2,55,18,37,278,114,164,0
2021,Peterborough 018A,E01015627,779,539,320,219,10,10,67,21,46,163,126,37,0
2021,Peterborough 004D,E01015628,764,499,220,279,6,6,46,9,37,213,150,63,0
2021,Peterborough 001A,E01015629,696,602,346,256,2,2,51,14,37,41,34,7,0
2021,Peterborough 003A,E01015630,785,520,269,251,19,19,133,56,77,113,89,24,0
2021,Peterborough 003B,E01015631,595,519,255,264,0,0,27,13,14,49,42,7,0
2021,Peterborough 010C,E01015632,716,292,123,169,2,2,160,66,94,262,252,10,0
2021,Peterborough 008D,E01015633,1003,470,229,241,19,19,354,114,240,160,142,18,0
2021,Peterborough 008E,E01015634,754,305,134,171,5,5,296,104,192,147,134,13,1
2021,Peterborough 001B,E01015635,650,594,362,232,4,4,11,3,8,40,28,12,1
2021,Peterborough 001C,E01015636,480,408,239,169,1,1,33,10,23,38,26,12,0
2021,Peterborough 021A,E01015637,590,232,90,142,1,1,183,78,105,171,158,13,3
2021,Peterborough 022A,E01015638,621,480,288,192,2,2,74,12,62,65,55,10,0
2021,Peterborough 021B,E01015639,716,195,82,113,4,4,338,97,241,177,163,14,2
2021,Peterborough 021C,E01015640,610,341,166,175,4,4,101,37,64,162,150,12,2
2021,Peterborough 021D,E01015641,572,292,154,138,2,2,134,42,92,141,124,17,3
2021,Peterborough 021E,E01015642,590,172,65,107,2,2,250,88,162,164,155,9,2
2021,Peterborough 023A,E01015643,597,354,178,176,8,8,111,26,85,123,112,11,1
2021,Peterborough 018B,E01015644,1021,677,233,444,14,14,102,40,62,228,214,14,0
2021,Peterborough 018C,E01015645,771,494,276,218,3,3,106,21,85,168,159,9,0
2021,Peterborough 018D,E01015646,890,792,550,242,2,2,13,4,9,83,73,10,0
2021,Peterborough 021F,E01015647,695,171,83,88,2,2,302,91,211,219,208,11,1
2021,Peterborough 018E,E01015648,605,529,372,157,0,0,49,6,43,27,21,6,0
2021,Peterborough 022B,E01015650,871,586,279,307,4,4,63,10,53,218,194,24,0
2021,Peterborough 012B,E01015651,663,488,243,245,5,5,13,10,3,157,143,14,0
2021,Peterborough 012C,E01015652,645,376,164,212,3,3,28,7,21,236,217,19,2
2021,Peterborough 012D,E01015653,655,476,262,214,4,4,55,14,41,120,102,18,0
2021,Peterborough 012E,E01015654,910,317,146,171,9,9,161,34,127,423,403,20,0
2021,Peterborough 014E,E01015655,848,406,219,187,2,2,24,4,20,416,388,28,0
2021,Peterborough 007C,E01015656,677,292,139,153,1,1,317,74,243,65,59,6,2
2021,Peterborough 007E,E01015658,663,191,82,109,4,4,352,136,216,114,107,7,2
2021,Peterborough 003C,E01015659,841,580,237,343,6,6,35,13,22,220,203,17,0
2021,Peterborough 007F,E01015660,753,369,165,204,5,5,255,112,143,124,112,12,0
2021,Peterborough 010D,E01015661,615,308,144,164,2,2,154,57,97,151,138,13,0
2021,Peterborough 009C,E01015662,481,234,116,118,1,1,81,34,47,163,158,5,2
2021,Peterborough 009D,E01015663,689,160,69,91,14,14,400,139,261,111,97,14,4
2021,Peterborough 009E,E01015664,658,186,82,104,6,6,341,151,190,122,115,7,3
2021,Peterborough 016C,E01015665,584,292,115,177,3,3,102,34,68,185,166,19,2
2021,Peterborough 017D,E01015666,676,295,158,137,5,5,234,52,182,141,134,7,1
2021,Peterborough 019A,E01015667,642,352,151,201,2,2,150,49,101,138,123,15,0
2021,Peterborough 017E,E01015668,923,310,132,178,38,38,242,45,197,332,301,31,1
2021,Peterborough 019B,E01015669,626,430,249,181,0,0,91,31,60,105,93,12,0
2021,Peterborough 019C,E01015670,605,472,287,185,1,1,64,27,37,68,54,14,0
2021,Peterborough 019E,E01015672,643,504,282,222,2,2,43,7,36,94,81,13,0
2021,Peterborough 019F,E01015673,654,271,136,135,3,3,296,83,213,82,70,12,2
2021,Peterborough 006A,E01015674,671,360,152,208,3,3,213,77,136,94,86,8,1
2021,Peterborough 006B,E01015675,690,518,263,255,3,3,70,23,47,98,87,11,1
2021,Peterborough 006C,E01015676,826,448,213,235,15,15,166,38,128,196,185,11,1
2021,Peterborough 010E,E01015677,517,268,127,141,6,6,57,18,39,186,170,16,0
2021,Peterborough 002A,E01015678,567,420,190,230,13,13,28,4,24,106,95,11,0
2021,Peterborough 001D,E01015679,841,532,303,229,10,10,89,22,67,210,195,15,0
2021,Peterborough 002B,E01015680,629,236,91,145,2,2,247,71,176,144,135,9,0
2021,Peterborough 002C,E01015681,596,479,246,233,18,18,40,2,38,59,56,3,0
2021,Peterborough 002D,E01015682,680,430,210,220,1,1,60,4,56,189,177,12,0
2021,Peterborough 006D,E01015683,869,703,479,224,2,2,68,12,56,96,86,10,0
2021,Peterborough 003D,E01015684,619,589,422,167,0,0,7,3,4,23,18,5,0
2021,Peterborough 003E,E01015685,709,620,405,215,0,0,12,2,10,77,65,12,0
2021,Peterborough 006E,E01015686,714,605,426,179,3,3,10,1,9,96,80,16,0
2021,Peterborough 015B,E01015687,645,566,355,211,0,0,8,4,4,71,61,10,0
2021,Peterborough 016D,E01015688,1023,505,245,260,17,17,118,31,87,382,352,30,1
2021,Peterborough 015C,E01015689,626,508,349,159,1,1,29,5,24,88,76,12,0
2021,Peterborough 015D,E01015690,505,406,259,147,3,3,13,4,9,83,64,19,0
2021,Peterborough 015E,E01015691,645,462,218,244,18,18,62,22,40,103,88,15,0
2021,Peterborough 016E,E01015692,532,267,132,135,10,10,37,10,27,218,203,15,0
2021,Luton 007A,E01015693,529,484,210,274,0,0,4,3,1,41,35,6,0
2021,Luton 007B,E01015694,492,423,218,205,2,2,2,1,1,65,56,9,0
2021,Luton 007C,E01015695,496,422,155,267,0,0,4,2,2,70,56,14,0
2021,Luton 007D,E01015696,503,343,129,214,0,0,19,2,17,141,133,8,0
2021,Luton 007E,E01015697,641,489,246,243,2,2,8,2,6,142,133,9,0
2021,Luton 017A,E01015698,561,196,116,80,2,2,68,32,36,295,272,23,0
2021,Luton 017B,E01015699,787,178,109,69,3,3,186,117,69,419,407,12,1
2021,Luton 010A,E01015700,799,455,173,282,4,4,84,42,42,253,237,16,3
2021,Luton 010B,E01015701,525,328,152,176,2,2,33,20,13,162,142,20,0
2021,Luton 017C,E01015702,470,274,127,147,1,1,51,13,38,144,131,13,0
2021,Luton 015A,E01015703,464,336,181,155,0,0,28,3,25,100,89,11,0
2021,Luton 010C,E01015704,576,248,103,145,0,0,65,12,53,261,244,17,2
2021,Luton 017D,E01015705,486,145,64,81,0,0,76,29,47,260,236,24,5
2021,Luton 001A,E01015706,605,441,255,186,0,0,69,59,10,94,86,8,1
2021,Luton 001B,E01015707,599,481,246,235,7,7,8,4,4,103,96,7,0
2021,Luton 001C,E01015708,514,456,248,208,0,0,6,4,2,52,48,4,0
2021,Luton 001D,E01015709,622,452,230,222,0,0,26,6,20,143,135,8,1
2021,Luton 001E,E01015710,652,500,265,235,0,0,10,4,6,141,130,11,1
2021,Luton 011A,E01015711,542,375,169,206,3,3,13,6,7,151,142,9,0
2021,Luton 011B,E01015712,637,433,228,205,3,3,9,5,4,192,170,22,0
2021,Luton 013A,E01015713,519,376,204,172,3,3,40,24,16,100,89,11,0
2021,Luton 013B,E01015714,687,415,233,182,0,0,80,68,12,192,176,16,0
2021,Luton 011C,E01015715,627,390,169,221,3,3,121,16,105,113,104,9,0
2021,Luton 011D,E01015716,679,274,78,196,2,2,219,11,208,184,167,17,0
2021,Luton 011E,E01015717,507,307,142,165,2,2,40,17,23,158,137,21,0
2021,Luton 013C,E01015718,581,379,223,156,13,13,56,21,35,133,121,12,0
2021,Luton 016A,E01015719,894,604,254,350,4,4,30,18,12,256,238,18,0
2021,Luton 016B,E01015720,625,233,77,156,15,15,225,174,51,151,144,7,1
2021,Luton 014A,E01015721,656,471,224,247,0,0,46,43,3,138,129,9,1
2021,Luton 014B,E01015722,556,311,135,176,11,11,82,59,23,152,142,10,0
2021,Luton 016C,E01015723,503,324,140,184,1,1,58,16,42,120,109,11,0
2021,Luton 019A,E01015724,742,361,148,213,3,3,44,8,36,334,313,21,0
2021,Luton 017E,E01015725,494,177,71,106,1,1,114,52,62,200,186,14,2
2021,Luton 015B,E01015726,584,313,164,149,2,2,91,30,61,178,156,22,0
2021,Luton 017F,E01015727,571,252,103,149,4,4,83,8,75,232,212,20,0
2021,Luton 019B,E01015728,517,276,124,152,3,3,25,2,23,213,192,21,0
2021,Luton 019C,E01015729,706,189,119,70,6,6,121,31,90,390,375,15,0
2021,Luton 019D,E01015730,763,236,99,137,2,2,86,29,57,438,417,21,1
2021,Luton 015C,E01015731,550,321,132,189,2,2,20,8,12,207,185,22,0
2021,Luton 020A,E01015732,594,226,95,131,2,2,298,142,156,68,56,12,0
2021,Luton 020B,E01015733,625,303,135,168,0,0,252,228,24,69,54,15,1
2021,Luton 020C,E01015734,726,453,206,247,8,8,90,78,12,172,150,22,3
2021,Luton 020D,E01015735,776,202,119,83,3,3,134,107,27,433,425,8,4
2021,Luton 020E,E01015736,761,277,106,171,24,24,358,261,97,98,89,9,4
2021,Luton 020F,E01015737,487,295,118,177,1,1,101,95,6,88,79,9,2
2021,Luton 021A,E01015738,870,314,141,173,3,3,71,26,45,480,466,14,2
2021,Luton 022A,E01015739,966,282,147,135,3,3,27,11,16,652,631,21,2
2021,Luton 012A,E01015740,604,356,185,171,3,3,14,9,5,231,219,12,0
2021,Luton 022B,E01015742,814,295,117,178,3,3,50,19,31,465,452,13,1
2021,Luton 022E,E01015743,760,210,88,122,22,22,145,50,95,383,372,11,0
2021,Luton 004A,E01015744,643,323,127,196,4,4,202,197,5,113,103,10,1
2021,Luton 007F,E01015745,544,481,289,192,0,0,0,0,0,63,59,4,0
2021,Luton 004B,E01015746,620,466,277,189,1,1,56,2,54,97,82,15,0
2021,Luton 004C,E01015747,475,446,281,165,1,1,7,6,1,21,20,1,0
2021,Luton 004D,E01015748,739,571,364,207,3,3,50,46,4,115,88,27,0
2021,Luton 005A,E01015749,714,241,103,138,4,4,397,367,30,72,64,8,0
2021,Luton 011F,E01015750,762,433,152,281,5,5,59,33,26,264,249,15,1
2021,Luton 005B,E01015751,725,397,174,223,13,13,205,134,71,108,94,14,2
2021,Luton 005C,E01015752,484,348,159,189,1,1,57,43,14,78,71,7,0
2021,Luton 005D,E01015753,661,437,176,261,9,9,75,43,32,140,130,10,0
2021,Luton 005E,E01015754,802,270,134,136,0,0,432,290,142,100,93,7,0
2021,Luton 005F,E01015755,684,449,243,206,0,0,114,34,80,121,110,11,0
2021,Luton 009A,E01015756,696,424,155,269,6,6,143,88,55,121,109,12,2
2021,Luton 009B,E01015757,618,303,139,164,3,3,247,213,34,64,57,7,1
2021,Luton 009C,E01015758,528,287,86,201,1,1,144,133,11,96,89,7,0
2021,Luton 009D,E01015759,616,230,102,128,0,0,276,193,83,107,98,9,3
2021,Luton 009E,E01015760,589,232,102,130,0,0,286,217,69,67,63,4,4
2021,Luton 009F,E01015761,611,357,139,218,3,3,163,148,15,86,69,17,2
2021,Luton 013D,E01015762,674,447,202,245,0,0,26,19,7,201,184,17,0
2021,Luton 013E,E01015763,632,470,256,214,1,1,76,59,17,85,74,11,0
2021,Luton 006A,E01015764,593,491,296,195,1,1,12,10,2,89,77,12,0
2021,Luton 006B,E01015765,709,330,172,158,0,0,109,83,26,267,255,12,3
2021,Luton 006C,E01015766,551,407,187,220,0,0,24,7,17,120,113,7,0
2021,Luton 006D,E01015767,599,425,205,220,2,2,21,18,3,151,146,5,0
2021,Luton 006E,E01015768,580,442,262,180,8,8,52,42,10,77,67,10,1
2021,Luton 003A,E01015769,498,295,131,164,4,4,99,57,42,100,92,8,0
2021,Luton 001F,E01015770,496,440,251,189,1,1,13,6,7,42,39,3,0
2021,Luton 003B,E01015771,583,153,64,89,2,2,354,336,18,67,60,7,7
2021,Luton 003C,E01015772,593,234,98,136,0,0,227,178,49,128,113,15,4
2021,Luton 003D,E01015773,458,174,61,113,13,13,203,192,11,67,60,7,1
2021,Luton 003E,E01015774,513,235,87,148,0,0,147,136,11,131,119,12,0
2021,Luton 012B,E01015775,815,502,225,277,3,3,36,9,27,274,264,10,0
2021,Luton 012C,E01015776,731,475,245,230,1,1,135,97,38,120,106,14,0
2021,Luton 012D,E01015777,731,425,207,218,2,2,89,24,65,215,203,12,0
2021,Luton 012E,E01015778,674,452,199,253,2,2,13,10,3,207,185,22,0
2021,Luton 016D,E01015779,505,215,104,111,1,1,245,244,1,40,36,4,4
2021,Luton 016E,E01015780,629,447,209,238,2,2,44,43,1,136,121,15,0
2021,Luton 016F,E01015781,539,336,135,201,1,1,105,92,13,97,92,5,0
2021,Luton 010D,E01015782,661,452,184,268,0,0,31,15,16,177,160,17,1
2021,Luton 006F,E01015783,535,304,101,203,0,0,114,107,7,115,103,12,2
2021,Luton 010E,E01015784,543,415,137,278,2,2,18,11,7,108,95,13,0
2021,Luton 006G,E01015785,915,425,186,239,9,9,62,42,20,417,393,24,2
2021,Luton 010F,E01015786,589,356,163,193,1,1,23,6,17,209,188,21,0
2021,Luton 015D,E01015787,756,379,148,231,54,54,116,12,104,205,188,17,2
2021,Luton 015E,E01015788,474,291,155,136,1,1,53,25,28,128,112,16,1
2021,Luton 023D,E01015789,982,80,41,39,4,4,563,489,74,327,314,13,8
2021,Luton 021B,E01015790,594,321,154,167,3,3,61,53,8,208,193,15,1
2021,Luton 021D,E01015792,732,234,112,122,3,3,76,35,41,419,394,25,0
2021,Luton 021E,E01015793,664,372,177,195,0,0,60,8,52,231,218,13,1
2021,Luton 021F,E01015795,1054,136,61,75,2,2,180,80,100,734,722,12,2
2021,Luton 012F,E01015796,646,481,305,176,4,4,48,40,8,112,99,13,1
2021,Luton 008A,E01015797,523,473,302,171,0,0,14,1,13,36,32,4,0
2021,Luton 008B,E01015798,543,348,176,172,2,2,117,51,66,74,63,11,2
2021,Luton 008C,E01015799,575,483,265,218,3,3,13,7,6,76,63,13,0
2021,Luton 008D,E01015800,616,476,228,248,1,1,7,3,4,132,114,18,0
2021,Luton 002A,E01015801,801,356,157,199,9,9,265,235,30,168,158,10,3
2021,Luton 003F,E01015802,608,281,126,155,2,2,258,203,55,66,53,13,1
2021,Luton 002B,E01015803,609,512,268,244,1,1,12,10,2,84,71,13,0
2021,Luton 002C,E01015804,714,463,209,254,1,1,116,25,91,134,122,12,0
2021,Luton 002D,E01015805,488,431,244,187,0,0,5,3,2,51,46,5,1
2021,Luton 014C,E01015806,583,377,174,203,2,2,22,6,16,182,174,8,0
2021,Luton 016G,E01015807,616,358,143,215,15,15,156,121,35,85,77,8,2
2021,Luton 014D,E01015808,620,383,167,216,1,1,36,22,14,198,182,16,2
2021,Luton 014E,E01015809,513,449,237,212,1,1,11,5,6,52,45,7,0
2021,Luton 014F,E01015810,514,288,128,160,0,0,121,5,116,105,100,5,0
2021,Luton 014G,E01015811,580,440,239,201,1,1,8,1,7,131,121,10,0
2021,Luton 008E,E01015812,521,440,215,225,1,1,5,4,1,75,68,7,0
2021,Luton 008F,E01015813,722,311,171,140,1,1,225,218,7,181,178,3,4
2021,Southend-on-Sea 003A,E01015814,606,431,240,191,0,0,100,78,22,74,60,14,1
2021,Southend-on-Sea 003B,E01015815,640,539,279,260,0,0,6,3,3,95,86,9,0
2021,Southend-on-Sea 003C,E01015816,786,590,389,201,1,1,81,61,20,114,97,17,0
2021,Southend-on-Sea 003D,E01015817,742,681,426,255,1,1,4,4,0,56,36,20,0
2021,Southend-on-Sea 003E,E01015818,792,594,366,228,4,4,67,48,19,126,107,19,1
2021,Southend-on-Sea 003F,E01015819,634,376,209,167,2,2,151,118,33,103,91,12,2
2021,Southend-on-Sea 005A,E01015820,673,289,138,151,11,11,279,201,78,91,79,12,3
2021,Southend-on-Sea 005B,E01015821,754,567,314,253,3,3,56,36,20,128,113,15,0
2021,Southend-on-Sea 005C,E01015822,501,412,192,220,0,0,15,4,11,74,67,7,0
2021,Southend-on-Sea 005D,E01015823,738,558,257,301,12,12,8,5,3,160,142,18,0
2021,Southend-on-Sea 005E,E01015824,628,324,128,196,0,0,220,197,23,84,74,10,0
2021,Southend-on-Sea 005F,E01015825,585,409,202,207,1,1,124,113,11,50,43,7,1
2021,Southend-on-Sea 005G,E01015826,567,449,241,208,2,2,46,34,12,70,55,15,0
2021,Southend-on-Sea 012A,E01015827,701,528,286,242,1,1,13,7,6,159,137,22,0
2021,Southend-on-Sea 012B,E01015828,937,297,116,181,19,19,96,35,61,524,510,14,1
2021,Southend-on-Sea 012C,E01015829,654,435,197,238,1,1,4,2,2,214,204,10,0
2021,Southend-on-Sea 012D,E01015830,623,517,284,233,1,1,6,2,4,99,83,16,0
2021,Southend-on-Sea 012E,E01015831,791,346,142,204,2,2,24,8,16,419,402,17,0
2021,Southend-on-Sea 012F,E01015832,766,497,316,181,1,1,73,36,37,193,179,14,2
2021,Southend-on-Sea 001A,E01015833,637,579,357,222,1,1,8,5,3,49,40,9,0
2021,Southend-on-Sea 001B,E01015834,629,551,324,227,0,0,9,5,4,69,59,10,0
2021,Southend-on-Sea 001C,E01015835,760,503,286,217,4,4,80,44,36,173,152,21,0
2021,Southend-on-Sea 001D,E01015836,653,583,354,229,2,2,9,1,8,59,50,9,0
2021,Southend-on-Sea 001E,E01015837,745,577,283,294,0,0,56,24,32,112,88,24,0
2021,Southend-on-Sea 001F,E01015838,636,586,383,203,1,1,2,2,0,47,39,8,0
2021,Southend-on-Sea 014A,E01015839,820,340,158,182,15,15,110,29,81,355,335,20,0
2021,Southend-on-Sea 014B,E01015840,783,332,138,194,3,3,103,20,83,345,328,17,0
2021,Southend-on-Sea 014C,E01015841,1189,348,151,197,17,17,80,15,65,744,709,35,0
2021,Southend-on-Sea 014D,E01015842,963,106,51,55,3,3,689,75,614,164,157,7,1
2021,Southend-on-Sea 014E,E01015843,744,351,154,197,6,6,64,12,52,323,310,13,0
2021,Southend-on-Sea 014F,E01015844,1061,369,134,235,9,9,292,171,121,390,368,22,1
2021,Southend-on-Sea 011A,E01015845,692,516,207,309,2,2,4,2,2,170,158,12,0
2021,Southend-on-Sea 011B,E01015846,841,559,259,300,2,2,12,5,7,268,240,28,0
2021,Southend-on-Sea 011C,E01015847,773,452,194,258,0,0,12,5,7,309,288,21,0
2021,Southend-on-Sea 011D,E01015848,937,577,355,222,2,2,26,14,12,332,295,37,0
2021,Southend-on-Sea 011E,E01015849,791,495,202,293,3,3,24,14,10,269,237,32,0
2021,Southend-on-Sea 011F,E01015850,674,527,232,295,3,3,5,2,3,139,126,13,0
2021,Southend-on-Sea 015A,E01015851,1008,482,319,163,2,2,28,13,15,496,462,34,0
2021,Southend-on-Sea 015B,E01015852,1115,309,161,148,6,6,69,22,47,731,703,28,0
2021,Southend-on-Sea 015C,E01015853,933,456,244,212,1,1,26,12,14,450,424,26,0
2021,Southend-on-Sea 015D,E01015854,825,287,104,183,5,5,52,8,44,480,466,14,1
2021,Southend-on-Sea 015E,E01015855,950,363,156,207,2,2,45,18,27,539,522,17,1
2021,Southend-on-Sea 015F,E01015856,836,409,158,251,4,4,23,2,21,400,376,24,0
2021,Southend-on-Sea 004A,E01015857,665,600,366,234,2,2,9,4,5,54,47,7,0
2021,Southend-on-Sea 004B,E01015858,724,572,299,273,1,1,22,7,15,129,114,15,0
2021,Southend-on-Sea 004C,E01015859,796,533,283,250,2,2,102,27,75,158,143,15,1
2021,Southend-on-Sea 004D,E01015860,635,510,275,235,1,1,13,2,11,111,95,16,0
2021,Southend-on-Sea 004E,E01015861,881,435,171,264,0,0,236,160,76,210,198,12,0
2021,Southend-on-Sea 004F,E01015862,742,393,170,223,0,0,44,22,22,305,290,15,0
2021,Southend-on-Sea 002A,E01015863,999,704,332,372,6,6,146,105,41,140,125,15,3
2021,Southend-on-Sea 002B,E01015864,599,498,276,222,2,2,52,41,11,47,38,9,0
2021,Southend-on-Sea 002C,E01015865,651,534,324,210,1,1,16,5,11,100,83,17,0
2021,Southend-on-Sea 002D,E01015866,904,745,366,379,28,28,33,6,27,98,85,13,0
2021,Southend-on-Sea 002E,E01015867,652,308,178,130,2,2,217,168,49,123,115,8,2
2021,Southend-on-Sea 002F,E01015868,676,389,200,189,0,0,141,113,28,146,133,13,0
2021,Southend-on-Sea 006A,E01015869,643,416,178,238,1,1,48,38,10,178,165,13,0
2021,Southend-on-Sea 006B,E01015870,653,432,193,239,0,0,19,9,10,202,189,13,0
2021,Southend-on-Sea 006C,E01015871,645,486,248,238,1,1,59,48,11,99,88,11,0
2021,Southend-on-Sea 006D,E01015872,682,460,196,264,3,3,15,4,11,204,185,19,0
2021,Southend-on-Sea 006E,E01015873,541,344,143,201,1,1,14,5,9,182,165,17,0
2021,Southend-on-Sea 006F,E01015874,744,484,216,268,11,11,72,48,24,177,163,14,0
2021,Southend-on-Sea 006G,E01015875,732,317,142,175,9,9,252,186,66,148,138,10,6
2021,Southend-on-Sea 013A,E01015876,1042,838,449,389,22,22,27,7,20,155,138,17,0
2021,Southend-on-Sea 013B,E01015877,906,459,204,255,20,20,221,106,115,206,187,19,0
2021,Southend-on-Sea 013C,E01015878,583,392,209,183,0,0,43,1,42,148,133,15,0
2021,Southend-on-Sea 013D,E01015879,595,239,107,132,12,12,221,38,183,123,116,7,0
2021,Southend-on-Sea 013E,E01015880,659,229,113,116,0,0,314,213,101,116,106,10,0
2021,Southend-on-Sea 013F,E01015881,583,384,209,175,0,0,136,38,98,63,48,15,0
2021,Southend-on-Sea 013G,E01015882,773,380,192,188,6,6,182,62,120,205,193,12,0
2021,Southend-on-Sea 009A,E01015883,561,500,305,195,0,0,5,4,1,56,44,12,0
2021,Southend-on-Sea 009B,E01015884,1055,558,276,282,18,18,146,55,91,328,305,23,5
2021,Southend-on-Sea 009C,E01015885,712,659,438,221,0,0,6,2,4,47,40,7,0
2021,Southend-on-Sea 009D,E01015886,623,198,92,106,3,3,357,242,115,65,54,11,0
2021,Southend-on-Sea 009E,E01015887,603,247,131,116,1,1,257,144,113,97,89,8,1
2021,Southend-on-Sea 009F,E01015888,647,513,369,144,0,0,74,12,62,60,50,10,0
2021,Southend-on-Sea 016A,E01015889,618,544,390,154,1,1,4,2,2,69,55,14,0
2021,Southend-on-Sea 016B,E01015890,642,527,308,219,2,2,10,8,2,103,87,16,0
2021,Southend-on-Sea 016C,E01015891,689,431,214,217,3,3,10,2,8,245,216,29,0
2021,Southend-on-Sea 016D,E01015892,634,502,236,266,0,0,12,5,7,120,109,11,0
2021,Southend-on-Sea 016E,E01015893,767,703,550,153,4,4,13,7,6,47,34,13,0
2021,Southend-on-Sea 016F,E01015894,601,540,304,236,3,3,8,1,7,50,45,5,0
2021,Southend-on-Sea 010B,E01015896,887,285,147,138,4,4,240,152,88,358,292,66,0
2021,Southend-on-Sea 010C,E01015897,910,310,125,185,53,53,381,285,96,164,147,17,2
2021,Southend-on-Sea 010D,E01015898,918,416,177,239,2,2,125,71,54,375,357,18,0
2021,Southend-on-Sea 010E,E01015899,871,431,194,237,15,15,99,25,74,326,307,19,0
2021,Southend-on-Sea 010F,E01015900,698,297,113,184,3,3,54,17,37,344,324,20,0
2021,Southend-on-Sea 007A,E01015901,649,352,135,217,1,1,10,6,4,286,260,26,0
2021,Southend-on-Sea 007B,E01015902,699,328,126,202,1,1,10,8,2,360,336,24,0
2021,Southend-on-Sea 007C,E01015903,674,427,165,262,5,5,9,3,6,233,211,22,0
2021,Southend-on-Sea 007D,E01015904,741,470,185,285,0,0,16,1,15,255,233,22,0
2021,Southend-on-Sea 007E,E01015905,619,391,143,248,1,1,6,2,4,221,203,18,0
2021,Southend-on-Sea 007F,E01015906,615,331,135,196,4,4,27,9,18,253,241,12,0
2021,Southend-on-Sea 007G,E01015907,635,350,136,214,3,3,20,4,16,261,235,26,1
2021,Southend-on-Sea 008A,E01015908,636,564,299,265,1,1,5,2,3,66,55,11,0
2021,Southend-on-Sea 008B,E01015909,635,456,194,262,0,0,28,18,10,151,141,10,0
2021,Southend-on-Sea 008C,E01015910,630,551,285,266,0,0,7,3,4,72,64,8,0
2021,Southend-on-Sea 008D,E01015911,502,458,246,212,7,7,13,2,11,24,22,2,0
2021,Southend-on-Sea 008E,E01015912,650,568,322,246,0,0,24,20,4,58,53,5,0
2021,Southend-on-Sea 008F,E01015913,806,520,270,250,1,1,33,10,23,252,234,18,0
2021,Southend-on-Sea 017A,E01015914,496,469,270,199,2,2,3,2,1,22,20,2,0
2021,Southend-on-Sea 017B,E01015915,612,520,318,202,6,6,15,11,4,71,59,12,0
2021,Southend-on-Sea 017C,E01015916,507,163,85,78,2,2,290,247,43,52,50,2,0
2021,Southend-on-Sea 017D,E01015917,624,241,98,143,0,0,233,128,105,150,140,10,0
2021,Southend-on-Sea 017E,E01015918,546,381,168,213,0,0,10,8,2,155,140,15,0
2021,Southend-on-Sea 017F,E01015919,500,392,195,197,4,4,59,34,25,45,42,3,0
2021,Southend-on-Sea 017G,E01015920,640,569,353,216,2,2,1,0,1,67,56,11,1
2021,Thurrock 021A,E01015921,545,331,97,234,6,6,39,38,1,169,151,18,0
2021,Thurrock 008A,E01015922,575,283,93,190,0,0,253,247,6,39,33,6,0
2021,Thurrock 008B,E01015923,885,557,150,407,19,19,187,146,41,121,106,15,1
2021,Thurrock 008C,E01015924,587,394,148,246,0,0,129,122,7,64,60,4,0
2021,Thurrock 008D,E01015925,673,575,239,336,1,1,41,40,1,56,46,10,0
2021,Thurrock 008E,E01015926,821,563,208,355,12,12,147,99,48,98,83,15,1
2021,Thurrock 007A,E01015927,660,359,112,247,3,3,234,216,18,63,49,14,1
2021,Thurrock 007B,E01015928,638,446,178,268,2,2,116,110,6,71,61,10,3
2021,Thurrock 007C,E01015929,652,259,91,168,2,2,324,308,16,66,62,4,1
2021,Thurrock 007D,E01015930,662,426,140,286,0,0,149,121,28,87,77,10,0
2021,Thurrock 007E,E01015931,659,255,76,179,4,4,284,277,7,116,107,9,0
2021,Thurrock 006A,E01015932,621,409,203,206,8,8,120,118,2,84,72,12,0
2021,Thurrock 012A,E01015933,636,415,158,257,0,0,151,142,9,68,57,11,2
2021,Thurrock 012B,E01015934,510,277,103,174,2,2,190,185,5,41,35,6,0
2021,Thurrock 012C,E01015935,627,340,125,215,1,1,197,196,1,89,83,6,0
2021,Thurrock 012D,E01015936,740,383,174,209,1,1,293,283,10,63,55,8,0
2021,Thurrock 012E,E01015937,670,510,315,195,0,0,108,106,2,52,45,7,0
2021,Thurrock 012F,E01015938,778,286,154,132,1,1,426,356,70,64,56,8,1
2021,Thurrock 020A,E01015939,549,448,140,308,1,1,2,1,1,98,87,11,0
2021,Thurrock 020B,E01015941,521,386,112,274,2,2,5,2,3,128,122,6,0
2021,Thurrock 020C,E01015942,562,440,161,279,0,0,17,14,3,105,94,11,0
2021,Thurrock 001A,E01015943,612,513,288,225,0,0,7,2,5,92,81,11,0
2021,Thurrock 001B,E01015944,517,472,285,187,0,0,1,0,1,44,36,8,0
2021,Thurrock 002A,E01015945,513,415,238,177,0,0,49,39,10,49,35,14,0
2021,Thurrock 001C,E01015946,631,540,283,257,3,3,16,15,1,72,63,9,0
2021,Thurrock 013A,E01015947,547,339,125,214,0,0,52,40,12,156,147,9,0
2021,Thurrock 013B,E01015948,914,600,191,409,28,28,94,19,75,191,179,12,1
2021,Thurrock 013C,E01015949,653,509,214,295,5,5,70,37,33,69,59,10,0
2021,Thurrock 013D,E01015950,688,568,293,275,0,0,22,5,17,98,82,16,0
2021,Thurrock 017A,E01015951,670,313,99,214,6,6,113,30,83,237,224,13,1
2021,Thurrock 017B,E01015952,926,375,126,249,5,5,167,130,37,378,361,17,1
2021,Thurrock 017C,E01015953,1128,503,110,393,15,15,126,25,101,484,454,30,0
2021,Thurrock 017D,E01015954,1047,277,73,204,17,17,468,428,40,281,268,13,4
2021,Thurrock 016A,E01015955,688,507,176,331,2,2,14,10,4,165,152,13,0
2021,Thurrock 016B,E01015956,815,372,135,237,11,11,75,46,29,356,345,11,1
2021,Thurrock 009A,E01015957,611,289,107,182,1,1,244,237,7,75,69,6,2
2021,Thurrock 009B,E01015958,467,281,126,155,2,2,129,125,4,55,52,3,0
2021,Thurrock 016C,E01015959,707,376,158,218,11,11,123,80,43,197,184,13,0
2021,Thurrock 014A,E01015960,544,408,200,208,0,0,86,84,2,50,38,12,0
2021,Thurrock 016D,E01015961,612,407,179,228,1,1,20,16,4,184,166,18,0
2021,Thurrock 016E,E01015962,619,295,106,189,2,2,66,54,12,256,226,30,0
2021,Thurrock 010A,E01015963,482,218,104,114,1,1,221,213,8,42,35,7,0
2021,Thurrock 010B,E01015964,598,505,266,239,0,0,27,25,2,66,55,11,0
2021,Thurrock 010C,E01015965,947,835,341,494,7,7,25,5,20,80,65,15,0
2021,Thurrock 010D,E01015966,630,571,346,225,2,2,8,7,1,49,36,13,0
2021,Thurrock 014B,E01015967,590,470,214,256,1,1,24,20,4,95,78,17,0
2021,Thurrock 014C,E01015968,600,452,241,211,2,2,21,8,13,124,111,13,1
2021,Thurrock 014D,E01015969,775,517,221,296,0,0,91,72,19,164,148,16,3
2021,Thurrock 014E,E01015970,498,403,181,222,6,6,12,7,5,77,71,6,0
2021,Thurrock 006B,E01015971,683,366,151,215,0,0,173,167,6,143,131,12,1
2021,Thurrock 006C,E01015972,716,417,158,259,1,1,218,199,19,78,65,13,2
2021,Thurrock 006E,E01015974,548,457,187,270,0,0,53,49,4,38,31,7,0
2021,Thurrock 006F,E01015975,625,447,197,250,1,1,105,90,15,72,62,10,0
2021,Thurrock 007F,E01015976,754,331,112,219,1,1,350,315,35,72,65,7,0
2021,Thurrock 004A,E01015977,735,535,278,257,0,0,78,72,6,122,108,14,0
2021,Thurrock 004B,E01015978,559,470,248,222,1,1,11,10,1,77,59,18,0
2021,Thurrock 004C,E01015979,552,472,186,286,0,0,1,1,0,79,66,13,0
2021,Thurrock 004D,E01015980,612,515,310,205,3,3,39,36,3,55,45,10,0
2021,Thurrock 019A,E01015982,892,664,144,520,1,1,8,4,4,219,212,7,0
2021,Thurrock 002B,E01015983,633,476,294,182,0,0,35,18,17,122,106,16,0
2021,Thurrock 003A,E01015984,487,426,223,203,1,1,16,12,4,43,37,6,1
2021,Thurrock 003B,E01015985,622,512,335,177,4,4,57,52,5,48,35,13,1
2021,Thurrock 003C,E01015986,608,302,113,189,2,2,229,80,149,74,61,13,1
2021,Thurrock 002C,E01015987,592,345,170,175,1,1,164,142,22,80,72,8,2
2021,Thurrock 002D,E01015988,590,257,93,164,0,0,267,257,10,66,58,8,0
2021,Thurrock 005A,E01015989,705,413,182,231,3,3,44,24,20,245,225,20,0
2021,Thurrock 003D,E01015990,592,396,182,214,1,1,143,141,2,52,44,8,0
2021,Thurrock 005B,E01015991,683,532,243,289,10,10,52,11,41,89,79,10,0
2021,Thurrock 005C,E01015992,1090,721,243,478,24,24,140,50,90,205,187,18,0
2021,Thurrock 009C,E01015993,641,432,198,234,2,2,160,137,23,47,39,8,0
2021,Thurrock 009D,E01015994,691,433,210,223,7,7,212,176,36,38,30,8,1
2021,Thurrock 009E,E01015995,608,571,301,270,0,0,6,5,1,31,23,8,0
2021,Thurrock 009F,E01015996,623,356,141,215,3,3,221,216,5,43,41,2,0
2021,Thurrock 001D,E01015997,513,476,252,224,1,1,2,2,0,34,27,7,0
2021,Thurrock 002E,E01015998,588,492,258,234,3,3,37,34,3,56,49,7,0
2021,Thurrock 001E,E01015999,490,447,215,232,1,1,2,1,1,40,35,5,0
2021,Thurrock 005D,E01016000,590,473,227,246,0,0,21,18,3,96,81,15,0
2021,Thurrock 003E,E01016001,519,460,218,242,0,0,12,7,5,47,35,12,0
2021,Thurrock 005E,E01016002,523,487,260,227,0,0,2,1,1,34,30,4,0
2021,Thurrock 018A,E01016003,941,462,169,293,11,11,96,85,11,371,352,19,1
2021,Thurrock 018B,E01016004,706,257,97,160,0,0,344,278,66,103,93,10,2
2021,Thurrock 018C,E01016005,555,301,115,186,1,1,149,90,59,104,101,3,0
2021,Thurrock 018D,E01016006,646,136,37,99,0,0,434,419,15,75,67,8,1
2021,Thurrock 018E,E01016007,646,209,80,129,1,1,300,257,43,136,122,14,0
2021,Thurrock 018F,E01016008,589,381,154,227,2,2,44,31,13,162,149,13,0
2021,Thurrock 018G,E01016009,640,276,97,179,8,8,249,232,17,106,99,7,1
2021,Thurrock 018H,E01016010,496,185,53,132,0,0,254,232,22,55,49,6,2
2021,Thurrock 022A,E01016011,740,344,86,258,1,1,64,23,41,331,306,25,0
2021,Thurrock 021C,E01016013,1081,542,136,406,12,12,67,31,36,459,440,19,1
2021,Thurrock 021B,E01016014,1019,391,78,313,35,35,341,284,57,248,238,10,4
2021,Thurrock 022B,E01016015,932,598,166,432,19,19,97,51,46,218,206,12,0
2021,Medway 015A,E01016016,640,280,139,141,8,8,164,35,129,187,170,17,1
2021,Medway 015B,E01016017,822,235,100,135,5,5,256,54,202,326,317,9,0
2021,Medway 022A,E01016018,726,334,130,204,11,11,67,28,39,310,300,10,4
2021,Medway 015C,E01016019,647,282,106,176,5,5,65,18,47,294,279,15,1
2021,Medway 021A,E01016020,516,269,126,143,2,2,102,21,81,143,131,12,0
2021,Medway 021B,E01016021,609,342,166,176,3,3,34,10,24,230,221,9,0
2021,Medway 021C,E01016022,536,273,136,137,1,1,69,10,59,193,181,12,0
2021,Medway 022B,E01016023,618,198,74,124,0,0,337,74,263,82,76,6,1
2021,Medway 022C,E01016024,752,360,125,235,2,2,36,9,27,354,336,18,0
2021,Medway 027A,E01016025,624,345,175,170,2,2,211,50,161,66,58,8,0
2021,Medway 028A,E01016026,539,449,209,240,20,20,14,3,11,56,48,8,0
2021,Medway 028B,E01016027,580,539,283,256,0,0,7,3,4,34,25,9,0
2021,Medway 028C,E01016028,663,559,327,232,6,6,41,7,34,56,47,9,1
2021,Medway 028D,E01016029,880,622,209,413,35,35,142,9,133,80,74,6,1
2021,Medway 010A,E01016030,695,363,161,202,20,20,235,149,86,77,64,13,0
2021,Medway 012A,E01016031,807,203,71,132,5,5,231,178,53,367,360,7,1
2021,Medway 010B,E01016032,467,120,59,61,1,1,275,101,174,71,67,4,0
2021,Medway 009A,E01016033,491,171,84,87,2,2,239,212,27,76,69,7,3
2021,Medway 010C,E01016034,1030,663,253,410,59,59,52,5,47,256,234,22,0
2021,Medway 007A,E01016035,750,272,126,146,1,1,169,38,131,308,296,12,0
2021,Medway 009C,E01016037,655,324,141,183,10,10,39,15,24,282,271,11,0
2021,Medway 010D,E01016038,628,377,160,217,1,1,64,26,38,185,174,11,1
2021,Medway 009D,E01016039,664,300,134,166,3,3,35,10,25,326,302,24,0
2021,Medway 013A,E01016040,703,364,167,197,15,15,66,23,43,258,243,15,0
2021,Medway 012B,E01016041,706,323,154,169,8,8,55,8,47,319,299,20,1
2021,Medway 013B,E01016042,544,293,123,170,2,2,29,18,11,220,206,14,0
2021,Medway 013C,E01016043,548,395,170,225,0,0,54,50,4,98,83,15,1
2021,Medway 016A,E01016044,688,367,165,202,1,1,31,16,15,289,267,22,0
2021,Medway 012C,E01016045,613,345,148,197,3,3,24,8,16,241,228,13,0
2021,Medway 016B,E01016046,625,318,144,174,0,0,19,5,14,288,266,22,0
2021,Medway 016C,E01016047,656,317,144,173,2,2,37,9,28,300,289,11,0
2021,Medway 016D,E01016048,669,368,157,211,2,2,16,4,12,283,254,29,0
2021,Medway 012D,E01016049,884,289,131,158,6,6,195,109,86,391,369,22,3
2021,Medway 035A,E01016050,667,596,330,266,0,0,11,4,7,60,52,8,0
2021,Medway 035B,E01016051,598,514,263,251,2,2,2,0,2,80,71,9,0
2021,Medway 035C,E01016052,651,607,362,245,2,2,3,0,3,39,28,11,0
2021,Medway 035D,E01016053,641,570,371,199,1,1,10,2,8,60,51,9,0
2021,Medway 035E,E01016054,639,556,307,249,2,2,6,3,3,75,66,9,0
2021,Medway 038A,E01016055,618,437,202,235,6,6,95,8,87,80,74,6,0
2021,Medway 038B,E01016056,642,400,158,242,26,26,61,8,53,154,138,16,1
2021,Medway 038C,E01016057,653,527,236,291,9,9,34,6,28,83,78,5,0
2021,Medway 031A,E01016058,619,505,251,254,1,1,14,3,11,99,84,15,0
2021,Medway 031B,E01016059,531,281,109,172,4,4,170,33,137,76,67,9,0
2021,Medway 038D,E01016060,628,579,325,254,4,4,7,3,4,38,30,8,0
2021,Medway 020A,E01016061,658,324,127,197,2,2,40,15,25,289,276,13,3
2021,Medway 022D,E01016062,601,307,136,171,8,8,136,29,107,148,134,14,2
2021,Medway 020B,E01016063,681,229,96,133,1,1,203,40,163,248,232,16,0
2021,Medway 020C,E01016064,741,342,150,192,25,25,186,25,161,188,175,13,0
2021,Medway 027B,E01016065,628,459,235,224,2,2,96,11,85,71,57,14,0
2021,Medway 027C,E01016066,658,382,164,218,11,11,180,34,146,85,71,14,0
2021,Medway 027D,E01016067,638,411,187,224,5,5,148,29,119,74,66,8,0
2021,Medway 027E,E01016068,667,309,121,188,3,3,276,35,241,78,72,6,1
2021,Medway 020D,E01016069,709,267,105,162,7,7,80,14,66,352,325,27,3
2021,Medway 001A,E01016070,700,581,340,241,5,5,48,12,36,66,58,8,0
2021,Medway 001B,E01016071,653,482,220,262,6,6,64,7,57,101,84,17,0
2021,Medway 001C,E01016072,527,372,172,200,1,1,98,14,84,56,38,18,0
2021,Medway 003A,E01016073,854,726,367,359,10,10,43,5,38,75,56,19,0
2021,Medway 001D,E01016074,983,806,550,256,18,18,68,16,52,91,69,22,0
2021,Medway 003B,E01016075,658,543,253,290,8,8,73,17,56,34,29,5,0
2021,Medway 003D,E01016077,670,419,241,178,14,14,133,18,115,104,88,16,0
2021,Medway 034A,E01016078,665,449,126,323,7,7,12,1,11,197,191,6,0
2021,Medway 031C,E01016079,480,391,172,219,6,6,44,14,30,39,32,7,0
2021,Medway 034B,E01016080,610,446,176,270,13,13,50,6,44,101,89,12,0
2021,Medway 034C,E01016081,581,484,169,315,7,7,13,3,10,77,69,8,0
2021,Medway 034D,E01016082,576,474,185,289,6,6,10,5,5,85,74,11,1
2021,Medway 031D,E01016083,561,229,105,124,4,4,265,45,220,62,58,4,1
2021,Medway 031E,E01016084,506,299,103,196,6,6,151,32,119,50,47,3,0
2021,Medway 030A,E01016085,672,599,395,204,5,5,5,1,4,63,55,8,0
2021,Medway 030B,E01016086,511,484,284,200,4,4,3,1,2,20,11,9,0
2021,Medway 029A,E01016087,702,555,313,242,2,2,22,5,17,123,109,14,0
2021,Medway 029B,E01016088,590,430,219,211,0,0,99,84,15,59,50,9,2
2021,Medway 029C,E01016089,667,506,286,220,4,4,71,64,7,86,75,11,0
2021,Medway 029D,E01016090,613,561,317,244,1,1,4,2,2,47,38,9,0
2021,Medway 030C,E01016091,617,552,347,205,0,0,37,35,2,26,21,5,2
2021,Medway 036A,E01016092,625,549,300,249,4,4,7,0,7,65,56,9,0
2021,Medway 023A,E01016093,766,692,396,296,5,5,26,9,17,43,35,8,0
2021,Medway 025A,E01016094,670,537,261,276,18,18,22,1,21,93,86,7,0
2021,Medway 025B,E01016095,542,425,188,237,0,0,25,15,10,92,85,7,0
2021,Medway 023B,E01016096,672,552,338,214,13,13,22,10,12,85,68,17,0
2021,Medway 025C,E01016097,628,391,194,197,4,4,89,79,10,142,120,22,2
2021,Medway 025D,E01016098,714,302,170,132,5,5,116,66,50,291,271,20,0
2021,Medway 036B,E01016099,622,482,205,277,1,1,14,5,9,125,113,12,0
2021,Medway 036C,E01016100,649,440,224,216,3,3,110,102,8,95,85,10,1
2021,Medway 032A,E01016101,564,457,211,246,3,3,10,2,8,94,81,13,0
2021,Medway 025E,E01016102,621,291,159,132,2,2,201,79,122,126,117,9,1
2021,Medway 032B,E01016103,727,601,284,317,14,14,26,3,23,85,74,11,1
2021,Medway 032C,E01016104,562,462,210,252,1,1,7,3,4,92,86,6,0
2021,Medway 036D,E01016105,585,503,310,193,4,4,5,4,1,73,63,10,0
2021,Medway 036E,E01016106,593,476,259,217,4,4,38,4,34,75,65,10,0
2021,Medway 032D,E01016107,603,514,236,278,1,1,8,3,5,80,74,6,0
2021,Medway 015E,E01016111,763,149,76,73,18,18,342,57,285,251,156,95,3
2021,Medway 017A,E01016113,596,468,227,241,5,5,39,2,37,84,74,10,0
2021,Medway 017B,E01016114,613,327,135,192,4,4,88,12,76,193,180,13,1
2021,Medway 017C,E01016115,771,427,214,213,54,54,201,15,186,89,81,8,0
2021,Medway 024A,E01016116,748,440,202,238,1,1,226,29,197,80,68,12,1
2021,Medway 014A,E01016117,949,269,98,171,13,13,329,47,282,338,326,12,0
2021,Medway 017D,E01016118,757,508,201,307,3,3,14,5,9,232,210,22,0
2021,Medway 026A,E01016119,550,450,277,173,18,18,33,1,32,48,36,12,1
2021,Medway 026B,E01016120,589,342,164,178,5,5,175,26,149,67,61,6,0
2021,Medway 033A,E01016121,635,551,323,228,3,3,14,1,13,67,52,15,0
2021,Medway 033B,E01016122,954,759,331,428,56,56,42,9,33,97,87,10,0
2021,Medway 033C,E01016123,636,509,266,243,2,2,49,12,37,76,63,13,0
2021,Medway 026C,E01016124,683,534,280,254,4,4,35,3,32,110,102,8,0
2021,Medway 021D,E01016125,652,478,205,273,5,5,9,1,8,160,143,17,0
2021,Medway 026D,E01016126,610,506,250,256,3,3,27,2,25,74,64,10,0
2021,Medway 024B,E01016127,679,441,233,208,3,3,106,17,89,129,114,15,0
2021,Medway 024C,E01016128,565,384,187,197,15,15,99,10,89,67,56,11,0
2021,Medway 014B,E01016129,944,385,176,209,7,7,255,40,215,295,282,13,2
2021,Medway 014C,E01016130,955,428,222,206,53,53,98,3,95,376,324,52,0
2021,Medway 014D,E01016131,815,471,168,303,3,3,177,5,172,164,136,28,0
2021,Medway 024D,E01016132,680,555,266,289,15,15,20,3,17,90,76,14,0
2021,Medway 005A,E01016133,552,511,308,203,2,2,3,2,1,36,29,7,0
2021,Medway 005B,E01016134,533,413,219,194,8,8,68,3,65,44,35,9,0
2021,Medway 006A,E01016135,619,446,195,251,8,8,41,5,36,124,111,13,0
2021,Medway 006B,E01016136,674,336,141,195,10,10,164,16,148,164,145,19,0
2021,Medway 006C,E01016137,635,354,140,214,7,7,49,8,41,225,209,16,0
2021,Medway 005C,E01016138,587,533,333,200,2,2,7,2,5,45,37,8,0
2021,Medway 005D,E01016139,613,519,240,279,3,3,22,2,20,69,60,9,0
2021,Medway 006D,E01016140,629,289,147,142,3,3,94,9,85,243,222,21,0
2021,Medway 006E,E01016141,744,425,167,258,11,11,19,2,17,289,267,22,0
2021,Medway 002A,E01016142,534,469,225,244,1,1,8,1,7,56,44,12,0
2021,Medway 003E,E01016143,1134,786,294,492,42,42,172,21,151,134,121,13,0
2021,Medway 002B,E01016144,587,497,294,203,4,4,33,4,29,53,39,14,0
2021,Medway 002C,E01016145,506,465,204,261,1,1,20,0,20,20,15,5,0
2021,Medway 004B,E01016147,742,618,324,294,3,3,13,3,10,107,88,19,1
2021,Medway 004C,E01016148,811,700,316,384,9,9,46,7,39,56,52,4,0
2021,Medway 002D,E01016149,600,407,191,216,13,13,108,19,89,72,61,11,0
2021,Medway 011A,E01016150,625,331,123,208,7,7,173,32,141,114,102,12,0
2021,Medway 008A,E01016151,630,462,196,266,6,6,63,12,51,99,83,16,0
2021,Medway 008B,E01016152,645,331,169,162,4,4,253,37,216,57,44,13,0
2021,Medway 008C,E01016153,605,249,117,132,1,1,263,53,210,92,82,10,0
2021,Medway 011B,E01016154,693,445,215,230,6,6,41,6,35,201,184,17,0
2021,Medway 008D,E01016155,615,380,201,179,16,16,158,17,141,61,47,14,0
2021,Medway 011C,E01016156,664,476,162,314,13,13,67,7,60,108,96,12,0
2021,Medway 011D,E01016157,900,633,212,421,46,46,115,21,94,106,90,16,0
2021,Medway 011E,E01016158,984,649,242,407,39,39,171,24,147,125,114,11,0
2021,Medway 019A,E01016159,554,236,87,149,9,9,259,233,26,47,40,7,3
2021,Medway 018A,E01016160,616,338,170,168,1,1,207,173,34,70,61,9,0
2021,Medway 018B,E01016161,743,291,133,158,2,2,359,286,73,86,75,11,5
2021,Medway 018C,E01016162,635,511,255,256,5,5,20,8,12,99,92,7,0
2021,Medway 018D,E01016163,509,376,171,205,3,3,88,61,27,42,29,13,0
2021,Medway 018E,E01016164,646,391,186,205,6,6,168,142,26,79,68,11,2
2021,Medway 018F,E01016165,520,433,218,215,3,3,43,42,1,41,35,6,0
2021,Medway 023C,E01016166,611,509,269,240,5,5,39,29,10,58,52,6,0
2021,Medway 023D,E01016167,581,460,255,205,1,1,70,63,7,47,40,7,3
2021,Medway 037A,E01016168,665,436,212,224,0,0,162,36,126,65,57,8,2
2021,Medway 037B,E01016169,621,554,272,282,4,4,10,2,8,53,45,8,0
2021,Medway 038E,E01016170,625,477,208,269,7,7,20,5,15,121,107,14,0
2021,Medway 037C,E01016171,646,356,150,206,3,3,225,40,185,62,51,11,0
2021,Medway 037D,E01016172,579,507,279,228,13,13,8,2,6,51,36,15,0
2021,Medway 033D,E01016173,653,397,189,208,17,17,171,31,140,68,57,11,0
2021,Medway 019B,E01016174,509,363,182,181,3,3,12,7,5,131,126,5,0
2021,Medway 019C,E01016175,747,601,317,284,25,25,49,4,45,72,62,10,0
2021,Medway 030D,E01016176,575,504,291,213,1,1,7,4,3,63,52,11,0
2021,Medway 013D,E01016177,616,397,184,213,4,4,62,48,14,153,138,15,0
2021,Medway 013E,E01016178,547,405,180,225,2,2,6,1,5,134,118,16,0
2021,Medway 019D,E01016179,504,424,233,191,0,0,14,3,11,66,56,10,0
2021,Bracknell Forest 005A,E01016180,542,370,180,190,2,2,83,31,52,84,75,9,3
2021,Bracknell Forest 005B,E01016181,652,501,268,233,0,0,11,4,7,140,107,33,0
2021,Bracknell Forest 005C,E01016182,627,498,242,256,0,0,25,9,16,104,94,10,0
2021,Bracknell Forest 005D,E01016183,527,437,188,249,1,1,12,4,8,77,70,7,0
2021,Bracknell Forest 002B,E01016185,625,452,189,263,2,2,9,3,6,162,147,15,0
2021,Bracknell Forest 002D,E01016187,678,586,318,268,4,4,15,7,8,73,62,11,0
2021,Bracknell Forest 002E,E01016188,776,600,217,383,10,10,83,14,69,83,77,6,0
2021,Bracknell Forest 003A,E01016190,616,424,217,207,0,0,143,52,91,47,42,5,2
2021,Bracknell Forest 006B,E01016191,640,450,198,252,9,9,147,60,87,34,29,5,0
2021,Bracknell Forest 014A,E01016192,605,365,163,202,0,0,113,29,84,127,121,6,0
2021,Bracknell Forest 015A,E01016193,532,386,154,232,1,1,54,23,31,91,83,8,0
2021,Bracknell Forest 014B,E01016194,502,477,284,193,0,0,3,0,3,22,20,2,0
2021,Bracknell Forest 014C,E01016195,484,368,132,236,1,1,51,11,40,64,52,12,0
2021,Bracknell Forest 015B,E01016196,497,294,134,160,0,0,26,8,18,177,43,134,0
2021,Bracknell Forest 015C,E01016197,507,369,171,198,3,3,93,19,74,42,33,9,0
2021,Bracknell Forest 015D,E01016198,515,432,251,181,1,1,2,1,1,80,70,10,0
2021,Bracknell Forest 015E,E01016199,467,410,230,180,2,2,4,1,3,51,45,6,0
2021,Bracknell Forest 008A,E01016200,565,399,129,270,12,12,36,17,19,116,105,11,2
2021,Bracknell Forest 008B,E01016201,560,366,132,234,9,9,43,13,30,141,132,9,1
2021,Bracknell Forest 008C,E01016202,616,371,115,256,8,8,18,4,14,219,208,11,0
2021,Bracknell Forest 008D,E01016203,587,262,91,171,2,2,252,105,147,68,62,6,3
2021,Bracknell Forest 008E,E01016204,469,292,101,191,4,4,113,51,62,60,55,5,0
2021,Bracknell Forest 010A,E01016205,543,314,122,192,4,4,143,56,87,82,76,6,0
2021,Bracknell Forest 012A,E01016206,854,655,393,262,3,3,28,8,20,168,149,19,0
2021,Bracknell Forest 013A,E01016207,729,520,156,364,16,16,115,11,104,78,67,11,0
2021,Bracknell Forest 012B,E01016208,911,632,285,347,68,68,83,19,64,128,116,12,0
2021,Bracknell Forest 009A,E01016209,558,402,189,213,3,3,100,53,47,53,50,3,0
2021,Bracknell Forest 009B,E01016210,517,248,91,157,1,1,167,69,98,100,92,8,1
2021,Bracknell Forest 011A,E01016212,493,299,130,169,0,0,140,54,86,54,45,9,0
2021,Bracknell Forest 009D,E01016213,424,343,166,177,9,9,45,19,26,27,21,6,0
2021,Bracknell Forest 009E,E01016214,498,458,258,200,1,1,16,6,10,23,19,4,0
2021,Bracknell Forest 009F,E01016215,477,244,95,149,1,1,177,72,105,55,51,4,0
2021,Bracknell Forest 011B,E01016216,549,349,151,198,0,0,118,49,69,82,74,8,0
2021,Bracknell Forest 010B,E01016217,569,371,143,228,2,2,112,30,82,84,74,10,0
2021,Bracknell Forest 010C,E01016218,634,359,152,207,6,6,193,66,127,76,66,10,0
2021,Bracknell Forest 011C,E01016219,539,401,232,169,2,2,103,29,74,33,30,3,0
2021,Bracknell Forest 011D,E01016220,576,334,127,207,3,3,142,51,91,97,90,7,0
2021,Bracknell Forest 011E,E01016221,573,398,177,221,1,1,79,32,47,95,82,13,0
2021,Bracknell Forest 005E,E01016222,498,425,215,210,2,2,4,0,4,66,66,0,1
2021,Bracknell Forest 006C,E01016223,545,328,132,196,3,3,107,37,70,107,102,5,0
2021,Bracknell Forest 006D,E01016224,874,436,154,282,26,26,275,118,157,134,118,16,3
2021,Bracknell Forest 006E,E01016226,634,355,144,211,5,5,168,61,107,106,91,15,0
2021,Bracknell Forest 014D,E01016227,475,416,174,242,0,0,33,9,24,26,22,4,0
2021,Bracknell Forest 014E,E01016228,678,562,252,310,12,12,45,7,38,59,49,10,0
2021,Bracknell Forest 012C,E01016229,486,436,252,184,0,0,7,1,6,42,37,5,1
2021,Bracknell Forest 012D,E01016230,420,285,181,104,1,1,15,4,11,119,65,54,0
2021,Bracknell Forest 010D,E01016231,732,477,167,310,7,7,160,63,97,87,79,8,1
2021,Bracknell Forest 010E,E01016232,598,419,200,219,1,1,103,39,64,75,68,7,0
2021,Bracknell Forest 007B,E01016233,1051,436,148,288,1,1,434,106,328,179,163,16,1
2021,Bracknell Forest 013B,E01016234,450,390,181,209,2,2,5,2,3,53,47,6,0
2021,Bracknell Forest 013C,E01016235,486,433,206,227,1,1,10,3,7,41,36,5,1
2021,Bracknell Forest 013D,E01016236,573,372,131,241,3,3,137,54,83,61,53,8,0
2021,Bracknell Forest 013E,E01016237,472,400,179,221,4,4,15,4,11,53,51,2,0
2021,Bracknell Forest 003B,E01016238,710,432,184,248,8,8,142,50,92,127,124,3,1
2021,Bracknell Forest 004A,E01016239,614,401,185,216,1,1,161,70,91,48,43,5,3
2021,Bracknell Forest 004B,E01016240,645,337,134,203,1,1,226,74,152,78,70,8,3
2021,Bracknell Forest 004C,E01016241,632,331,124,207,7,7,243,85,158,51,43,8,0
2021,Bracknell Forest 004D,E01016242,990,324,119,205,53,53,313,123,190,298,280,18,2
2021,Bracknell Forest 003C,E01016243,584,412,156,256,5,5,71,4,67,96,91,5,0
2021,Bracknell Forest 003D,E01016245,877,706,294,412,5,5,29,9,20,137,121,16,0
2021,Bracknell Forest 003E,E01016246,607,498,195,303,0,0,3,1,2,106,100,6,0
2021,Bracknell Forest 003F,E01016247,731,546,188,358,23,23,52,11,41,110,105,5,0
2021,Bracknell Forest 007C,E01016248,565,338,149,189,2,2,152,56,96,71,56,15,2
2021,Bracknell Forest 007E,E01016250,762,428,216,212,70,70,119,40,79,142,131,11,3
2021,Bracknell Forest 001C,E01016252,700,555,385,170,6,6,11,6,5,128,89,39,0
2021,Bracknell Forest 001D,E01016253,539,467,205,262,0,0,10,2,8,62,51,11,0
2021,West Berkshire 011A,E01016254,692,553,347,206,12,12,51,5,46,76,49,27,0
2021,West Berkshire 011B,E01016255,584,403,224,179,2,2,71,9,62,107,85,22,1
2021,West Berkshire 003A,E01016256,698,559,286,273,0,0,55,1,54,84,59,25,0
2021,West Berkshire 003B,E01016257,515,406,228,178,3,3,25,1,24,81,68,13,0
2021,West Berkshire 005A,E01016258,685,622,422,200,0,0,5,0,5,58,45,13,0
2021,West Berkshire 006A,E01016259,606,515,251,264,2,2,21,0,21,68,61,7,0
2021,West Berkshire 006B,E01016260,643,576,320,256,1,1,8,1,7,58,46,12,0
2021,West Berkshire 005B,E01016261,591,539,242,297,4,4,14,1,13,34,30,4,0
2021,West Berkshire 006C,E01016262,535,474,292,182,0,0,7,2,5,54,52,2,0
2021,West Berkshire 007A,E01016263,898,634,275,359,27,27,106,5,101,131,118,13,0
2021,West Berkshire 011C,E01016264,413,269,158,111,1,1,23,1,22,120,66,54,0
2021,West Berkshire 011D,E01016265,602,463,289,174,3,3,70,8,62,66,49,17,0
2021,West Berkshire 011E,E01016266,543,413,230,183,3,3,79,12,67,48,36,12,0
2021,West Berkshire 015A,E01016267,582,505,252,253,4,4,23,1,22,50,46,4,0
2021,West Berkshire 015B,E01016268,682,390,198,192,18,18,213,18,195,61,46,15,0
2021,West Berkshire 015C,E01016269,579,468,258,210,1,1,27,4,23,83,69,14,0
2021,West Berkshire 015D,E01016270,538,324,129,195,3,3,32,3,29,179,56,123,0
2021,West Berkshire 008A,E01016271,646,382,178,204,6,6,198,9,189,60,51,9,0
2021,West Berkshire 006D,E01016272,613,520,292,228,1,1,12,1,11,80,74,6,0
2021,West Berkshire 006E,E01016273,691,331,158,173,5,5,285,22,263,69,63,6,1
2021,West Berkshire 008B,E01016274,569,429,224,205,3,3,72,5,67,65,60,5,0
2021,West Berkshire 008C,E01016275,655,468,197,271,4,4,53,4,49,130,115,15,0
2021,West Berkshire 008D,E01016276,582,472,208,264,4,4,6,1,5,100,95,5,0
2021,West Berkshire 001A,E01016277,542,426,249,177,8,8,37,4,33,71,48,23,0
2021,West Berkshire 013A,E01016279,946,442,148,294,21,21,238,24,214,245,230,15,0
2021,West Berkshire 013B,E01016280,688,329,153,176,26,26,197,21,176,136,129,7,0
2021,West Berkshire 013C,E01016281,578,445,241,204,3,3,58,3,55,72,60,12,0
2021,West Berkshire 013D,E01016282,616,420,198,222,14,14,55,8,47,127,119,8,0
2021,West Berkshire 007D,E01016284,529,438,223,215,3,3,47,1,46,41,32,9,0
2021,West Berkshire 007E,E01016285,638,329,179,150,7,7,93,6,87,209,178,31,0
2021,West Berkshire 001B,E01016286,651,423,187,236,7,7,142,6,136,79,66,13,0
2021,West Berkshire 001C,E01016287,586,345,162,183,1,1,94,8,86,146,97,49,0
2021,West Berkshire 001D,E01016288,696,448,243,205,6,6,120,7,113,122,99,23,0
2021,West Berkshire 021A,E01016289,581,511,303,208,2,2,42,3,39,26,19,7,0
2021,West Berkshire 021B,E01016290,627,512,280,232,0,0,16,3,13,99,87,12,0
2021,West Berkshire 021C,E01016291,736,572,298,274,6,6,44,1,43,114,96,18,0
2021,West Berkshire 021D,E01016292,608,414,208,206,4,4,118,14,104,72,65,7,0
2021,West Berkshire 020A,E01016294,653,511,251,260,2,2,18,1,17,122,107,15,0
2021,West Berkshire 020B,E01016295,622,204,83,121,2,2,359,30,329,57,53,4,0
2021,West Berkshire 010A,E01016296,749,446,271,175,17,17,95,7,88,191,181,10,0
2021,West Berkshire 010B,E01016297,715,390,228,162,1,1,256,19,237,68,59,9,0
2021,West Berkshire 010C,E01016298,567,340,214,126,4,4,34,3,31,189,161,28,0
2021,West Berkshire 010D,E01016299,663,445,265,180,1,1,38,4,34,179,166,13,0
2021,West Berkshire 018A,E01016300,636,435,249,186,2,2,115,14,101,84,72,12,0
2021,West Berkshire 018B,E01016301,869,580,366,214,0,0,70,2,68,219,167,52,0
2021,West Berkshire 018C,E01016302,641,443,246,197,5,5,109,8,101,84,62,22,0
2021,West Berkshire 002A,E01016303,632,442,257,185,2,2,79,5,74,109,79,30,0
2021,West Berkshire 002B,E01016304,710,408,248,160,1,1,128,12,116,173,120,53,0
2021,West Berkshire 002C,E01016305,612,364,194,170,3,3,83,8,75,161,99,62,1
2021,West Berkshire 002D,E01016306,554,322,173,149,5,5,163,21,142,64,56,8,0
2021,West Berkshire 022A,E01016307,731,422,224,198,5,5,195,20,175,109,96,13,0
2021,West Berkshire 022B,E01016308,803,655,372,283,10,10,43,3,40,95,76,19,0
2021,West Berkshire 022C,E01016309,964,694,330,364,11,11,101,12,89,158,135,23,0
2021,West Berkshire 012A,E01016310,884,431,249,182,17,17,252,21,231,184,164,20,0
2021,West Berkshire 012B,E01016311,867,499,301,198,6,6,74,10,64,287,264,23,1
2021,West Berkshire 020C,E01016312,877,468,200,268,3,3,200,19,181,206,191,15,0
2021,West Berkshire 003C,E01016313,751,521,305,216,6,6,88,7,81,136,114,22,0
2021,West Berkshire 003D,E01016314,601,439,275,164,10,10,19,1,18,133,97,36,0
2021,West Berkshire 004A,E01016315,724,589,341,248,7,7,15,3,12,113,95,18,0
2021,West Berkshire 004B,E01016316,799,664,328,336,7,7,36,1,35,92,74,18,0
2021,West Berkshire 004C,E01016317,565,441,255,186,6,6,79,6,73,39,34,5,0
2021,West Berkshire 004D,E01016318,629,552,319,233,1,1,14,3,11,62,52,10,0
2021,West Berkshire 020D,E01016319,847,466,234,232,18,18,228,25,203,135,121,14,0
2021,West Berkshire 020E,E01016320,662,411,198,213,8,8,97,18,79,146,132,14,0
2021,West Berkshire 021E,E01016321,685,423,225,198,17,17,100,10,90,145,136,9,0
2021,West Berkshire 021F,E01016322,512,463,245,218,0,0,8,1,7,40,31,9,1
2021,West Berkshire 012C,E01016323,601,435,261,174,2,2,89,2,87,75,66,9,0
2021,West Berkshire 012D,E01016324,591,398,225,173,2,2,96,5,91,95,74,21,0
2021,West Berkshire 012E,E01016325,654,348,177,171,9,9,218,28,190,79,73,6,0
2021,West Berkshire 018D,E01016326,563,373,203,170,2,2,35,0,35,153,116,37,0
2021,West Berkshire 009A,E01016327,495,344,169,175,9,9,66,4,62,76,74,2,0
2021,West Berkshire 009B,E01016328,796,455,177,278,18,18,169,25,144,154,135,19,0
2021,West Berkshire 014A,E01016329,620,503,212,291,4,4,30,0,30,83,77,6,0
2021,West Berkshire 016A,E01016330,671,430,210,220,9,9,105,10,95,127,114,13,0
2021,West Berkshire 016B,E01016331,595,349,140,209,4,4,172,11,161,70,58,12,0
2021,West Berkshire 016C,E01016332,747,420,260,160,18,18,164,17,147,145,126,19,0
2021,West Berkshire 017A,E01016333,505,414,198,216,2,2,9,0,9,80,74,6,0
2021,West Berkshire 016D,E01016334,659,396,146,250,4,4,136,6,130,123,115,8,0
2021,West Berkshire 017B,E01016335,600,501,241,260,2,2,26,0,26,71,63,8,0
2021,West Berkshire 016E,E01016336,536,215,117,98,6,6,272,17,255,42,33,9,1
2021,West Berkshire 017C,E01016337,916,587,236,351,18,18,174,14,160,137,126,11,0
2021,West Berkshire 017D,E01016338,742,612,314,298,5,5,28,3,25,97,90,7,0
2021,West Berkshire 011F,E01016339,1137,821,384,437,34,34,106,5,101,176,161,15,0
2021,West Berkshire 014B,E01016340,791,534,243,291,13,13,159,15,144,85,70,15,0
2021,West Berkshire 014C,E01016341,516,380,177,203,10,10,81,5,76,44,37,7,1
2021,West Berkshire 014D,E01016342,849,630,235,395,18,18,44,1,43,157,140,17,0
2021,West Berkshire 014E,E01016343,582,521,318,203,3,3,17,0,17,41,33,8,0
2021,West Berkshire 009C,E01016344,781,366,178,188,18,18,276,14,262,121,110,11,0
2021,West Berkshire 009D,E01016345,617,454,187,267,3,3,28,3,25,132,123,9,0
2021,West Berkshire 019B,E01016346,784,302,104,198,10,10,191,12,179,281,257,24,0
2021,West Berkshire 019D,E01016348,1111,533,193,340,45,45,160,13,147,373,356,17,0
2021,West Berkshire 005C,E01016349,485,451,232,219,0,0,4,1,3,30,23,7,0
2021,West Berkshire 005D,E01016350,587,545,305,240,0,0,2,0,2,40,33,7,0
2021,Reading 019C,E01016353,885,211,86,125,7,7,114,55,59,551,534,17,2
2021,Reading 007A,E01016355,823,336,147,189,6,6,40,12,28,441,421,20,0
2021,Reading 008A,E01016356,668,251,80,171,4,4,142,8,134,270,250,20,1
2021,Reading 008B,E01016357,754,371,140,231,17,17,29,8,21,337,320,17,0
2021,Reading 007B,E01016358,766,223,99,124,16,16,86,12,74,440,421,19,1
2021,Reading 007C,E01016359,1036,449,159,290,52,52,132,24,108,403,382,21,0
2021,Reading 007D,E01016360,885,304,117,187,3,3,86,12,74,492,453,39,0
2021,Reading 007E,E01016361,786,364,125,239,2,2,31,9,22,389,372,17,0
2021,Reading 004A,E01016362,903,432,215,217,5,5,66,58,8,400,381,19,0
2021,Reading 004B,E01016363,704,201,63,138,43,43,346,99,247,112,109,3,2
2021,Reading 003A,E01016364,599,457,229,228,3,3,4,2,2,135,129,6,0
2021,Reading 004C,E01016365,781,455,197,258,4,4,21,9,12,301,285,16,0
2021,Reading 004D,E01016366,680,436,218,218,5,5,103,25,78,136,125,11,0
2021,Reading 004E,E01016367,700,419,162,257,14,14,111,68,43,154,141,13,2
2021,Reading 017A,E01016368,545,198,73,125,5,5,290,145,145,50,42,8,2
2021,Reading 018A,E01016369,644,460,234,226,1,1,84,71,13,98,86,12,1
2021,Reading 016A,E01016370,471,244,135,109,1,1,82,65,17,140,131,9,4
2021,Reading 016B,E01016371,616,396,234,162,0,0,95,40,55,124,106,18,1
2021,Reading 017B,E01016372,486,180,64,116,4,4,222,148,74,76,65,11,4
2021,Reading 016C,E01016373,547,200,81,119,17,17,229,118,111,101,94,7,0
2021,Reading 014A,E01016374,705,289,111,178,12,12,42,19,23,362,345,17,0
2021,Reading 014B,E01016375,496,162,52,110,1,1,138,90,48,194,186,8,1
2021,Reading 014C,E01016376,785,270,109,161,7,7,105,83,22,402,382,20,1
2021,Reading 017C,E01016377,666,233,102,131,7,7,189,75,114,235,218,17,2
2021,Reading 014D,E01016379,804,248,82,166,7,7,30,21,9,519,491,28,0
2021,Reading 005A,E01016380,703,566,275,291,1,1,14,6,8,122,112,10,0
2021,Reading 006A,E01016381,530,317,117,200,6,6,109,94,15,95,81,14,3
2021,Reading 006B,E01016382,722,309,124,185,0,0,205,156,49,207,191,16,1
2021,Reading 005B,E01016383,666,478,220,258,2,2,48,25,23,134,122,12,4
2021,Reading 005C,E01016384,629,534,287,247,2,2,2,1,1,91,80,11,0
2021,Reading 006C,E01016385,606,472,164,308,5,5,28,17,11,101,90,11,0
2021,Reading 002A,E01016386,612,547,335,212,4,4,8,3,5,53,47,6,0
2021,Reading 002B,E01016387,590,550,294,256,1,1,8,5,3,31,26,5,0
2021,Reading 013A,E01016388,621,402,205,197,1,1,106,35,71,111,105,6,1
2021,Reading 013B,E01016389,697,174,88,86,1,1,426,329,97,93,83,10,3
2021,Reading 013C,E01016390,713,320,162,158,10,10,18,9,9,365,348,17,0
2021,Reading 020E,E01016391,941,317,107,210,16,16,230,59,171,375,357,18,3
2021,Reading 013D,E01016392,1058,429,187,242,4,4,90,18,72,535,508,27,0
2021,Reading 013E,E01016393,770,458,197,261,21,21,96,75,21,195,187,8,0
2021,Reading 009A,E01016394,589,208,107,101,1,1,319,293,26,59,56,3,2
2021,Reading 008C,E01016395,617,389,212,177,8,8,106,31,75,114,98,16,0
2021,Reading 006D,E01016396,663,331,102,229,50,50,176,81,95,103,97,6,3
2021,Reading 006E,E01016397,684,259,80,179,4,4,309,195,114,109,99,10,3
2021,Reading 008D,E01016398,754,364,95,269,24,24,67,28,39,299,286,13,0
2021,Reading 008E,E01016399,584,411,179,232,3,3,48,6,42,122,116,6,0
2021,Reading 008F,E01016400,689,323,138,185,17,17,46,23,23,298,287,11,5
2021,Reading 012A,E01016401,569,320,184,136,3,3,24,6,18,222,209,13,0
2021,Reading 010B,E01016402,630,219,91,128,10,10,19,10,9,382,364,18,0
2021,Reading 012B,E01016403,675,427,202,225,9,9,16,3,13,223,208,15,0
2021,Reading 010C,E01016404,811,338,108,230,13,13,136,38,98,323,292,31,1
2021,Reading 010D,E01016405,669,311,115,196,1,1,23,3,20,334,310,24,0
2021,Reading 010E,E01016406,470,217,116,101,5,5,6,2,4,242,227,15,0
2021,Reading 001A,E01016407,654,515,296,219,7,7,34,6,28,98,83,15,0
2021,Reading 001B,E01016408,579,469,260,209,6,6,18,13,5,86,76,10,0
2021,Reading 003B,E01016409,748,528,270,258,2,2,123,110,13,93,84,9,2
2021,Reading 001C,E01016410,714,566,275,291,11,11,42,24,18,95,81,14,0
2021,Reading 001D,E01016411,668,588,341,247,2,2,40,4,36,38,32,6,0
2021,Reading 001E,E01016412,580,466,220,246,21,21,10,4,6,83,75,8,0
2021,Reading 014E,E01016413,503,262,134,128,3,3,50,17,33,188,174,14,0
2021,Reading 014F,E01016414,771,255,121,134,5,5,82,12,70,429,403,26,0
2021,Reading 016D,E01016415,648,216,109,107,3,3,322,299,23,101,92,9,6
2021,Reading 012C,E01016416,728,174,72,102,3,3,25,6,19,526,516,10,0
2021,Reading 012D,E01016417,552,190,94,96,0,0,30,9,21,332,322,10,0
2021,Reading 012E,E01016418,569,205,92,113,2,2,12,2,10,350,341,9,0
2021,Reading 015A,E01016419,929,471,187,284,19,19,190,108,82,245,226,19,4
2021,Reading 015B,E01016420,624,170,64,106,12,12,398,352,46,37,33,4,7
2021,Reading 015C,E01016421,527,412,235,177,2,2,53,51,2,59,52,7,1
2021,Reading 015D,E01016422,614,322,180,142,0,0,230,66,164,59,57,2,3
2021,Reading 015E,E01016423,598,331,157,174,3,3,210,199,11,51,43,8,3
2021,Reading 015F,E01016424,534,461,216,245,4,4,13,9,4,56,47,9,0
2021,Reading 002C,E01016425,669,582,272,310,4,4,23,6,17,60,56,4,0
2021,Reading 002D,E01016426,512,467,244,223,0,0,3,1,2,42,38,4,0
2021,Reading 003C,E01016427,666,511,264,247,1,1,46,7,39,108,93,15,0
2021,Reading 003D,E01016428,763,544,265,279,4,4,107,72,35,107,96,11,1
2021,Reading 003E,E01016429,634,580,289,291,1,1,6,3,3,47,42,5,0
2021,Reading 002E,E01016430,512,466,214,252,0,0,4,2,2,42,40,2,0
2021,Reading 005D,E01016431,653,541,280,261,1,1,26,23,3,85,76,9,0
2021,Reading 005E,E01016432,627,539,317,222,0,0,11,1,10,77,67,10,0
2021,Reading 009B,E01016433,644,440,229,211,2,2,73,50,23,127,114,13,2
2021,Reading 009C,E01016434,762,501,268,233,1,1,92,80,12,164,153,11,4
2021,Reading 009D,E01016435,622,351,177,174,3,3,199,140,59,63,53,10,6
2021,Reading 009E,E01016436,633,433,180,253,2,2,147,126,21,48,41,7,3
2021,Reading 018B,E01016437,510,318,132,186,5,5,97,76,21,90,83,7,0
2021,Reading 017D,E01016438,526,187,93,94,1,1,253,195,58,81,77,4,4
2021,Reading 018C,E01016439,743,439,137,302,25,25,173,123,50,103,96,7,3
2021,Reading 018D,E01016440,564,312,149,163,4,4,174,143,31,70,62,8,4
2021,Reading 018E,E01016441,586,189,80,109,23,23,320,199,121,51,45,6,3
2021,Reading 017F,E01016443,557,221,70,151,3,3,275,181,94,58,49,9,0
2021,Slough 004A,E01016444,475,249,81,168,3,3,124,106,18,96,87,9,3
2021,Slough 004B,E01016445,521,213,90,123,3,3,208,144,64,96,86,10,1
2021,Slough 004C,E01016446,459,283,123,160,3,3,49,39,10,124,106,18,0
2021,Slough 004D,E01016447,521,281,153,128,1,1,23,12,11,215,203,12,1
2021,Slough 004E,E01016448,764,338,187,151,9,9,91,40,51,325,296,29,1
2021,Slough 004F,E01016449,657,319,108,211,6,6,171,147,24,153,134,19,8
2021,Slough 001A,E01016450,533,197,52,145,2,2,276,149,127,58,54,4,0
2021,Slough 001B,E01016451,617,171,47,124,18,18,351,289,62,76,72,4,1
2021,Slough 001C,E01016452,643,337,115,222,3,3,228,206,22,71,63,8,4
2021,Slough 001D,E01016453,632,369,153,216,1,1,176,147,29,82,70,12,4
2021,Slough 001E,E01016454,597,313,108,205,3,3,205,172,33,73,69,4,3
2021,Slough 001F,E01016455,688,353,82,271,34,34,197,162,35,104,97,7,0
2021,Slough 016D,E01016456,621,258,144,114,5,5,126,60,66,229,214,15,3
2021,Slough 016C,E01016457,561,307,143,164,9,9,49,12,37,196,181,15,0
2021,Slough 015A,E01016458,555,163,71,92,15,15,252,68,184,123,102,21,2
2021,Slough 016A,E01016460,567,344,213,131,5,5,22,18,4,193,184,9,3
2021,Slough 009A,E01016462,760,278,116,162,8,8,90,23,67,384,367,17,0
2021,Slough 009B,E01016463,594,232,93,139,1,1,165,149,16,194,165,29,2
2021,Slough 009C,E01016464,606,258,130,128,0,0,88,73,15,260,244,16,0
2021,Slough 009D,E01016465,927,339,148,191,16,16,130,41,89,441,422,19,1
2021,Slough 006A,E01016467,539,286,116,170,4,4,99,26,73,150,140,10,0
2021,Slough 006B,E01016468,654,462,168,294,7,7,44,12,32,141,137,4,0
2021,Slough 006C,E01016469,666,365,161,204,7,7,97,74,23,196,184,12,1
2021,Slough 006D,E01016470,680,415,189,226,6,6,36,14,22,223,208,15,0
2021,Slough 006E,E01016471,500,335,138,197,2,2,58,54,4,105,95,10,0
2021,Slough 006F,E01016472,589,356,149,207,2,2,158,148,10,73,63,10,0
2021,Slough 008A,E01016473,913,464,113,351,28,28,143,26,117,278,266,12,0
2021,Slough 008B,E01016474,829,344,139,205,8,8,259,189,70,218,205,13,0
2021,Slough 008C,E01016475,630,323,157,166,2,2,105,78,27,199,183,16,1
2021,Slough 008D,E01016476,651,317,81,236,2,2,165,23,142,167,157,10,0
2021,Slough 008E,E01016477,1034,534,160,374,32,32,116,18,98,351,339,12,1
2021,Slough 008F,E01016478,678,387,122,265,11,11,65,46,19,215,208,7,0
2021,Slough 014A,E01016479,540,290,104,186,2,2,41,17,24,207,199,8,0
2021,Slough 014B,E01016480,514,233,94,139,5,5,161,20,141,114,109,5,1
2021,Slough 014C,E01016481,670,220,69,151,28,28,137,21,116,285,270,15,0
2021,Slough 014D,E01016482,674,367,157,210,6,6,29,8,21,272,262,10,0
2021,Slough 002A,E01016483,599,275,143,132,6,6,30,10,20,287,273,14,1
2021,Slough 002B,E01016484,621,289,159,130,1,1,81,31,50,248,240,8,2
2021,Slough 002C,E01016485,539,327,148,179,1,1,44,19,25,167,157,10,0
2021,Slough 002D,E01016486,590,240,92,148,1,1,222,155,67,124,104,20,3
2021,Slough 002E,E01016487,504,309,188,121,1,1,44,26,18,149,133,16,1
2021,Slough 002F,E01016488,668,386,138,248,3,3,36,26,10,243,233,10,0
2021,Slough 013B,E01016490,792,202,79,123,13,13,475,188,287,101,89,12,1
2021,Slough 013C,E01016491,621,440,222,218,2,2,47,42,5,132,119,13,0
2021,Slough 013D,E01016492,608,377,133,244,4,4,102,56,46,125,114,11,0
2021,Slough 003A,E01016493,465,338,150,188,2,2,36,33,3,89,83,6,0
2021,Slough 003B,E01016494,752,325,121,204,14,14,88,26,62,325,313,12,0
2021,Slough 003C,E01016495,623,327,133,194,3,3,82,64,18,210,193,17,1
2021,Slough 003D,E01016496,571,261,105,156,4,4,217,206,11,86,78,8,3
2021,Slough 003E,E01016497,464,391,186,205,2,2,18,17,1,53,50,3,0
2021,Slough 003F,E01016498,621,313,124,189,4,4,159,126,33,145,136,9,0
2021,Slough 003G,E01016499,493,139,47,92,4,4,271,189,82,79,71,8,0
2021,Slough 012A,E01016500,599,379,155,224,5,5,76,50,26,139,135,4,0
2021,Slough 012B,E01016501,611,229,73,156,3,3,307,288,19,71,65,6,1
2021,Slough 012C,E01016502,493,282,99,183,1,1,111,77,34,97,92,5,2
2021,Slough 012D,E01016503,586,286,93,193,6,6,166,155,11,126,114,12,2
2021,Slough 012E,E01016504,471,321,162,159,2,2,52,30,22,96,92,4,0
2021,Slough 012F,E01016505,620,277,99,178,14,14,203,193,10,123,118,5,3
2021,Slough 010A,E01016506,739,294,103,191,7,7,90,59,31,348,333,15,0
2021,Slough 010B,E01016507,623,360,159,201,0,0,159,108,51,104,94,10,0
2021,Slough 010C,E01016508,714,467,185,282,12,12,66,22,44,169,159,10,0
2021,Slough 010D,E01016509,590,385,179,206,1,1,41,33,8,163,150,13,0
2021,Slough 010E,E01016510,647,506,194,312,5,5,21,3,18,115,110,5,0
2021,Slough 011A,E01016511,963,273,135,138,10,10,186,72,114,494,476,18,0
2021,Slough 011D,E01016514,876,352,106,246,14,14,125,98,27,384,362,22,1
2021,Slough 011E,E01016515,609,449,238,211,1,1,13,7,6,146,135,11,0
2021,Slough 005A,E01016516,481,269,108,161,1,1,87,46,41,124,107,17,0
2021,Slough 005B,E01016517,483,220,91,129,2,2,105,75,30,154,141,13,2
2021,Slough 005C,E01016518,606,313,145,168,2,2,35,17,18,256,244,12,0
2021,Slough 005D,E01016519,961,460,154,306,9,9,278,183,95,211,191,20,3
2021,Slough 005E,E01016520,569,185,98,87,5,5,275,123,152,101,88,13,3
2021,Slough 005F,E01016521,647,328,137,191,3,3,185,174,11,125,106,19,6
2021,Windsor and Maidenhead 017A,E01016522,715,610,328,282,11,11,12,1,11,82,75,7,0
2021,Windsor and Maidenhead 017B,E01016523,587,393,220,173,5,5,27,3,24,162,135,27,0
2021,Windsor and Maidenhead 017C,E01016524,886,591,310,281,0,0,133,7,126,162,127,35,0
2021,Windsor and Maidenhead 005A,E01016525,723,539,271,268,0,0,5,0,5,179,167,12,0
2021,Windsor and Maidenhead 006A,E01016526,706,508,208,300,0,0,18,3,15,180,161,19,0
2021,Windsor and Maidenhead 006B,E01016527,653,387,149,238,14,14,62,3,59,190,181,9,0
2021,Windsor and Maidenhead 005B,E01016528,666,443,224,219,2,2,17,1,16,204,194,10,0
2021,Windsor and Maidenhead 005C,E01016529,898,314,112,202,8,8,290,21,269,283,269,14,3
2021,Windsor and Maidenhead 002A,E01016530,654,381,197,184,14,14,177,8,169,81,68,13,1
2021,Windsor and Maidenhead 002B,E01016531,589,495,301,194,0,0,9,1,8,84,66,18,1
2021,Windsor and Maidenhead 002C,E01016532,840,676,388,288,3,3,22,1,21,139,113,26,0
2021,Windsor and Maidenhead 002D,E01016533,765,653,355,298,1,1,25,1,24,86,75,11,0
2021,Windsor and Maidenhead 006C,E01016534,600,525,285,240,0,0,3,0,3,72,48,24,0
2021,Windsor and Maidenhead 007A,E01016535,511,351,198,153,5,5,9,0,9,146,133,13,0
2021,Windsor and Maidenhead 005D,E01016536,861,393,168,225,7,7,140,21,119,320,303,17,1
2021,Windsor and Maidenhead 007B,E01016537,569,339,140,199,23,23,56,5,51,151,140,11,0
2021,Windsor and Maidenhead 007C,E01016538,627,465,201,264,0,0,16,2,14,146,133,13,0
2021,Windsor and Maidenhead 009A,E01016539,643,497,257,240,0,0,45,0,45,101,88,13,0
2021,Windsor and Maidenhead 009B,E01016540,640,532,287,245,1,1,33,0,33,74,52,22,0
2021,Windsor and Maidenhead 009C,E01016541,513,445,234,211,1,1,5,1,4,62,60,2,0
2021,Windsor and Maidenhead 009D,E01016542,482,321,171,150,6,6,94,6,88,60,51,9,1
2021,Windsor and Maidenhead 009E,E01016543,681,552,287,265,1,1,12,0,12,116,89,27,0
2021,Windsor and Maidenhead 010A,E01016544,883,391,165,226,4,4,92,7,85,396,360,36,0
2021,Windsor and Maidenhead 012A,E01016545,1139,463,231,232,1,1,207,16,191,468,435,33,0
2021,Windsor and Maidenhead 015A,E01016546,755,458,243,215,2,2,10,2,8,285,262,23,0
2021,Windsor and Maidenhead 012B,E01016547,775,503,190,313,0,0,34,4,30,237,215,22,1
2021,Windsor and Maidenhead 014A,E01016548,824,580,278,302,10,10,39,8,31,195,184,11,0
2021,Windsor and Maidenhead 014B,E01016549,852,475,244,231,13,13,231,21,210,133,121,12,0
2021,Windsor and Maidenhead 012C,E01016550,512,287,124,163,0,0,99,9,90,126,88,38,0
2021,Windsor and Maidenhead 013A,E01016551,629,538,297,241,0,0,9,0,9,82,73,9,0
2021,Windsor and Maidenhead 012D,E01016552,712,512,264,248,3,3,59,3,56,138,125,13,0
2021,Windsor and Maidenhead 013B,E01016553,678,576,393,183,3,3,30,2,28,69,56,13,0
2021,Windsor and Maidenhead 014C,E01016554,688,311,167,144,8,8,284,40,244,85,78,7,0
2021,Windsor and Maidenhead 014D,E01016555,641,254,100,154,6,6,305,44,261,76,66,10,0
2021,Windsor and Maidenhead 014E,E01016556,768,418,208,210,6,6,237,18,219,106,100,6,1
2021,Windsor and Maidenhead 013C,E01016557,827,541,294,247,5,5,140,19,121,141,124,17,0
2021,Windsor and Maidenhead 013D,E01016558,530,160,72,88,3,3,123,24,99,244,47,197,0
2021,Windsor and Maidenhead 008A,E01016559,566,503,271,232,10,10,4,1,3,49,44,5,0
2021,Windsor and Maidenhead 008B,E01016560,607,296,137,159,1,1,252,18,234,57,47,10,1
2021,Windsor and Maidenhead 008C,E01016561,681,552,251,301,2,2,46,4,42,81,66,15,0
2021,Windsor and Maidenhead 008D,E01016562,520,467,249,218,1,1,4,0,4,48,42,6,0
2021,Windsor and Maidenhead 008E,E01016563,531,453,253,200,2,2,21,6,15,55,46,9,0
2021,Windsor and Maidenhead 011A,E01016564,663,440,197,243,4,4,124,23,101,95,83,12,0
2021,Windsor and Maidenhead 011B,E01016565,670,534,268,266,4,4,3,0,3,129,109,20,0
2021,Windsor and Maidenhead 011C,E01016566,736,393,160,233,2,2,172,21,151,169,160,9,0
2021,Windsor and Maidenhead 010B,E01016567,690,248,146,102,3,3,97,5,92,342,184,158,0
2021,Windsor and Maidenhead 010C,E01016568,512,362,203,159,3,3,93,11,82,54,37,17,0
2021,Windsor and Maidenhead 010D,E01016569,506,316,160,156,4,4,104,10,94,82,70,12,0
2021,Windsor and Maidenhead 001A,E01016570,635,550,303,247,2,2,4,1,3,79,67,12,0
2021,Windsor and Maidenhead 003A,E01016571,674,535,243,292,12,12,48,2,46,79,73,6,0
2021,Windsor and Maidenhead 001B,E01016572,554,440,249,191,4,4,49,3,46,60,47,13,1
2021,Windsor and Maidenhead 003B,E01016573,539,220,88,132,4,4,278,14,264,37,31,6,0
2021,Windsor and Maidenhead 003C,E01016574,564,384,200,184,1,1,73,7,66,106,97,9,0
2021,Windsor and Maidenhead 016A,E01016575,662,591,320,271,3,3,7,1,6,61,44,17,0
2021,Windsor and Maidenhead 016B,E01016576,686,526,263,263,1,1,33,3,30,126,98,28,0
2021,Windsor and Maidenhead 011D,E01016577,723,477,197,280,1,1,114,23,91,130,106,24,1
2021,Windsor and Maidenhead 002E,E01016578,667,508,264,244,0,0,24,3,21,135,85,50,0
2021,Windsor and Maidenhead 002F,E01016579,740,485,283,202,5,5,107,6,101,143,107,36,0
2021,Windsor and Maidenhead 008F,E01016580,658,327,171,156,6,6,283,16,267,42,38,4,0
2021,Windsor and Maidenhead 002G,E01016581,601,485,257,228,1,1,39,3,36,76,47,29,0
2021,Windsor and Maidenhead 001C,E01016582,513,361,182,179,0,0,22,2,20,130,116,14,0
2021,Windsor and Maidenhead 004A,E01016583,802,597,305,292,3,3,7,0,7,195,180,15,0
2021,Windsor and Maidenhead 005E,E01016584,933,455,187,268,1,1,179,8,171,298,275,23,0
2021,Windsor and Maidenhead 004B,E01016585,826,519,280,239,1,1,11,1,10,295,277,18,0
2021,Windsor and Maidenhead 004C,E01016586,537,485,254,231,0,0,2,0,2,50,44,6,0
2021,Windsor and Maidenhead 016C,E01016587,677,553,264,289,1,1,55,7,48,68,54,14,0
2021,Windsor and Maidenhead 016D,E01016588,806,354,172,182,1,1,150,6,144,299,168,131,2
2021,Windsor and Maidenhead 016E,E01016589,672,572,309,263,0,0,6,2,4,94,73,21,0
2021,Windsor and Maidenhead 004D,E01016591,881,725,298,427,26,26,27,1,26,103,90,13,0
2021,Windsor and Maidenhead 004E,E01016592,854,505,276,229,3,3,56,4,52,290,267,23,0
2021,Windsor and Maidenhead 007D,E01016593,706,291,159,132,18,18,285,17,268,110,104,6,2
2021,Windsor and Maidenhead 007E,E01016594,626,286,113,173,8,8,255,26,229,77,67,10,0
2021,Windsor and Maidenhead 015B,E01016595,708,451,179,272,0,0,93,10,83,164,128,36,0
2021,Windsor and Maidenhead 015C,E01016596,852,523,246,277,0,0,54,3,51,275,225,50,0
2021,Windsor and Maidenhead 015D,E01016597,610,543,295,248,0,0,6,2,4,61,32,29,0
2021,Windsor and Maidenhead 006D,E01016598,539,476,259,217,1,1,4,0,4,57,52,5,1
2021,Windsor and Maidenhead 003D,E01016599,604,268,119,149,4,4,260,19,241,70,62,8,2
2021,Windsor and Maidenhead 001D,E01016600,448,389,215,174,2,2,8,1,7,49,42,7,0
2021,Windsor and Maidenhead 006E,E01016601,637,440,208,232,0,0,103,7,96,94,86,8,0
2021,Windsor and Maidenhead 006F,E01016602,634,559,314,245,2,2,7,2,5,66,53,13,0
2021,Windsor and Maidenhead 018A,E01016603,726,533,317,216,2,2,5,1,4,186,157,29,0
2021,Windsor and Maidenhead 018B,E01016604,963,738,483,255,2,2,24,1,23,199,175,24,0
2021,Windsor and Maidenhead 018C,E01016605,628,405,191,214,4,4,118,19,99,101,86,15,0
2021,Windsor and Maidenhead 018D,E01016606,652,520,252,268,1,1,17,1,16,114,107,7,0
2021,Windsor and Maidenhead 018E,E01016607,577,483,266,217,0,0,7,1,6,87,72,15,0
2021,Windsor and Maidenhead 018F,E01016608,811,473,224,249,3,3,157,19,138,178,147,31,0
2021,Windsor and Maidenhead 017D,E01016609,765,404,158,246,0,0,233,16,217,128,110,18,0
2021,Wokingham 018B,E01016611,793,374,103,271,23,23,66,29,37,329,255,74,1
2021,Wokingham 015A,E01016612,998,883,414,469,25,25,34,14,20,56,49,7,0
2021,Wokingham 006A,E01016613,493,339,168,171,5,5,47,14,33,102,92,10,0
2021,Wokingham 006B,E01016614,503,427,213,214,1,1,2,0,2,73,66,7,0
2021,Wokingham 005A,E01016615,598,342,179,163,8,8,174,146,28,72,62,10,2
2021,Wokingham 005B,E01016616,674,473,279,194,3,3,73,22,51,125,113,12,0
2021,Wokingham 005C,E01016617,777,597,287,310,26,26,94,32,62,60,51,9,0
2021,Wokingham 006C,E01016618,467,373,193,180,11,11,13,3,10,70,64,6,0
2021,Wokingham 002A,E01016619,606,527,270,257,6,6,22,21,1,51,48,3,0
2021,Wokingham 002B,E01016620,542,428,226,202,1,1,63,37,26,50,44,6,0
2021,Wokingham 003A,E01016621,597,476,243,233,4,4,27,24,3,90,86,4,0
2021,Wokingham 004A,E01016622,457,419,251,168,5,5,7,5,2,26,24,2,0
2021,Wokingham 003B,E01016623,616,523,313,210,3,3,20,17,3,70,59,11,0
2021,Wokingham 003C,E01016624,540,496,291,205,2,2,2,2,0,40,31,9,0
2021,Wokingham 016A,E01016625,692,583,316,267,2,2,7,4,3,98,91,7,2
2021,Wokingham 013A,E01016626,1031,563,311,252,17,17,151,53,98,300,278,22,0
2021,Wokingham 010A,E01016627,830,652,309,343,18,18,45,26,19,115,107,8,0
2021,Wokingham 010B,E01016628,988,726,328,398,132,132,66,11,55,64,48,16,0
2021,Wokingham 015B,E01016629,543,527,310,217,1,1,2,0,2,13,11,2,0
2021,Wokingham 015C,E01016630,582,507,248,259,1,1,1,1,0,73,69,4,0
2021,Wokingham 016B,E01016631,554,395,186,209,7,7,87,31,56,65,60,5,0
2021,Wokingham 016C,E01016632,712,611,279,332,9,9,17,1,16,75,68,7,0
2021,Wokingham 019A,E01016633,512,471,233,238,2,2,12,9,3,26,24,2,1
2021,Wokingham 016D,E01016634,883,557,296,261,8,8,107,8,99,209,193,16,2
2021,Wokingham 015D,E01016635,533,452,203,249,7,7,8,0,8,66,58,8,0
2021,Wokingham 019B,E01016636,580,547,296,251,2,2,1,1,0,30,27,3,0
2021,Wokingham 019C,E01016637,425,393,224,169,0,0,3,2,1,29,26,3,0
2021,Wokingham 019D,E01016638,497,440,198,242,2,2,7,4,3,48,46,2,0
2021,Wokingham 019E,E01016639,625,493,233,260,1,1,71,65,6,59,54,5,1
2021,Wokingham 019F,E01016640,645,554,317,237,1,1,41,16,25,49,40,9,0
2021,Wokingham 019G,E01016643,503,463,232,231,0,0,3,2,1,37,33,4,0
2021,Wokingham 011A,E01016644,534,438,197,241,2,2,4,1,3,89,81,8,1
2021,Wokingham 011B,E01016645,738,478,205,273,9,9,10,0,10,241,234,7,0
2021,Wokingham 011C,E01016646,626,515,226,289,0,0,1,0,1,110,102,8,0
2021,Wokingham 009A,E01016647,620,447,171,276,20,20,76,5,71,77,71,6,0
2021,Wokingham 011D,E01016648,633,419,175,244,6,6,40,6,34,168,162,6,0
2021,Wokingham 011E,E01016649,623,448,204,244,4,4,11,2,9,160,145,15,0
2021,Wokingham 012A,E01016651,585,421,227,194,5,5,16,1,15,143,131,12,0
2021,Wokingham 008B,E01016652,468,411,228,183,1,1,3,2,1,53,52,1,0
2021,Wokingham 008C,E01016653,520,407,217,190,8,8,63,15,48,42,38,4,0
2021,Wokingham 012B,E01016654,588,474,272,202,5,5,12,5,7,97,86,11,0
2021,Wokingham 012C,E01016655,501,423,188,235,1,1,2,2,0,75,69,6,0
2021,Wokingham 010C,E01016656,587,418,242,176,1,1,48,35,13,120,90,30,0
2021,Wokingham 004B,E01016657,563,475,207,268,2,2,13,6,7,73,66,7,0
2021,Wokingham 004C,E01016658,1020,788,219,569,34,34,98,11,87,100,96,4,0
2021,Wokingham 004D,E01016659,645,458,205,253,6,6,12,5,7,169,160,9,0
2021,Wokingham 004E,E01016660,649,541,241,300,5,5,9,2,7,94,87,7,0
2021,Wokingham 007A,E01016661,498,455,225,230,0,0,4,1,3,39,33,6,0
2021,Wokingham 005D,E01016662,733,316,149,167,13,13,314,267,47,89,79,10,1
2021,Wokingham 007B,E01016663,601,524,259,265,0,0,10,4,6,67,60,7,0
2021,Wokingham 006D,E01016664,463,402,196,206,1,1,8,5,3,52,47,5,0
2021,Wokingham 008D,E01016665,629,508,251,257,1,1,6,3,3,114,103,11,0
2021,Wokingham 008E,E01016666,511,455,207,248,0,0,1,1,0,55,50,5,0
2021,Wokingham 006E,E01016668,629,464,226,238,2,2,36,20,16,123,111,12,4
2021,Wokingham 006F,E01016669,723,573,287,286,11,11,15,0,15,124,109,15,0
2021,Wokingham 014A,E01016670,1119,815,300,515,51,51,98,25,73,155,142,13,0
2021,Wokingham 013B,E01016671,1081,774,526,248,24,24,88,64,24,193,180,13,2
2021,Wokingham 014B,E01016672,1081,888,391,497,49,49,66,10,56,78,72,6,0
2021,Wokingham 013C,E01016673,795,340,170,170,5,5,339,298,41,111,96,15,0
2021,Wokingham 013D,E01016674,729,475,217,258,28,28,159,81,78,67,61,6,0
2021,Wokingham 001B,E01016676,628,564,338,226,2,2,8,3,5,54,47,7,0
2021,Wokingham 001D,E01016678,604,403,225,178,6,6,97,91,6,96,60,36,2
2021,Wokingham 012D,E01016679,845,492,178,314,35,35,147,86,61,171,160,11,0
2021,Wokingham 012E,E01016680,511,284,134,150,3,3,125,106,19,98,90,8,1
2021,Wokingham 003D,E01016684,634,557,325,232,1,1,15,0,15,61,55,6,0
2021,Wokingham 003E,E01016685,631,468,238,230,2,2,77,66,11,82,64,18,2
2021,Wokingham 007C,E01016686,479,373,177,196,3,3,11,4,7,92,86,6,0
2021,Wokingham 007D,E01016687,490,446,256,190,2,2,4,3,1,38,37,1,0
2021,Wokingham 007E,E01016688,780,629,222,407,20,20,50,13,37,81,74,7,0
2021,Wokingham 007F,E01016689,577,527,324,203,3,3,7,3,4,40,35,5,0
2021,Wokingham 017C,E01016690,911,632,315,317,50,50,129,99,30,100,85,15,0
2021,Wokingham 017D,E01016691,509,406,216,190,9,9,31,18,13,61,44,17,2
2021,Wokingham 002C,E01016692,678,486,256,230,6,6,103,80,23,81,71,10,2
2021,Wokingham 002D,E01016693,615,439,199,240,4,4,7,6,1,165,153,12,0
2021,Wokingham 002E,E01016694,726,445,233,212,11,11,59,38,21,211,199,12,0
2021,Wokingham 002F,E01016695,611,544,286,258,3,3,10,4,6,54,51,3,0
2021,Wokingham 013E,E01016696,904,439,188,251,8,8,129,56,73,328,298,30,0
2021,Wokingham 016E,E01016699,728,510,238,272,3,3,54,32,22,159,145,14,2
2021,Wokingham 010D,E01016700,728,606,267,339,4,4,12,2,10,106,94,12,0
2021,Wokingham 009B,E01016701,742,650,311,339,22,22,30,15,15,39,32,7,1
2021,Wokingham 009C,E01016702,721,549,267,282,24,24,49,18,31,99,87,12,0
2021,Wokingham 009D,E01016703,957,686,194,492,73,73,94,22,72,104,92,12,0
2021,Wokingham 009E,E01016704,908,501,203,298,64,64,198,74,124,145,129,16,0
2021,Wokingham 020A,E01016705,558,346,170,176,4,4,43,35,8,165,121,44,0
2021,Wokingham 020B,E01016706,680,630,309,321,0,0,7,4,3,43,34,9,0
2021,Wokingham 020C,E01016707,713,636,308,328,1,1,18,12,6,57,45,12,1
2021,Wokingham 020D,E01016708,650,586,331,255,1,1,5,4,1,58,53,5,0
2021,Wokingham 020E,E01016709,622,593,325,268,0,0,4,1,3,25,22,3,0
2021,Milton Keynes 030A,E01016710,791,477,259,218,9,9,205,200,5,95,83,12,5
2021,Milton Keynes 031A,E01016711,1195,795,420,375,32,32,149,24,125,219,203,16,0
2021,Milton Keynes 031B,E01016713,736,566,329,237,2,2,33,19,14,135,121,14,0
2021,Milton Keynes 030B,E01016714,846,423,244,179,28,28,91,32,59,302,279,23,2
2021,Milton Keynes 031C,E01016715,670,400,170,230,6,6,187,181,6,74,63,11,3
2021,Milton Keynes 030C,E01016716,1083,654,257,397,25,25,136,91,45,266,239,27,2
2021,Milton Keynes 013A,E01016717,674,336,154,182,60,60,128,87,41,150,128,22,0
2021,Milton Keynes 014A,E01016718,678,147,67,80,10,10,266,175,91,254,245,9,1
2021,Milton Keynes 011A,E01016719,645,399,194,205,45,45,84,77,7,117,111,6,0
2021,Milton Keynes 013B,E01016720,634,190,84,106,24,24,316,169,147,102,92,10,2
2021,Milton Keynes 009A,E01016721,645,267,152,115,9,9,163,89,74,205,189,16,1
2021,Milton Keynes 011B,E01016722,622,420,220,200,40,40,68,53,15,93,86,7,1
2021,Milton Keynes 013C,E01016723,618,437,250,187,49,49,38,2,36,94,87,7,0
2021,Milton Keynes 013D,E01016724,651,204,98,106,48,48,183,121,62,216,201,15,0
2021,Milton Keynes 021A,E01016725,592,133,63,70,37,37,203,83,120,217,198,19,2
2021,Milton Keynes 018A,E01016726,618,108,48,60,16,16,282,176,106,212,201,11,0
2021,Milton Keynes 021B,E01016727,681,259,135,124,39,39,193,47,146,188,172,16,2
2021,Milton Keynes 021C,E01016728,723,251,97,154,36,36,62,8,54,374,357,17,0
2021,Milton Keynes 014B,E01016729,805,178,84,94,50,50,275,190,85,298,274,24,4
2021,Milton Keynes 016A,E01016731,649,395,227,168,17,17,114,98,16,120,106,14,3
2021,Milton Keynes 016B,E01016732,533,353,199,154,5,5,61,39,22,113,103,10,1
2021,Milton Keynes 018B,E01016733,629,153,55,98,26,26,223,161,62,226,205,21,1
2021,Milton Keynes 024A,E01016734,706,496,270,226,20,20,105,44,61,82,74,8,3
2021,Milton Keynes 024C,E01016736,641,475,307,168,6,6,55,49,6,105,93,12,0
2021,Milton Keynes 027A,E01016737,640,471,222,249,12,12,92,85,7,63,57,6,2
2021,Milton Keynes 027B,E01016738,762,300,130,170,28,28,330,254,76,101,88,13,3
2021,Milton Keynes 027C,E01016739,596,433,233,200,4,4,43,32,11,115,108,7,1
2021,Milton Keynes 027D,E01016740,578,475,273,202,5,5,17,14,3,81,65,16,0
2021,Milton Keynes 027E,E01016741,651,326,155,171,4,4,232,223,9,84,75,9,5
2021,Milton Keynes 032A,E01016742,647,140,59,81,4,4,420,411,9,81,75,6,2
2021,Milton Keynes 032C,E01016744,565,196,76,120,14,14,227,212,15,123,117,6,5
2021,Milton Keynes 030D,E01016745,625,490,272,218,5,5,30,26,4,100,88,12,0
2021,Milton Keynes 032D,E01016746,705,421,214,207,5,5,166,139,27,107,96,11,6
2021,Milton Keynes 028A,E01016748,856,423,153,270,73,73,122,13,109,238,228,10,0
2021,Milton Keynes 028C,E01016750,627,413,177,236,45,45,51,46,5,118,106,12,0
2021,Milton Keynes 028D,E01016751,634,349,120,229,78,78,76,5,71,129,122,7,2
2021,Milton Keynes 025B,E01016752,623,339,133,206,18,18,156,8,148,110,100,10,0
2021,Milton Keynes 025C,E01016753,891,384,125,259,56,56,219,18,201,232,223,9,0
2021,Milton Keynes 026A,E01016754,729,313,170,143,152,152,111,31,80,153,142,11,0
2021,Milton Keynes 025D,E01016755,711,373,138,235,81,81,97,10,87,160,154,6,0
2021,Milton Keynes 026B,E01016756,921,317,119,198,132,132,330,34,296,141,130,11,1
2021,Milton Keynes 026C,E01016757,600,394,195,199,20,20,40,34,6,146,129,17,0
2021,Milton Keynes 026D,E01016758,668,374,161,213,46,46,78,6,72,170,156,14,0
2021,Milton Keynes 002A,E01016759,698,461,206,255,26,26,162,95,67,48,39,9,1
2021,Milton Keynes 002C,E01016761,649,544,292,252,6,6,19,1,18,80,70,10,0
2021,Milton Keynes 005A,E01016762,534,343,188,155,12,12,105,85,20,73,69,4,1
2021,Milton Keynes 007A,E01016763,630,381,212,169,101,101,68,59,9,80,68,12,0
2021,Milton Keynes 005B,E01016764,633,401,232,169,77,77,65,24,41,89,82,7,1
2021,Milton Keynes 009B,E01016765,647,372,228,144,7,7,199,116,83,68,51,17,1
2021,Milton Keynes 005C,E01016766,540,308,148,160,21,21,126,104,22,84,76,8,1
2021,Milton Keynes 005D,E01016767,538,423,229,194,35,35,6,4,2,74,68,6,0
2021,Milton Keynes 014D,E01016768,1077,328,139,189,108,108,201,119,82,438,422,16,2
2021,Milton Keynes 007B,E01016769,579,404,237,167,45,45,33,25,8,97,83,14,0
2021,Milton Keynes 007C,E01016770,663,363,180,183,99,99,68,49,19,133,124,9,0
2021,Milton Keynes 005E,E01016771,497,262,118,144,3,3,122,99,23,110,103,7,0
2021,Milton Keynes 009C,E01016772,509,239,98,141,7,7,140,96,44,123,110,13,0
2021,Milton Keynes 007D,E01016773,859,551,300,251,84,84,104,23,81,120,112,8,0
2021,Milton Keynes 020A,E01016774,671,453,213,240,22,22,76,20,56,117,108,9,3
2021,Milton Keynes 020B,E01016775,709,345,169,176,52,52,125,26,99,187,170,17,0
2021,Milton Keynes 015A,E01016776,540,368,174,194,60,60,11,8,3,101,94,7,0
2021,Milton Keynes 020C,E01016777,638,295,137,158,134,134,69,46,23,140,127,13,0
2021,Milton Keynes 020D,E01016778,697,307,116,191,129,129,97,41,56,164,148,16,0
2021,Milton Keynes 037C,E01016780,657,370,166,204,90,90,32,28,4,164,153,11,1
2021,Milton Keynes 037D,E01016781,560,424,210,214,18,18,50,8,42,68,64,4,0
2021,Milton Keynes 035A,E01016783,735,298,81,217,136,136,109,13,96,192,184,8,0
2021,Milton Keynes 016D,E01016784,768,316,214,102,29,29,188,48,140,233,218,15,2
2021,Milton Keynes 003A,E01016786,628,513,318,195,5,5,17,12,5,92,77,15,1
2021,Milton Keynes 003B,E01016787,688,397,196,201,4,4,171,156,15,116,103,13,0
2021,Milton Keynes 003C,E01016788,611,507,274,233,4,4,10,4,6,90,81,9,0
2021,Milton Keynes 003D,E01016789,515,357,166,191,17,17,39,4,35,102,96,6,0
2021,Milton Keynes 003E,E01016790,578,510,304,206,8,8,22,7,15,38,33,5,0
2021,Milton Keynes 004A,E01016791,596,492,281,211,4,4,27,22,5,73,66,7,0
2021,Milton Keynes 004B,E01016792,529,401,196,205,7,7,9,6,3,112,107,5,0
2021,Milton Keynes 004C,E01016793,871,600,272,328,48,48,98,59,39,125,113,12,0
2021,Milton Keynes 004D,E01016794,802,523,261,262,9,9,36,7,29,234,206,28,0
2021,Milton Keynes 004E,E01016795,692,449,190,259,4,4,52,32,20,186,167,19,1
2021,Milton Keynes 001A,E01016796,731,518,307,211,3,3,12,12,0,197,182,15,1
2021,Milton Keynes 001B,E01016797,838,545,348,197,9,9,68,26,42,216,196,20,0
2021,Milton Keynes 001C,E01016798,761,619,343,276,5,5,15,3,12,122,114,8,0
2021,Milton Keynes 001D,E01016799,798,544,314,230,17,17,121,101,20,115,102,13,1
2021,Milton Keynes 001E,E01016800,751,574,292,282,1,1,61,33,28,115,97,18,0
2021,Milton Keynes 002D,E01016801,576,420,247,173,4,4,81,59,22,68,54,14,3
2021,Milton Keynes 002E,E01016802,605,487,302,185,6,6,46,33,13,66,50,16,0
2021,Milton Keynes 002F,E01016803,571,417,233,184,3,3,51,37,14,100,77,23,0
2021,Milton Keynes 009D,E01016804,777,253,82,171,7,7,280,140,140,235,220,15,2
2021,Milton Keynes 011C,E01016805,607,462,278,184,18,18,9,4,5,118,109,9,0
2021,Milton Keynes 006A,E01016806,726,228,90,138,69,69,322,244,78,103,93,10,4
2021,Milton Keynes 006B,E01016807,690,444,206,238,9,9,101,83,18,135,114,21,1
2021,Milton Keynes 011D,E01016808,544,386,210,176,24,24,18,13,5,115,107,8,1
2021,Milton Keynes 006C,E01016809,534,364,177,187,1,1,53,44,9,116,109,7,0
2021,Milton Keynes 012A,E01016810,642,190,86,104,16,16,344,170,174,89,86,3,3
2021,Milton Keynes 012B,E01016811,499,135,53,82,4,4,282,256,26,73,64,9,5
2021,Milton Keynes 010A,E01016812,646,493,284,209,3,3,52,44,8,97,86,11,1
2021,Milton Keynes 015B,E01016813,666,238,104,134,61,61,33,18,15,334,312,22,0
2021,Milton Keynes 015C,E01016815,535,229,101,128,150,150,48,40,8,108,97,11,0
2021,Milton Keynes 015D,E01016816,596,460,257,203,32,32,7,4,3,97,91,6,0
2021,Milton Keynes 010B,E01016817,671,444,242,202,7,7,104,100,4,115,109,6,1
2021,Milton Keynes 010C,E01016818,941,569,366,203,6,6,102,86,16,262,238,24,2
2021,Milton Keynes 012C,E01016819,460,174,79,95,9,9,198,174,24,78,65,13,1
2021,Milton Keynes 035D,E01016820,770,429,183,246,11,11,173,10,163,157,144,13,0
2021,Milton Keynes 035B,E01016821,526,306,122,184,62,62,46,4,42,112,110,2,0
2021,Milton Keynes 022A,E01016822,667,203,84,119,34,34,281,15,266,149,143,6,0
2021,Milton Keynes 035C,E01016823,789,262,98,164,135,135,27,12,15,365,357,8,0
2021,Milton Keynes 022B,E01016824,674,317,130,187,92,92,189,14,175,76,70,6,0
2021,Milton Keynes 022C,E01016825,635,246,89,157,131,131,97,11,86,160,147,13,1
2021,Milton Keynes 024D,E01016826,534,435,202,233,24,24,8,0,8,67,61,6,0
2021,Milton Keynes 022D,E01016827,723,360,151,209,50,50,118,6,112,195,184,11,0
2021,Milton Keynes 022E,E01016828,739,465,215,250,108,108,44,2,42,120,115,5,2
2021,Milton Keynes 029A,E01016829,681,364,191,173,15,15,203,196,7,93,86,7,6
2021,Milton Keynes 031D,E01016830,520,325,154,171,87,87,6,3,3,102,90,12,0
2021,Milton Keynes 029B,E01016831,628,466,257,209,6,6,43,35,8,112,98,14,1
2021,Milton Keynes 029C,E01016832,504,364,190,174,5,5,76,73,3,59,52,7,0
2021,Milton Keynes 029D,E01016833,501,435,267,168,14,14,20,18,2,30,26,4,2
2021,Milton Keynes 029E,E01016834,643,339,143,196,5,5,205,193,12,91,84,7,3
2021,Milton Keynes 006D,E01016835,727,276,107,169,11,11,303,215,88,133,120,13,4
2021,Milton Keynes 008A,E01016836,637,453,182,271,9,9,23,19,4,151,137,14,1
2021,Milton Keynes 008B,E01016837,745,462,183,279,4,4,57,34,23,222,204,18,0
2021,Milton Keynes 008C,E01016838,601,397,188,209,3,3,120,114,6,81,71,10,0
2021,Milton Keynes 012D,E01016839,637,202,74,128,25,25,280,236,44,126,114,12,4
2021,Milton Keynes 008D,E01016841,1107,462,163,299,31,31,180,110,70,434,412,22,0
2021,Milton Keynes 023B,E01016842,581,103,47,56,12,12,372,305,67,93,81,12,1
2021,Milton Keynes 023C,E01016843,549,150,68,82,1,1,302,255,47,96,85,11,0
2021,Milton Keynes 023D,E01016844,631,158,68,90,27,27,382,301,81,58,48,10,6
2021,Milton Keynes 018C,E01016845,659,101,36,65,16,16,412,346,66,129,123,6,1
2021,Milton Keynes 018D,E01016846,635,268,125,143,6,6,124,100,24,237,226,11,0
2021,Milton Keynes 021D,E01016847,870,211,88,123,100,100,449,214,235,106,85,21,4
2021,Milton Keynes 018E,E01016848,634,237,110,127,20,20,190,112,78,185,143,42,2
2021,Brighton and Hove 026A,E01016849,827,356,165,191,1,1,21,5,16,449,428,21,0
2021,Brighton and Hove 029A,E01016850,867,319,127,192,3,3,46,13,33,499,473,26,0
2021,Brighton and Hove 029B,E01016851,1028,366,153,213,2,2,26,10,16,633,607,26,1
2021,Brighton and Hove 026B,E01016852,920,262,83,179,3,3,22,3,19,633,602,31,0
2021,Brighton and Hove 026C,E01016853,1067,411,183,228,1,1,30,9,21,625,592,33,0
2021,Brighton and Hove 029C,E01016854,993,273,98,175,2,2,136,9,127,582,557,25,0
2021,Brighton and Hove 026D,E01016855,965,290,93,197,4,4,65,25,40,606,583,23,0
2021,Brighton and Hove 026E,E01016856,932,341,197,144,1,1,33,24,9,557,534,23,0
2021,Brighton and Hove 028A,E01016857,835,349,159,190,14,14,59,18,41,413,390,23,0
2021,Brighton and Hove 028B,E01016858,865,314,139,175,8,8,19,4,15,524,508,16,0
2021,Brighton and Hove 028C,E01016859,845,447,289,158,8,8,65,15,50,325,292,33,0
2021,Brighton and Hove 019A,E01016860,865,300,113,187,5,5,86,31,55,472,456,16,2
2021,Brighton and Hove 031A,E01016861,910,396,207,189,3,3,54,9,45,457,430,27,0
2021,Brighton and Hove 031B,E01016862,825,347,186,161,2,2,73,23,50,403,382,21,0
2021,Brighton and Hove 032A,E01016863,888,236,120,116,2,2,334,261,73,303,290,13,13
2021,Brighton and Hove 025A,E01016864,571,241,156,85,1,1,269,242,27,58,41,17,2
2021,Brighton and Hove 025B,E01016865,565,58,16,42,9,9,447,406,41,48,43,5,3
2021,Brighton and Hove 025C,E01016866,564,125,50,75,0,0,373,352,21,61,56,5,5
2021,Brighton and Hove 025D,E01016867,643,180,79,101,2,2,365,270,95,93,86,7,3
2021,Brighton and Hove 025E,E01016868,735,105,56,49,2,2,558,317,241,64,60,4,6
2021,Brighton and Hove 032B,E01016869,860,433,228,205,9,9,169,148,21,246,219,27,3
2021,Brighton and Hove 020A,E01016870,693,408,175,233,1,1,20,9,11,264,255,9,0
2021,Brighton and Hove 019B,E01016871,979,333,172,161,1,1,105,67,38,537,515,22,3
2021,Brighton and Hove 019C,E01016872,903,384,112,272,4,4,44,26,18,471,453,18,0
2021,Brighton and Hove 019D,E01016873,976,282,110,172,3,3,222,196,26,463,446,17,6
2021,Brighton and Hove 020B,E01016874,1032,513,312,201,3,3,43,23,20,473,438,35,0
2021,Brighton and Hove 020C,E01016875,619,408,165,243,1,1,16,9,7,194,181,13,0
2021,Brighton and Hove 020D,E01016876,864,410,183,227,28,28,59,6,53,367,349,18,0
2021,Brighton and Hove 020E,E01016877,927,427,255,172,23,23,67,7,60,410,379,31,0
2021,Brighton and Hove 019E,E01016878,880,491,233,258,14,14,57,19,38,318,298,20,0
2021,Brighton and Hove 013A,E01016879,560,320,121,199,2,2,179,25,154,59,50,9,0
2021,Brighton and Hove 013B,E01016880,491,144,61,83,3,3,277,246,31,64,55,9,3
2021,Brighton and Hove 013C,E01016881,615,321,143,178,0,0,176,124,52,114,103,11,4
2021,Brighton and Hove 006A,E01016882,625,345,181,164,9,9,195,181,14,72,60,12,4
2021,Brighton and Hove 006B,E01016883,652,564,372,192,1,1,38,34,4,49,41,8,0
2021,Brighton and Hove 006C,E01016884,625,390,180,210,0,0,121,114,7,113,100,13,1
2021,Brighton and Hove 006D,E01016885,612,179,72,107,5,5,321,290,31,100,91,9,7
2021,Brighton and Hove 006E,E01016886,625,448,229,219,3,3,106,89,17,65,61,4,3
2021,Brighton and Hove 013D,E01016887,607,494,257,237,2,2,30,26,4,81,67,14,0
2021,Brighton and Hove 013E,E01016888,576,486,249,237,7,7,12,7,5,71,66,5,0
2021,Brighton and Hove 022A,E01016889,734,329,131,198,5,5,68,13,55,331,311,20,1
2021,Brighton and Hove 015A,E01016890,837,259,79,180,24,24,82,25,57,472,443,29,0
2021,Brighton and Hove 022B,E01016891,834,308,115,193,0,0,144,101,43,376,353,23,6
2021,Brighton and Hove 018A,E01016892,621,377,162,215,2,2,44,30,14,198,186,12,0
2021,Brighton and Hove 018B,E01016893,761,520,207,313,2,2,10,6,4,229,210,19,0
2021,Brighton and Hove 022C,E01016894,712,302,134,168,6,6,149,31,118,255,243,12,0
2021,Brighton and Hove 025F,E01016895,624,224,95,129,39,39,289,234,55,70,64,6,2
2021,Brighton and Hove 022D,E01016896,695,397,168,229,5,5,34,15,19,259,240,19,0
2021,Brighton and Hove 022E,E01016897,749,447,181,266,3,3,84,65,19,215,201,14,0
2021,Brighton and Hove 002A,E01016898,730,413,243,170,1,1,185,118,67,126,115,11,5
2021,Brighton and Hove 002B,E01016899,407,215,111,104,2,2,83,67,16,101,92,9,6
2021,Brighton and Hove 008A,E01016900,743,138,73,65,1,1,472,358,114,128,122,6,4
2021,Brighton and Hove 010A,E01016901,602,481,187,294,1,1,9,4,5,111,100,11,0
2021,Brighton and Hove 008B,E01016902,593,355,165,190,4,4,156,90,66,78,67,11,0
2021,Brighton and Hove 010B,E01016903,653,419,168,251,3,3,30,11,19,201,186,15,0
2021,Brighton and Hove 008C,E01016904,681,135,62,73,6,6,396,214,182,134,120,14,10
2021,Brighton and Hove 008D,E01016905,797,274,111,163,12,12,315,299,16,188,164,24,8
2021,Brighton and Hove 009A,E01016906,590,222,108,114,6,6,283,212,71,73,65,8,6
2021,Brighton and Hove 009B,E01016907,577,220,128,92,4,4,150,117,33,200,194,6,3
2021,Brighton and Hove 009C,E01016908,570,147,75,72,4,4,329,282,47,85,80,5,5
2021,Brighton and Hove 008E,E01016909,621,249,138,111,5,5,144,123,21,216,207,9,7
2021,Brighton and Hove 009D,E01016910,501,115,54,61,17,17,282,30,252,86,81,5,1
2021,Brighton and Hove 009E,E01016911,523,287,152,135,8,8,125,83,42,100,89,11,3
2021,Brighton and Hove 018C,E01016912,762,290,105,185,13,13,77,32,45,382,356,26,0
2021,Brighton and Hove 018D,E01016913,646,326,143,183,3,3,14,5,9,303,281,22,0
2021,Brighton and Hove 002C,E01016914,472,121,53,68,2,2,261,237,24,85,78,7,3
2021,Brighton and Hove 002D,E01016915,468,73,36,37,0,0,311,299,12,81,73,8,3
2021,Brighton and Hove 005A,E01016916,601,483,259,224,9,9,23,19,4,85,74,11,1
2021,Brighton and Hove 005B,E01016917,571,481,236,245,0,0,21,16,5,69,60,9,0
2021,Brighton and Hove 005C,E01016918,598,274,129,145,3,3,253,121,132,67,55,12,1
2021,Brighton and Hove 005D,E01016919,545,293,148,145,1,1,174,40,134,76,65,11,1
2021,Brighton and Hove 005E,E01016920,630,510,209,301,9,9,11,8,3,100,92,8,0
2021,Brighton and Hove 012A,E01016921,663,393,168,225,12,12,169,128,41,88,79,9,1
2021,Brighton and Hove 012B,E01016922,519,330,148,182,2,2,109,101,8,76,71,5,2
2021,Brighton and Hove 003A,E01016923,665,428,234,194,2,2,102,76,26,132,122,10,1
2021,Brighton and Hove 001A,E01016924,574,517,272,245,0,0,6,3,3,51,42,9,0
2021,Brighton and Hove 004A,E01016925,599,397,178,219,4,4,112,96,16,86,73,13,0
2021,Brighton and Hove 001B,E01016926,603,340,159,181,4,4,209,179,30,48,44,4,2
2021,Brighton and Hove 001C,E01016927,619,493,228,265,3,3,53,47,6,70,60,10,0
2021,Brighton and Hove 003B,E01016928,669,520,314,206,0,0,28,24,4,120,112,8,1
2021,Brighton and Hove 001D,E01016929,625,472,238,234,1,1,62,53,9,90,73,17,0
2021,Brighton and Hove 004B,E01016930,755,659,354,305,3,3,24,20,4,69,61,8,0
2021,Brighton and Hove 001E,E01016931,632,565,277,288,2,2,5,2,3,60,51,9,0
2021,Brighton and Hove 014A,E01016932,694,453,204,249,2,2,46,15,31,192,167,25,1
2021,Brighton and Hove 014B,E01016933,620,383,179,204,2,2,37,16,21,198,189,9,0
2021,Brighton and Hove 010C,E01016934,509,424,207,217,0,0,16,10,6,69,63,6,0
2021,Brighton and Hove 014C,E01016935,799,407,196,211,15,15,113,30,83,263,240,23,1
2021,Brighton and Hove 014D,E01016936,763,441,177,264,1,1,19,8,11,302,286,16,0
2021,Brighton and Hove 014E,E01016937,1026,386,118,268,35,35,87,15,72,518,491,27,0
2021,Brighton and Hove 024A,E01016938,927,400,158,242,2,2,37,20,17,488,469,19,0
2021,Brighton and Hove 010D,E01016939,591,479,204,275,2,2,13,7,6,97,91,6,0
2021,Brighton and Hove 010E,E01016940,598,456,193,263,2,2,20,10,10,120,114,6,0
2021,Brighton and Hove 030A,E01016941,1101,290,193,97,20,20,253,163,90,535,505,30,3
2021,Brighton and Hove 031C,E01016942,1040,174,125,49,9,9,730,541,189,116,100,16,11
2021,Brighton and Hove 031D,E01016943,676,375,159,216,5,5,38,22,16,258,236,22,0
2021,Brighton and Hove 031E,E01016944,890,311,143,168,2,2,32,16,16,542,518,24,3
2021,Brighton and Hove 030B,E01016945,936,260,106,154,3,3,53,18,35,619,595,24,1
2021,Brighton and Hove 018E,E01016946,611,424,214,210,1,1,16,11,5,169,163,6,1
2021,Brighton and Hove 030C,E01016947,973,122,51,71,18,18,543,474,69,269,247,22,21
2021,Brighton and Hove 030D,E01016948,767,363,167,196,3,3,155,110,45,245,218,27,1
2021,Brighton and Hove 030E,E01016949,912,255,129,126,9,9,361,296,65,283,270,13,4
2021,Brighton and Hove 024B,E01016950,1025,386,183,203,4,4,59,12,47,575,550,25,1
2021,Brighton and Hove 024C,E01016951,900,261,110,151,0,0,152,30,122,487,464,23,0
2021,Brighton and Hove 027A,E01016952,904,165,95,70,9,9,51,14,37,679,644,35,0
2021,Brighton and Hove 027B,E01016953,801,380,202,178,0,0,21,13,8,400,387,13,0
2021,Brighton and Hove 029D,E01016954,970,251,132,119,2,2,55,14,41,662,639,23,0
2021,Brighton and Hove 029E,E01016955,936,289,148,141,1,1,58,18,40,588,564,24,0
2021,Brighton and Hove 033A,E01016956,716,605,357,248,0,0,9,6,3,102,87,15,0
2021,Brighton and Hove 032C,E01016957,1064,426,303,123,15,15,32,25,7,591,561,30,0
2021,Brighton and Hove 033B,E01016958,843,647,425,222,1,1,48,13,35,146,126,20,1
2021,Brighton and Hove 033C,E01016959,653,526,342,184,0,0,29,3,26,98,91,7,0
2021,Brighton and Hove 033D,E01016960,815,603,398,205,2,2,33,26,7,176,156,20,1
2021,Brighton and Hove 033E,E01016961,893,610,343,267,42,42,58,15,43,182,164,18,1
2021,Brighton and Hove 033F,E01016962,736,642,404,238,1,1,23,17,6,70,61,9,0
2021,Brighton and Hove 032D,E01016963,1004,497,294,203,2,2,72,28,44,433,408,25,0
2021,Brighton and Hove 027C,E01016964,1199,247,107,140,40,40,286,153,133,621,594,27,5
2021,Brighton and Hove 015B,E01016966,753,261,110,151,4,4,122,91,31,366,348,18,0
2021,Brighton and Hove 024D,E01016967,1037,352,136,216,0,0,49,19,30,635,610,25,1
2021,Brighton and Hove 024E,E01016968,843,272,123,149,2,2,45,11,34,524,507,17,0
2021,Brighton and Hove 027E,E01016969,968,333,191,142,3,3,169,49,120,459,433,26,4
2021,Brighton and Hove 015C,E01016970,715,387,157,230,2,2,75,36,39,250,232,18,1
2021,Brighton and Hove 015D,E01016971,736,246,97,149,4,4,51,16,35,434,417,17,1
2021,Brighton and Hove 015E,E01016972,793,414,176,238,3,3,25,11,14,350,330,20,1
2021,Brighton and Hove 012C,E01016973,641,440,217,223,7,7,68,35,33,126,106,20,0
2021,Brighton and Hove 021A,E01016974,783,469,157,312,7,7,59,31,28,248,231,17,0
2021,Brighton and Hove 021B,E01016975,627,346,137,209,11,11,163,115,48,102,92,10,5
2021,Brighton and Hove 013F,E01016976,604,527,277,250,2,2,2,2,0,73,65,8,0
2021,Brighton and Hove 012D,E01016977,623,431,191,240,0,0,119,101,18,69,59,10,4
2021,Brighton and Hove 012E,E01016978,781,389,146,243,5,5,207,84,123,180,162,18,0
2021,Brighton and Hove 016A,E01016979,683,504,183,321,20,20,20,7,13,139,130,9,0
2021,Brighton and Hove 007A,E01016980,638,448,224,224,20,20,34,8,26,136,120,16,0
2021,Brighton and Hove 011A,E01016981,665,547,306,241,0,0,22,7,15,96,81,15,0
2021,Brighton and Hove 007B,E01016982,501,439,221,218,0,0,6,6,0,56,47,9,0
2021,Brighton and Hove 007C,E01016983,543,475,254,221,1,1,8,4,4,59,53,6,0
2021,Brighton and Hove 007D,E01016984,581,529,305,224,0,0,9,7,2,43,34,9,0
2021,Brighton and Hove 007E,E01016985,617,426,187,239,1,1,17,12,5,173,165,8,0
2021,Brighton and Hove 028D,E01016986,837,406,242,164,21,21,94,19,75,315,293,22,1
2021,Brighton and Hove 023A,E01016987,742,451,236,215,10,10,31,7,24,250,233,17,0
2021,Brighton and Hove 028E,E01016988,748,386,175,211,2,2,45,2,43,315,299,16,0
2021,Brighton and Hove 023B,E01016989,695,431,214,217,0,0,47,21,26,217,206,11,0
2021,Brighton and Hove 016B,E01016990,763,427,145,282,13,13,103,54,49,219,207,12,1
2021,Brighton and Hove 016C,E01016991,770,464,175,289,5,5,35,12,23,265,257,8,1
2021,Brighton and Hove 021C,E01016992,700,540,279,261,2,2,47,9,38,111,101,10,0
2021,Brighton and Hove 023C,E01016993,747,251,123,128,1,1,347,268,79,144,136,8,4
2021,Brighton and Hove 021D,E01016994,754,421,168,253,0,0,44,28,16,288,274,14,1
2021,Brighton and Hove 023D,E01016995,633,504,243,261,0,0,9,6,3,119,104,15,1
2021,Brighton and Hove 016D,E01016996,748,489,177,312,2,2,56,12,44,200,184,16,1
2021,Brighton and Hove 021E,E01016997,664,476,225,251,1,1,17,9,8,170,156,14,0
2021,Brighton and Hove 003C,E01016998,583,523,251,272,1,1,7,5,2,52,44,8,0
2021,Brighton and Hove 003D,E01016999,598,528,276,252,3,3,7,2,5,60,44,16,0
2021,Brighton and Hove 003E,E01017000,853,540,299,241,9,9,65,9,56,238,215,23,1
2021,Brighton and Hove 004C,E01017001,598,521,287,234,1,1,35,7,28,41,35,6,0
2021,Brighton and Hove 011B,E01017002,749,487,277,210,0,0,8,5,3,253,242,11,1
2021,Brighton and Hove 004D,E01017003,691,518,280,238,2,2,31,25,6,139,128,11,1
2021,Brighton and Hove 011C,E01017004,777,390,189,201,10,10,68,31,37,309,296,13,0
2021,Brighton and Hove 011D,E01017005,706,475,200,275,1,1,4,2,2,226,216,10,0
2021,Brighton and Hove 011E,E01017006,766,463,191,272,12,12,17,4,13,274,265,9,0
2021,Brighton and Hove 017A,E01017007,654,340,165,175,3,3,206,124,82,103,87,16,2
2021,Brighton and Hove 017B,E01017008,699,611,377,234,1,1,7,2,5,80,72,8,0
2021,Brighton and Hove 017C,E01017009,615,454,274,180,3,3,78,46,32,78,71,7,2
2021,Brighton and Hove 017D,E01017010,710,593,353,240,8,8,35,14,21,73,60,13,1
2021,Brighton and Hove 017E,E01017011,526,237,112,125,3,3,242,212,30,43,35,8,1
2021,Brighton and Hove 017F,E01017012,709,533,287,246,6,6,62,41,21,106,93,13,2
2021,Portsmouth 012A,E01017013,697,430,162,268,4,4,62,7,55,201,181,20,0
2021,Portsmouth 008A,E01017014,636,520,249,271,4,4,7,6,1,105,93,12,0
2021,Portsmouth 014A,E01017015,619,420,206,214,1,1,96,90,6,101,86,15,1
2021,Portsmouth 014B,E01017016,642,469,203,266,3,3,21,5,16,148,128,20,1
2021,Portsmouth 014C,E01017017,590,519,266,253,0,0,19,4,15,52,48,4,0
2021,Portsmouth 014D,E01017018,621,519,266,253,4,4,26,10,16,72,61,11,0
2021,Portsmouth 014E,E01017019,728,423,176,247,43,43,129,29,100,133,111,22,0
2021,Portsmouth 014F,E01017020,965,579,273,306,3,3,247,129,118,133,127,6,3
2021,Portsmouth 017A,E01017021,645,481,296,185,21,21,82,28,54,61,47,14,0
2021,Portsmouth 020A,E01017022,641,263,127,136,0,0,89,9,80,288,266,22,1
2021,Portsmouth 019A,E01017023,661,410,188,222,1,1,14,5,9,236,217,19,0
2021,Portsmouth 020B,E01017024,757,312,143,169,5,5,38,8,30,402,374,28,0
2021,Portsmouth 019B,E01017025,776,368,148,220,4,4,21,7,14,383,362,21,0
2021,Portsmouth 019C,E01017026,760,420,199,221,6,6,111,11,100,222,207,15,1
2021,Portsmouth 020C,E01017027,621,278,136,142,4,4,25,12,13,314,296,18,0
2021,Portsmouth 020D,E01017028,753,226,101,125,16,16,80,18,62,431,401,30,0
2021,Portsmouth 019D,E01017029,683,407,189,218,3,3,34,4,30,239,219,20,0
2021,Portsmouth 019E,E01017030,689,321,146,175,7,7,19,10,9,342,324,18,0
2021,Portsmouth 028A,E01017031,935,119,57,62,26,26,647,295,352,140,124,16,3
2021,Portsmouth 027C,E01017032,670,54,25,29,4,4,353,231,122,255,244,11,4
2021,Portsmouth 027A,E01017034,639,56,30,26,11,11,429,327,102,139,115,24,4
2021,Portsmouth 018A,E01017035,771,43,24,19,15,15,649,594,55,55,51,4,9
2021,Portsmouth 013A,E01017036,598,197,84,113,13,13,278,233,45,105,98,7,5
2021,Portsmouth 013B,E01017037,656,62,36,26,1,1,547,511,36,41,38,3,5
2021,Portsmouth 013C,E01017038,782,93,48,45,7,7,588,494,94,85,75,10,9
2021,Portsmouth 028C,E01017039,723,161,87,74,20,20,392,261,131,146,134,12,4
2021,Portsmouth 028B,E01017040,632,42,19,23,4,4,513,380,133,65,63,2,8
2021,Portsmouth 011A,E01017041,504,395,175,220,7,7,6,3,3,96,88,8,0
2021,Portsmouth 012B,E01017042,514,333,141,192,5,5,55,4,51,121,112,9,0
2021,Portsmouth 011B,E01017043,502,352,154,198,1,1,11,2,9,138,121,17,0
2021,Portsmouth 011C,E01017044,600,389,149,240,4,4,18,5,13,189,174,15,0
2021,Portsmouth 012C,E01017045,507,350,149,201,4,4,15,3,12,137,119,18,1
2021,Portsmouth 008B,E01017046,784,576,353,223,7,7,11,6,5,189,168,21,1
2021,Portsmouth 008C,E01017047,627,515,232,283,1,1,8,3,5,102,91,11,1
2021,Portsmouth 008D,E01017048,596,501,233,268,1,1,6,1,5,88,68,20,0
2021,Portsmouth 011D,E01017049,586,508,270,238,2,2,11,8,3,65,53,12,0
2021,Portsmouth 003A,E01017050,741,516,334,182,17,17,128,11,117,80,70,10,0
2021,Portsmouth 002A,E01017051,897,302,151,151,14,14,314,169,145,265,219,46,2
2021,Portsmouth 002B,E01017052,593,320,152,168,1,1,178,139,39,93,89,4,1
2021,Portsmouth 002C,E01017053,531,203,100,103,0,0,273,234,39,48,43,5,7
2021,Portsmouth 004A,E01017054,616,399,182,217,2,2,116,103,13,98,89,9,1
2021,Portsmouth 006A,E01017055,676,474,263,211,1,1,47,3,44,153,133,20,1
2021,Portsmouth 006B,E01017056,494,438,198,240,0,0,3,2,1,53,44,9,0
2021,Portsmouth 006C,E01017057,568,504,244,260,3,3,7,3,4,54,46,8,0
2021,Portsmouth 006D,E01017058,746,431,172,259,11,11,188,151,37,113,95,18,3
2021,Portsmouth 026A,E01017059,632,535,299,236,2,2,32,29,3,63,50,13,0
2021,Portsmouth 006E,E01017060,764,626,266,360,12,12,31,3,28,95,83,12,0
2021,Portsmouth 003B,E01017061,667,604,364,240,1,1,13,9,4,49,40,9,0
2021,Portsmouth 026B,E01017062,620,440,208,232,1,1,12,3,9,167,53,114,0
2021,Portsmouth 003C,E01017063,614,578,338,240,0,0,7,6,1,29,22,7,0
2021,Portsmouth 003D,E01017064,782,641,409,232,2,2,19,5,14,120,102,18,0
2021,Portsmouth 026C,E01017066,766,578,285,293,4,4,60,33,27,122,108,14,2
2021,Portsmouth 023A,E01017067,645,433,262,171,12,12,74,22,52,126,96,30,0
2021,Portsmouth 023B,E01017068,890,555,302,253,7,7,33,19,14,295,274,21,0
2021,Portsmouth 023C,E01017069,665,484,240,244,0,0,18,11,7,163,146,17,0
2021,Portsmouth 023D,E01017070,732,413,243,170,1,1,54,8,46,264,251,13,0
2021,Portsmouth 025A,E01017071,638,306,127,179,1,1,32,5,27,299,288,11,0
2021,Portsmouth 025B,E01017072,580,388,212,176,0,0,21,13,8,171,154,17,0
2021,Portsmouth 024A,E01017073,1034,411,264,147,7,7,104,20,84,512,486,26,0
2021,Portsmouth 023E,E01017074,788,291,182,109,12,12,69,16,53,413,314,99,3
2021,Portsmouth 012D,E01017075,678,316,121,195,8,8,34,5,29,320,296,24,0
2021,Portsmouth 015A,E01017076,746,397,150,247,2,2,47,27,20,297,284,13,3
2021,Portsmouth 015B,E01017077,899,235,105,130,27,27,327,177,150,304,285,19,6
2021,Portsmouth 015C,E01017078,623,360,138,222,3,3,34,8,26,225,206,19,1
2021,Portsmouth 015D,E01017079,620,312,128,184,3,3,47,14,33,258,242,16,0
2021,Portsmouth 015E,E01017080,799,292,127,165,3,3,127,27,100,377,355,22,0
2021,Portsmouth 015F,E01017081,659,348,132,216,6,6,32,6,26,272,260,12,1
2021,Portsmouth 012E,E01017082,726,339,126,213,1,1,44,13,31,342,323,19,0
2021,Portsmouth 012F,E01017083,701,422,153,269,1,1,33,21,12,243,228,15,2
2021,Portsmouth 009A,E01017084,573,402,188,214,1,1,13,1,12,153,142,11,4
2021,Portsmouth 008E,E01017085,670,464,281,183,4,4,83,7,76,119,104,15,0
2021,Portsmouth 007A,E01017086,504,437,200,237,0,0,5,3,2,62,49,13,0
2021,Portsmouth 009B,E01017087,575,395,157,238,2,2,20,18,2,158,148,10,0
2021,Portsmouth 009C,E01017088,721,489,212,277,1,1,9,1,8,222,207,15,0
2021,Portsmouth 007B,E01017089,638,292,138,154,7,7,197,75,122,138,85,53,4
2021,Portsmouth 007C,E01017090,741,433,177,256,29,29,141,26,115,138,121,17,0
2021,Portsmouth 007D,E01017091,785,208,109,99,1,1,391,172,219,181,62,119,4
2021,Portsmouth 007E,E01017092,650,456,235,221,9,9,31,25,6,154,132,22,0
2021,Portsmouth 017B,E01017093,498,311,172,139,3,3,114,108,6,67,60,7,3
2021,Portsmouth 021A,E01017094,613,453,191,262,3,3,18,12,6,139,122,17,0
2021,Portsmouth 021B,E01017095,855,477,215,262,8,8,65,18,47,305,275,30,0
2021,Portsmouth 017C,E01017096,650,464,245,219,2,2,28,7,21,156,142,14,0
2021,Portsmouth 021C,E01017097,709,425,174,251,10,10,26,4,22,248,227,21,0
2021,Portsmouth 021D,E01017098,671,310,120,190,3,3,101,28,73,257,236,21,0
2021,Portsmouth 017D,E01017099,1126,564,242,322,47,47,241,51,190,272,248,24,2
2021,Portsmouth 017E,E01017100,532,429,197,232,3,3,14,11,3,86,73,13,0
2021,Portsmouth 017F,E01017101,645,462,208,254,2,2,31,5,26,150,132,18,0
2021,Portsmouth 013D,E01017102,773,213,115,98,8,8,345,240,105,205,195,10,2
2021,Portsmouth 013E,E01017103,522,97,39,58,2,2,376,354,22,44,41,3,3
2021,Portsmouth 010A,E01017104,497,323,138,185,1,1,48,38,10,125,107,18,0
2021,Portsmouth 009D,E01017105,710,370,172,198,0,0,112,14,98,226,206,20,2
2021,Portsmouth 010B,E01017106,635,324,139,185,3,3,125,71,54,182,167,15,1
2021,Portsmouth 009E,E01017107,681,353,156,197,4,4,33,8,25,290,267,23,1
2021,Portsmouth 010C,E01017108,716,350,178,172,5,5,110,75,35,246,227,19,5
2021,Portsmouth 010D,E01017109,636,303,122,181,4,4,107,78,29,220,198,22,2
2021,Portsmouth 011E,E01017110,592,350,152,198,5,5,22,7,15,215,200,15,0
2021,Portsmouth 011F,E01017111,705,312,124,188,5,5,51,22,29,337,314,23,0
2021,Portsmouth 001A,E01017112,664,309,115,194,5,5,282,253,29,67,57,10,1
2021,Portsmouth 004B,E01017113,669,491,240,251,7,7,44,15,29,126,104,22,1
2021,Portsmouth 004C,E01017114,757,528,315,213,0,0,18,7,11,211,190,21,0
2021,Portsmouth 001B,E01017115,487,285,130,155,12,12,139,117,22,49,45,4,2
2021,Portsmouth 004D,E01017116,691,294,105,189,11,11,248,140,108,137,62,75,1
2021,Portsmouth 001C,E01017117,590,297,139,158,4,4,199,133,66,88,71,17,2
2021,Portsmouth 002D,E01017118,562,224,101,123,1,1,253,168,85,84,74,10,0
2021,Portsmouth 001D,E01017119,632,366,166,200,4,4,190,154,36,68,63,5,4
2021,Portsmouth 001E,E01017120,685,253,103,150,3,3,350,317,33,72,63,9,7
2021,Portsmouth 025C,E01017121,732,353,186,167,1,1,19,3,16,359,343,16,0
2021,Portsmouth 022A,E01017122,853,326,143,183,4,4,57,12,45,466,445,21,0
2021,Portsmouth 024B,E01017123,1135,498,293,205,1,1,34,7,27,601,563,38,1
2021,Portsmouth 020E,E01017124,747,338,156,182,4,4,51,18,33,352,331,21,2
2021,Portsmouth 022B,E01017125,860,344,202,142,2,2,222,19,203,289,257,32,3
2021,Portsmouth 025D,E01017126,829,427,205,222,32,32,19,2,17,351,333,18,0
2021,Portsmouth 022C,E01017127,976,314,134,180,4,4,70,17,53,586,567,19,2
2021,Portsmouth 018B,E01017128,625,172,82,90,3,3,24,4,20,426,412,14,0
2021,Portsmouth 018C,E01017129,639,183,80,103,5,5,89,17,72,362,353,9,0
2021,Portsmouth 018D,E01017130,809,85,52,33,4,4,614,540,74,93,84,9,13
2021,Portsmouth 024C,E01017131,755,307,201,106,3,3,93,30,63,352,269,83,0
2021,Portsmouth 018E,E01017132,556,97,55,42,1,1,306,197,109,148,134,14,4
2021,Portsmouth 018F,E01017133,820,286,204,82,2,2,252,183,69,275,265,10,5
2021,Portsmouth 022D,E01017135,809,295,166,129,2,2,153,78,75,356,318,38,3
2021,Southampton 023A,E01017136,642,191,113,78,3,3,54,9,45,394,383,11,0
2021,Southampton 023B,E01017137,477,86,32,54,0,0,24,9,15,367,354,13,0
2021,Southampton 023C,E01017138,872,237,115,122,2,2,122,16,106,511,498,13,0
2021,Southampton 033B,E01017139,1034,136,52,84,14,14,416,305,111,461,446,15,7
2021,Southampton 001A,E01017144,421,245,121,124,4,4,51,41,10,121,110,11,0
2021,Southampton 001B,E01017145,666,463,248,215,0,0,46,40,6,156,140,16,1
2021,Southampton 001C,E01017146,694,500,266,234,5,5,34,6,28,154,143,11,1
2021,Southampton 006A,E01017147,624,426,272,154,2,2,15,11,4,181,167,14,0
2021,Southampton 001D,E01017148,420,357,173,184,1,1,2,1,1,60,55,5,0
2021,Southampton 001E,E01017149,459,134,63,71,1,1,132,123,9,190,179,11,2
2021,Southampton 006B,E01017150,603,410,237,173,3,3,51,34,17,135,123,12,4
2021,Southampton 006C,E01017151,720,380,192,188,5,5,195,172,23,140,129,11,0
2021,Southampton 006D,E01017152,691,327,164,163,1,1,102,65,37,261,249,12,0
2021,Southampton 022A,E01017153,473,142,69,73,3,3,96,40,56,228,212,16,4
2021,Southampton 022B,E01017154,1020,235,66,169,12,12,545,433,112,228,217,11,0
2021,Southampton 022C,E01017155,600,166,74,92,8,8,83,29,54,343,312,31,0
2021,Southampton 022D,E01017156,506,182,83,99,0,0,71,26,45,253,231,22,0
2021,Southampton 017A,E01017157,598,83,51,32,13,13,110,9,101,392,382,10,0
2021,Southampton 017B,E01017158,935,250,109,141,7,7,145,12,133,533,506,27,0
2021,Southampton 017C,E01017159,525,99,51,48,2,2,46,8,38,378,363,15,0
2021,Southampton 017D,E01017160,660,245,93,152,4,4,56,29,27,355,335,20,0
2021,Southampton 025A,E01017162,628,468,305,163,10,10,102,90,12,48,43,5,0
2021,Southampton 025B,E01017163,652,144,64,80,3,3,440,407,33,62,51,11,3
2021,Southampton 025C,E01017164,687,504,261,243,3,3,104,76,28,76,66,10,0
2021,Southampton 025D,E01017165,621,317,138,179,3,3,244,225,19,53,47,6,4
2021,Southampton 025E,E01017166,739,191,72,119,1,1,491,383,108,52,48,4,4
2021,Southampton 027A,E01017167,706,124,60,64,3,3,500,435,65,78,74,4,1
2021,Southampton 027B,E01017168,793,299,136,163,2,2,388,336,52,104,93,11,0
2021,Southampton 027C,E01017169,663,239,115,124,23,23,338,293,45,63,54,9,0
2021,Southampton 027D,E01017170,675,377,176,201,5,5,192,170,22,97,85,12,4
2021,Southampton 014A,E01017171,884,401,153,248,21,21,132,14,118,330,305,25,0
2021,Southampton 014B,E01017172,827,397,169,228,8,8,69,11,58,353,332,21,0
2021,Southampton 014C,E01017173,640,420,190,230,2,2,79,67,12,139,130,9,0
2021,Southampton 008A,E01017174,572,492,276,216,0,0,24,22,2,56,45,11,0
2021,Southampton 008B,E01017175,602,461,215,246,2,2,20,3,17,119,108,11,0
2021,Southampton 008C,E01017176,674,466,223,243,2,2,48,7,41,158,149,9,0
2021,Southampton 014D,E01017177,784,468,272,196,6,6,44,7,37,266,247,19,0
2021,Southampton 014E,E01017178,585,458,199,259,3,3,8,5,3,116,104,12,0
2021,Southampton 008D,E01017179,532,297,162,135,10,10,117,95,22,108,101,7,0
2021,Southampton 002A,E01017180,585,492,246,246,0,0,22,18,4,70,58,12,1
2021,Southampton 002B,E01017181,597,292,128,164,11,11,234,203,31,60,56,4,0
2021,Southampton 004A,E01017182,710,291,143,148,0,0,368,353,15,45,40,5,6
2021,Southampton 002C,E01017183,663,497,240,257,3,3,60,17,43,103,97,6,0
2021,Southampton 004B,E01017184,599,356,173,183,2,2,177,164,13,63,55,8,1
2021,Southampton 002D,E01017185,716,377,173,204,3,3,223,211,12,113,105,8,0
2021,Southampton 004C,E01017186,714,273,103,170,5,5,305,162,143,130,122,8,1
2021,Southampton 002E,E01017187,728,394,190,204,6,6,150,62,88,178,167,11,0
2021,Southampton 004D,E01017188,620,217,81,136,1,1,282,251,31,118,109,9,2
2021,Southampton 020A,E01017189,702,197,83,114,3,3,38,2,36,464,450,14,0
2021,Southampton 020B,E01017190,674,352,156,196,0,0,3,2,1,319,314,5,0
2021,Southampton 020C,E01017191,801,217,88,129,7,7,52,7,45,525,508,17,0
2021,Southampton 021A,E01017192,907,384,164,220,12,12,133,56,77,377,354,23,1
2021,Southampton 021B,E01017193,882,372,179,193,14,14,154,49,105,342,323,19,0
2021,Southampton 021C,E01017194,964,294,127,167,3,3,165,46,119,501,483,18,1
2021,Southampton 021D,E01017195,978,411,194,217,4,4,116,22,94,447,422,25,0
2021,Southampton 020D,E01017196,1061,436,190,246,10,10,53,11,42,561,531,30,1
2021,Southampton 020E,E01017197,531,394,179,215,1,1,22,6,16,114,108,6,0
2021,Southampton 018A,E01017198,681,415,197,218,13,13,180,165,15,70,59,11,3
2021,Southampton 018B,E01017199,750,477,280,197,3,3,150,65,85,119,112,7,1
2021,Southampton 016A,E01017200,873,657,375,282,8,8,59,17,42,149,132,17,0
2021,Southampton 016B,E01017201,549,249,124,125,4,4,197,163,34,96,89,7,3
2021,Southampton 016C,E01017202,750,260,114,146,4,4,323,286,37,161,151,10,2
2021,Southampton 016D,E01017203,629,457,188,269,4,4,78,68,10,87,81,6,3
2021,Southampton 016E,E01017204,633,495,240,255,6,6,57,18,39,75,63,12,0
2021,Southampton 018C,E01017205,620,255,73,182,19,19,284,195,89,59,54,5,3
2021,Southampton 018D,E01017206,670,460,224,236,6,6,129,100,29,71,57,14,4
2021,Southampton 015A,E01017207,665,148,66,82,1,1,443,399,44,71,68,3,2
2021,Southampton 019A,E01017208,582,239,109,130,1,1,276,254,22,64,57,7,2
2021,Southampton 015B,E01017209,582,366,154,212,2,2,12,8,4,202,184,18,0
2021,Southampton 019B,E01017210,670,194,72,122,14,14,371,313,58,86,78,8,5
2021,Southampton 015C,E01017211,931,412,235,177,11,11,220,94,126,288,273,15,0
2021,Southampton 015D,E01017212,565,376,198,178,2,2,54,7,47,133,120,13,0
2021,Southampton 015E,E01017213,816,394,186,208,27,27,78,25,53,316,302,14,1
2021,Southampton 019C,E01017214,552,400,165,235,0,0,23,8,15,129,122,7,0
2021,Southampton 019D,E01017215,699,567,281,286,6,6,15,7,8,111,102,9,0
2021,Southampton 019E,E01017216,563,303,147,156,2,2,96,61,35,162,147,15,0
2021,Southampton 024A,E01017217,692,489,249,240,4,4,68,35,33,129,117,12,2
2021,Southampton 028A,E01017218,493,267,96,171,3,3,169,113,56,54,49,5,0
2021,Southampton 028B,E01017219,870,283,120,163,15,15,298,235,63,273,256,17,1
2021,Southampton 028C,E01017220,797,394,163,231,9,9,216,96,120,177,167,10,1
2021,Southampton 028D,E01017221,667,480,179,301,3,3,17,4,13,167,149,18,0
2021,Southampton 028E,E01017222,625,432,171,261,4,4,32,11,21,157,140,17,0
2021,Southampton 024B,E01017223,646,529,243,286,2,2,13,10,3,101,98,3,1
2021,Southampton 024C,E01017224,557,435,216,219,2,2,13,8,5,107,97,10,0
2021,Southampton 024D,E01017225,606,387,162,225,3,3,112,104,8,101,96,5,3
2021,Southampton 009A,E01017226,846,418,273,145,2,2,107,16,91,319,302,17,0
2021,Southampton 013A,E01017227,429,78,40,38,4,4,61,13,48,286,276,10,0
2021,Southampton 013B,E01017228,701,284,142,142,5,5,145,86,59,265,246,19,2
2021,Southampton 009D,E01017231,632,222,123,99,1,1,37,13,24,372,354,18,0
2021,Southampton 009E,E01017232,500,269,136,133,4,4,42,19,23,184,177,7,1
2021,Southampton 013C,E01017233,736,343,168,175,8,8,180,65,115,205,193,12,0
2021,Southampton 013D,E01017234,739,263,145,118,2,2,141,60,81,331,321,10,2
2021,Southampton 013E,E01017235,602,115,63,52,3,3,56,11,45,423,413,10,5
2021,Southampton 012A,E01017236,593,248,112,136,6,6,273,255,18,66,56,10,0
2021,Southampton 012B,E01017237,598,240,89,151,1,1,294,254,40,61,58,3,2
2021,Southampton 007A,E01017238,823,404,166,238,10,10,251,184,67,158,147,11,0
2021,Southampton 012C,E01017239,637,333,138,195,3,3,167,153,14,132,127,5,2
2021,Southampton 012D,E01017240,611,210,116,94,8,8,333,280,53,59,53,6,1
2021,Southampton 007B,E01017241,670,273,123,150,18,18,306,269,37,68,60,8,5
2021,Southampton 007C,E01017242,925,478,167,311,15,15,217,112,105,213,197,16,2
2021,Southampton 007D,E01017243,653,493,240,253,5,5,64,42,22,90,79,11,1
2021,Southampton 007E,E01017244,548,290,118,172,7,7,156,129,27,94,85,9,1
2021,Southampton 012E,E01017245,625,137,59,78,1,1,421,396,25,65,60,5,1
2021,Southampton 010A,E01017246,966,373,165,208,24,24,127,22,105,442,431,11,0
2021,Southampton 011A,E01017247,623,481,243,238,2,2,11,4,7,129,123,6,0
2021,Southampton 011B,E01017248,597,471,231,240,1,1,26,5,21,99,91,8,0
2021,Southampton 011C,E01017249,499,443,256,187,0,0,5,0,5,51,41,10,0
2021,Southampton 010B,E01017250,764,196,97,99,5,5,408,374,34,151,135,16,4
2021,Southampton 010C,E01017251,663,203,92,111,13,13,217,155,62,229,214,15,1
2021,Southampton 011D,E01017252,647,506,283,223,4,4,16,16,0,121,106,15,0
2021,Southampton 010D,E01017253,669,341,153,188,4,4,143,110,33,180,175,5,1
2021,Southampton 011E,E01017254,678,355,162,193,7,7,128,45,83,188,175,13,0
2021,Southampton 030A,E01017255,706,532,227,305,1,1,11,6,5,162,149,13,0
2021,Southampton 026A,E01017256,874,708,366,342,5,5,28,6,22,133,118,15,0
2021,Southampton 026B,E01017257,777,448,213,235,6,6,97,58,39,226,208,18,0
2021,Southampton 030B,E01017258,645,416,195,221,1,1,128,111,17,100,91,9,0
2021,Southampton 026C,E01017259,595,493,238,255,1,1,25,23,2,76,68,8,0
2021,Southampton 026D,E01017260,638,427,240,187,2,2,116,109,7,93,85,8,0
2021,Southampton 030C,E01017261,729,560,288,272,10,10,32,2,30,127,108,19,0
2021,Southampton 026E,E01017262,538,333,157,176,9,9,129,75,54,67,55,12,0
2021,Southampton 030D,E01017263,666,394,176,218,10,10,150,67,83,111,102,9,1
2021,Southampton 003A,E01017264,521,105,40,65,17,17,275,29,246,124,116,8,0
2021,Southampton 003B,E01017265,741,274,140,134,10,10,369,28,341,88,74,14,0
2021,Southampton 005A,E01017266,487,152,82,70,2,2,167,145,22,164,161,3,2
2021,Southampton 005B,E01017267,459,162,78,84,3,3,84,58,26,210,203,7,0
2021,Southampton 003C,E01017270,565,242,111,131,1,1,218,205,13,104,91,13,0
2021,Southampton 003D,E01017271,480,334,192,142,2,2,25,13,12,119,108,11,0
2021,Southampton 005E,E01017272,506,230,88,142,2,2,166,162,4,108,101,7,0
2021,Southampton 031A,E01017273,649,449,224,225,7,7,54,22,32,139,121,18,0
2021,Southampton 032A,E01017274,614,225,100,125,1,1,324,227,97,59,52,7,5
2021,Southampton 031B,E01017275,684,464,221,243,1,1,73,48,25,146,140,6,0
2021,Southampton 031C,E01017276,867,404,134,270,6,6,189,20,169,267,256,11,1
2021,Southampton 032B,E01017277,583,408,188,220,2,2,94,85,9,79,70,9,0
2021,Southampton 031E,E01017279,722,438,218,220,5,5,100,37,63,179,162,17,0
2021,Southampton 032C,E01017280,732,248,105,143,8,8,352,322,30,121,114,7,3
2021,Southampton 032D,E01017281,690,62,39,23,6,6,543,508,35,76,68,8,3
2021,Isle of Wight 006A,E01017282,596,421,213,208,2,2,71,9,62,102,90,12,0
2021,Isle of Wight 006B,E01017283,738,605,378,227,3,3,24,3,21,106,90,16,0
2021,Isle of Wight 010A,E01017284,805,679,532,147,4,4,7,0,7,115,90,25,0
2021,Isle of Wight 010B,E01017285,945,738,585,153,3,3,90,5,85,114,90,24,0
2021,Isle of Wight 005A,E01017286,727,620,449,171,4,4,26,3,23,77,61,16,0
2021,Isle of Wight 005B,E01017287,742,631,403,228,3,3,9,1,8,99,91,8,0
2021,Isle of Wight 010C,E01017288,593,436,317,119,3,3,42,1,41,112,88,24,0
2021,Isle of Wight 014A,E01017289,977,719,488,231,4,4,129,14,115,125,113,12,0
2021,Isle of Wight 013A,E01017290,551,428,315,113,2,2,24,4,20,97,71,26,0
2021,Isle of Wight 013B,E01017291,580,497,376,121,3,3,29,2,27,51,42,9,0
2021,Isle of Wight 011A,E01017292,780,551,313,238,22,22,55,2,53,152,133,19,0
2021,Isle of Wight 011B,E01017293,791,662,370,292,3,3,19,1,18,107,94,13,0
2021,Isle of Wight 013C,E01017294,694,565,346,219,0,0,20,1,19,109,89,20,0
2021,Isle of Wight 009A,E01017295,592,331,188,143,7,7,98,11,87,156,137,19,0
2021,Isle of Wight 011C,E01017296,554,441,302,139,2,2,20,0,20,91,59,32,0
2021,Isle of Wight 017A,E01017297,639,479,319,160,3,3,68,2,66,89,62,27,0
2021,Isle of Wight 017B,E01017298,705,594,412,182,2,2,29,3,26,80,65,15,0
2021,Isle of Wight 017C,E01017299,578,393,287,106,8,8,98,11,87,79,64,15,0
2021,Isle of Wight 001A,E01017300,1148,713,498,215,6,6,90,4,86,339,300,39,0
2021,Isle of Wight 002A,E01017301,483,426,284,142,0,0,3,0,3,54,46,8,0
2021,Isle of Wight 002B,E01017302,687,546,291,255,6,6,28,1,27,107,94,13,0
2021,Isle of Wight 001B,E01017303,558,364,188,176,6,6,8,1,7,180,169,11,0
2021,Isle of Wight 002C,E01017304,581,406,211,195,1,1,78,9,69,96,76,20,0
2021,Isle of Wight 001C,E01017305,703,354,178,176,5,5,81,5,76,263,242,21,0
2021,Isle of Wight 001D,E01017306,558,334,141,193,2,2,102,15,87,119,107,12,1
2021,Isle of Wight 003A,E01017307,1129,812,576,236,31,31,64,5,59,222,201,21,0
2021,Isle of Wight 003B,E01017308,737,447,232,215,4,4,135,5,130,151,131,20,0
2021,Isle of Wight 001E,E01017309,699,427,185,242,4,4,41,4,37,227,204,23,0
2021,Isle of Wight 008A,E01017310,585,479,312,167,0,0,17,0,17,89,75,14,0
2021,Isle of Wight 008B,E01017311,709,466,262,204,2,2,68,4,64,173,161,12,0
2021,Isle of Wight 012A,E01017312,884,536,391,145,12,12,150,12,138,186,166,20,0
2021,Isle of Wight 012D,E01017315,722,443,309,134,5,5,183,12,171,91,77,14,0
2021,Isle of Wight 002D,E01017316,979,742,508,234,6,6,29,2,27,202,174,28,0
2021,Isle of Wight 015A,E01017317,664,507,328,179,0,0,65,7,58,92,73,19,0
2021,Isle of Wight 016A,E01017318,523,293,165,128,1,1,127,8,119,102,90,12,0
2021,Isle of Wight 016B,E01017319,676,456,359,97,0,0,105,7,98,115,101,14,0
2021,Isle of Wight 015B,E01017320,567,492,380,112,3,3,16,0,16,56,39,17,0
2021,Isle of Wight 011D,E01017321,604,499,304,195,3,3,38,3,35,64,54,10,0
2021,Isle of Wight 011E,E01017322,606,262,128,134,3,3,240,20,220,101,88,13,0
2021,Isle of Wight 015C,E01017323,522,468,325,143,3,3,19,0,19,32,27,5,0
2021,Isle of Wight 015D,E01017324,649,525,353,172,3,3,35,3,32,86,69,17,0
2021,Isle of Wight 009B,E01017325,624,320,180,140,2,2,137,10,127,165,145,20,0
2021,Isle of Wight 009C,E01017326,884,291,187,104,3,3,145,15,130,445,404,41,0
2021,Isle of Wight 011F,E01017327,694,457,278,179,7,7,61,14,47,167,146,21,2
2021,Isle of Wight 009D,E01017328,705,321,166,155,4,4,75,4,71,305,287,18,0
2021,Isle of Wight 002E,E01017329,1007,846,556,290,4,4,56,2,54,101,75,26,0
2021,Isle of Wight 008C,E01017331,995,513,231,282,49,49,315,28,287,118,100,18,0
2021,Isle of Wight 008D,E01017332,840,368,175,193,22,22,320,41,279,129,114,15,1
2021,Isle of Wight 009E,E01017333,668,506,220,286,3,3,35,5,30,124,105,19,0
2021,Isle of Wight 008E,E01017334,496,369,190,179,2,2,54,6,48,69,56,13,2
2021,Isle of Wight 004A,E01017335,811,400,247,153,1,1,97,7,90,313,289,24,0
2021,Isle of Wight 004B,E01017336,895,315,215,100,4,4,43,11,32,533,513,20,0
2021,Isle of Wight 004C,E01017337,855,405,241,164,3,3,66,8,58,381,343,38,0
2021,Isle of Wight 006C,E01017338,652,505,362,143,2,2,36,5,31,109,88,21,0
2021,Isle of Wight 007A,E01017339,784,499,259,240,4,4,112,11,101,169,158,11,0
2021,Isle of Wight 007B,E01017340,875,459,242,217,1,1,106,14,92,309,283,26,0
2021,Isle of Wight 006D,E01017341,676,390,235,155,8,8,166,19,147,112,92,20,0
2021,Isle of Wight 006E,E01017342,741,498,304,194,3,3,75,10,65,165,149,16,0
2021,Isle of Wight 007C,E01017343,574,340,207,133,0,0,142,24,118,91,75,16,1
2021,Isle of Wight 007D,E01017344,783,631,439,192,6,6,28,3,25,118,103,15,0
2021,Isle of Wight 007E,E01017345,825,292,170,122,6,6,336,31,305,191,182,9,0
2021,Isle of Wight 004D,E01017346,720,397,236,161,0,0,67,5,62,256,240,16,0
2021,Isle of Wight 014B,E01017347,811,581,402,179,4,4,92,8,84,134,123,11,0
2021,Isle of Wight 014C,E01017348,601,374,238,136,1,1,26,4,22,199,179,20,1
2021,Isle of Wight 014D,E01017349,1025,558,349,209,25,25,18,6,12,424,390,34,0
2021,Isle of Wight 014E,E01017350,821,467,299,168,31,31,196,25,171,127,110,17,0
2021,Isle of Wight 010D,E01017351,667,516,377,139,1,1,32,4,28,118,99,19,0
2021,Isle of Wight 010E,E01017352,542,500,382,118,1,1,3,1,2,38,28,10,0
2021,Isle of Wight 013D,E01017353,577,460,328,132,12,12,51,4,47,54,40,14,0
2021,Isle of Wight 012E,E01017354,581,383,302,81,5,5,73,5,68,120,108,12,0
2021,Isle of Wight 015E,E01017355,712,553,384,169,7,7,38,7,31,114,97,17,0
2021,Isle of Wight 016C,E01017356,738,378,253,125,7,7,72,7,65,281,254,27,0
2021,Isle of Wight 016D,E01017357,658,400,288,112,3,3,158,17,141,97,84,13,0
2021,Isle of Wight 015F,E01017358,599,498,392,106,1,1,55,6,49,45,30,15,0
2021,Isle of Wight 016E,E01017359,729,589,439,150,1,1,8,1,7,131,114,17,0
2021,Isle of Wight 016F,E01017360,888,461,330,131,0,0,45,4,41,382,357,25,0
2021,Isle of Wight 012F,E01017361,673,547,422,125,2,2,32,3,29,92,71,21,0
2021,Isle of Wight 012G,E01017362,724,483,346,137,6,6,67,5,62,168,154,14,0
2021,Isle of Wight 018A,E01017363,790,349,263,86,4,4,146,14,132,291,261,30,0
2021,Isle of Wight 018B,E01017364,699,497,353,144,4,4,39,2,37,159,135,24,0
2021,Isle of Wight 018C,E01017365,696,538,431,107,0,0,34,3,31,124,105,19,0
2021,Isle of Wight 018D,E01017366,642,394,261,133,3,3,139,13,126,106,89,17,0
2021,Isle of Wight 005C,E01017367,895,772,556,216,3,3,8,1,7,112,84,28,0
2021,Isle of Wight 005D,E01017368,735,458,307,151,40,40,107,13,94,130,109,21,0
2021,Isle of Wight 017D,E01017369,668,514,335,179,2,2,66,2,64,86,73,13,0
2021,Isle of Wight 018E,E01017370,796,611,436,175,2,2,117,5,112,66,50,16,0
2021,Central Bedfordshire 012A,E01017371,738,605,330,275,26,26,51,7,44,56,43,13,0
2021,Central Bedfordshire 012B,E01017372,790,570,235,335,1,1,144,12,132,75,61,14,0
2021,Central Bedfordshire 012C,E01017373,866,688,276,412,49,49,63,5,58,66,53,13,0
2021,Central Bedfordshire 012D,E01017374,665,531,281,250,5,5,16,3,13,113,101,12,0
2021,Central Bedfordshire 012E,E01017375,691,474,233,241,7,7,83,7,76,127,112,15,0
2021,Central Bedfordshire 010A,E01017376,918,651,246,405,19,19,71,3,68,177,161,16,0
2021,Central Bedfordshire 010B,E01017377,764,577,260,317,4,4,100,10,90,82,68,14,1
2021,Central Bedfordshire 010C,E01017378,889,484,191,293,10,10,297,34,263,97,83,14,1
2021,Central Bedfordshire 007A,E01017379,516,309,173,136,0,0,118,8,110,89,66,23,0
2021,Central Bedfordshire 007B,E01017380,541,471,235,236,0,0,14,1,13,56,46,10,0
2021,Central Bedfordshire 006A,E01017381,625,533,329,204,6,6,8,3,5,78,73,5,0
2021,Central Bedfordshire 006B,E01017382,601,393,222,171,1,1,138,15,123,67,60,7,2
2021,Central Bedfordshire 005A,E01017383,897,558,279,279,17,17,71,11,60,251,228,23,0
2021,Central Bedfordshire 005B,E01017384,689,350,139,211,20,20,215,28,187,103,94,9,1
2021,Central Bedfordshire 005C,E01017385,1012,600,352,248,9,9,108,11,97,295,268,27,0
2021,Central Bedfordshire 005D,E01017386,768,492,223,269,2,2,110,6,104,163,148,15,1
2021,Central Bedfordshire 005E,E01017387,490,405,210,195,2,2,51,9,42,32,28,4,0
2021,Central Bedfordshire 005F,E01017388,1112,773,263,510,57,57,204,24,180,78,71,7,0
2021,Central Bedfordshire 013A,E01017391,636,413,206,207,11,11,166,6,160,46,38,8,0
2021,Central Bedfordshire 013B,E01017392,777,682,404,278,16,16,27,5,22,52,41,11,0
2021,Central Bedfordshire 013C,E01017393,804,665,336,329,5,5,61,1,60,73,65,8,0
2021,Central Bedfordshire 007C,E01017394,588,423,220,203,0,0,73,1,72,92,89,3,0
2021,Central Bedfordshire 007F,E01017397,719,526,284,242,5,5,51,4,47,136,125,11,1
2021,Central Bedfordshire 017A,E01017398,985,824,430,394,13,13,71,8,63,77,66,11,0
2021,Central Bedfordshire 015A,E01017399,592,438,185,253,4,4,34,1,33,116,103,13,0
2021,Central Bedfordshire 015B,E01017400,660,227,108,119,3,3,382,38,344,48,38,10,0
2021,Central Bedfordshire 015C,E01017401,537,362,156,206,0,0,52,4,48,123,118,5,0
2021,Central Bedfordshire 015D,E01017402,656,566,347,219,2,2,13,5,8,74,64,10,1
2021,Central Bedfordshire 016A,E01017403,625,471,214,257,12,12,56,4,52,85,75,10,1
2021,Central Bedfordshire 016B,E01017404,492,464,286,178,0,0,3,1,2,25,22,3,0
2021,Central Bedfordshire 016C,E01017405,607,462,241,221,1,1,12,5,7,132,124,8,0
2021,Central Bedfordshire 016D,E01017406,1043,826,265,561,5,5,56,8,48,156,139,17,0
2021,Central Bedfordshire 016E,E01017407,682,488,230,258,4,4,31,3,28,159,144,15,0
2021,Central Bedfordshire 017B,E01017408,433,375,207,168,0,0,10,0,10,48,42,6,0
2021,Central Bedfordshire 017C,E01017409,520,410,235,175,1,1,67,1,66,42,32,10,0
2021,Central Bedfordshire 008A,E01017410,498,393,245,148,5,5,64,7,57,35,27,8,1
2021,Central Bedfordshire 004A,E01017412,610,298,172,126,1,1,109,8,101,202,179,23,0
2021,Central Bedfordshire 010D,E01017413,909,748,370,378,37,37,69,8,61,55,44,11,0
2021,Central Bedfordshire 010E,E01017414,804,603,333,270,13,13,126,16,110,61,48,13,1
2021,Central Bedfordshire 010F,E01017415,849,567,283,284,38,38,153,10,143,90,75,15,1
2021,Central Bedfordshire 009C,E01017418,639,386,202,184,4,4,176,16,160,73,65,8,0
2021,Central Bedfordshire 008C,E01017419,673,607,349,258,6,6,15,4,11,45,40,5,0
2021,Central Bedfordshire 008D,E01017420,700,449,232,217,4,4,165,8,157,82,70,12,0
2021,Central Bedfordshire 008E,E01017421,746,575,302,273,5,5,106,5,101,59,51,8,1
2021,Central Bedfordshire 004B,E01017422,696,544,320,224,10,10,85,7,78,57,42,15,0
2021,Central Bedfordshire 004C,E01017423,798,565,286,279,13,13,149,13,136,71,58,13,0
2021,Central Bedfordshire 004D,E01017424,614,486,291,195,9,9,73,5,68,46,35,11,0
2021,Central Bedfordshire 003A,E01017425,479,344,196,148,2,2,70,10,60,63,51,12,0
2021,Central Bedfordshire 003B,E01017426,599,516,317,199,1,1,40,7,33,42,33,9,0
2021,Central Bedfordshire 003C,E01017427,841,531,255,276,24,24,163,18,145,123,114,9,0
2021,Central Bedfordshire 003D,E01017428,707,517,264,253,4,4,97,13,84,89,73,16,0
2021,Central Bedfordshire 003E,E01017429,867,621,265,356,36,36,55,5,50,153,132,21,2
2021,Central Bedfordshire 002A,E01017430,643,414,219,195,2,2,139,22,117,88,76,12,0
2021,Central Bedfordshire 002B,E01017431,750,492,244,248,18,18,102,18,84,138,124,14,0
2021,Central Bedfordshire 002C,E01017432,579,511,275,236,1,1,24,2,22,43,38,5,0
2021,Central Bedfordshire 001A,E01017433,646,218,90,128,14,14,366,44,322,48,45,3,0
2021,Central Bedfordshire 001B,E01017434,690,480,211,269,6,6,94,7,87,110,103,7,0
2021,Central Bedfordshire 002D,E01017435,729,411,189,222,4,4,183,18,165,131,114,17,0
2021,Central Bedfordshire 001C,E01017436,977,815,373,442,24,24,16,0,16,122,110,12,0
2021,Central Bedfordshire 011A,E01017437,807,476,238,238,23,23,177,18,159,131,119,12,0
2021,Central Bedfordshire 011B,E01017438,725,585,293,292,4,4,37,3,34,99,91,8,0
2021,Central Bedfordshire 011C,E01017439,791,596,247,349,25,25,58,6,52,111,45,66,1
2021,Central Bedfordshire 011D,E01017440,822,456,168,288,35,35,270,26,244,61,48,13,0
2021,Central Bedfordshire 011E,E01017441,643,412,192,220,5,5,47,3,44,179,46,133,0
2021,Central Bedfordshire 013D,E01017442,1080,826,346,480,50,50,131,7,124,73,62,11,0
2021,Central Bedfordshire 013E,E01017443,715,462,251,211,12,12,42,7,35,198,95,103,1
2021,Central Bedfordshire 011F,E01017444,876,606,342,264,18,18,144,12,132,108,89,19,0
2021,Central Bedfordshire 014A,E01017446,746,468,238,230,2,2,178,18,160,97,87,10,1
2021,Central Bedfordshire 014B,E01017447,1046,829,408,421,29,29,82,5,77,106,91,15,0
2021,Central Bedfordshire 014D,E01017449,860,692,318,374,16,16,81,11,70,71,56,15,0
2021,Central Bedfordshire 017E,E01017450,891,719,381,338,9,9,82,6,76,81,62,19,0
2021,Central Bedfordshire 009D,E01017451,601,330,178,152,0,0,64,2,62,207,179,28,0
2021,Central Bedfordshire 009E,E01017452,601,383,256,127,3,3,53,4,49,162,139,23,0
2021,Bedford 005A,E01017453,624,304,183,121,3,3,255,28,227,62,53,9,0
2021,Bedford 005B,E01017454,584,484,306,178,3,3,41,5,36,56,41,15,0
2021,Bedford 005C,E01017455,646,540,331,209,1,1,20,4,16,84,75,9,1
2021,Bedford 005D,E01017456,644,552,343,209,1,1,48,1,47,43,36,7,0
2021,Bedford 005E,E01017457,495,342,186,156,2,2,115,15,100,36,30,6,0
2021,Bedford 005F,E01017458,512,403,219,184,4,4,40,4,36,65,56,9,0
2021,Bedford 008A,E01017459,696,609,397,212,13,13,2,0,2,72,66,6,0
2021,Bedford 008B,E01017460,926,724,340,384,51,51,34,2,32,117,103,14,0
2021,Bedford 008D,E01017462,622,553,316,237,3,3,13,1,12,53,41,12,0
2021,Bedford 008E,E01017463,592,490,305,185,5,5,62,6,56,35,25,10,0
2021,Bedford 002A,E01017464,632,531,353,178,5,5,43,5,38,53,44,9,0
2021,Bedford 002B,E01017465,643,505,322,183,15,15,49,4,45,74,65,9,0
2021,Bedford 012A,E01017466,995,241,105,136,37,37,151,21,130,566,530,36,0
2021,Bedford 012B,E01017467,653,406,196,210,4,4,58,6,52,185,176,9,0
2021,Bedford 012C,E01017468,595,409,210,199,2,2,21,5,16,163,145,18,0
2021,Bedford 012E,E01017470,509,409,222,187,3,3,4,0,4,93,85,8,0
2021,Bedford 012F,E01017471,979,123,65,58,49,49,415,80,335,386,360,26,6
2021,Bedford 015A,E01017472,545,173,73,100,7,7,256,52,204,109,102,7,0
2021,Bedford 015C,E01017474,696,232,106,126,11,11,181,36,145,272,256,16,0
2021,Bedford 015D,E01017475,577,343,172,171,3,3,39,8,31,192,176,16,0
2021,Bedford 015E,E01017476,550,381,194,187,0,0,37,6,31,132,117,15,0
2021,Bedford 015F,E01017477,520,141,73,68,6,6,336,63,273,37,35,2,0
2021,Bedford 003A,E01017478,725,532,307,225,4,4,91,9,82,98,82,16,0
2021,Bedford 003B,E01017479,644,519,353,166,1,1,45,3,42,79,69,10,0
2021,Bedford 003C,E01017480,781,566,237,329,13,13,77,13,64,125,110,15,0
2021,Bedford 003D,E01017481,493,356,199,157,1,1,83,18,65,53,43,10,0
2021,Bedford 009A,E01017482,622,298,148,150,1,1,119,19,100,203,190,13,1
2021,Bedford 009B,E01017483,590,457,301,156,3,3,16,1,15,114,103,11,0
2021,Bedford 009C,E01017484,621,196,107,89,1,1,89,12,77,333,308,25,2
2021,Bedford 009D,E01017485,626,320,154,166,17,17,32,4,28,257,244,13,0
2021,Bedford 021B,E01017487,744,451,164,287,4,4,200,24,176,89,75,14,0
2021,Bedford 007A,E01017488,699,588,388,200,4,4,42,4,38,65,55,10,0
2021,Bedford 007B,E01017489,612,225,121,104,5,5,315,63,252,67,53,14,0
2021,Bedford 007C,E01017490,597,204,92,112,1,1,331,61,270,61,58,3,0
2021,Bedford 007D,E01017491,642,448,239,209,1,1,76,16,60,117,99,18,0
2021,Bedford 007E,E01017492,614,276,131,145,6,6,236,44,192,96,86,10,0
2021,Bedford 007F,E01017493,649,327,133,194,16,16,200,17,183,106,100,6,0
2021,Bedford 004B,E01017495,939,717,368,349,20,20,82,10,72,120,99,21,0
2021,Bedford 004C,E01017496,684,557,347,210,5,5,64,9,55,58,50,8,0
2021,Bedford 010A,E01017497,603,302,140,162,3,3,49,7,42,247,229,18,2
2021,Bedford 010B,E01017498,491,392,229,163,4,4,11,1,10,84,75,9,0
2021,Bedford 010C,E01017499,625,277,131,146,2,2,65,4,61,281,256,25,0
2021,Bedford 010D,E01017500,620,228,107,121,2,2,151,22,129,239,234,5,0
2021,Bedford 010E,E01017501,941,291,151,140,19,19,162,22,140,468,448,20,1
2021,Bedford 010F,E01017502,926,121,55,66,2,2,492,91,401,307,275,32,4
2021,Bedford 002C,E01017503,548,373,198,175,5,5,72,9,63,98,81,17,0
2021,Bedford 002D,E01017504,854,603,316,287,12,12,85,11,74,154,143,11,0
2021,Bedford 017A,E01017505,645,411,233,178,3,3,103,15,88,128,119,9,0
2021,Bedford 017B,E01017506,671,325,159,166,29,29,129,18,111,187,178,9,1
2021,Bedford 017C,E01017507,528,393,203,190,2,2,41,3,38,92,86,6,0
2021,Bedford 017D,E01017508,687,475,227,248,5,5,35,7,28,172,154,18,0
2021,Bedford 016A,E01017509,520,174,96,78,1,1,306,23,283,36,33,3,3
2021,Bedford 016B,E01017510,720,513,276,237,1,1,70,1,69,136,123,13,0
2021,Bedford 016C,E01017511,484,340,211,129,10,10,55,2,53,79,75,4,0
2021,Bedford 016D,E01017512,541,295,147,148,8,8,143,13,130,94,86,8,1
2021,Bedford 018A,E01017513,547,402,203,199,4,4,35,11,24,106,92,14,0
2021,Bedford 018B,E01017514,667,278,152,126,3,3,286,51,235,100,88,12,0
2021,Bedford 018C,E01017515,625,343,160,183,6,6,206,34,172,69,58,11,1
2021,Bedford 018E,E01017517,597,482,250,232,5,5,24,3,21,86,74,12,0
2021,Bedford 014A,E01017518,653,311,119,192,16,16,180,27,153,146,129,17,0
2021,Bedford 014B,E01017519,643,264,116,148,0,0,301,61,240,77,63,14,1
2021,Bedford 014C,E01017520,786,482,227,255,12,12,139,21,118,153,137,16,0
2021,Bedford 014D,E01017521,643,416,189,227,4,4,90,10,80,130,115,15,3
2021,Bedford 014E,E01017522,948,322,180,142,6,6,222,44,178,396,363,33,2
2021,Bedford 014F,E01017523,631,180,64,116,0,0,375,91,284,76,62,14,0
2021,Bedford 011A,E01017524,696,527,306,221,3,3,72,6,66,94,81,13,0
2021,Bedford 011B,E01017525,509,311,161,150,2,2,145,16,129,51,45,6,0
2021,Bedford 011C,E01017526,614,428,228,200,6,6,17,3,14,163,153,10,0
2021,Bedford 011D,E01017527,545,358,215,143,5,5,19,3,16,163,155,8,0
2021,Bedford 003E,E01017528,977,802,424,378,12,12,57,3,54,106,85,21,0
2021,Bedford 006A,E01017529,514,448,261,187,1,1,13,0,13,52,47,5,0
2021,Bedford 006B,E01017530,582,523,326,197,1,1,9,1,8,48,37,11,1
2021,Bedford 006C,E01017531,581,272,149,123,4,4,252,25,227,53,47,6,0
2021,Bedford 006D,E01017532,511,467,275,192,2,2,3,0,3,39,33,6,0
2021,Bedford 006E,E01017533,481,434,304,130,0,0,8,2,6,39,31,8,0
2021,Bedford 006F,E01017534,641,566,356,210,3,3,5,1,4,67,56,11,0
2021,Bedford 013A,E01017535,674,483,183,300,17,17,71,11,60,103,92,11,0
2021,Bedford 013B,E01017536,843,302,143,159,8,8,122,21,101,411,381,30,0
2021,Bedford 013C,E01017537,492,200,98,102,6,6,220,43,177,66,57,9,0
2021,Bedford 013D,E01017538,524,308,162,146,3,3,54,11,43,159,140,19,0
2021,Bedford 013E,E01017539,526,264,151,113,2,2,61,7,54,199,181,18,0
2021,Bedford 001A,E01017540,615,511,302,209,0,0,31,5,26,73,51,22,0
2021,Bedford 001B,E01017541,532,423,252,171,9,9,57,3,54,42,35,7,1
2021,Bedford 004D,E01017542,615,447,260,187,2,2,74,4,70,92,78,14,0
2021,Bedford 004E,E01017543,630,516,297,219,1,1,43,0,43,70,54,16,0
2021,Bedford 001C,E01017544,607,476,295,181,6,6,52,6,46,72,52,20,1
2021,Bedford 001D,E01017545,596,444,248,196,5,5,31,1,30,116,94,22,0
2021,Bedford 002E,E01017546,503,369,219,150,1,1,62,5,57,70,59,11,1
2021,Bedford 002F,E01017547,643,558,306,252,3,3,34,6,28,48,40,8,0
2021,Bedford 021F,E01017549,714,608,413,195,20,20,35,5,30,51,40,11,0
2021,Bedford 020B,E01017552,1043,736,173,563,67,67,158,24,134,82,50,32,0
2021,Bedford 020C,E01017553,551,492,274,218,9,9,26,4,22,24,18,6,0
2021,Bedford 020D,E01017554,808,542,267,275,23,23,191,21,170,52,45,7,0
2021,Central Bedfordshire 021A,E01017555,1061,497,258,239,4,4,195,143,52,359,326,33,6
2021,Central Bedfordshire 021B,E01017556,722,544,222,322,2,2,27,20,7,149,136,13,0
2021,Central Bedfordshire 021C,E01017557,1000,533,279,254,6,6,243,118,125,215,198,17,3
2021,Central Bedfordshire 018A,E01017558,752,574,292,282,8,8,54,8,46,116,99,17,0
2021,Central Bedfordshire 018B,E01017559,677,543,276,267,2,2,78,63,15,53,48,5,1
2021,Central Bedfordshire 018C,E01017560,624,574,348,226,1,1,12,7,5,37,32,5,0
2021,Central Bedfordshire 033A,E01017561,620,538,321,217,5,5,33,27,6,44,40,4,0
2021,Central Bedfordshire 033B,E01017562,1057,736,366,370,24,24,223,109,114,73,57,16,1
2021,Central Bedfordshire 033C,E01017563,687,621,372,249,0,0,8,2,6,58,51,7,0
2021,Central Bedfordshire 033D,E01017564,622,473,255,218,2,2,24,20,4,122,101,21,1
2021,Central Bedfordshire 029A,E01017565,632,554,342,212,1,1,36,15,21,41,30,11,0
2021,Central Bedfordshire 028A,E01017566,596,550,344,206,2,2,13,3,10,31,26,5,0
2021,Central Bedfordshire 029B,E01017567,708,438,207,231,0,0,150,89,61,119,105,14,1
2021,Central Bedfordshire 029C,E01017568,1036,464,184,280,37,37,181,94,87,352,327,25,2
2021,Central Bedfordshire 029D,E01017569,813,451,195,256,3,3,123,59,64,236,217,19,0
2021,Central Bedfordshire 032A,E01017571,543,396,243,153,1,1,103,93,10,43,35,8,0
2021,Central Bedfordshire 032B,E01017572,585,473,254,219,5,5,17,8,9,90,77,13,0
2021,Central Bedfordshire 024A,E01017573,594,538,324,214,1,1,6,1,5,48,38,10,1
2021,Central Bedfordshire 024D,E01017576,554,430,227,203,2,2,86,78,8,32,26,6,4
2021,Central Bedfordshire 019A,E01017577,1066,820,402,418,8,8,106,88,18,130,117,13,2
2021,Central Bedfordshire 026A,E01017578,913,754,274,480,9,9,49,5,44,101,86,15,0
2021,Central Bedfordshire 026B,E01017579,785,496,215,281,26,26,178,69,109,85,76,9,0
2021,Central Bedfordshire 026C,E01017580,1019,500,171,329,37,37,291,11,280,191,178,13,0
2021,Central Bedfordshire 026D,E01017581,760,470,189,281,4,4,178,109,69,106,95,11,2
2021,Central Bedfordshire 027A,E01017582,597,507,277,230,0,0,11,5,6,79,67,12,0
2021,Central Bedfordshire 027B,E01017583,742,584,278,306,9,9,25,2,23,124,113,11,0
2021,Central Bedfordshire 027C,E01017584,807,593,305,288,6,6,55,6,49,153,132,21,0
2021,Central Bedfordshire 027D,E01017585,538,490,274,216,2,2,7,3,4,39,31,8,0
2021,Central Bedfordshire 032C,E01017586,626,452,221,231,1,1,125,122,3,46,33,13,2
2021,Central Bedfordshire 032D,E01017587,717,625,418,207,6,6,36,27,9,50,39,11,0
2021,Central Bedfordshire 032E,E01017588,553,437,275,162,1,1,57,46,11,58,46,12,0
2021,Central Bedfordshire 022A,E01017589,806,449,176,273,5,5,110,76,34,240,231,9,2
2021,Central Bedfordshire 022B,E01017590,659,534,314,220,5,5,24,17,7,96,89,7,0
2021,Central Bedfordshire 022C,E01017591,774,529,271,258,5,5,91,51,40,149,138,11,0
2021,Central Bedfordshire 030A,E01017592,753,528,267,261,1,1,96,65,31,128,112,16,0
2021,Central Bedfordshire 030B,E01017593,637,498,268,230,1,1,76,62,14,62,55,7,0
2021,Central Bedfordshire 030C,E01017594,891,307,112,195,16,16,499,384,115,66,57,9,3
2021,Central Bedfordshire 028B,E01017595,469,286,149,137,1,1,157,144,13,24,15,9,1
2021,Central Bedfordshire 028C,E01017596,620,324,123,201,1,1,220,186,34,73,68,5,2
2021,Central Bedfordshire 028D,E01017597,617,403,190,213,5,5,144,130,14,63,54,9,2
2021,Central Bedfordshire 028E,E01017598,641,534,184,350,35,35,26,3,23,46,38,8,0
2021,Central Bedfordshire 025A,E01017600,838,588,218,370,3,3,25,8,17,220,191,29,2
2021,Central Bedfordshire 025B,E01017601,506,241,97,144,2,2,186,163,23,75,67,8,2
2021,Central Bedfordshire 025C,E01017602,629,248,111,137,27,27,261,202,59,90,75,15,3
2021,Central Bedfordshire 020A,E01017603,643,528,293,235,4,4,10,2,8,101,84,17,0
2021,Central Bedfordshire 020B,E01017604,640,546,276,270,3,3,29,20,9,62,51,11,0
2021,Central Bedfordshire 020C,E01017605,514,259,111,148,5,5,204,193,11,44,37,7,2
2021,Central Bedfordshire 020D,E01017606,734,683,384,299,3,3,6,0,6,42,38,4,0
2021,Central Bedfordshire 020E,E01017607,532,486,282,204,1,1,6,4,2,39,34,5,0
2021,Central Bedfordshire 021D,E01017608,754,494,237,257,6,6,128,85,43,126,107,19,0
2021,Central Bedfordshire 021E,E01017609,817,386,131,255,15,15,354,313,41,61,50,11,1
2021,Central Bedfordshire 022D,E01017610,449,411,231,180,3,3,4,0,4,31,28,3,0
2021,Central Bedfordshire 023A,E01017611,505,423,241,182,1,1,7,3,4,74,71,3,0
2021,Central Bedfordshire 023B,E01017612,534,453,231,222,1,1,9,1,8,71,61,10,0
2021,Central Bedfordshire 023C,E01017613,595,471,240,231,3,3,35,4,31,86,81,5,0
2021,Central Bedfordshire 023D,E01017614,583,471,237,234,2,2,34,33,1,76,61,15,0
2021,Central Bedfordshire 018D,E01017616,957,646,304,342,6,6,71,58,13,231,214,17,3
2021,Central Bedfordshire 026E,E01017617,529,394,211,183,0,0,72,61,11,63,52,11,0
2021,Central Bedfordshire 025D,E01017618,792,435,137,298,11,11,256,210,46,90,82,8,0
2021,Central Bedfordshire 025E,E01017619,776,408,135,273,4,4,282,261,21,81,70,11,1
2021,Central Bedfordshire 019C,E01017620,762,593,300,293,6,6,32,21,11,131,117,14,0
2021,Central Bedfordshire 019D,E01017621,635,575,348,227,1,1,7,3,4,52,45,7,0
2021,Central Bedfordshire 019E,E01017622,705,430,189,241,7,7,159,137,22,108,90,18,1
2021,Central Bedfordshire 031A,E01017623,784,449,215,234,3,3,72,53,19,259,244,15,1
2021,Central Bedfordshire 031B,E01017624,729,582,284,298,28,28,24,2,22,95,88,7,0
2021,Central Bedfordshire 031C,E01017625,646,603,361,242,1,1,10,2,8,32,24,8,0
2021,Central Bedfordshire 031D,E01017626,664,567,366,201,2,2,12,7,5,83,71,12,0
2021,Buckinghamshire 021A,E01017627,755,543,277,266,0,0,122,27,95,90,56,34,0
2021,Buckinghamshire 021B,E01017628,663,563,323,240,12,12,38,3,35,50,43,7,0
2021,Buckinghamshire 021C,E01017629,719,622,374,248,4,4,23,2,21,70,56,14,0
2021,Buckinghamshire 021D,E01017630,648,531,309,222,3,3,72,27,45,42,34,8,0
2021,Buckinghamshire 021E,E01017631,919,651,273,378,14,14,134,35,99,120,110,10,0
2021,Buckinghamshire 015A,E01017634,733,401,145,256,23,23,49,11,38,260,242,18,0
2021,Buckinghamshire 018A,E01017635,630,471,272,199,2,2,35,9,26,122,111,11,0
2021,Buckinghamshire 018B,E01017636,630,542,315,227,3,3,12,3,9,73,65,8,0
2021,Buckinghamshire 018C,E01017637,485,382,181,201,9,9,35,6,29,59,52,7,0
2021,Buckinghamshire 018D,E01017638,508,433,286,147,4,4,5,1,4,66,29,37,0
2021,Buckinghamshire 018E,E01017639,607,551,324,227,1,1,2,0,2,53,41,12,0
2021,Buckinghamshire 018F,E01017640,639,544,293,251,1,1,53,6,47,41,32,9,0
2021,Buckinghamshire 010A,E01017642,554,419,244,175,2,2,54,22,32,79,63,16,0
2021,Buckinghamshire 010B,E01017643,593,422,220,202,5,5,46,14,32,119,100,19,1
2021,Buckinghamshire 002A,E01017644,649,444,235,209,8,8,16,4,12,181,169,12,0
2021,Buckinghamshire 002B,E01017645,680,212,103,109,12,12,175,38,137,281,253,28,0
2021,Buckinghamshire 002C,E01017646,995,558,299,259,12,12,272,71,201,151,129,22,2
2021,Buckinghamshire 002D,E01017647,620,578,366,212,0,0,7,1,6,35,30,5,0
2021,Buckinghamshire 001A,E01017648,676,575,327,248,4,4,17,3,14,80,67,13,0
2021,Buckinghamshire 001B,E01017649,1036,668,361,307,20,20,179,51,128,169,150,19,0
2021,Buckinghamshire 008A,E01017651,642,565,312,253,1,1,32,14,18,44,36,8,0
2021,Buckinghamshire 008B,E01017652,705,526,258,268,11,11,84,28,56,84,68,16,0
2021,Buckinghamshire 016A,E01017653,608,446,191,255,1,1,47,18,29,114,104,10,0
2021,Buckinghamshire 016B,E01017654,648,226,91,135,13,13,222,69,153,186,166,20,1
2021,Buckinghamshire 016C,E01017655,815,598,231,367,9,9,44,3,41,164,154,10,0
2021,Buckinghamshire 008C,E01017657,663,561,345,216,5,5,41,11,30,56,46,10,0
2021,Buckinghamshire 008D,E01017658,665,552,276,276,3,3,33,10,23,77,65,12,0
2021,Buckinghamshire 012A,E01017659,618,350,174,176,6,6,190,57,133,71,64,7,1
2021,Buckinghamshire 012B,E01017660,755,452,190,262,2,2,69,15,54,232,218,14,0
2021,Buckinghamshire 012C,E01017661,634,324,128,196,9,9,201,44,157,99,88,11,1
2021,Buckinghamshire 015B,E01017662,578,324,162,162,11,11,117,5,112,126,113,13,0
2021,Buckinghamshire 015C,E01017663,616,280,149,131,6,6,151,50,101,177,168,9,2
2021,Buckinghamshire 012D,E01017664,623,458,197,261,4,4,11,0,11,150,143,7,0
2021,Buckinghamshire 013A,E01017665,1058,488,143,345,48,48,356,105,251,164,139,25,2
2021,Buckinghamshire 013B,E01017666,961,581,242,339,15,15,102,22,80,262,243,19,1
2021,Buckinghamshire 013C,E01017667,532,295,117,178,10,10,168,59,109,59,48,11,0
2021,Buckinghamshire 013D,E01017668,634,451,185,266,5,5,87,29,58,90,83,7,1
2021,Buckinghamshire 006A,E01017669,950,682,303,379,21,21,145,29,116,102,71,31,0
2021,Buckinghamshire 006B,E01017670,751,595,294,301,4,4,71,22,49,81,73,8,0
2021,Buckinghamshire 003A,E01017671,640,532,253,279,13,13,51,20,31,44,38,6,0
2021,Buckinghamshire 003B,E01017672,644,534,284,250,3,3,42,10,32,65,55,10,0
2021,Buckinghamshire 010C,E01017673,540,429,219,210,12,12,37,9,28,62,42,20,0
2021,Buckinghamshire 010D,E01017674,560,476,242,234,0,0,22,7,15,62,49,13,0
2021,Buckinghamshire 022A,E01017675,766,613,341,272,24,24,20,1,19,109,104,5,0
2021,Buckinghamshire 022B,E01017676,603,528,330,198,0,0,14,4,10,61,53,8,0
2021,Buckinghamshire 022C,E01017677,842,662,378,284,25,25,92,11,81,63,52,11,0
2021,Buckinghamshire 022D,E01017678,578,442,238,204,1,1,28,9,19,106,86,20,1
2021,Buckinghamshire 022E,E01017679,625,482,242,240,7,7,93,19,74,43,36,7,0
2021,Buckinghamshire 022F,E01017680,545,305,158,147,9,9,169,53,116,60,46,14,2
2021,Buckinghamshire 023A,E01017681,584,372,207,165,6,6,155,50,105,51,43,8,0
2021,Buckinghamshire 023B,E01017682,506,443,230,213,0,0,6,1,5,57,48,9,0
2021,Buckinghamshire 023C,E01017683,711,557,304,253,2,2,83,20,63,69,53,16,0
2021,Buckinghamshire 023D,E01017684,482,389,232,157,0,0,42,9,33,51,40,11,0
2021,Buckinghamshire 019A,E01017687,1057,481,156,325,35,35,350,69,281,189,170,19,2
2021,Buckinghamshire 019B,E01017688,509,327,165,162,0,0,41,7,34,141,130,11,0
2021,Buckinghamshire 019C,E01017689,554,463,221,242,4,4,18,6,12,69,50,19,0
2021,Buckinghamshire 019D,E01017690,481,387,194,193,3,3,24,8,16,67,59,8,0
2021,Buckinghamshire 019E,E01017691,532,470,236,234,2,2,11,2,9,49,43,6,0
2021,Buckinghamshire 019F,E01017692,681,457,239,218,14,14,6,0,6,204,186,18,0
2021,Buckinghamshire 004A,E01017693,466,326,168,158,3,3,68,12,56,69,59,10,0
2021,Buckinghamshire 004B,E01017694,944,723,325,398,18,18,97,17,80,105,92,13,1
2021,Buckinghamshire 003C,E01017695,530,425,262,163,2,2,67,29,38,35,27,8,1
2021,Buckinghamshire 003D,E01017696,557,439,224,215,3,3,52,27,25,63,49,14,0
2021,Buckinghamshire 014A,E01017697,613,432,194,238,4,4,31,6,25,145,136,9,1
2021,Buckinghamshire 014B,E01017698,532,338,139,199,13,13,118,31,87,63,55,8,0
2021,Buckinghamshire 014C,E01017699,637,285,105,180,64,64,166,14,152,121,108,13,1
2021,Buckinghamshire 014D,E01017700,642,572,323,249,1,1,4,1,3,65,57,8,0
2021,Buckinghamshire 008E,E01017701,1037,826,347,479,17,17,109,15,94,85,70,15,0
2021,Buckinghamshire 008F,E01017702,658,438,215,223,5,5,151,51,100,63,52,11,1
2021,Buckinghamshire 009A,E01017703,548,394,232,162,6,6,59,10,49,89,78,11,0
2021,Buckinghamshire 009B,E01017704,508,437,246,191,1,1,32,5,27,38,28,10,0
2021,Buckinghamshire 011A,E01017706,503,283,98,185,1,1,158,49,109,59,52,7,2
2021,Buckinghamshire 011B,E01017707,466,169,54,115,1,1,253,105,148,43,38,5,0
2021,Buckinghamshire 011C,E01017708,589,291,111,180,1,1,187,69,118,110,92,18,0
2021,Buckinghamshire 017A,E01017709,570,250,108,142,5,5,250,105,145,64,59,5,1
2021,Buckinghamshire 017B,E01017710,545,331,123,208,10,10,150,56,94,54,43,11,0
2021,Buckinghamshire 017C,E01017711,655,250,88,162,19,19,302,125,177,80,67,13,4
2021,Buckinghamshire 017D,E01017712,921,326,116,210,21,21,295,96,199,279,265,14,0
2021,Buckinghamshire 004C,E01017713,605,430,204,226,7,7,103,32,71,65,61,4,0
2021,Buckinghamshire 004D,E01017714,651,516,262,254,8,8,45,8,37,82,73,9,0
2021,Buckinghamshire 006C,E01017715,507,346,206,140,2,2,40,12,28,119,99,20,0
2021,Buckinghamshire 006D,E01017716,748,582,312,270,9,9,86,24,62,71,52,19,0
2021,Buckinghamshire 004E,E01017717,750,549,291,258,3,3,91,33,58,105,83,22,2
2021,Buckinghamshire 004F,E01017718,753,573,298,275,15,15,67,12,55,98,71,27,0
2021,Buckinghamshire 009C,E01017719,508,324,140,184,5,5,117,24,93,61,53,8,1
2021,Buckinghamshire 009D,E01017720,524,319,161,158,2,2,45,7,38,157,114,43,1
2021,Buckinghamshire 020A,E01017721,805,492,203,289,14,14,106,38,68,191,178,13,2
2021,Buckinghamshire 020B,E01017722,638,501,215,286,8,8,32,4,28,97,84,13,0
2021,Buckinghamshire 020C,E01017723,496,237,87,150,2,2,189,73,116,66,61,5,2
2021,Buckinghamshire 020D,E01017724,519,248,113,135,3,3,205,79,126,62,57,5,1
2021,Buckinghamshire 024A,E01017726,570,372,249,123,2,2,82,17,65,112,85,27,2
2021,Buckinghamshire 024B,E01017727,716,580,336,244,2,2,8,0,8,126,110,16,0
2021,Buckinghamshire 024C,E01017729,678,577,296,281,6,6,40,7,33,54,44,10,1
2021,Buckinghamshire 024D,E01017730,737,432,220,212,0,0,224,72,152,81,74,7,0
2021,Buckinghamshire 007A,E01017731,589,340,169,171,16,16,161,42,119,71,38,33,1
2021,Buckinghamshire 007B,E01017732,663,553,284,269,8,8,36,3,33,66,49,17,0
2021,Buckinghamshire 007C,E01017733,548,384,225,159,3,3,100,15,85,61,50,11,0
2021,Buckinghamshire 007D,E01017734,640,547,290,257,6,6,37,8,29,50,39,11,0
2021,Buckinghamshire 005A,E01017735,590,442,235,207,3,3,65,21,44,80,66,14,0
2021,Buckinghamshire 005B,E01017736,685,396,238,158,5,5,184,40,144,99,90,9,1
2021,Buckinghamshire 005C,E01017737,590,515,356,159,2,2,8,4,4,65,56,9,0
2021,Buckinghamshire 005D,E01017738,1061,694,328,366,10,10,122,39,83,233,215,18,2
2021,Buckinghamshire 034A,E01017739,493,429,234,195,0,0,6,3,3,58,52,6,0
2021,Buckinghamshire 034B,E01017740,564,403,165,238,9,9,61,6,55,91,80,11,0
2021,Buckinghamshire 032A,E01017741,665,422,207,215,3,3,164,23,141,76,70,6,0
2021,Buckinghamshire 032B,E01017742,786,542,335,207,1,1,27,7,20,215,199,16,1
2021,Buckinghamshire 032C,E01017743,734,330,120,210,7,7,308,34,274,89,81,8,0
2021,Buckinghamshire 034C,E01017744,613,446,244,202,18,18,82,13,69,67,54,13,0
2021,Buckinghamshire 034D,E01017745,820,523,308,215,5,5,124,12,112,168,147,21,0
2021,Buckinghamshire 034E,E01017746,605,465,207,258,2,2,49,5,44,89,85,4,0
2021,Buckinghamshire 027A,E01017747,539,384,179,205,6,6,79,18,61,69,61,8,1
2021,Buckinghamshire 027B,E01017748,796,331,143,188,8,8,396,83,313,59,48,11,2
2021,Buckinghamshire 027C,E01017749,732,636,344,292,3,3,20,0,20,73,61,12,0
2021,Buckinghamshire 029A,E01017750,908,738,442,296,2,2,68,11,57,100,78,22,0
2021,Buckinghamshire 054A,E01017751,792,713,396,317,0,0,0,0,0,79,62,17,0
2021,Buckinghamshire 029B,E01017752,903,748,448,300,1,1,28,2,26,126,85,41,0
2021,Buckinghamshire 054B,E01017753,513,320,132,188,0,0,152,20,132,41,32,9,0
2021,Buckinghamshire 050A,E01017754,548,499,265,234,1,1,14,0,14,34,26,8,0
2021,Buckinghamshire 050B,E01017755,890,602,300,302,16,16,78,7,71,193,182,11,1
2021,Buckinghamshire 050C,E01017756,582,550,330,220,0,0,5,2,3,27,22,5,0
2021,Buckinghamshire 050D,E01017757,474,382,193,189,1,1,56,7,49,35,26,9,0
2021,Buckinghamshire 050E,E01017758,501,442,259,183,2,2,13,0,13,44,25,19,0
2021,Buckinghamshire 047A,E01017759,780,516,291,225,19,19,140,13,127,105,80,25,0
2021,Buckinghamshire 047B,E01017760,652,583,341,242,1,1,28,3,25,40,36,4,0
2021,Buckinghamshire 047C,E01017761,857,750,382,368,0,0,39,8,31,68,59,9,0
2021,Buckinghamshire 035A,E01017762,511,469,266,203,1,1,4,1,3,37,30,7,0
2021,Buckinghamshire 032D,E01017763,802,571,357,214,0,0,34,3,31,197,183,14,0
2021,Buckinghamshire 032E,E01017764,607,568,318,250,0,0,4,0,4,35,30,5,0
2021,Buckinghamshire 032F,E01017765,622,583,331,252,0,0,1,1,0,38,29,9,0
2021,Buckinghamshire 029C,E01017766,934,801,491,310,1,1,42,2,40,90,75,15,0
2021,Buckinghamshire 054C,E01017767,909,677,355,322,2,2,147,34,113,83,68,15,0
2021,Buckinghamshire 031A,E01017768,1010,717,415,302,4,4,129,12,117,160,140,20,0
2021,Buckinghamshire 028A,E01017769,641,532,256,276,2,2,17,1,16,90,83,7,0
2021,Buckinghamshire 030A,E01017770,749,401,177,224,5,5,123,30,93,220,210,10,0
2021,Buckinghamshire 028B,E01017771,630,573,340,233,1,1,6,2,4,50,40,10,0
2021,Buckinghamshire 039A,E01017773,646,557,336,221,2,2,38,4,34,49,39,10,0
2021,Buckinghamshire 039B,E01017774,529,492,317,175,1,1,10,5,5,26,19,7,0
2021,Buckinghamshire 035B,E01017775,730,426,218,208,43,43,175,24,151,86,81,5,0
2021,Buckinghamshire 035C,E01017776,891,477,191,286,26,26,261,34,227,127,115,12,0
2021,Buckinghamshire 035D,E01017777,669,592,320,272,5,5,19,3,16,53,48,5,0
2021,Buckinghamshire 029D,E01017778,509,399,219,180,3,3,61,8,53,46,32,14,0
2021,Buckinghamshire 031B,E01017779,412,365,197,168,0,0,25,4,21,22,18,4,0
2021,Buckinghamshire 028C,E01017780,554,459,214,245,5,5,26,2,24,64,53,11,0
2021,Buckinghamshire 028D,E01017781,477,254,87,167,1,1,140,28,112,82,79,3,0
2021,Buckinghamshire 039C,E01017782,552,521,289,232,0,0,0,0,0,31,29,2,0
2021,Buckinghamshire 039D,E01017783,609,464,236,228,15,15,49,7,42,81,70,11,0
2021,Buckinghamshire 039E,E01017784,659,532,306,226,3,3,41,0,41,83,68,15,0
2021,Buckinghamshire 031C,E01017785,662,582,335,247,2,2,8,0,8,70,50,20,0
2021,Buckinghamshire 031D,E01017786,624,542,300,242,2,2,31,4,27,48,41,7,1
2021,Buckinghamshire 031E,E01017787,627,572,326,246,1,1,5,1,4,49,39,10,0
2021,Buckinghamshire 031F,E01017788,759,464,239,225,1,1,204,27,177,89,78,11,1
2021,Buckinghamshire 027D,E01017789,535,322,161,161,1,1,146,17,129,66,64,2,0
2021,Buckinghamshire 027E,E01017790,523,218,103,115,3,3,274,50,224,28,22,6,0
2021,Buckinghamshire 030B,E01017791,623,396,177,219,6,6,167,22,145,54,44,10,0
2021,Buckinghamshire 030C,E01017792,1130,518,256,262,7,7,254,32,222,349,329,20,2
2021,Buckinghamshire 030D,E01017793,603,398,214,184,2,2,163,18,145,39,29,10,1
2021,Buckinghamshire 047D,E01017794,888,740,412,328,1,1,60,5,55,87,72,15,0
2021,Buckinghamshire 027F,E01017795,859,561,281,280,17,17,187,37,150,94,83,11,0
2021,Buckinghamshire 053A,E01017796,808,407,245,162,4,4,159,13,146,238,213,25,0
2021,Buckinghamshire 053B,E01017797,522,476,275,201,0,0,1,0,1,45,42,3,0
2021,Buckinghamshire 053C,E01017798,728,612,379,233,1,1,25,5,20,90,71,19,0
2021,Buckinghamshire 053D,E01017799,880,604,307,297,9,9,71,8,63,196,180,16,0
2021,Buckinghamshire 053E,E01017800,685,316,131,185,5,5,193,17,176,171,154,17,0
2021,Buckinghamshire 053F,E01017801,611,524,268,256,0,0,18,0,18,69,59,10,0
2021,Buckinghamshire 053G,E01017802,650,380,190,190,2,2,207,18,189,61,54,7,0
2021,Buckinghamshire 065A,E01017803,531,430,250,180,0,0,8,3,5,89,70,19,4
2021,Buckinghamshire 066A,E01017804,743,469,271,198,2,2,109,9,100,163,144,19,0
2021,Buckinghamshire 066B,E01017805,821,400,175,225,3,3,320,33,287,97,86,11,1
2021,Buckinghamshire 065B,E01017806,659,577,322,255,7,7,25,3,22,50,42,8,0
2021,Buckinghamshire 066C,E01017807,617,485,232,253,2,2,28,4,24,102,95,7,0
2021,Buckinghamshire 066D,E01017808,692,427,232,195,18,18,125,7,118,122,109,13,0
2021,Buckinghamshire 066E,E01017809,603,356,148,208,2,2,172,20,152,73,66,7,0
2021,Buckinghamshire 059A,E01017810,1152,564,317,247,30,30,382,28,354,176,159,17,0
2021,Buckinghamshire 059B,E01017811,509,417,264,153,7,7,39,4,35,46,37,9,0
2021,Buckinghamshire 059C,E01017812,743,464,204,260,10,10,113,22,91,156,141,15,0
2021,Buckinghamshire 059D,E01017813,820,669,343,326,20,20,14,2,12,117,102,15,0
2021,Buckinghamshire 065C,E01017814,629,487,254,233,0,0,55,9,46,87,72,15,0
2021,Buckinghamshire 063A,E01017815,713,602,331,271,3,3,35,4,31,73,71,2,0
2021,Buckinghamshire 063B,E01017816,777,533,293,240,21,21,98,9,89,125,100,25,0
2021,Buckinghamshire 063C,E01017817,756,530,262,268,24,24,109,7,102,93,78,15,0
2021,Buckinghamshire 058A,E01017818,729,538,227,311,1,1,84,9,75,106,88,18,0
2021,Buckinghamshire 058B,E01017819,583,512,283,229,1,1,4,1,3,66,61,5,0
2021,Buckinghamshire 058C,E01017820,814,496,326,170,0,0,45,2,43,273,249,24,0
2021,Buckinghamshire 058D,E01017821,582,464,246,218,4,4,13,2,11,101,91,10,0
2021,Buckinghamshire 058E,E01017822,650,587,275,312,1,1,6,2,4,56,49,7,0
2021,Buckinghamshire 063D,E01017823,572,418,214,204,2,2,74,5,69,78,60,18,0
2021,Buckinghamshire 067A,E01017824,675,512,255,257,14,14,86,14,72,63,54,9,0
2021,Buckinghamshire 067B,E01017825,660,568,241,327,10,10,16,2,14,66,54,12,0
2021,Buckinghamshire 067C,E01017826,629,336,162,174,70,70,166,17,149,57,44,13,0
2021,Buckinghamshire 067D,E01017827,823,479,225,254,5,5,125,14,111,214,188,26,0
2021,Buckinghamshire 067E,E01017828,639,386,195,191,4,4,168,17,151,81,65,16,0
2021,Buckinghamshire 067F,E01017829,701,576,233,343,1,1,5,1,4,119,111,8,0
2021,Buckinghamshire 064A,E01017830,798,554,273,281,13,13,125,12,113,106,89,17,0
2021,Buckinghamshire 064B,E01017831,651,577,308,269,0,0,6,2,4,68,62,6,0
2021,Buckinghamshire 064C,E01017832,650,478,221,257,2,2,69,4,65,101,82,19,0
2021,Buckinghamshire 065D,E01017833,1138,781,438,343,29,29,84,12,72,244,219,25,0
2021,Buckinghamshire 064D,E01017834,583,403,221,182,2,2,81,13,68,97,86,11,0
2021,Buckinghamshire 064E,E01017835,747,575,382,193,32,32,27,3,24,113,99,14,0
2021,Buckinghamshire 049A,E01017836,557,389,169,220,3,3,24,9,15,141,132,9,0
2021,Buckinghamshire 049B,E01017837,1012,320,96,224,18,18,162,37,125,510,473,37,2
2021,Buckinghamshire 049C,E01017838,512,363,177,186,1,1,11,2,9,137,122,15,0
2021,Buckinghamshire 049D,E01017839,791,296,135,161,0,0,69,6,63,426,397,29,0
2021,Buckinghamshire 049E,E01017840,673,528,250,278,2,2,34,11,23,109,95,14,0
2021,Buckinghamshire 049F,E01017841,879,614,212,402,20,20,104,5,99,141,124,17,0
2021,Buckinghamshire 052A,E01017843,661,559,330,229,4,4,43,17,26,55,47,8,0
2021,Buckinghamshire 052B,E01017844,699,376,151,225,22,22,212,50,162,89,80,9,0
2021,Buckinghamshire 052C,E01017845,684,427,214,213,5,5,141,27,114,111,95,16,0
2021,Buckinghamshire 060A,E01017846,661,356,188,168,2,2,165,39,126,138,113,25,0
2021,Buckinghamshire 060B,E01017847,760,567,328,239,1,1,49,4,45,143,134,9,0
2021,Buckinghamshire 060C,E01017848,489,430,239,191,0,0,20,6,14,39,31,8,0
2021,Buckinghamshire 060D,E01017849,699,521,291,230,3,3,9,2,7,166,144,22,0
2021,Buckinghamshire 042A,E01017850,481,231,67,164,0,0,147,40,107,102,95,7,1
2021,Buckinghamshire 042B,E01017851,668,365,141,224,3,3,114,23,91,185,168,17,1
2021,Buckinghamshire 042C,E01017852,710,534,255,279,3,3,18,4,14,154,142,12,1
2021,Buckinghamshire 040A,E01017853,569,400,183,217,5,5,55,4,51,109,91,18,0
2021,Buckinghamshire 040B,E01017854,506,409,216,193,1,1,27,3,24,69,58,11,0
2021,Buckinghamshire 052D,E01017855,660,507,254,253,14,14,70,17,53,67,59,8,2
2021,Buckinghamshire 052E,E01017856,570,319,140,179,8,8,189,51,138,52,44,8,2
2021,Buckinghamshire 038A,E01017857,596,236,100,136,5,5,256,77,179,96,90,6,3
2021,Buckinghamshire 038B,E01017858,964,468,212,256,73,73,239,26,213,184,167,17,0
2021,Buckinghamshire 038C,E01017859,612,484,230,254,8,8,32,6,26,88,77,11,0
2021,Buckinghamshire 038D,E01017860,488,303,135,168,3,3,111,22,89,70,63,7,1
2021,Buckinghamshire 038E,E01017861,595,521,276,245,3,3,21,0,21,50,46,4,0
2021,Buckinghamshire 038F,E01017862,709,559,276,283,9,9,40,5,35,101,85,16,0
2021,Buckinghamshire 038G,E01017863,638,585,264,321,0,0,6,0,6,47,37,10,0
2021,Buckinghamshire 055A,E01017864,525,497,301,196,2,2,2,1,1,24,18,6,0
2021,Buckinghamshire 055B,E01017865,611,577,343,234,1,1,5,2,3,28,20,8,0
2021,Buckinghamshire 057A,E01017866,615,531,339,192,2,2,4,0,4,78,64,14,0
2021,Buckinghamshire 055C,E01017867,597,374,179,195,2,2,172,47,125,48,42,6,1
2021,Buckinghamshire 055D,E01017868,645,558,332,226,2,2,8,1,7,77,61,16,0
2021,Buckinghamshire 033A,E01017869,508,484,284,200,1,1,3,0,3,20,15,5,0
2021,Buckinghamshire 033B,E01017870,465,427,249,178,2,2,8,0,8,28,18,10,0
2021,Buckinghamshire 033C,E01017871,613,564,322,242,2,2,7,2,5,40,26,14,0
2021,Buckinghamshire 033D,E01017872,654,596,362,234,5,5,13,2,11,39,32,7,1
2021,Buckinghamshire 033E,E01017873,522,473,237,236,3,3,7,1,6,39,29,10,0
2021,Buckinghamshire 033F,E01017874,555,351,169,182,5,5,35,5,30,164,40,124,0
2021,Buckinghamshire 057B,E01017875,546,351,215,136,0,0,2,1,1,193,45,148,0
2021,Buckinghamshire 057C,E01017876,770,740,419,321,0,0,3,1,2,27,23,4,0
2021,Buckinghamshire 057D,E01017877,645,483,268,215,4,4,102,9,93,56,47,9,0
2021,Buckinghamshire 040C,E01017878,1016,736,448,288,6,6,40,5,35,234,163,71,0
2021,Buckinghamshire 036A,E01017880,516,492,259,233,0,0,4,1,3,20,11,9,0
2021,Buckinghamshire 036B,E01017881,745,658,370,288,0,0,25,6,19,62,50,12,0
2021,Buckinghamshire 036C,E01017882,640,539,276,263,8,8,26,3,23,67,61,6,0
2021,Buckinghamshire 036D,E01017883,633,541,295,246,1,1,29,2,27,62,48,14,0
2021,Buckinghamshire 036E,E01017884,620,444,219,225,5,5,103,5,98,68,61,7,0
2021,Buckinghamshire 025A,E01017885,869,662,351,311,30,30,102,13,89,75,59,16,0
2021,Buckinghamshire 025B,E01017886,619,538,303,235,2,2,19,2,17,60,38,22,0
2021,Buckinghamshire 025C,E01017887,469,412,223,189,1,1,18,4,14,38,30,8,0
2021,Buckinghamshire 025D,E01017888,599,381,218,163,3,3,26,10,16,189,66,123,0
2021,Buckinghamshire 062A,E01017889,573,328,141,187,6,6,130,27,103,109,97,12,0
2021,Buckinghamshire 062B,E01017890,495,447,246,201,0,0,9,3,6,39,33,6,0
2021,Buckinghamshire 062C,E01017891,630,508,280,228,2,2,18,3,15,102,94,8,0
2021,Buckinghamshire 062D,E01017892,604,567,339,228,0,0,5,1,4,32,25,7,0
2021,Buckinghamshire 062E,E01017893,906,422,239,183,11,11,271,65,206,201,173,28,1
2021,Buckinghamshire 062F,E01017894,662,516,307,209,2,2,21,7,14,122,112,10,1
2021,Buckinghamshire 061A,E01017895,613,381,215,166,2,2,108,26,82,122,111,11,0
2021,Buckinghamshire 061B,E01017896,614,488,290,198,1,1,9,2,7,116,97,19,0
2021,Buckinghamshire 061C,E01017897,664,480,216,264,6,6,58,18,40,118,109,9,2
2021,Buckinghamshire 061D,E01017898,486,274,117,157,4,4,99,18,81,108,95,13,1
2021,Buckinghamshire 048A,E01017899,678,380,133,247,8,8,218,49,169,69,58,11,3
2021,Buckinghamshire 048B,E01017900,486,268,135,133,25,25,103,10,93,90,88,2,0
2021,Buckinghamshire 048C,E01017901,461,230,88,142,2,2,187,52,135,42,34,8,0
2021,Buckinghamshire 048D,E01017902,636,322,111,211,6,6,209,59,150,95,82,13,4
2021,Buckinghamshire 046A,E01017903,525,288,116,172,2,2,77,19,58,158,140,18,0
2021,Buckinghamshire 046B,E01017904,659,299,126,173,20,20,91,11,80,246,226,20,3
2021,Buckinghamshire 046C,E01017905,945,374,161,213,6,6,112,17,95,453,429,24,0
2021,Buckinghamshire 046D,E01017906,491,270,104,166,0,0,142,56,86,79,70,9,0
2021,Buckinghamshire 046E,E01017907,600,299,148,151,0,0,152,40,112,149,125,24,0
2021,Buckinghamshire 051A,E01017910,1097,582,217,365,3,3,145,29,116,366,349,17,1
2021,Buckinghamshire 044A,E01017911,626,363,131,232,5,5,176,51,125,81,71,10,1
2021,Buckinghamshire 044B,E01017912,547,408,174,234,2,2,20,1,19,117,106,11,0
2021,Buckinghamshire 044C,E01017913,873,361,122,239,24,24,164,14,150,323,300,23,1
2021,Buckinghamshire 044D,E01017914,517,402,159,243,12,12,35,7,28,68,61,7,0
2021,Buckinghamshire 037A,E01017915,564,440,226,214,6,6,60,15,45,58,45,13,0
2021,Buckinghamshire 037B,E01017916,480,428,249,179,1,1,17,3,14,34,28,6,0
2021,Buckinghamshire 037C,E01017917,631,511,226,285,2,2,14,1,13,104,93,11,0
2021,Buckinghamshire 037D,E01017918,705,429,227,202,6,6,167,20,147,103,93,10,0
2021,Buckinghamshire 042D,E01017919,635,289,111,178,9,9,100,14,86,237,222,15,0
2021,Buckinghamshire 041A,E01017920,568,453,191,262,11,11,45,14,31,59,47,12,0
2021,Buckinghamshire 041B,E01017921,701,448,195,253,3,3,26,2,24,224,207,17,0
2021,Buckinghamshire 041C,E01017922,885,516,206,310,24,24,140,15,125,205,190,15,0
2021,Buckinghamshire 041D,E01017923,759,247,107,140,3,3,83,10,73,426,404,22,0
2021,Buckinghamshire 041E,E01017924,590,466,232,234,1,1,11,1,10,112,101,11,0
2021,Buckinghamshire 043A,E01017925,776,419,149,270,24,24,170,51,119,163,150,13,0
2021,Buckinghamshire 043B,E01017926,654,209,79,130,54,54,289,54,235,102,92,10,0
2021,Buckinghamshire 043C,E01017927,643,494,233,261,10,10,74,26,48,62,54,8,3
2021,Buckinghamshire 043D,E01017928,594,374,162,212,1,1,147,41,106,71,64,7,1
2021,Buckinghamshire 026A,E01017929,817,365,207,158,4,4,270,59,211,176,159,17,2
2021,Buckinghamshire 026B,E01017930,805,702,391,311,0,0,5,0,5,98,92,6,0
2021,Buckinghamshire 026C,E01017931,648,469,250,219,6,6,118,25,93,54,49,5,1
2021,Buckinghamshire 026D,E01017932,689,586,379,207,4,4,47,5,42,52,41,11,0
2021,Buckinghamshire 026E,E01017933,856,649,451,198,16,16,123,28,95,68,51,17,0
2021,Buckinghamshire 056A,E01017934,785,456,187,269,6,6,213,63,150,108,93,15,2
2021,Buckinghamshire 056B,E01017935,869,606,255,351,18,18,77,11,66,168,148,20,0
2021,Buckinghamshire 056C,E01017936,638,542,294,248,2,2,16,8,8,78,65,13,0
2021,Buckinghamshire 045A,E01017937,559,509,267,242,0,0,17,0,17,33,28,5,0
2021,Buckinghamshire 045B,E01017938,500,436,221,215,5,5,6,3,3,52,40,12,1
2021,Buckinghamshire 056D,E01017939,585,445,198,247,3,3,34,3,31,103,91,12,0
2021,Buckinghamshire 045C,E01017940,692,531,248,283,3,3,24,10,14,134,113,21,0
2021,Buckinghamshire 051B,E01017941,637,416,178,238,7,7,86,9,77,128,111,17,0
2021,Buckinghamshire 045D,E01017942,581,495,268,227,0,0,64,10,54,22,20,2,0
2021,Cambridge 006A,E01017943,900,381,211,170,15,15,126,29,97,377,356,21,1
2021,Cambridge 006B,E01017944,588,243,118,125,1,1,235,215,20,103,95,8,6
2021,Cambridge 006C,E01017945,781,304,150,154,14,14,156,97,59,306,289,17,1
2021,Cambridge 006D,E01017946,604,258,140,118,2,2,234,217,17,109,101,8,1
2021,Cambridge 006E,E01017947,692,349,181,168,4,4,206,183,23,133,121,12,0
2021,Cambridge 006F,E01017948,674,174,67,107,0,0,398,288,110,99,92,7,3
2021,Cambridge 002A,E01017949,740,274,155,119,5,5,141,86,55,320,298,22,0
2021,Cambridge 002B,E01017950,534,309,188,121,2,2,27,14,13,194,174,20,2
2021,Cambridge 002C,E01017951,635,337,201,136,0,0,169,157,12,127,123,4,2
2021,Cambridge 002D,E01017952,681,272,135,137,1,1,299,284,15,103,96,7,6
2021,Cambridge 002E,E01017953,723,346,210,136,17,17,222,210,12,133,119,14,5
2021,Cambridge 002F,E01017954,587,309,150,159,1,1,173,159,14,102,93,9,2
2021,Cambridge 005A,E01017955,639,432,293,139,3,3,9,6,3,195,182,13,0
2021,Cambridge 011A,E01017959,684,444,238,206,4,4,43,11,32,193,176,17,0
2021,Cambridge 011B,E01017960,556,227,105,122,2,2,216,198,18,111,107,4,0
2021,Cambridge 011C,E01017961,568,244,133,111,2,2,201,171,30,119,110,9,2
2021,Cambridge 011D,E01017962,759,428,220,208,15,15,195,80,115,121,114,7,0
2021,Cambridge 011E,E01017963,665,368,170,198,1,1,178,172,6,115,104,11,3
2021,Cambridge 011F,E01017964,507,401,237,164,1,1,12,6,6,93,77,16,0
2021,Cambridge 010A,E01017965,719,326,195,131,7,7,228,204,24,156,147,9,2
2021,Cambridge 010C,E01017967,584,255,123,132,2,2,195,166,29,126,113,13,6
2021,Cambridge 010D,E01017968,691,405,255,150,0,0,86,77,9,198,177,21,2
2021,Cambridge 010E,E01017969,681,379,222,157,4,4,121,94,27,177,168,9,0
2021,Cambridge 003B,E01017971,682,213,110,103,11,11,302,139,163,156,151,5,0
2021,Cambridge 003C,E01017972,688,340,211,129,7,7,195,21,174,146,135,11,0
2021,Cambridge 003D,E01017973,739,163,83,80,22,22,409,59,350,145,134,11,0
2021,Cambridge 003E,E01017974,713,269,127,142,2,2,270,205,65,170,159,11,2
2021,Cambridge 001A,E01017975,708,242,118,124,3,3,350,308,42,112,103,9,1
2021,Cambridge 001B,E01017976,690,368,190,178,4,4,110,92,18,207,197,10,1
2021,Cambridge 001C,E01017977,775,219,102,117,49,49,289,190,99,217,182,35,1
2021,Cambridge 001D,E01017978,625,211,105,106,0,0,287,241,46,122,108,14,5
2021,Cambridge 001E,E01017979,658,167,70,97,32,32,328,296,32,126,113,13,5
2021,Cambridge 001F,E01017980,556,275,164,111,5,5,79,65,14,197,188,9,0
2021,Cambridge 007C,E01017983,1142,462,295,167,9,9,87,52,35,583,492,91,1
2021,Cambridge 007E,E01017985,655,355,239,116,9,9,73,28,45,218,163,55,0
2021,Cambridge 008A,E01017987,808,332,203,129,16,16,134,7,127,326,288,38,0
2021,Cambridge 008B,E01017988,527,253,155,98,3,3,20,14,6,251,232,19,0
2021,Cambridge 008C,E01017989,899,354,193,161,4,4,135,59,76,406,387,19,0
2021,Cambridge 008D,E01017990,587,288,156,132,6,6,36,14,22,257,245,12,0
2021,Cambridge 008E,E01017991,568,192,112,80,2,2,178,150,28,194,184,10,2
2021,Cambridge 013A,E01017992,782,358,213,145,13,13,216,149,67,195,180,15,0
2021,Cambridge 013C,E01017994,737,328,181,147,0,0,317,309,8,91,84,7,1
2021,Cambridge 013D,E01017995,824,581,363,218,20,20,95,11,84,128,119,9,0
2021,Cambridge 013E,E01017996,623,387,235,152,14,14,35,23,12,187,169,18,0
2021,Cambridge 009A,E01017997,1071,501,235,266,35,35,197,117,80,338,323,15,0
2021,Cambridge 009B,E01017998,722,311,144,167,6,6,40,29,11,365,343,22,0
2021,Cambridge 009C,E01017999,744,300,134,166,3,3,211,157,54,229,221,8,1
2021,Cambridge 009D,E01018000,754,337,167,170,5,5,61,35,26,350,328,22,1
2021,Cambridge 009E,E01018001,749,339,190,149,4,4,53,15,38,353,335,18,0
2021,Cambridge 014A,E01018005,690,240,155,85,2,2,153,98,55,294,242,52,1
2021,Cambridge 004A,E01018006,736,384,231,153,6,6,59,15,44,286,270,16,1
2021,Cambridge 004B,E01018007,613,487,327,160,3,3,11,3,8,112,97,15,0
2021,Cambridge 004C,E01018008,668,376,236,140,3,3,73,52,21,215,203,12,1
2021,Cambridge 004D,E01018009,916,340,191,149,17,17,194,48,146,362,344,18,3
2021,Cambridge 004E,E01018010,842,379,253,126,4,4,112,12,100,345,325,20,2
2021,East Cambridgeshire 009A,E01018011,1028,773,460,313,14,14,101,12,89,140,108,32,0
2021,East Cambridgeshire 009B,E01018012,635,401,230,171,20,20,136,14,122,78,69,9,0
2021,East Cambridgeshire 008A,E01018013,830,687,410,277,10,10,56,6,50,77,63,14,0
2021,East Cambridgeshire 008B,E01018014,768,588,309,279,13,13,62,3,59,105,93,12,0
2021,East Cambridgeshire 008C,E01018015,581,481,268,213,5,5,14,5,9,81,72,9,0
2021,East Cambridgeshire 008D,E01018016,587,352,185,167,2,2,187,28,159,46,35,11,0
2021,East Cambridgeshire 011A,E01018017,592,317,184,133,10,10,160,22,138,105,49,56,0
2021,East Cambridgeshire 011B,E01018019,482,340,219,121,8,8,43,6,37,91,51,40,0
2021,East Cambridgeshire 002A,E01018020,605,511,284,227,2,2,20,0,20,72,57,15,0
2021,East Cambridgeshire 002B,E01018021,623,456,237,219,2,2,107,13,94,58,42,16,0
2021,East Cambridgeshire 002C,E01018022,604,484,272,212,2,2,77,7,70,41,27,14,0
2021,East Cambridgeshire 011C,E01018023,918,575,338,237,4,4,108,8,100,231,116,115,0
2021,East Cambridgeshire 004A,E01018024,583,395,258,137,6,6,106,11,95,76,58,18,0
2021,East Cambridgeshire 004B,E01018025,745,287,160,127,4,4,130,13,117,324,294,30,0
2021,East Cambridgeshire 004C,E01018026,702,500,327,173,3,3,28,4,24,171,149,22,0
2021,East Cambridgeshire 003A,E01018027,784,553,335,218,8,8,72,14,58,150,140,10,1
2021,East Cambridgeshire 003D,E01018032,1088,791,472,319,6,6,114,27,87,177,156,21,0
2021,East Cambridgeshire 003E,E01018033,912,501,301,200,7,7,259,32,227,144,132,12,1
2021,East Cambridgeshire 007A,E01018034,692,521,291,230,12,12,55,5,50,104,80,24,0
2021,East Cambridgeshire 007B,E01018035,962,555,286,269,9,9,205,25,180,193,150,43,0
2021,East Cambridgeshire 005A,E01018036,717,488,270,218,3,3,122,18,104,101,89,12,3
2021,East Cambridgeshire 005B,E01018037,595,494,291,203,7,7,43,8,35,51,40,11,0
2021,East Cambridgeshire 005C,E01018038,664,546,308,238,5,5,28,4,24,85,75,10,0
2021,East Cambridgeshire 005D,E01018039,552,432,251,181,8,8,62,4,58,50,41,9,0
2021,East Cambridgeshire 007C,E01018040,553,480,283,197,0,0,8,1,7,65,57,8,0
2021,East Cambridgeshire 007D,E01018041,493,343,178,165,4,4,101,14,87,45,41,4,0
2021,East Cambridgeshire 001A,E01018042,651,372,228,144,2,2,168,19,149,109,92,17,0
2021,East Cambridgeshire 001B,E01018043,914,661,345,316,8,8,90,10,80,155,139,16,0
2021,East Cambridgeshire 001C,E01018044,817,483,242,241,6,6,70,9,61,258,227,31,0
2021,East Cambridgeshire 001D,E01018045,559,382,177,205,4,4,75,11,64,98,90,8,0
2021,East Cambridgeshire 006A,E01018047,823,532,297,235,11,11,154,23,131,125,102,23,1
2021,East Cambridgeshire 006C,E01018049,892,565,272,293,15,15,150,19,131,162,142,20,0
2021,East Cambridgeshire 006D,E01018050,602,396,216,180,17,17,86,12,74,103,82,21,0
2021,East Cambridgeshire 006E,E01018051,998,652,275,377,29,29,204,41,163,113,96,17,0
2021,East Cambridgeshire 006F,E01018052,892,412,208,204,6,6,171,29,142,303,282,21,0
2021,East Cambridgeshire 005E,E01018053,735,527,317,210,1,1,138,30,108,69,56,13,0
2021,East Cambridgeshire 005F,E01018054,1039,785,418,367,22,22,106,8,98,126,100,26,0
2021,East Cambridgeshire 002D,E01018055,856,739,399,340,10,10,21,2,19,86,71,15,0
2021,East Cambridgeshire 002E,E01018056,821,548,239,309,13,13,158,18,140,102,84,18,0
2021,East Cambridgeshire 009C,E01018057,857,576,338,238,10,10,149,24,125,122,86,36,0
2021,Fenland 008A,E01018058,697,576,366,210,0,0,9,0,9,112,100,12,0
2021,Fenland 008B,E01018059,600,487,260,227,0,0,29,5,24,84,63,21,0
2021,Fenland 008C,E01018060,790,597,276,321,2,2,64,23,41,127,111,16,0
2021,Fenland 008D,E01018061,530,409,189,220,0,0,44,8,36,77,70,7,0
2021,Fenland 011A,E01018062,1127,777,405,372,16,16,164,26,138,170,144,26,0
2021,Fenland 002A,E01018063,1135,436,239,197,7,7,212,49,163,480,445,35,0
2021,Fenland 006A,E01018064,1035,798,395,403,5,5,113,12,101,119,101,18,0
2021,Fenland 010A,E01018065,1045,834,466,368,0,0,74,13,61,137,113,24,0
2021,Fenland 004A,E01018066,682,488,296,192,0,0,125,41,84,69,53,16,0
2021,Fenland 004B,E01018067,793,611,346,265,3,3,51,10,41,128,108,20,0
2021,Fenland 004C,E01018068,644,459,274,185,0,0,75,16,59,110,92,18,0
2021,Fenland 003A,E01018069,749,590,348,242,6,6,20,3,17,133,121,12,0
2021,Fenland 003B,E01018070,878,310,163,147,8,8,241,51,190,318,296,22,1
2021,Fenland 003C,E01018071,820,433,284,149,4,4,184,46,138,199,181,18,0
2021,Fenland 006B,E01018072,954,626,228,398,30,30,174,46,128,124,101,23,0
2021,Fenland 002B,E01018073,1050,693,379,314,1,1,106,25,81,249,226,23,1
2021,Fenland 006C,E01018074,530,416,254,162,0,0,42,10,32,71,63,8,1
2021,Fenland 006D,E01018075,522,258,140,118,1,1,185,21,164,78,67,11,0
2021,Fenland 010B,E01018076,1078,828,410,418,11,11,79,9,70,160,127,33,0
2021,Fenland 007A,E01018077,935,459,266,193,2,2,102,10,92,372,348,24,0
2021,Fenland 007B,E01018078,832,354,203,151,5,5,310,56,254,162,146,16,1
2021,Fenland 007C,E01018079,799,576,395,181,2,2,107,10,97,114,99,15,0
2021,Fenland 007D,E01018080,988,713,409,304,4,4,54,4,50,217,196,21,0
2021,Fenland 005A,E01018081,604,457,251,206,1,1,46,10,36,100,75,25,0
2021,Fenland 005B,E01018082,816,637,344,293,7,7,45,3,42,127,107,20,0
2021,Fenland 005C,E01018083,759,459,225,234,14,14,82,9,73,202,185,17,2
2021,Fenland 005D,E01018084,925,696,432,264,1,1,46,8,38,181,163,18,1
2021,Fenland 009A,E01018085,712,588,389,199,3,3,8,0,8,113,101,12,0
2021,Fenland 009B,E01018086,857,519,313,206,11,11,158,23,135,169,155,14,0
2021,Fenland 009C,E01018087,1058,665,358,307,11,11,179,29,150,199,173,26,4
2021,Fenland 009D,E01018088,707,564,378,186,1,1,27,3,24,115,106,9,0
2021,Fenland 004D,E01018090,869,676,424,252,5,5,109,36,73,78,53,25,1
2021,Fenland 004E,E01018091,646,471,225,246,3,3,88,22,66,84,69,15,0
2021,Fenland 004F,E01018092,814,606,355,251,0,0,76,28,48,132,111,21,0
2021,Fenland 003E,E01018093,1080,684,407,277,2,2,148,25,123,244,213,31,2
2021,Fenland 001A,E01018094,814,587,363,224,1,1,122,22,100,104,85,19,0
2021,Fenland 001B,E01018095,716,594,394,200,11,11,42,8,34,69,58,11,0
2021,Fenland 001C,E01018096,791,638,406,232,4,4,13,5,8,136,122,14,0
2021,Fenland 001D,E01018097,681,526,339,187,3,3,81,15,66,70,59,11,1
2021,Fenland 006E,E01018098,596,473,280,193,3,3,26,3,23,94,77,17,0
2021,Fenland 006F,E01018099,533,459,283,176,2,2,3,1,2,69,57,12,0
2021,Fenland 006G,E01018100,704,391,187,204,1,1,68,15,53,244,220,24,0
2021,Fenland 006H,E01018101,658,435,242,193,3,3,24,5,19,196,182,14,0
2021,Fenland 003F,E01018103,492,202,98,104,0,0,174,58,116,116,104,12,0
2021,Fenland 003G,E01018104,527,388,244,144,2,2,81,18,63,56,45,11,0
2021,Fenland 011C,E01018105,555,353,165,188,3,3,80,14,66,119,104,15,0
2021,Fenland 011D,E01018106,703,539,263,276,2,2,31,6,25,130,114,16,1
2021,Fenland 002C,E01018107,664,268,134,134,4,4,264,82,182,125,112,13,3
2021,Fenland 002D,E01018108,830,301,187,114,4,4,294,88,206,231,218,13,0
2021,Fenland 002E,E01018109,809,505,293,212,1,1,66,16,50,237,222,15,0
2021,Fenland 011E,E01018110,1140,842,468,374,8,8,82,21,61,208,175,33,0
2021,Fenland 010C,E01018111,1018,788,464,324,2,2,99,21,78,129,97,32,0
2021,Huntingdonshire 010B,E01018113,612,493,280,213,1,1,48,9,39,70,58,12,0
2021,Huntingdonshire 017A,E01018115,570,473,294,179,0,0,19,1,18,78,66,12,0
2021,Huntingdonshire 010D,E01018116,1061,651,261,390,72,72,140,24,116,198,125,73,0
2021,Huntingdonshire 010E,E01018117,838,567,324,243,5,5,149,31,118,117,92,25,0
2021,Huntingdonshire 010F,E01018118,866,648,311,337,5,5,66,9,57,146,131,15,1
2021,Huntingdonshire 017B,E01018119,683,527,304,223,6,6,47,6,41,103,91,12,0
2021,Huntingdonshire 017C,E01018120,828,641,393,248,1,1,104,12,92,82,69,13,0
2021,Huntingdonshire 007A,E01018121,528,465,268,197,0,0,13,1,12,50,42,8,0
2021,Huntingdonshire 007B,E01018122,490,419,256,163,1,1,34,9,25,36,31,5,0
2021,Huntingdonshire 007C,E01018123,687,568,300,268,9,9,35,6,29,75,60,15,0
2021,Huntingdonshire 007D,E01018124,778,640,354,286,1,1,67,21,46,69,49,20,1
2021,Huntingdonshire 015A,E01018125,623,514,284,230,2,2,54,14,40,53,44,9,0
2021,Huntingdonshire 015B,E01018126,685,558,307,251,4,4,51,7,44,72,54,18,0
2021,Huntingdonshire 002A,E01018127,638,488,279,209,0,0,44,11,33,106,92,14,0
2021,Huntingdonshire 002B,E01018128,530,350,210,140,2,2,78,14,64,100,77,23,0
2021,Huntingdonshire 016A,E01018129,719,504,290,214,13,13,85,13,72,117,103,14,0
2021,Huntingdonshire 016B,E01018130,809,613,294,319,30,30,70,5,65,96,78,18,0
2021,Huntingdonshire 014A,E01018131,659,390,182,208,0,0,192,27,165,77,68,9,0
2021,Huntingdonshire 014C,E01018133,675,488,246,242,9,9,112,7,105,66,57,9,0
2021,Huntingdonshire 014D,E01018134,783,522,247,275,25,25,61,3,58,175,165,10,0
2021,Huntingdonshire 018B,E01018136,688,578,333,245,1,1,29,4,25,80,62,18,0
2021,Huntingdonshire 017D,E01018137,728,564,298,266,9,9,70,8,62,85,75,10,0
2021,Huntingdonshire 012A,E01018138,1063,510,243,267,32,32,190,38,152,331,304,27,0
2021,Huntingdonshire 009A,E01018139,619,396,171,225,0,0,140,27,113,82,77,5,1
2021,Huntingdonshire 009B,E01018140,508,413,233,180,2,2,19,6,13,74,66,8,0
2021,Huntingdonshire 009C,E01018141,705,615,369,246,2,2,3,0,3,85,80,5,0
2021,Huntingdonshire 009D,E01018142,633,467,299,168,4,4,99,27,72,63,53,10,0
2021,Huntingdonshire 008A,E01018143,884,410,144,266,15,15,360,78,282,96,82,14,3
2021,Huntingdonshire 008B,E01018144,624,241,90,151,25,25,245,67,178,112,106,6,1
2021,Huntingdonshire 008C,E01018145,486,223,89,134,2,2,158,52,106,102,96,6,1
2021,Huntingdonshire 008D,E01018146,793,394,146,248,9,9,225,37,188,164,153,11,1
2021,Huntingdonshire 008E,E01018147,623,259,121,138,3,3,238,65,173,122,113,9,1
2021,Huntingdonshire 012B,E01018148,1045,640,226,414,43,43,137,20,117,225,212,13,0
2021,Huntingdonshire 012C,E01018149,549,441,191,250,2,2,3,0,3,103,95,8,0
2021,Huntingdonshire 012D,E01018150,678,365,153,212,7,7,140,19,121,166,153,13,0
2021,Huntingdonshire 015C,E01018152,597,476,260,216,3,3,26,5,21,92,72,20,0
2021,Huntingdonshire 015D,E01018153,759,577,335,242,4,4,64,6,58,114,82,32,0
2021,Huntingdonshire 018C,E01018154,1083,754,374,380,25,25,116,14,102,188,169,19,0
2021,Huntingdonshire 018D,E01018155,690,568,343,225,4,4,21,5,16,97,86,11,0
2021,Huntingdonshire 003A,E01018156,723,546,332,214,2,2,55,10,45,120,93,27,0
2021,Huntingdonshire 003B,E01018157,845,704,337,367,0,0,62,17,45,79,62,17,0
2021,Huntingdonshire 003C,E01018158,904,414,233,181,2,2,159,24,135,329,301,28,0
2021,Huntingdonshire 003D,E01018159,667,503,259,244,38,38,34,2,32,92,84,8,0
2021,Huntingdonshire 003E,E01018160,683,363,172,191,2,2,242,55,187,75,57,18,1
2021,Huntingdonshire 011A,E01018161,582,453,243,210,5,5,18,2,16,106,92,14,0
2021,Huntingdonshire 011B,E01018162,622,475,250,225,22,22,37,5,32,88,77,11,0
2021,Huntingdonshire 011C,E01018163,607,313,120,193,11,11,99,20,79,184,178,6,0
2021,Huntingdonshire 011D,E01018164,525,392,204,188,2,2,21,4,17,110,104,6,0
2021,Huntingdonshire 011E,E01018165,555,358,165,193,0,0,45,6,39,152,144,8,0
2021,Huntingdonshire 013A,E01018166,652,495,328,167,2,2,44,8,36,111,98,13,0
2021,Huntingdonshire 013B,E01018167,597,520,306,214,6,6,4,0,4,67,56,11,0
2021,Huntingdonshire 013C,E01018168,1182,438,292,146,5,5,235,32,203,504,457,47,0
2021,Huntingdonshire 013D,E01018169,919,595,282,313,21,21,180,17,163,122,109,13,1
2021,Huntingdonshire 011F,E01018170,592,438,267,171,1,1,63,9,54,90,76,14,0
2021,Huntingdonshire 011G,E01018171,689,553,321,232,12,12,52,8,44,72,64,8,0
2021,Huntingdonshire 020A,E01018172,657,495,300,195,2,2,57,1,56,103,88,15,0
2021,Huntingdonshire 020B,E01018173,517,346,180,166,0,0,18,0,18,153,141,12,0
2021,Huntingdonshire 020C,E01018174,693,522,290,232,4,4,52,14,38,115,104,11,0
2021,Huntingdonshire 020D,E01018175,556,471,268,203,2,2,14,1,13,69,63,6,0
2021,Huntingdonshire 020E,E01018176,520,481,296,185,4,4,11,0,11,24,18,6,0
2021,Huntingdonshire 022A,E01018177,647,543,336,207,1,1,31,10,21,72,68,4,0
2021,Huntingdonshire 022B,E01018178,676,538,287,251,6,6,66,7,59,66,54,12,0
2021,Huntingdonshire 022C,E01018179,600,302,107,195,2,2,166,42,124,129,114,15,1
2021,Huntingdonshire 022D,E01018180,574,235,91,144,1,1,259,63,196,78,68,10,1
2021,Huntingdonshire 021B,E01018182,585,430,175,255,3,3,59,13,46,93,88,5,0
2021,Huntingdonshire 021C,E01018183,627,341,186,155,1,1,191,55,136,93,78,15,1
2021,Huntingdonshire 021D,E01018184,497,259,131,128,3,3,166,39,127,69,63,6,0
2021,Huntingdonshire 021E,E01018185,728,517,296,221,13,13,88,25,63,110,94,16,0
2021,Huntingdonshire 021F,E01018186,732,486,246,240,13,13,147,30,117,86,76,10,0
2021,Huntingdonshire 019A,E01018187,1155,489,288,201,7,7,239,21,218,419,385,34,1
2021,Huntingdonshire 019B,E01018188,638,421,213,208,2,2,105,26,79,109,101,8,1
2021,Huntingdonshire 019C,E01018189,502,475,284,191,0,0,3,0,3,24,19,5,0
2021,Huntingdonshire 019D,E01018190,665,446,248,198,10,10,124,29,95,85,76,9,0
2021,Huntingdonshire 004A,E01018191,567,442,226,216,25,25,25,5,20,75,59,16,0
2021,Huntingdonshire 004B,E01018192,785,610,333,277,20,20,67,8,59,88,77,11,0
2021,Huntingdonshire 004C,E01018193,549,440,211,229,4,4,17,1,16,88,87,1,0
2021,Huntingdonshire 004D,E01018194,589,460,247,213,2,2,35,9,26,92,76,16,0
2021,Huntingdonshire 004E,E01018195,553,290,137,153,3,3,178,40,138,82,67,15,0
2021,Huntingdonshire 006A,E01018196,551,454,275,179,3,3,34,11,23,60,49,11,0
2021,Huntingdonshire 006B,E01018197,651,434,205,229,0,0,103,18,85,114,100,14,0
2021,Huntingdonshire 006C,E01018198,707,579,323,256,0,0,25,6,19,103,88,15,0
2021,Huntingdonshire 006D,E01018199,664,565,340,225,9,9,25,4,21,65,43,22,0
2021,Huntingdonshire 002C,E01018200,656,527,301,226,1,1,55,8,47,73,61,12,0
2021,Huntingdonshire 002D,E01018201,616,444,213,231,0,0,71,7,64,101,85,16,0
2021,Huntingdonshire 016C,E01018202,639,542,356,186,0,0,31,6,25,66,58,8,0
2021,Huntingdonshire 016D,E01018203,790,552,294,258,19,19,111,16,95,107,101,6,1
2021,Huntingdonshire 016E,E01018204,558,468,262,206,5,5,28,2,26,57,46,11,0
2021,Huntingdonshire 016F,E01018205,830,671,461,210,6,6,29,4,25,124,109,15,0
2021,Huntingdonshire 006E,E01018206,764,359,118,241,12,12,73,14,59,320,144,176,0
2021,Huntingdonshire 006F,E01018207,646,485,253,232,7,7,68,7,61,86,69,17,0
2021,Huntingdonshire 005A,E01018208,899,601,292,309,27,27,163,29,134,108,96,12,0
2021,Huntingdonshire 005B,E01018209,669,551,328,223,11,11,51,16,35,56,48,8,0
2021,Huntingdonshire 005C,E01018210,619,415,220,195,1,1,120,12,108,83,67,16,0
2021,Huntingdonshire 005D,E01018211,765,613,325,288,1,1,62,14,48,89,69,20,0
2021,Huntingdonshire 001A,E01018212,681,465,261,204,2,2,116,26,90,97,81,16,1
2021,Huntingdonshire 001B,E01018213,797,578,263,315,9,9,71,15,56,139,125,14,0
2021,Huntingdonshire 001C,E01018214,830,502,211,291,10,10,205,54,151,113,98,15,0
2021,Huntingdonshire 001D,E01018215,605,476,230,246,8,8,14,3,11,107,91,16,0
2021,Huntingdonshire 001E,E01018216,988,789,359,430,7,7,66,9,57,126,112,14,0
2021,Huntingdonshire 001F,E01018217,731,555,328,227,10,10,93,12,81,73,62,11,0
2021,South Cambridgeshire 016A,E01018218,709,579,351,228,6,6,56,43,13,68,42,26,0
2021,South Cambridgeshire 016B,E01018219,597,391,231,160,28,28,132,88,44,46,33,13,0
2021,South Cambridgeshire 016C,E01018220,595,444,243,201,5,5,71,55,16,75,52,23,0
2021,South Cambridgeshire 022A,E01018221,756,526,277,249,4,4,21,5,16,205,192,13,0
2021,South Cambridgeshire 022B,E01018222,587,518,316,202,2,2,7,2,5,60,46,14,0
2021,South Cambridgeshire 022C,E01018223,831,595,329,266,8,8,87,53,34,140,113,27,1
2021,South Cambridgeshire 022F,E01018224,584,413,250,163,12,12,82,34,48,77,62,15,0
2021,South Cambridgeshire 022G,E01018225,482,300,204,96,17,17,90,75,15,74,62,12,1
2021,South Cambridgeshire 019A,E01018226,418,261,113,148,5,5,54,39,15,98,52,46,0
2021,South Cambridgeshire 019B,E01018227,786,512,244,268,18,18,193,141,52,61,52,9,2
2021,South Cambridgeshire 019C,E01018228,658,536,294,242,3,3,64,56,8,55,49,6,0
2021,South Cambridgeshire 010A,E01018231,1067,812,418,394,28,28,83,30,53,144,121,23,0
2021,South Cambridgeshire 010B,E01018232,969,726,437,289,30,30,106,70,36,106,94,12,1
2021,South Cambridgeshire 002A,E01018233,665,568,356,212,3,3,18,15,3,76,60,16,0
2021,South Cambridgeshire 002B,E01018234,699,531,313,218,2,2,9,5,4,157,140,17,0
2021,South Cambridgeshire 002C,E01018235,695,504,267,237,17,17,91,74,17,82,68,14,1
2021,South Cambridgeshire 002D,E01018236,854,549,232,317,26,26,218,142,76,55,47,8,6
2021,South Cambridgeshire 003A,E01018237,613,464,276,188,5,5,79,56,23,65,58,7,0
2021,South Cambridgeshire 017A,E01018238,589,390,207,183,2,2,122,93,29,75,68,7,0
2021,South Cambridgeshire 017B,E01018239,620,437,229,208,13,13,101,52,49,67,54,13,2
2021,South Cambridgeshire 014A,E01018240,534,400,243,157,4,4,85,72,13,44,35,9,1
2021,South Cambridgeshire 018A,E01018241,533,425,247,178,7,7,49,36,13,52,44,8,0
2021,South Cambridgeshire 011A,E01018242,718,421,259,162,35,35,169,82,87,90,80,10,3
2021,South Cambridgeshire 011B,E01018243,664,372,205,167,5,5,106,3,103,181,173,8,0
2021,South Cambridgeshire 011C,E01018244,780,621,458,163,15,15,33,18,15,110,89,21,1
2021,South Cambridgeshire 013A,E01018245,720,605,349,256,0,0,30,16,14,85,66,19,0
2021,South Cambridgeshire 013B,E01018246,704,474,271,203,14,14,139,126,13,73,62,11,4
2021,South Cambridgeshire 013C,E01018247,734,520,289,231,20,20,119,65,54,75,51,24,0
2021,South Cambridgeshire 022E,E01018248,786,568,337,231,30,30,81,14,67,106,89,17,1
2021,South Cambridgeshire 010C,E01018251,483,399,223,176,4,4,16,10,6,64,59,5,0
2021,South Cambridgeshire 010D,E01018252,601,441,249,192,22,22,67,40,27,69,55,14,2
2021,South Cambridgeshire 014B,E01018253,446,370,214,156,2,2,16,13,3,58,47,11,0
2021,South Cambridgeshire 014C,E01018254,877,633,246,387,27,27,134,95,39,82,70,12,1
2021,South Cambridgeshire 010E,E01018255,466,369,219,150,12,12,55,37,18,29,24,5,1
2021,South Cambridgeshire 014D,E01018256,1023,663,342,321,48,48,187,45,142,125,115,10,0
2021,South Cambridgeshire 006A,E01018257,625,346,188,158,17,17,208,155,53,52,45,7,2
2021,South Cambridgeshire 006B,E01018258,683,533,315,218,3,3,87,73,14,57,49,8,3
2021,South Cambridgeshire 006C,E01018259,591,422,245,177,8,8,63,24,39,98,90,8,0
2021,South Cambridgeshire 006D,E01018260,879,637,391,246,19,19,103,40,63,117,98,19,3
2021,South Cambridgeshire 006F,E01018262,544,472,276,196,2,2,9,5,4,61,51,10,0
2021,South Cambridgeshire 016D,E01018263,609,462,264,198,7,7,55,38,17,85,70,15,0
2021,South Cambridgeshire 016E,E01018264,695,341,195,146,17,17,274,203,71,60,52,8,3
2021,South Cambridgeshire 016F,E01018265,714,608,356,252,2,2,19,13,6,85,68,17,0
2021,South Cambridgeshire 018B,E01018267,1020,792,500,292,15,15,97,44,53,116,94,22,0
2021,South Cambridgeshire 018C,E01018268,810,590,325,265,16,16,112,36,76,92,75,17,0
2021,South Cambridgeshire 018D,E01018269,676,379,183,196,27,27,210,177,33,58,47,11,2
2021,South Cambridgeshire 018E,E01018270,464,350,214,136,7,7,67,38,29,40,31,9,0
2021,South Cambridgeshire 018F,E01018271,639,382,204,178,28,28,165,105,60,64,49,15,0
2021,South Cambridgeshire 007A,E01018272,585,484,271,213,12,12,22,4,18,67,62,5,0
2021,South Cambridgeshire 007B,E01018273,661,425,293,132,0,0,62,30,32,172,155,17,2
2021,South Cambridgeshire 007C,E01018274,683,399,208,191,3,3,35,21,14,245,233,12,1
2021,South Cambridgeshire 013D,E01018275,1151,778,492,286,38,38,266,192,74,69,47,22,0
2021,South Cambridgeshire 021A,E01018276,617,292,88,204,8,8,223,31,192,94,91,3,0
2021,South Cambridgeshire 021B,E01018277,770,596,330,266,7,7,81,54,27,86,62,24,0
2021,South Cambridgeshire 021C,E01018278,1029,738,226,512,35,35,165,26,139,91,79,12,0
2021,South Cambridgeshire 015A,E01018279,701,427,242,185,22,22,176,142,34,76,56,20,0
2021,South Cambridgeshire 015B,E01018280,617,430,248,182,9,9,80,59,21,93,82,11,5
2021,South Cambridgeshire 015C,E01018281,689,352,204,148,33,33,253,184,69,51,44,7,0
2021,South Cambridgeshire 015D,E01018282,560,407,228,179,4,4,83,37,46,66,59,7,0
2021,South Cambridgeshire 015E,E01018283,491,418,224,194,2,2,7,4,3,64,53,11,0
2021,South Cambridgeshire 003C,E01018284,581,441,249,192,3,3,23,10,13,114,103,11,0
2021,South Cambridgeshire 003D,E01018285,586,405,166,239,11,11,98,64,34,70,65,5,2
2021,South Cambridgeshire 011D,E01018286,659,354,173,181,7,7,153,112,41,144,133,11,1
2021,South Cambridgeshire 011E,E01018287,569,268,125,143,7,7,30,20,10,263,256,7,1
2021,South Cambridgeshire 017C,E01018288,565,392,232,160,9,9,101,75,26,62,50,12,1
2021,South Cambridgeshire 017D,E01018289,506,317,172,145,6,6,60,27,33,122,91,31,1
2021,South Cambridgeshire 019D,E01018290,1011,773,443,330,12,12,118,85,33,107,87,20,1
2021,South Cambridgeshire 014E,E01018291,487,363,220,143,1,1,65,53,12,57,45,12,1
2021,South Cambridgeshire 012A,E01018292,577,458,290,168,3,3,16,6,10,99,90,9,1
2021,South Cambridgeshire 012B,E01018293,677,562,349,213,5,5,12,6,6,98,82,16,0
2021,South Cambridgeshire 012C,E01018294,894,377,234,143,12,12,319,276,43,182,172,10,4
2021,South Cambridgeshire 012D,E01018295,697,560,337,223,17,17,71,44,27,49,45,4,0
2021,South Cambridgeshire 011F,E01018296,451,312,183,129,2,2,59,47,12,78,65,13,0
2021,South Cambridgeshire 007D,E01018297,780,472,254,218,23,23,111,78,33,173,158,15,1
2021,South Cambridgeshire 004A,E01018298,698,370,122,248,18,18,92,22,70,218,144,74,0
2021,South Cambridgeshire 004B,E01018299,981,638,286,352,41,41,211,119,92,91,83,8,0
2021,South Cambridgeshire 004C,E01018300,525,327,214,113,11,11,96,69,27,89,73,16,2
2021,South Cambridgeshire 004D,E01018301,584,449,266,183,6,6,45,33,12,81,67,14,3
2021,South Cambridgeshire 017E,E01018302,611,465,193,272,2,2,49,40,9,94,76,18,1
2021,South Cambridgeshire 017F,E01018303,527,372,216,156,15,15,101,60,41,38,28,10,1
2021,South Cambridgeshire 001A,E01018304,920,564,257,307,29,29,209,128,81,118,98,20,0
2021,South Cambridgeshire 001B,E01018305,539,429,260,169,9,9,61,48,13,40,33,7,0
2021,South Cambridgeshire 001C,E01018306,621,542,289,253,4,4,22,3,19,53,45,8,0
2021,South Cambridgeshire 001D,E01018307,922,718,399,319,9,9,99,51,48,94,83,11,2
2021,Cheshire West and Chester 022A,E01018308,842,619,385,234,1,1,116,20,96,106,88,18,0
2021,Cheshire West and Chester 029A,E01018309,662,449,254,195,1,1,132,40,92,80,66,14,0
2021,Cheshire West and Chester 029B,E01018310,644,253,123,130,0,0,321,86,235,70,61,9,0
2021,Cheshire West and Chester 029C,E01018311,661,173,68,105,1,1,386,107,279,101,92,9,0
2021,Cheshire West and Chester 029D,E01018312,599,353,168,185,0,0,177,62,115,69,58,11,0
2021,Cheshire West and Chester 031A,E01018313,605,451,277,174,2,2,71,23,48,80,57,23,1
2021,Cheshire West and Chester 031B,E01018314,719,311,167,144,3,3,290,85,205,115,98,17,0
2021,Cheshire West and Chester 031C,E01018315,553,379,211,168,3,3,98,24,74,73,43,30,0
2021,Cheshire West and Chester 031D,E01018316,588,208,107,101,4,4,294,92,202,80,55,25,2
2021,Cheshire West and Chester 031E,E01018317,753,191,73,118,12,12,459,145,314,89,77,12,2
2021,Cheshire West and Chester 036A,E01018319,1025,562,271,291,3,3,119,20,99,340,328,12,1
2021,Cheshire West and Chester 041A,E01018320,605,530,302,228,3,3,8,3,5,64,46,18,0
2021,Cheshire West and Chester 041B,E01018321,559,441,260,181,0,0,63,10,53,55,53,2,0
2021,Cheshire West and Chester 041C,E01018322,502,468,330,138,1,1,5,3,2,28,24,4,0
2021,Cheshire West and Chester 039A,E01018323,602,469,219,250,5,5,61,14,47,67,59,8,0
2021,Cheshire West and Chester 039B,E01018324,555,477,261,216,6,6,13,2,11,59,45,14,0
2021,Cheshire West and Chester 039C,E01018325,603,501,315,186,9,9,53,6,47,40,34,6,0
2021,Cheshire West and Chester 034B,E01018328,456,178,99,79,6,6,40,10,30,232,220,12,0
2021,Cheshire West and Chester 034D,E01018330,471,301,156,145,3,3,9,2,7,158,148,10,0
2021,Cheshire West and Chester 034E,E01018331,754,300,145,155,5,5,34,3,31,414,396,18,1
2021,Cheshire West and Chester 043A,E01018332,472,364,216,148,1,1,55,10,45,52,43,9,0
2021,Cheshire West and Chester 043B,E01018333,690,584,380,204,1,1,3,2,1,102,77,25,0
2021,Cheshire West and Chester 043C,E01018334,684,613,407,206,3,3,16,4,12,52,46,6,0
2021,Cheshire West and Chester 046A,E01018335,951,605,316,289,5,5,47,7,40,294,211,83,0
2021,Cheshire West and Chester 022B,E01018336,531,453,247,206,1,1,14,6,8,63,48,15,0
2021,Cheshire West and Chester 022C,E01018337,542,430,236,194,3,3,38,8,30,71,59,12,0
2021,Cheshire West and Chester 022D,E01018338,793,609,316,293,3,3,59,10,49,122,107,15,0
2021,Cheshire West and Chester 047A,E01018339,1125,846,474,372,39,39,118,18,100,122,92,30,0
2021,Cheshire West and Chester 043D,E01018340,745,505,279,226,0,0,131,73,58,109,96,13,0
2021,Cheshire West and Chester 043E,E01018341,517,429,303,126,1,1,31,11,20,55,51,4,1
2021,Cheshire West and Chester 043F,E01018342,965,472,282,190,2,2,48,19,29,443,416,27,0
2021,Cheshire West and Chester 033C,E01018343,803,268,132,136,3,3,159,20,139,373,348,25,0
2021,Cheshire West and Chester 036B,E01018344,904,552,255,297,4,4,33,7,26,315,291,24,0
2021,Cheshire West and Chester 032A,E01018345,502,413,204,209,2,2,41,11,30,46,44,2,0
2021,Cheshire West and Chester 032B,E01018346,618,547,290,257,0,0,20,6,14,51,49,2,0
2021,Cheshire West and Chester 032C,E01018347,624,348,181,167,4,4,206,56,150,65,56,9,1
2021,Cheshire West and Chester 030A,E01018349,758,601,368,233,19,19,74,15,59,64,52,12,0
2021,Cheshire West and Chester 030B,E01018350,914,816,493,323,15,15,17,3,14,66,55,11,0
2021,Cheshire West and Chester 044A,E01018351,653,157,68,89,4,4,426,186,240,63,57,6,3
2021,Cheshire West and Chester 044B,E01018352,906,584,270,314,8,8,34,17,17,280,258,22,0
2021,Cheshire West and Chester 044C,E01018353,625,521,262,259,0,0,46,23,23,58,49,9,0
2021,Cheshire West and Chester 044D,E01018354,660,321,155,166,7,7,235,71,164,97,84,13,0
2021,Cheshire West and Chester 047B,E01018355,634,364,232,132,2,2,145,20,125,123,106,17,0
2021,Cheshire West and Chester 047C,E01018356,687,481,271,210,14,14,79,5,74,113,97,16,0
2021,Cheshire West and Chester 047D,E01018357,771,603,334,269,9,9,58,9,49,101,77,24,0
2021,Cheshire West and Chester 022E,E01018358,496,410,237,173,10,10,32,5,27,44,40,4,0
2021,Cheshire West and Chester 022F,E01018359,437,407,258,149,0,0,10,5,5,20,15,5,0
2021,Cheshire West and Chester 025A,E01018360,833,633,355,278,2,2,39,14,25,159,59,100,0
2021,Cheshire West and Chester 033D,E01018361,598,379,177,202,0,0,19,2,17,200,190,10,0
2021,Cheshire West and Chester 028A,E01018362,631,548,282,266,11,11,22,3,19,50,45,5,0
2021,Cheshire West and Chester 028B,E01018363,470,408,257,151,2,2,6,3,3,54,44,10,0
2021,Cheshire West and Chester 027A,E01018364,729,290,146,144,11,11,342,86,256,85,79,6,1
2021,Cheshire West and Chester 027B,E01018365,939,735,458,277,8,8,105,16,89,91,74,17,0
2021,Cheshire West and Chester 025B,E01018366,651,592,393,199,3,3,4,2,2,52,42,10,0
2021,Cheshire West and Chester 025C,E01018367,872,601,315,286,13,13,164,46,118,94,71,23,0
2021,Cheshire West and Chester 030C,E01018368,676,487,271,216,11,11,83,17,66,95,82,13,0
2021,Cheshire West and Chester 046B,E01018369,661,500,311,189,14,14,27,6,21,120,86,34,0
2021,Cheshire West and Chester 030D,E01018370,658,568,318,250,15,15,19,4,15,56,41,15,0
2021,Cheshire West and Chester 046C,E01018371,936,572,349,223,31,31,144,18,126,189,160,29,0
2021,Cheshire West and Chester 046D,E01018372,969,717,463,254,15,15,35,7,28,200,159,41,2
2021,Cheshire West and Chester 047E,E01018373,950,726,429,297,13,13,53,6,47,158,126,32,0
2021,Cheshire West and Chester 028C,E01018374,765,542,306,236,2,2,69,7,62,152,134,18,0
2021,Cheshire West and Chester 028D,E01018375,841,450,249,201,5,5,64,8,56,322,308,14,0
2021,Cheshire West and Chester 028E,E01018376,648,538,285,253,0,0,49,14,35,61,47,14,0
2021,Cheshire West and Chester 028F,E01018377,840,703,351,352,25,25,47,7,40,65,56,9,0
2021,Cheshire West and Chester 027C,E01018378,537,281,137,144,3,3,192,60,132,60,45,15,1
2021,Cheshire West and Chester 027D,E01018379,610,486,324,162,2,2,63,16,47,59,53,6,0
2021,Cheshire West and Chester 027E,E01018380,502,401,249,152,0,0,56,8,48,44,37,7,1
2021,Cheshire West and Chester 036C,E01018381,516,416,231,185,3,3,9,3,6,88,82,6,0
2021,Cheshire West and Chester 036D,E01018382,847,494,297,197,14,14,173,22,151,164,146,18,2
2021,Cheshire West and Chester 032D,E01018383,599,525,258,267,2,2,23,5,18,49,45,4,0
2021,Cheshire West and Chester 032E,E01018384,631,558,337,221,4,4,10,4,6,59,46,13,0
2021,Cheshire West and Chester 039D,E01018385,845,721,473,248,3,3,27,8,19,94,74,20,0
2021,Cheshire East 042A,E01018386,950,735,356,379,30,30,105,15,90,80,64,16,0
2021,Cheshire East 040A,E01018387,828,782,504,278,1,1,14,2,12,31,23,8,0
2021,Cheshire East 040B,E01018388,760,331,158,173,2,2,299,71,228,126,103,23,2
2021,Cheshire East 040C,E01018389,788,644,397,247,13,13,35,2,33,95,78,17,1
2021,Cheshire East 040D,E01018390,749,660,422,238,5,5,24,3,21,60,52,8,0
2021,Cheshire East 042B,E01018391,1068,749,318,431,23,23,178,35,143,117,99,18,1
2021,Cheshire East 042C,E01018392,787,712,439,273,0,0,3,0,3,72,62,10,0
2021,Cheshire East 026A,E01018395,894,707,401,306,5,5,50,15,35,132,125,7,0
2021,Cheshire East 026B,E01018396,611,398,217,181,1,1,167,45,122,44,40,4,1
2021,Cheshire East 028A,E01018397,828,712,342,370,2,2,45,4,41,69,59,10,0
2021,Cheshire East 027A,E01018398,743,392,210,182,6,6,172,37,135,172,145,27,1
2021,Cheshire East 027B,E01018399,864,565,286,279,7,7,149,17,132,142,126,16,1
2021,Cheshire East 026C,E01018400,1140,433,182,251,40,40,511,155,356,156,134,22,0
2021,Cheshire East 026D,E01018401,625,400,200,200,2,2,182,52,130,40,36,4,1
2021,Cheshire East 027C,E01018402,1020,514,281,233,6,6,164,24,140,335,297,38,1
2021,Cheshire East 027D,E01018403,1027,861,477,384,18,18,51,7,44,97,82,15,0
2021,Cheshire East 029A,E01018404,621,560,345,215,1,1,11,2,9,49,44,5,0
2021,Cheshire East 029B,E01018405,607,507,272,235,1,1,8,3,5,91,83,8,0
2021,Cheshire East 029C,E01018406,615,543,354,189,2,2,5,0,5,65,60,5,0
2021,Cheshire East 029D,E01018407,668,616,382,234,1,1,9,5,4,42,33,9,0
2021,Cheshire East 028B,E01018408,849,751,453,298,1,1,44,7,37,53,46,7,0
2021,Cheshire East 028C,E01018409,948,702,421,281,38,38,113,16,97,95,83,12,0
2021,Cheshire East 028D,E01018410,785,700,431,269,13,13,28,3,25,44,37,7,0
2021,Cheshire East 022B,E01018411,986,890,562,328,12,12,22,3,19,62,51,11,0
2021,Cheshire East 022C,E01018412,700,549,367,182,3,3,94,14,80,54,41,13,0
2021,Cheshire East 023A,E01018413,618,537,289,248,12,12,23,2,21,46,40,6,0
2021,Cheshire East 023B,E01018414,710,608,392,216,7,7,30,3,27,65,58,7,0
2021,Cheshire East 023C,E01018415,818,581,358,223,2,2,109,15,94,126,105,21,0
2021,Cheshire East 023D,E01018416,701,580,310,270,22,22,52,7,45,47,42,5,0
2021,Cheshire East 033B,E01018417,773,666,464,202,1,1,53,7,46,53,45,8,0
2021,Cheshire East 033C,E01018418,682,541,346,195,7,7,55,8,47,79,63,16,0
2021,Cheshire East 025A,E01018419,955,745,271,474,37,37,91,13,78,82,76,6,0
2021,Cheshire East 025B,E01018420,746,596,237,359,7,7,35,7,28,108,92,16,0
2021,Cheshire East 025C,E01018421,557,432,182,250,1,1,33,4,29,90,84,6,1
2021,Cheshire East 025D,E01018422,591,438,236,202,2,2,61,22,39,90,71,19,0
2021,Cheshire East 025E,E01018423,640,354,184,170,2,2,211,61,150,73,66,7,0
2021,Cheshire East 024A,E01018424,776,616,351,265,3,3,51,15,36,103,89,14,3
2021,Cheshire East 024B,E01018425,797,534,310,224,10,10,85,7,78,168,148,20,0
2021,Cheshire East 024C,E01018426,709,481,296,185,1,1,155,34,121,71,57,14,1
2021,Cheshire East 024D,E01018427,504,463,278,185,2,2,2,1,1,37,27,10,0
2021,Cheshire East 033D,E01018428,599,458,279,179,0,0,62,15,47,78,60,18,1
2021,Cheshire East 033E,E01018429,690,524,348,176,3,3,104,21,83,59,44,15,0
2021,Cheshire East 033F,E01018430,569,482,265,217,3,3,33,4,29,51,41,10,0
2021,Cheshire East 033G,E01018431,550,432,233,199,3,3,11,2,9,104,91,13,0
2021,Cheshire East 032A,E01018432,633,444,261,183,7,7,123,33,90,59,51,8,0
2021,Cheshire East 032B,E01018433,694,566,350,216,3,3,52,5,47,73,66,7,0
2021,Cheshire East 032C,E01018434,667,531,293,238,6,6,49,6,43,81,67,14,0
2021,Cheshire East 032D,E01018435,733,373,199,174,4,4,258,46,212,98,88,10,0
2021,Cheshire East 030A,E01018436,716,625,386,239,13,13,19,0,19,59,51,8,0
2021,Cheshire East 030B,E01018437,788,427,234,193,17,17,166,21,145,178,151,27,0
2021,Cheshire East 030C,E01018438,614,573,377,196,2,2,1,0,1,38,29,9,0
2021,Cheshire East 030D,E01018439,881,746,384,362,22,22,34,4,30,79,67,12,0
2021,Cheshire East 031A,E01018440,1102,767,280,487,13,13,128,16,112,194,186,8,0
2021,Cheshire East 031B,E01018441,880,697,246,451,13,13,34,2,32,136,125,11,0
2021,Cheshire East 031D,E01018443,935,721,365,356,38,38,52,2,50,124,97,27,0
2021,Cheshire East 045A,E01018445,828,290,118,172,9,9,282,86,196,245,235,10,2
2021,Cheshire East 045B,E01018446,550,367,167,200,2,2,127,52,75,54,46,8,0
2021,Cheshire East 045C,E01018447,807,292,158,134,2,2,35,7,28,477,445,32,1
2021,Cheshire East 045D,E01018448,753,509,262,247,13,13,15,2,13,216,196,20,0
2021,Cheshire East 051A,E01018449,793,674,484,190,5,5,58,6,52,56,40,16,0
2021,Cheshire East 051B,E01018450,1142,904,570,334,16,16,78,14,64,143,117,26,1
2021,Cheshire East 047A,E01018451,749,377,244,133,1,1,252,27,225,119,106,13,0
2021,Cheshire East 050A,E01018452,509,339,219,120,4,4,111,28,83,54,49,5,1
2021,Cheshire East 047B,E01018454,713,346,181,165,5,5,196,57,139,165,153,12,1
2021,Cheshire East 047C,E01018455,610,501,316,185,1,1,49,15,34,59,51,8,0
2021,Cheshire East 047D,E01018456,610,571,429,142,2,2,5,1,4,32,31,1,0
2021,Cheshire East 047E,E01018457,801,465,295,170,26,26,47,6,41,263,248,15,0
2021,Cheshire East 051C,E01018458,969,766,457,309,10,10,105,14,91,88,66,22,0
2021,Cheshire East 036A,E01018459,520,243,115,128,0,0,214,88,126,62,54,8,1
2021,Cheshire East 036B,E01018460,627,467,296,171,1,1,51,27,24,108,92,16,0
2021,Cheshire East 036C,E01018461,662,388,253,135,9,9,172,43,129,92,79,13,1
2021,Cheshire East 039A,E01018462,942,187,103,84,14,14,351,105,246,390,376,14,0
2021,Cheshire East 035A,E01018463,649,322,151,171,7,7,101,33,68,207,194,13,12
2021,Cheshire East 039B,E01018464,729,366,183,183,3,3,40,17,23,320,298,22,0
2021,Cheshire East 036D,E01018466,1163,359,195,164,2,2,433,154,279,369,336,33,0
2021,Cheshire East 041B,E01018468,640,566,324,242,1,1,6,0,6,67,59,8,0
2021,Cheshire East 041C,E01018469,726,553,316,237,10,10,80,11,69,82,67,15,1
2021,Cheshire East 041D,E01018470,788,656,358,298,17,17,63,11,52,52,40,12,0
2021,Cheshire East 041E,E01018471,634,554,341,213,0,0,12,3,9,68,60,8,0
2021,Cheshire East 034A,E01018472,673,497,258,239,1,1,36,12,24,139,115,24,0
2021,Cheshire East 034B,E01018473,663,524,219,305,6,6,37,2,35,96,84,12,0
2021,Cheshire East 034C,E01018474,662,575,246,329,0,0,4,3,1,83,81,2,0
2021,Cheshire East 034D,E01018475,639,578,245,333,1,1,5,1,4,55,46,9,0
2021,Cheshire East 035B,E01018476,549,188,98,90,1,1,267,99,168,93,84,9,0
2021,Cheshire East 035C,E01018477,699,424,211,213,0,0,208,79,129,67,61,6,0
2021,Cheshire East 035D,E01018478,649,399,146,253,2,2,144,69,75,104,96,8,0
2021,Cheshire East 035E,E01018479,1049,736,304,432,55,55,135,49,86,122,98,24,1
2021,Cheshire East 051D,E01018481,842,636,392,244,3,3,44,13,31,159,124,35,0
2021,Cheshire East 037A,E01018482,624,373,217,156,1,1,182,75,107,66,57,9,2
2021,Cheshire East 037B,E01018483,638,464,306,158,1,1,36,10,26,137,125,12,0
2021,Cheshire East 037C,E01018484,782,306,79,227,2,2,300,129,171,173,164,9,1
2021,Cheshire East 037D,E01018485,614,251,105,146,4,4,239,81,158,119,112,7,1
2021,Cheshire East 043A,E01018486,736,147,102,45,7,7,164,34,130,417,390,27,1
2021,Cheshire East 043B,E01018487,738,245,132,113,20,20,28,6,22,444,419,25,1
2021,Cheshire East 043C,E01018488,654,539,274,265,2,2,9,3,6,104,91,13,0
2021,Cheshire East 043D,E01018489,610,235,128,107,2,2,17,2,15,355,305,50,1
2021,Cheshire East 046A,E01018490,775,700,403,297,10,10,23,8,15,42,31,11,0
2021,Cheshire East 046B,E01018491,726,599,341,258,6,6,41,8,33,80,67,13,0
2021,Cheshire East 046C,E01018492,516,472,314,158,0,0,3,3,0,41,29,12,0
2021,Cheshire East 048A,E01018493,694,556,339,217,1,1,54,13,41,81,66,15,2
2021,Cheshire East 048B,E01018494,1153,911,345,566,61,61,93,23,70,88,65,23,0
2021,Cheshire East 048C,E01018495,674,544,288,256,19,19,53,10,43,58,46,12,0
2021,Cheshire East 039C,E01018496,677,458,209,249,1,1,98,28,70,119,110,9,1
2021,Cheshire East 039D,E01018497,557,261,139,122,2,2,25,1,24,269,255,14,0
2021,Cheshire East 039E,E01018498,653,234,78,156,2,2,237,83,154,180,168,12,0
2021,Cheshire East 038A,E01018499,728,542,279,263,7,7,78,7,71,101,91,10,0
2021,Cheshire East 038B,E01018500,523,456,292,164,3,3,9,3,6,55,41,14,0
2021,Cheshire East 038C,E01018501,791,539,375,164,3,3,63,13,50,186,168,18,0
2021,Cheshire East 038D,E01018502,534,464,330,134,0,0,12,1,11,58,47,11,0
2021,Cheshire East 050C,E01018503,733,656,434,222,4,4,10,2,8,63,51,12,0
2021,Cheshire East 050D,E01018504,857,527,349,178,7,7,117,22,95,205,188,17,1
2021,Cheshire East 046D,E01018505,502,458,256,202,0,0,11,3,8,33,25,8,0
2021,Cheshire East 046E,E01018506,535,524,315,209,1,1,0,0,0,10,7,3,0
2021,Cheshire East 046F,E01018507,566,538,368,170,0,0,4,3,1,24,23,1,0
2021,Cheshire East 048D,E01018508,591,532,296,236,2,2,23,2,21,34,31,3,0
2021,Cheshire East 048E,E01018509,558,404,211,193,8,8,44,7,37,102,88,14,0
2021,Cheshire East 044A,E01018510,731,616,284,332,14,14,56,13,43,43,35,8,2
2021,Cheshire East 044B,E01018511,628,363,162,201,1,1,174,62,112,89,77,12,1
2021,Cheshire East 044C,E01018512,700,468,250,218,0,0,144,60,84,88,82,6,0
2021,Cheshire East 044D,E01018513,668,599,347,252,0,0,9,4,5,60,51,9,0
2021,Cheshire East 051E,E01018514,891,673,433,240,9,9,103,15,88,106,83,23,0
2021,Cheshire East 053F,E01018515,920,788,415,373,1,1,21,1,20,110,88,22,0
2021,Cheshire East 053C,E01018516,697,605,366,239,7,7,29,7,22,56,45,11,0
2021,Cheshire West and Chester 004A,E01018518,689,627,418,209,1,1,13,5,8,48,38,10,0
2021,Cheshire West and Chester 007A,E01018519,711,332,172,160,3,3,69,34,35,305,296,9,2
2021,Cheshire West and Chester 007B,E01018520,894,311,117,194,8,8,154,67,87,419,400,19,2
2021,Cheshire West and Chester 011A,E01018521,570,241,108,133,0,0,261,187,74,65,54,11,3
2021,Cheshire West and Chester 010A,E01018522,616,311,157,154,0,0,232,188,44,68,61,7,5
2021,Cheshire West and Chester 008A,E01018523,605,285,143,142,2,2,231,193,38,83,71,12,4
2021,Cheshire West and Chester 008B,E01018524,613,170,68,102,1,1,365,263,102,75,65,10,2
2021,Cheshire West and Chester 007C,E01018525,754,372,124,248,6,6,280,197,83,96,81,15,0
2021,Cheshire West and Chester 016A,E01018526,659,588,328,260,3,3,3,2,1,65,58,7,0
2021,Cheshire West and Chester 016B,E01018527,649,594,324,270,0,0,5,2,3,50,39,11,0
2021,Cheshire West and Chester 009A,E01018528,725,635,274,361,12,12,26,10,16,52,50,2,0
2021,Cheshire West and Chester 009B,E01018529,631,581,372,209,2,2,5,3,2,43,29,14,0
2021,Cheshire West and Chester 009C,E01018530,572,521,274,247,10,10,16,1,15,25,20,5,0
2021,Cheshire West and Chester 009D,E01018531,711,593,335,258,7,7,10,5,5,101,90,11,0
2021,Cheshire West and Chester 006A,E01018532,871,555,312,243,3,3,207,128,79,105,92,13,1
2021,Cheshire West and Chester 006B,E01018533,645,605,396,209,3,3,6,2,4,31,24,7,0
2021,Cheshire West and Chester 001A,E01018534,1193,511,251,260,6,6,449,193,256,225,208,17,2
2021,Cheshire West and Chester 001B,E01018535,682,444,273,171,3,3,153,89,64,81,59,22,1
2021,Cheshire West and Chester 001C,E01018536,814,676,426,250,1,1,15,6,9,122,110,12,0
2021,Cheshire West and Chester 001D,E01018537,948,828,584,244,1,1,35,5,30,84,68,16,0
2021,Cheshire West and Chester 010B,E01018538,480,236,126,110,0,0,191,161,30,50,45,5,3
2021,Cheshire West and Chester 010C,E01018539,512,256,118,138,3,3,154,128,26,96,87,9,3
2021,Cheshire West and Chester 010D,E01018540,616,484,240,244,1,1,33,19,14,98,84,14,0
2021,Cheshire West and Chester 008C,E01018541,631,462,226,236,1,1,57,39,18,110,98,12,1
2021,Cheshire West and Chester 008D,E01018542,508,157,58,99,2,2,285,228,57,62,58,4,2
2021,Cheshire West and Chester 008E,E01018543,613,364,157,207,1,1,124,65,59,122,102,20,2
2021,Cheshire West and Chester 006C,E01018544,640,569,360,209,1,1,4,2,2,66,60,6,0
2021,Cheshire West and Chester 006D,E01018545,822,708,437,271,4,4,14,2,12,96,86,10,0
2021,Cheshire West and Chester 005A,E01018546,684,396,198,198,3,3,151,96,55,133,124,9,1
2021,Cheshire West and Chester 005B,E01018547,621,458,270,188,20,20,64,51,13,79,62,17,0
2021,Cheshire West and Chester 005C,E01018548,932,541,248,293,42,42,242,135,107,103,86,17,4
2021,Cheshire West and Chester 005D,E01018549,691,484,292,192,2,2,84,52,32,121,97,24,0
2021,Cheshire West and Chester 011B,E01018550,506,154,72,82,2,2,275,218,57,75,66,9,0
2021,Cheshire West and Chester 011C,E01018551,719,224,94,130,3,3,391,294,97,99,91,8,2
2021,Cheshire West and Chester 011D,E01018552,1105,606,184,422,60,60,265,171,94,174,154,20,0
2021,Cheshire West and Chester 011E,E01018553,745,386,173,213,11,11,266,162,104,79,71,8,3
2021,Cheshire West and Chester 016C,E01018554,988,894,552,342,5,5,7,5,2,82,67,15,0
2021,Cheshire West and Chester 016D,E01018555,488,439,222,217,1,1,6,1,5,42,30,12,0
2021,Cheshire West and Chester 013A,E01018556,633,540,342,198,2,2,44,37,7,46,37,9,1
2021,Cheshire West and Chester 013B,E01018557,655,351,177,174,0,0,216,176,40,83,70,13,5
2021,Cheshire West and Chester 013C,E01018558,490,437,203,234,3,3,3,1,2,47,35,12,0
2021,Cheshire West and Chester 013D,E01018559,466,431,245,186,0,0,7,5,2,28,20,8,0
2021,Cheshire West and Chester 009E,E01018560,477,447,232,215,0,0,2,1,1,28,26,2,0
2021,Cheshire West and Chester 009F,E01018561,488,462,238,224,2,2,4,1,3,20,15,5,0
2021,Cheshire West and Chester 009G,E01018562,557,496,216,280,9,9,11,2,9,41,34,7,0
2021,Cheshire West and Chester 014A,E01018565,638,552,316,236,2,2,35,19,16,49,38,11,0
2021,Cheshire West and Chester 014B,E01018566,597,540,362,178,1,1,12,10,2,44,31,13,0
2021,Cheshire West and Chester 014C,E01018567,598,547,315,232,1,1,11,2,9,39,31,8,0
2021,Cheshire West and Chester 014D,E01018568,574,502,193,309,7,7,1,0,1,64,58,6,0
2021,Cheshire West and Chester 004B,E01018569,561,528,344,184,0,0,12,0,12,21,18,3,0
2021,Cheshire West and Chester 004C,E01018570,599,489,268,221,0,0,29,20,9,80,68,12,1
2021,Cheshire West and Chester 004D,E01018571,660,495,326,169,4,4,63,20,43,98,77,21,0
2021,Cheshire East 012A,E01018572,752,633,382,251,0,0,25,8,17,94,87,7,0
2021,Cheshire East 012B,E01018573,654,559,351,208,1,1,8,1,7,86,64,22,0
2021,Cheshire East 012C,E01018574,1021,570,325,245,1,1,144,28,116,306,288,18,0
2021,Cheshire East 013A,E01018575,582,442,238,204,9,9,6,2,4,124,110,14,1
2021,Cheshire East 013B,E01018576,932,626,327,299,5,5,41,2,39,260,241,19,0
2021,Cheshire East 013C,E01018577,1100,835,489,346,4,4,81,21,60,180,155,25,0
2021,Cheshire East 013D,E01018578,508,426,247,179,4,4,16,7,9,62,58,4,0
2021,Cheshire East 013E,E01018579,546,322,141,181,4,4,150,42,108,70,57,13,0
2021,Cheshire East 012D,E01018580,786,672,411,261,2,2,18,7,11,94,77,17,0
2021,Cheshire East 012E,E01018581,714,544,290,254,11,11,81,13,68,78,67,11,0
2021,Cheshire East 004A,E01018582,1055,747,330,417,11,11,67,9,58,230,215,15,0
2021,Cheshire East 005A,E01018583,792,607,283,324,1,1,20,2,18,164,152,12,0
2021,Cheshire East 005B,E01018584,748,655,352,303,1,1,5,0,5,87,84,3,0
2021,Cheshire East 001A,E01018585,638,480,273,207,3,3,93,20,73,62,56,6,0
2021,Cheshire East 001B,E01018586,833,704,320,384,3,3,25,6,19,100,80,20,1
2021,Cheshire East 001C,E01018587,697,587,341,246,16,16,2,0,2,92,81,11,0
2021,Cheshire East 008A,E01018588,634,546,282,264,2,2,7,2,5,79,69,10,0
2021,Cheshire East 008B,E01018589,625,579,309,270,0,0,4,1,3,42,34,8,0
2021,Cheshire East 008C,E01018590,791,669,342,327,1,1,45,3,42,76,65,11,0
2021,Cheshire East 020A,E01018591,1057,902,585,317,11,11,68,21,47,75,59,16,1
2021,Cheshire East 004B,E01018592,780,620,333,287,3,3,88,10,78,69,56,13,0
2021,Cheshire East 004C,E01018593,808,636,370,266,6,6,65,8,57,101,89,12,0
2021,Cheshire East 004D,E01018594,847,298,150,148,49,49,367,29,338,133,123,10,0
2021,Cheshire East 004E,E01018595,778,475,245,230,1,1,170,21,149,132,118,14,0
2021,Cheshire East 004F,E01018596,904,291,116,175,12,12,445,65,380,156,147,9,0
2021,Cheshire East 007A,E01018598,744,553,294,259,8,8,14,2,12,169,156,13,0
2021,Cheshire East 007B,E01018599,489,403,267,136,5,5,27,6,21,54,50,4,0
2021,Cheshire East 006A,E01018600,680,619,363,256,2,2,5,1,4,54,45,9,0
2021,Cheshire East 006B,E01018601,921,615,395,220,2,2,82,9,73,221,194,27,1
2021,Cheshire East 006C,E01018602,872,578,343,235,2,2,43,1,42,249,227,22,0
2021,Cheshire East 010A,E01018603,514,479,286,193,3,3,2,1,1,30,24,6,0
2021,Cheshire East 010B,E01018604,596,423,207,216,2,2,79,16,63,91,85,6,1
2021,Cheshire East 009A,E01018605,490,439,272,167,1,1,7,1,6,43,39,4,0
2021,Cheshire East 010C,E01018606,813,451,305,146,4,4,106,11,95,252,226,26,0
2021,Cheshire East 010D,E01018607,507,472,306,166,0,0,3,0,3,32,23,9,0
2021,Cheshire East 010E,E01018608,554,497,298,199,0,0,3,1,2,54,46,8,0
2021,Cheshire East 009B,E01018609,754,588,358,230,7,7,73,13,60,86,67,19,0
2021,Cheshire East 009C,E01018610,899,554,256,298,1,1,187,45,142,156,141,15,1
2021,Cheshire East 009D,E01018611,754,277,129,148,5,5,353,52,301,119,111,8,0
2021,Cheshire East 005C,E01018612,576,392,196,196,10,10,110,19,91,64,58,6,0
2021,Cheshire East 005D,E01018613,755,367,181,186,19,19,228,35,193,141,121,20,0
2021,Cheshire East 015A,E01018614,843,651,369,282,3,3,6,1,5,183,170,13,0
2021,Cheshire East 017A,E01018615,589,385,182,203,26,26,25,1,24,153,145,8,0
2021,Cheshire East 017B,E01018616,637,467,261,206,4,4,67,3,64,99,64,35,0
2021,Cheshire East 017C,E01018617,674,502,286,216,3,3,85,24,61,84,74,10,0
2021,Cheshire East 015B,E01018618,646,330,163,167,12,12,189,55,134,115,104,11,0
2021,Cheshire East 015C,E01018619,624,556,279,277,0,0,15,4,11,53,48,5,0
2021,Cheshire East 015D,E01018620,590,364,219,145,5,5,164,29,135,57,49,8,0
2021,Cheshire East 015E,E01018621,599,517,289,228,3,3,29,6,23,50,39,11,0
2021,Cheshire East 018A,E01018622,742,337,160,177,19,19,132,10,122,254,243,11,0
2021,Cheshire East 018B,E01018623,700,497,250,247,5,5,46,10,36,151,132,19,1
2021,Cheshire East 018C,E01018624,1132,446,181,265,1,1,74,10,64,611,571,40,0
2021,Cheshire East 018D,E01018625,732,420,184,236,1,1,37,2,35,274,248,26,0
2021,Cheshire East 018E,E01018627,907,478,247,231,15,15,122,15,107,291,260,31,1
2021,Cheshire East 016B,E01018628,639,559,331,228,2,2,30,9,21,47,41,6,1
2021,Cheshire East 016C,E01018629,848,443,198,245,7,7,230,55,175,168,148,20,0
2021,Cheshire East 016D,E01018630,624,435,237,198,2,2,76,22,54,111,96,15,0
2021,Cheshire East 016E,E01018631,695,300,141,159,5,5,318,110,208,69,57,12,3
2021,Cheshire East 017D,E01018632,726,605,304,301,5,5,23,1,22,93,82,11,0
2021,Cheshire East 017E,E01018633,620,581,360,221,0,0,21,2,19,18,16,2,0
2021,Cheshire East 019A,E01018634,768,683,384,299,2,2,18,2,16,65,52,13,0
2021,Cheshire East 018F,E01018635,571,342,180,162,2,2,28,0,28,199,187,12,0
2021,Cheshire East 018G,E01018636,580,467,211,256,1,1,65,2,63,46,37,9,1
2021,Cheshire East 021A,E01018637,747,371,140,231,18,18,281,76,205,75,66,9,2
2021,Cheshire East 021B,E01018638,676,376,203,173,1,1,217,65,152,82,71,11,0
2021,Cheshire East 021C,E01018639,791,452,179,273,12,12,81,13,68,246,218,28,0
2021,Cheshire East 021D,E01018640,631,245,117,128,0,0,324,89,235,60,51,9,2
2021,Cheshire East 014A,E01018641,651,561,296,265,14,14,42,1,41,34,24,10,0
2021,Cheshire East 014B,E01018642,535,493,279,214,0,0,1,1,0,41,33,8,0
2021,Cheshire East 014C,E01018643,797,716,404,312,8,8,37,6,31,36,35,1,0
2021,Cheshire East 014D,E01018644,650,530,335,195,0,0,7,3,4,113,96,17,0
2021,Cheshire East 019B,E01018645,883,337,163,174,0,0,438,167,271,105,83,22,3
2021,Cheshire East 019C,E01018646,749,449,213,236,1,1,239,84,155,59,48,11,1
2021,Cheshire East 019D,E01018647,664,437,239,198,17,17,147,29,118,62,49,13,1
2021,Cheshire East 007C,E01018648,960,591,340,251,4,4,79,13,66,286,263,23,0
2021,Cheshire East 007D,E01018649,586,538,356,182,1,1,3,0,3,44,35,9,0
2021,Cheshire East 007E,E01018650,742,597,303,294,6,6,38,8,30,101,83,18,0
2021,Cheshire East 007F,E01018651,500,374,205,169,3,3,44,3,41,79,57,22,0
2021,Cheshire East 006D,E01018652,603,524,278,246,0,0,10,4,6,69,62,7,0
2021,Cheshire East 008D,E01018653,913,794,442,352,4,4,10,0,10,105,81,24,0
2021,Cheshire East 007G,E01018654,967,749,477,272,5,5,80,14,66,132,99,33,1
2021,Cheshire East 003A,E01018655,746,600,396,204,1,1,34,7,27,111,92,19,0
2021,Cheshire East 002A,E01018657,506,287,141,146,6,6,172,31,141,41,29,12,0
2021,Cheshire East 003C,E01018658,486,452,262,190,3,3,5,2,3,26,24,2,0
2021,Cheshire East 003D,E01018659,520,497,343,154,0,0,1,1,0,22,19,3,0
2021,Cheshire East 001D,E01018661,528,476,300,176,1,1,8,2,6,43,30,13,0
2021,Cheshire East 002B,E01018662,489,438,229,209,5,5,5,1,4,41,37,4,0
2021,Cheshire East 002C,E01018663,677,587,369,218,0,0,9,1,8,81,73,8,0
2021,Cheshire East 002D,E01018664,581,538,343,195,2,2,13,3,10,28,23,5,0
2021,Cheshire East 002E,E01018665,493,367,189,178,1,1,86,12,74,39,33,6,0
2021,Cheshire East 011A,E01018666,715,665,409,256,0,0,6,0,6,43,33,10,1
2021,Cheshire East 011B,E01018667,756,606,402,204,2,2,63,10,53,85,71,14,0
2021,Cheshire East 011C,E01018668,703,604,386,218,1,1,11,0,11,87,72,15,0
2021,Cheshire East 020C,E01018669,1109,929,562,367,10,10,56,11,45,114,90,24,0
2021,Cheshire East 020D,E01018670,1031,808,536,272,21,21,98,19,79,104,79,25,0
2021,Cheshire West and Chester 012A,E01018671,517,473,303,170,2,2,2,0,2,40,32,8,0
2021,Cheshire West and Chester 012B,E01018672,719,365,171,194,4,4,231,114,117,117,103,14,2
2021,Cheshire West and Chester 012C,E01018673,536,437,253,184,3,3,34,14,20,62,55,7,0
2021,Cheshire West and Chester 012D,E01018674,699,480,243,237,12,12,31,12,19,176,151,25,0
2021,Cheshire West and Chester 003A,E01018675,876,774,482,292,8,8,48,23,25,46,36,10,0
2021,Cheshire West and Chester 024A,E01018676,795,709,416,293,8,8,27,8,19,51,44,7,0
2021,Cheshire West and Chester 024B,E01018677,750,645,428,217,2,2,32,8,24,71,59,12,0
2021,Cheshire West and Chester 024C,E01018678,514,484,309,175,1,1,3,1,2,26,18,8,0
2021,Cheshire West and Chester 024D,E01018679,907,612,276,336,29,29,165,65,100,101,88,13,0
2021,Cheshire West and Chester 026A,E01018680,716,585,324,261,9,9,28,5,23,94,76,18,0
2021,Cheshire West and Chester 026B,E01018681,715,553,308,245,15,15,55,15,40,92,78,14,0
2021,Cheshire West and Chester 026C,E01018682,581,366,180,186,20,20,138,54,84,54,45,9,3
2021,Cheshire West and Chester 026D,E01018683,746,649,366,283,10,10,21,5,16,66,58,8,0
2021,Cheshire West and Chester 015A,E01018684,1010,906,577,329,6,6,28,9,19,70,59,11,0
2021,Cheshire West and Chester 002A,E01018685,629,231,112,119,15,15,324,112,212,56,42,14,3
2021,Cheshire West and Chester 002B,E01018686,631,459,188,271,19,19,34,15,19,119,110,9,0
2021,Cheshire West and Chester 002C,E01018687,577,544,363,181,2,2,14,6,8,17,13,4,0
2021,Cheshire West and Chester 002D,E01018688,712,560,347,213,1,1,7,6,1,143,129,14,1
2021,Cheshire West and Chester 002E,E01018689,670,538,346,192,14,14,38,15,23,80,67,13,0
2021,Cheshire West and Chester 002F,E01018690,893,805,494,311,1,1,11,3,8,76,62,14,0
2021,Cheshire West and Chester 023A,E01018691,725,561,318,243,4,4,58,27,31,102,86,16,0
2021,Cheshire West and Chester 024E,E01018692,815,725,420,305,7,7,11,3,8,72,48,24,0
2021,Cheshire West and Chester 023B,E01018693,863,747,429,318,22,22,23,4,19,71,61,10,0
2021,Cheshire West and Chester 023C,E01018694,921,759,426,333,43,43,38,7,31,81,70,11,0
2021,Cheshire West and Chester 015B,E01018695,943,646,311,335,74,74,66,6,60,157,142,15,0
2021,Cheshire West and Chester 015C,E01018696,666,567,362,205,13,13,13,0,13,73,57,16,0
2021,Cheshire West and Chester 015D,E01018697,779,623,335,288,0,0,76,28,48,79,68,11,1
2021,Cheshire West and Chester 015E,E01018698,843,737,496,241,6,6,43,12,31,57,41,16,0
2021,Cheshire West and Chester 021A,E01018699,659,474,243,231,30,30,89,48,41,64,52,12,2
2021,Cheshire West and Chester 023D,E01018700,751,636,280,356,1,1,9,3,6,104,95,9,1
2021,Cheshire West and Chester 021B,E01018701,627,297,154,143,0,0,254,122,132,75,67,8,1
2021,Cheshire West and Chester 023E,E01018702,581,470,179,291,42,42,40,3,37,28,24,4,1
2021,Cheshire West and Chester 023F,E01018703,968,684,377,307,42,42,48,10,38,193,181,12,1
2021,Cheshire West and Chester 017A,E01018704,626,459,286,173,10,10,121,41,80,36,30,6,0
2021,Cheshire West and Chester 017B,E01018705,620,537,310,227,4,4,16,6,10,63,45,18,0
2021,Cheshire West and Chester 017C,E01018706,731,512,227,285,25,25,108,46,62,86,78,8,0
2021,Cheshire West and Chester 045A,E01018707,770,614,416,198,4,4,64,24,40,86,76,10,2
2021,Cheshire West and Chester 003B,E01018708,941,805,524,281,4,4,41,11,30,91,76,15,0
2021,Cheshire West and Chester 020A,E01018709,673,363,188,175,4,4,50,20,30,255,239,16,1
2021,Cheshire West and Chester 020B,E01018710,592,321,158,163,5,5,198,69,129,66,61,5,2
2021,Cheshire West and Chester 020C,E01018711,720,501,260,241,1,1,40,4,36,178,168,10,0
2021,Cheshire West and Chester 020D,E01018712,741,434,222,212,10,10,118,47,71,178,165,13,1
2021,Cheshire West and Chester 018B,E01018714,1044,384,225,159,21,21,311,86,225,327,302,25,1
2021,Cheshire West and Chester 018C,E01018715,799,436,202,234,2,2,111,21,90,249,231,18,1
2021,Cheshire West and Chester 021C,E01018716,655,321,171,150,9,9,245,124,121,74,67,7,6
2021,Cheshire West and Chester 021D,E01018717,740,474,257,217,4,4,48,21,27,214,195,19,0
2021,Cheshire West and Chester 017D,E01018718,801,634,319,315,3,3,64,23,41,100,80,20,0
2021,Cheshire West and Chester 021E,E01018719,633,455,220,235,0,0,103,57,46,74,62,12,1
2021,Cheshire West and Chester 021F,E01018720,768,448,200,248,34,34,211,118,93,73,59,14,2
2021,Cheshire West and Chester 003C,E01018721,989,850,528,322,6,6,71,22,49,62,45,17,0
2021,Cheshire West and Chester 017E,E01018722,1114,924,607,317,4,4,62,22,40,124,96,28,0
2021,Cheshire West and Chester 045B,E01018723,646,488,261,227,20,20,59,24,35,79,69,10,0
2021,Cheshire West and Chester 045C,E01018724,799,657,438,219,21,21,25,5,20,96,84,12,0
2021,Cheshire West and Chester 045D,E01018725,586,431,259,172,3,3,48,22,26,104,83,21,0
2021,Cheshire West and Chester 019A,E01018726,624,411,224,187,0,0,156,83,73,57,47,10,0
2021,Cheshire West and Chester 019B,E01018727,794,669,430,239,6,6,13,0,13,106,93,13,0
2021,Cheshire West and Chester 019C,E01018728,634,460,244,216,4,4,105,49,56,65,56,9,0
2021,Cheshire West and Chester 019D,E01018729,750,393,190,203,5,5,251,129,122,98,84,14,3
2021,Cheshire West and Chester 040A,E01018730,651,405,210,195,1,1,190,89,101,53,44,9,2
2021,Cheshire West and Chester 042A,E01018731,847,568,244,324,3,3,66,27,39,197,174,23,13
2021,Cheshire West and Chester 038A,E01018732,555,403,186,217,3,3,20,8,12,129,116,13,0
2021,Cheshire West and Chester 035A,E01018733,632,529,337,192,3,3,25,10,15,75,62,13,0
2021,Cheshire West and Chester 035B,E01018734,511,325,181,144,1,1,118,51,67,66,55,11,1
2021,Cheshire West and Chester 042B,E01018735,551,416,219,197,10,10,16,1,15,107,99,8,2
2021,Cheshire West and Chester 037A,E01018736,738,460,212,248,7,7,102,25,77,167,145,22,2
2021,Cheshire West and Chester 037B,E01018737,862,672,244,428,32,32,61,27,34,97,83,14,0
2021,Cheshire West and Chester 040B,E01018738,681,110,65,45,38,38,498,201,297,31,26,5,4
2021,Cheshire West and Chester 040C,E01018739,823,289,94,195,35,35,349,187,162,149,138,11,1
2021,Cheshire West and Chester 042C,E01018740,613,229,129,100,3,3,322,46,276,59,47,12,0
2021,Cheshire West and Chester 040D,E01018741,519,427,262,165,2,2,36,2,34,54,40,14,0
2021,Cheshire West and Chester 042D,E01018742,967,802,383,419,28,28,58,5,53,78,67,11,1
2021,Cheshire West and Chester 037C,E01018743,606,496,295,201,3,3,26,12,14,81,71,10,0
2021,Cheshire West and Chester 037D,E01018744,678,422,185,237,9,9,171,87,84,75,64,11,1
2021,Cheshire West and Chester 038B,E01018745,717,265,127,138,2,2,321,195,126,124,116,8,5
2021,Cheshire West and Chester 038C,E01018746,853,437,242,195,9,9,277,99,178,120,102,18,10
2021,Cheshire West and Chester 038D,E01018747,739,432,224,208,7,7,120,36,84,179,164,15,1
2021,Cheshire West and Chester 035C,E01018748,509,136,70,66,2,2,275,144,131,96,94,2,0
2021,Cheshire West and Chester 035D,E01018749,973,660,215,445,5,5,136,54,82,172,157,15,0
2021,Cornwall 013A,E01018750,972,747,480,267,11,11,45,7,38,169,153,16,0
2021,Cornwall 013B,E01018751,746,361,232,129,8,8,154,102,52,220,202,18,3
2021,Cornwall 013C,E01018752,965,678,411,267,20,20,78,17,61,189,151,38,0
2021,Cornwall 010A,E01018753,775,663,445,218,14,14,17,4,13,81,60,21,0
2021,Cornwall 010B,E01018754,840,547,305,242,8,8,187,138,49,97,93,4,1
2021,Cornwall 010C,E01018755,682,566,384,182,1,1,14,10,4,101,80,21,0
2021,Cornwall 010D,E01018756,743,591,432,159,2,2,44,32,12,105,83,22,1
2021,Cornwall 023A,E01018757,996,778,514,264,8,8,39,29,10,171,137,34,0
2021,Cornwall 028A,E01018759,672,491,337,154,11,11,60,38,22,110,88,22,0
2021,Cornwall 028B,E01018760,578,408,280,128,13,13,52,34,18,105,73,32,0
2021,Cornwall 028C,E01018761,866,611,473,138,16,16,139,96,43,98,78,20,2
2021,Cornwall 037A,E01018762,550,404,285,119,10,10,32,4,28,103,84,19,1
2021,Cornwall 023B,E01018763,480,345,194,151,1,1,45,36,9,89,76,13,0
2021,Cornwall 022A,E01018764,643,537,340,197,1,1,22,17,5,83,70,13,0
2021,Cornwall 023C,E01018765,672,508,366,142,2,2,83,54,29,78,57,21,1
2021,Cornwall 028D,E01018766,786,519,395,124,7,7,136,105,31,123,92,31,1
2021,Cornwall 017A,E01018767,636,261,137,124,2,2,281,270,11,86,74,12,6
2021,Cornwall 016B,E01018768,848,525,268,257,15,15,96,7,89,211,181,30,1
2021,Cornwall 017B,E01018770,602,285,186,99,2,2,224,110,114,87,78,9,4
2021,Cornwall 017C,E01018771,751,308,200,108,1,1,78,51,27,362,340,22,2
2021,Cornwall 017D,E01018772,796,625,422,203,19,19,50,8,42,101,81,20,1
2021,Cornwall 037B,E01018773,764,494,369,125,3,3,124,100,24,142,112,30,1
2021,Cornwall 028E,E01018774,801,480,300,180,17,17,203,158,45,100,73,27,1
2021,Cornwall 012A,E01018777,889,714,488,226,4,4,73,57,16,98,69,29,0
2021,Cornwall 016D,E01018778,770,526,341,185,7,7,78,54,24,158,127,31,1
2021,Cornwall 013D,E01018779,1033,789,517,272,6,6,93,61,32,144,111,33,1
2021,Cornwall 034A,E01018780,1064,713,479,234,9,9,189,99,90,152,137,15,1
2021,Cornwall 034B,E01018781,805,567,430,137,6,6,74,62,12,158,120,38,0
2021,Cornwall 012B,E01018782,650,470,286,184,2,2,81,62,19,96,77,19,1
2021,Cornwall 012C,E01018783,674,557,370,187,1,1,38,28,10,78,56,22,0
2021,Cornwall 012D,E01018784,674,510,348,162,3,3,53,39,14,105,70,35,3
2021,Cornwall 023D,E01018785,830,589,371,218,3,3,79,63,16,157,131,26,2
2021,Cornwall 025A,E01018786,551,455,277,178,1,1,27,13,14,68,63,5,0
2021,Cornwall 022B,E01018787,642,510,278,232,14,14,23,4,19,95,84,11,0
2021,Cornwall 025B,E01018788,707,366,230,136,9,9,248,218,30,75,60,15,9
2021,Cornwall 026A,E01018789,616,480,298,182,2,2,20,13,7,114,103,11,0
2021,Cornwall 025C,E01018790,484,303,173,130,1,1,129,115,14,49,43,6,2
2021,Cornwall 026B,E01018791,537,326,190,136,1,1,150,139,11,57,44,13,3
2021,Cornwall 026C,E01018792,1191,924,487,437,22,22,68,13,55,177,161,16,0
2021,Cornwall 026D,E01018793,824,502,306,196,2,2,108,50,58,211,187,24,1
2021,Cornwall 025D,E01018794,642,446,255,191,10,10,105,42,63,77,73,4,4
2021,Cornwall 022C,E01018795,520,472,304,168,4,4,7,4,3,37,25,12,0
2021,Cornwall 022D,E01018796,497,390,201,189,2,2,7,1,6,98,88,10,0
2021,Cornwall 029A,E01018797,525,258,161,97,0,0,144,122,22,123,114,9,0
2021,Cornwall 029B,E01018798,711,544,314,230,1,1,59,55,4,106,89,17,1
2021,Cornwall 029C,E01018799,522,259,129,130,0,0,167,92,75,94,83,11,2
2021,Cornwall 029D,E01018800,659,456,278,178,4,4,18,4,14,181,118,63,0
2021,Cornwall 063A,E01018803,819,560,430,130,4,4,39,22,17,214,190,24,2
2021,Cornwall 063B,E01018804,750,295,180,115,2,2,31,3,28,422,389,33,0
2021,Cornwall 063C,E01018805,677,521,373,148,1,1,32,4,28,123,101,22,0
2021,Cornwall 063D,E01018806,653,340,188,152,7,7,47,10,37,258,241,17,1
2021,Cornwall 044A,E01018807,848,541,305,236,27,27,84,30,54,196,173,23,0
2021,Cornwall 044B,E01018808,677,450,269,181,2,2,75,13,62,150,138,12,0
2021,Cornwall 044D,E01018810,580,441,257,184,3,3,7,2,5,128,113,15,1
2021,Cornwall 064A,E01018811,687,564,318,246,2,2,12,2,10,109,89,20,0
2021,Cornwall 064B,E01018812,732,432,213,219,11,11,198,95,103,91,74,17,0
2021,Cornwall 064C,E01018813,707,553,332,221,11,11,27,4,23,116,100,16,0
2021,Cornwall 064D,E01018814,657,505,291,214,10,10,47,8,39,95,75,20,0
2021,Cornwall 032A,E01018815,1002,683,345,338,11,11,94,46,48,213,189,24,1
2021,Cornwall 047A,E01018816,714,645,456,189,3,3,16,11,5,50,35,15,0
2021,Cornwall 047B,E01018817,926,713,490,223,3,3,12,8,4,198,170,28,0
2021,Cornwall 047C,E01018818,820,638,451,187,20,20,99,54,45,61,49,12,2
2021,Cornwall 043A,E01018819,688,419,254,165,15,15,76,49,27,177,157,20,1
2021,Cornwall 047D,E01018820,791,545,308,237,1,1,67,53,14,178,150,28,0
2021,Cornwall 047E,E01018821,706,505,233,272,18,18,58,21,37,125,112,13,0
2021,Cornwall 043B,E01018822,577,452,272,180,6,6,14,4,10,105,91,14,0
2021,Cornwall 042A,E01018823,761,538,367,171,8,8,64,36,28,151,133,18,0
2021,Cornwall 042B,E01018824,1132,774,476,298,23,23,192,131,61,143,131,12,0
2021,Cornwall 040A,E01018825,718,504,308,196,9,9,63,2,61,142,119,23,0
2021,Cornwall 040B,E01018826,1094,744,440,304,19,19,106,42,64,223,183,40,2
2021,Cornwall 056A,E01018827,696,569,411,158,4,4,44,18,26,79,61,18,0
2021,Cornwall 056B,E01018828,697,491,368,123,5,5,87,76,11,114,98,16,0
2021,Cornwall 056C,E01018829,548,430,279,151,2,2,21,19,2,95,77,18,0
2021,Cornwall 056D,E01018830,740,568,393,175,7,7,98,78,20,67,46,21,0
2021,Cornwall 032B,E01018831,626,424,258,166,20,20,76,37,39,105,82,23,1
2021,Cornwall 032C,E01018832,566,456,281,175,10,10,27,5,22,73,54,19,0
2021,Cornwall 033A,E01018833,760,543,327,216,21,21,97,46,51,99,75,24,0
2021,Cornwall 060A,E01018834,805,541,314,227,5,5,82,38,44,177,163,14,0
2021,Cornwall 060B,E01018835,755,403,221,182,13,13,87,65,22,251,223,28,1
2021,Cornwall 060C,E01018836,810,301,144,157,4,4,226,154,72,276,248,28,3
2021,Cornwall 060D,E01018837,1117,658,364,294,16,16,123,62,61,319,273,46,1
2021,Cornwall 062A,E01018838,661,290,179,111,3,3,221,200,21,145,126,19,2
2021,Cornwall 062B,E01018839,575,308,229,79,4,4,23,7,16,240,215,25,0
2021,Cornwall 062C,E01018840,709,303,169,134,2,2,53,23,30,351,330,21,0
2021,Cornwall 062D,E01018841,644,243,151,92,2,2,301,239,62,98,81,17,0
2021,Cornwall 033B,E01018842,737,522,301,221,23,23,93,50,43,97,81,16,2
2021,Cornwall 033C,E01018843,559,471,304,167,3,3,7,4,3,78,55,23,0
2021,Cornwall 033D,E01018844,632,348,232,116,20,20,79,41,38,185,157,28,0
2021,Cornwall 048A,E01018845,779,519,329,190,1,1,102,51,51,157,129,28,0
2021,Cornwall 048B,E01018846,627,395,272,123,1,1,66,62,4,162,129,33,3
2021,Cornwall 032D,E01018847,723,511,285,226,22,22,65,21,44,124,107,17,1
2021,Cornwall 048C,E01018848,774,588,358,230,17,17,18,2,16,151,131,20,0
2021,Cornwall 048D,E01018849,886,578,436,142,14,14,149,77,72,144,107,37,1
2021,Cornwall 048E,E01018850,603,415,313,102,12,12,70,47,23,106,74,32,0
2021,Cornwall 040C,E01018851,619,374,242,132,2,2,125,97,28,114,92,22,4
2021,Cornwall 042C,E01018853,1195,740,434,306,6,6,207,123,84,242,211,31,0
2021,Cornwall 042D,E01018854,613,287,172,115,4,4,210,156,54,111,96,15,1
2021,Cornwall 043D,E01018856,651,346,213,133,2,2,167,144,23,134,121,13,2
2021,Cornwall 043E,E01018857,617,346,206,140,1,1,196,159,37,69,49,20,5
2021,Cornwall 043F,E01018858,657,481,331,150,2,2,77,70,7,94,70,24,3
2021,Cornwall 064E,E01018859,787,623,424,199,5,5,24,10,14,135,115,20,0
2021,Cornwall 062E,E01018860,838,332,186,146,2,2,402,362,40,99,81,18,3
2021,Cornwall 072A,E01018861,675,529,364,165,8,8,47,9,38,91,65,26,0
2021,Cornwall 072B,E01018862,661,574,427,147,3,3,30,5,25,54,37,17,0
2021,Cornwall 059A,E01018863,721,532,312,220,13,13,59,8,51,117,90,27,0
2021,Cornwall 059B,E01018864,743,607,387,220,10,10,28,7,21,98,82,16,0
2021,Cornwall 052A,E01018865,1011,629,358,271,55,55,108,36,72,219,195,24,0
2021,Cornwall 052B,E01018866,955,655,411,244,38,38,88,17,71,174,155,19,0
2021,Cornwall 052D,E01018868,888,479,285,194,3,3,31,8,23,375,341,34,0
2021,Cornwall 055A,E01018869,746,514,318,196,14,14,104,16,88,113,95,18,1
2021,Cornwall 055B,E01018870,538,144,70,74,7,7,290,86,204,96,88,8,1
2021,Cornwall 055C,E01018871,726,555,360,195,2,2,13,6,7,156,137,19,0
2021,Cornwall 055D,E01018872,551,429,274,155,1,1,30,16,14,91,76,15,0
2021,Cornwall 055E,E01018873,515,352,201,151,5,5,94,42,52,63,53,10,1
2021,Cornwall 053A,E01018874,579,440,283,157,2,2,82,30,52,52,41,11,3
2021,Cornwall 053B,E01018875,651,230,153,77,1,1,318,92,226,99,84,15,3
2021,Cornwall 053C,E01018876,630,479,300,179,4,4,40,12,28,107,94,13,0
2021,Cornwall 053D,E01018877,684,519,355,164,0,0,63,15,48,101,73,28,1
2021,Cornwall 053E,E01018878,809,355,220,135,16,16,111,29,82,327,295,32,0
2021,Cornwall 066A,E01018879,875,678,510,168,12,12,58,12,46,127,92,35,0
2021,Cornwall 066B,E01018880,984,719,502,217,6,6,96,29,67,163,139,24,0
2021,Cornwall 073A,E01018881,957,662,470,192,15,15,112,16,96,168,135,33,0
2021,Cornwall 071A,E01018882,624,514,312,202,2,2,7,2,5,101,87,14,0
2021,Cornwall 071B,E01018883,705,582,327,255,7,7,17,5,12,99,82,17,0
2021,Cornwall 071C,E01018884,698,561,315,246,3,3,10,3,7,124,112,12,0
2021,Cornwall 071D,E01018885,690,431,236,195,3,3,71,15,56,185,171,14,0
2021,Cornwall 071E,E01018886,677,369,199,170,1,1,42,15,27,265,85,180,0
2021,Cornwall 071F,E01018887,793,333,189,144,33,33,166,36,130,261,179,82,0
2021,Cornwall 071G,E01018888,1026,539,285,254,9,9,309,65,244,168,132,36,1
2021,Cornwall 045A,E01018889,543,478,273,205,2,2,2,0,2,61,53,8,0
2021,Cornwall 045B,E01018890,714,531,341,190,7,7,95,34,61,81,67,14,0
2021,Cornwall 045C,E01018891,612,443,275,168,4,4,10,6,4,155,139,16,0
2021,Cornwall 045D,E01018892,686,485,260,225,10,10,28,5,23,163,131,32,0
2021,Cornwall 045E,E01018893,620,354,225,129,3,3,182,47,135,79,66,13,2
2021,Cornwall 051A,E01018894,843,623,332,291,12,12,83,8,75,125,101,24,0
2021,Cornwall 051B,E01018895,798,586,321,265,3,3,57,9,48,152,134,18,0
2021,Cornwall 051C,E01018896,665,502,342,160,0,0,53,5,48,109,92,17,1
2021,Cornwall 051D,E01018897,993,533,262,271,46,46,182,36,146,230,211,19,2
2021,Cornwall 051E,E01018898,564,216,110,106,1,1,264,44,220,83,76,7,0
2021,Cornwall 066C,E01018899,714,507,300,207,5,5,87,19,68,115,91,24,0
2021,Cornwall 066D,E01018900,852,695,382,313,17,17,51,7,44,89,71,18,0
2021,Cornwall 066E,E01018901,685,555,386,169,12,12,30,11,19,88,79,9,0
2021,Cornwall 073B,E01018902,508,345,241,104,4,4,58,10,48,101,84,17,0
2021,Cornwall 073C,E01018903,481,362,257,105,3,3,30,4,26,86,62,24,0
2021,Cornwall 073D,E01018904,960,688,501,187,12,12,130,31,99,130,99,31,0
2021,Cornwall 072C,E01018905,639,466,317,149,13,13,71,11,60,89,70,19,0
2021,Cornwall 072D,E01018906,529,397,265,132,5,5,20,4,16,107,91,16,0
2021,Cornwall 072E,E01018907,625,346,235,111,9,9,186,46,140,83,74,9,1
2021,Cornwall 046A,E01018908,820,569,371,198,16,16,106,22,84,129,103,26,0
2021,Cornwall 046B,E01018909,773,567,304,263,2,2,25,8,17,179,147,32,0
2021,Cornwall 046C,E01018910,912,280,117,163,4,4,507,158,349,117,103,14,4
2021,Cornwall 046D,E01018911,916,430,233,197,11,11,233,34,199,241,220,21,1
2021,Cornwall 049A,E01018912,835,671,369,302,3,3,36,3,33,125,107,18,0
2021,Cornwall 049B,E01018913,876,467,227,240,3,3,77,13,64,329,301,28,0
2021,Cornwall 049C,E01018914,948,638,378,260,10,10,95,16,79,205,170,35,0
2021,Cornwall 049D,E01018915,982,706,395,311,8,8,23,7,16,245,210,35,0
2021,Cornwall 050A,E01018916,598,395,233,162,9,9,109,20,89,85,67,18,0
2021,Cornwall 050B,E01018917,636,544,355,189,1,1,2,2,0,89,76,13,0
2021,Cornwall 050C,E01018918,862,552,371,181,8,8,127,15,112,175,153,22,0
2021,Cornwall 050D,E01018919,659,520,318,202,12,12,39,7,32,88,70,18,0
2021,Cornwall 073E,E01018920,902,620,466,154,3,3,122,18,104,157,119,38,0
2021,Cornwall 059C,E01018921,934,685,404,281,13,13,90,20,70,146,125,21,0
2021,Cornwall 059D,E01018922,1014,844,503,341,5,5,21,3,18,144,104,40,0
2021,Cornwall 011A,E01018923,606,441,302,139,8,8,64,35,29,93,72,21,0
2021,Cornwall 007A,E01018924,525,345,225,120,10,10,36,13,23,134,96,38,0
2021,Cornwall 006A,E01018925,965,735,492,243,2,2,53,38,15,175,140,35,0
2021,Cornwall 011B,E01018926,1118,851,623,228,10,10,89,53,36,164,116,48,4
2021,Cornwall 015A,E01018927,733,408,236,172,2,2,175,118,57,147,125,22,1
2021,Cornwall 015B,E01018928,803,335,174,161,1,1,216,182,34,246,232,14,5
2021,Cornwall 015C,E01018929,787,523,277,246,5,5,120,63,57,138,122,16,1
2021,Cornwall 015D,E01018930,681,192,92,100,3,3,388,270,118,94,86,8,4
2021,Cornwall 015E,E01018931,498,395,233,162,1,1,41,30,11,58,43,15,3
2021,Cornwall 014A,E01018932,725,388,233,155,1,1,196,89,107,139,123,16,1
2021,Cornwall 014B,E01018933,821,311,185,126,19,19,168,103,65,320,300,20,3
2021,Cornwall 014C,E01018934,1076,821,451,370,4,4,62,9,53,189,168,21,0
2021,Cornwall 014D,E01018935,1123,687,372,315,27,27,152,54,98,257,235,22,0
2021,Cornwall 001A,E01018936,801,445,326,119,7,7,79,15,64,270,252,18,0
2021,Cornwall 001B,E01018937,873,429,271,158,18,18,273,112,161,150,138,12,3
2021,Cornwall 001C,E01018938,828,542,408,134,15,15,158,42,116,112,95,17,1
2021,Cornwall 003A,E01018940,720,576,407,169,4,4,44,29,15,96,73,23,0
2021,Cornwall 003B,E01018941,730,488,314,174,4,4,109,47,62,129,106,23,0
2021,Cornwall 003C,E01018942,710,501,367,134,0,0,29,26,3,180,154,26,0
2021,Cornwall 002A,E01018943,968,716,465,251,1,1,83,41,42,167,129,38,1
2021,Cornwall 011C,E01018944,467,325,217,108,1,1,70,49,21,71,59,12,0
2021,Cornwall 011D,E01018945,560,456,324,132,4,4,17,11,6,83,56,27,0
2021,Cornwall 005A,E01018946,694,444,292,152,2,2,127,42,85,121,110,11,0
2021,Cornwall 005C,E01018948,768,452,287,165,1,1,98,71,27,216,184,32,1
2021,Cornwall 005D,E01018949,526,232,117,115,2,2,202,154,48,87,77,10,3
2021,Cornwall 005E,E01018950,886,417,285,132,0,0,119,61,58,350,330,20,0
2021,Cornwall 002B,E01018951,1023,763,552,211,9,9,106,45,61,143,111,32,2
2021,Cornwall 006B,E01018952,550,430,291,139,1,1,20,12,8,99,76,23,0
2021,Cornwall 004B,E01018953,547,392,275,117,2,2,29,15,14,123,109,14,1
2021,Cornwall 008A,E01018954,586,371,180,191,2,2,33,26,7,180,133,47,0
2021,Cornwall 008B,E01018955,702,462,332,130,9,9,93,61,32,136,109,27,2
2021,Cornwall 008C,E01018956,458,316,219,97,1,1,43,31,12,98,70,28,0
2021,Cornwall 008D,E01018957,617,379,253,126,40,40,114,53,61,84,56,28,0
2021,Cornwall 008E,E01018958,503,248,184,64,7,7,190,135,55,56,40,16,2
2021,Cornwall 001D,E01018959,663,579,451,128,4,4,6,2,4,73,67,6,1
2021,Cornwall 001E,E01018960,1016,646,382,264,32,32,124,69,55,214,199,15,0
2021,Cornwall 001F,E01018961,664,432,306,126,1,1,38,28,10,193,178,15,0
2021,Cornwall 007B,E01018962,880,601,423,178,5,5,127,77,50,143,106,37,4
2021,Cornwall 006C,E01018965,1038,800,555,245,15,15,57,25,32,163,132,31,3
2021,Cornwall 006D,E01018966,478,396,279,117,3,3,19,7,12,60,49,11,0
2021,Cornwall 006E,E01018967,549,442,302,140,0,0,33,21,12,74,60,14,0
2021,Cornwall 004C,E01018968,1052,832,582,250,4,4,39,26,13,177,131,46,0
2021,Cornwall 003D,E01018969,1028,799,590,209,1,1,60,28,32,168,122,46,0
2021,Cornwall 009A,E01018970,695,532,328,204,5,5,50,12,38,108,97,11,0
2021,Cornwall 009B,E01018971,883,642,449,193,10,10,103,31,72,127,106,21,1
2021,Cornwall 009C,E01018972,887,429,288,141,10,10,220,150,70,227,197,30,1
2021,Cornwall 009D,E01018973,686,459,303,156,12,12,94,81,13,121,104,17,0
2021,Cornwall 002C,E01018974,1093,784,558,226,13,13,95,59,36,201,153,48,0
2021,Cornwall 061A,E01018975,901,665,436,229,25,25,99,15,84,111,90,21,1
2021,Cornwall 067A,E01018976,1004,768,540,228,6,6,27,8,19,203,178,25,0
2021,Cornwall 067B,E01018977,603,280,177,103,0,0,214,36,178,109,86,23,0
2021,Cornwall 057A,E01018978,675,407,261,146,32,32,143,25,118,93,70,23,0
2021,Cornwall 061B,E01018979,615,425,260,165,2,2,71,8,63,117,90,27,0
2021,Cornwall 061C,E01018980,646,438,292,146,36,36,58,5,53,114,82,32,0
2021,Cornwall 057B,E01018981,941,712,488,224,10,10,54,17,37,165,137,28,0
2021,Cornwall 057C,E01018982,928,600,381,219,6,6,93,23,70,229,189,40,0
2021,Cornwall 057D,E01018983,686,576,401,175,4,4,6,4,2,100,84,16,0
2021,Cornwall 058A,E01018985,1046,815,548,267,20,20,67,11,56,144,113,31,0
2021,Cornwall 058B,E01018986,717,525,371,154,6,6,35,10,25,151,122,29,0
2021,Cornwall 058C,E01018987,921,755,521,234,5,5,11,2,9,150,124,26,0
2021,Cornwall 065A,E01018988,726,533,345,188,4,4,44,5,39,145,109,36,0
2021,Cornwall 065B,E01018989,748,459,302,157,13,13,121,21,100,155,126,29,0
2021,Cornwall 061D,E01018990,901,530,400,130,15,15,181,36,145,174,141,33,1
2021,Cornwall 065C,E01018991,722,497,365,132,2,2,72,21,51,151,119,32,0
2021,Cornwall 069A,E01018992,832,649,472,177,2,2,40,2,38,141,113,28,0
2021,Cornwall 069B,E01018993,746,465,323,142,2,2,135,21,114,144,113,31,0
2021,Cornwall 067C,E01018994,952,553,385,168,22,22,262,119,143,115,94,21,0
2021,Cornwall 068A,E01018995,1091,417,306,111,3,3,415,88,327,253,230,23,3
2021,Cornwall 067D,E01018996,754,424,289,135,10,10,101,22,79,219,202,17,0
2021,Cornwall 067E,E01018997,600,152,76,76,2,2,392,56,336,54,45,9,0
2021,Cornwall 068B,E01018998,676,400,247,153,0,0,11,3,8,265,231,34,0
2021,Cornwall 068C,E01018999,949,403,273,130,13,13,210,28,182,323,290,33,0
2021,Cornwall 070A,E01019000,715,485,349,136,3,3,101,15,86,126,111,15,0
2021,Cornwall 068D,E01019001,897,456,322,134,3,3,102,14,88,336,303,33,0
2021,Cornwall 070B,E01019002,623,461,347,114,3,3,36,5,31,121,91,30,2
2021,Cornwall 070C,E01019003,785,634,436,198,0,0,11,4,7,139,114,25,1
2021,Cornwall 070D,E01019004,725,345,235,110,3,3,185,33,152,190,160,30,2
2021,Cornwall 069C,E01019005,946,591,415,176,10,10,160,30,130,184,142,42,1
2021,Cornwall 065D,E01019006,693,529,387,142,1,1,14,1,13,149,123,26,0
2021,Cornwall 061E,E01019007,1005,701,450,251,14,14,115,18,97,175,135,40,0
2021,Cornwall 054A,E01019008,621,274,183,91,0,0,266,36,230,81,62,19,0
2021,Cornwall 054B,E01019009,646,323,197,126,17,17,219,31,188,85,61,24,2
2021,Cornwall 054C,E01019010,534,394,253,141,16,16,46,7,39,78,61,17,0
2021,Cornwall 054D,E01019011,698,530,392,138,20,20,68,14,54,80,67,13,0
2021,Cornwall 054E,E01019012,740,402,298,104,3,3,102,20,82,233,189,44,0
2021,Cornwall 036A,E01019013,947,644,426,218,2,2,175,25,150,125,104,21,1
2021,Cornwall 036B,E01019014,647,525,316,209,2,2,45,7,38,75,63,12,0
2021,Cornwall 036C,E01019015,588,460,283,177,4,4,13,7,6,111,90,21,0
2021,Cornwall 036D,E01019016,721,518,256,262,20,20,55,20,35,128,119,9,0
2021,Cornwall 021A,E01019018,668,582,382,200,5,5,9,4,5,72,62,10,0
2021,Cornwall 021B,E01019019,837,514,314,200,6,6,68,13,55,249,221,28,0
2021,Cornwall 021C,E01019020,774,317,151,166,1,1,102,10,92,354,308,46,0
2021,Cornwall 021D,E01019021,709,539,306,233,9,9,20,1,19,141,122,19,0
2021,Cornwall 021E,E01019022,822,489,270,219,5,5,194,39,155,133,122,11,1
2021,Cornwall 021F,E01019023,654,375,182,193,15,15,65,14,51,199,161,38,0
2021,Cornwall 035A,E01019024,638,451,288,163,4,4,47,14,33,136,124,12,0
2021,Cornwall 035B,E01019025,685,523,358,165,2,2,29,5,24,131,109,22,0
2021,Cornwall 035C,E01019026,670,552,395,157,1,1,5,3,2,112,100,12,0
2021,Cornwall 035D,E01019027,608,421,300,121,7,7,68,11,57,111,88,23,1
2021,Cornwall 020A,E01019028,1053,477,240,237,10,10,189,31,158,376,346,30,1
2021,Cornwall 020B,E01019029,773,333,176,157,5,5,75,14,61,360,319,41,0
2021,Cornwall 020C,E01019030,924,659,366,293,17,17,48,8,40,199,172,27,1
2021,Cornwall 020D,E01019031,806,488,299,189,17,17,92,8,84,208,189,19,1
2021,Cornwall 038A,E01019032,633,509,329,180,2,2,22,6,16,100,87,13,0
2021,Cornwall 039A,E01019033,787,277,188,89,19,19,266,58,208,224,202,22,1
2021,Cornwall 038B,E01019034,686,399,220,179,1,1,55,9,46,231,214,17,0
2021,Cornwall 027A,E01019035,833,635,404,231,4,4,32,11,21,162,147,15,0
2021,Cornwall 027B,E01019036,786,612,436,176,7,7,27,8,19,140,103,37,0
2021,Cornwall 027C,E01019037,664,442,286,156,10,10,98,20,78,114,96,18,0
2021,Cornwall 041A,E01019038,539,388,284,104,0,0,25,5,20,126,101,25,0
2021,Cornwall 041B,E01019039,602,454,341,113,4,4,24,2,22,120,86,34,0
2021,Cornwall 041C,E01019040,584,399,295,104,14,14,52,9,43,119,102,17,0
2021,Cornwall 039B,E01019041,831,318,194,124,14,14,237,50,187,262,234,28,0
2021,Cornwall 039C,E01019042,779,418,238,180,7,7,122,23,99,232,203,29,0
2021,Cornwall 039D,E01019043,851,627,366,261,2,2,86,16,70,136,111,25,0
2021,Cornwall 039E,E01019044,721,563,411,152,6,6,22,6,16,130,111,19,0
2021,Cornwall 038C,E01019045,1127,775,380,395,33,33,93,18,75,225,200,25,1
2021,Cornwall 039F,E01019046,609,266,133,133,7,7,225,86,139,110,76,34,1
2021,Cornwall 038D,E01019047,683,360,199,161,10,10,158,50,108,154,128,26,1
2021,Cornwall 018A,E01019048,850,633,412,221,7,7,5,1,4,205,175,30,0
2021,Cornwall 018C,E01019050,756,577,349,228,25,25,30,2,28,124,93,31,0
2021,Cornwall 018D,E01019051,729,404,220,184,1,1,206,39,167,117,93,24,1
2021,Cornwall 024A,E01019052,820,518,270,248,10,10,132,25,107,160,127,33,0
2021,Cornwall 024B,E01019053,1014,652,396,256,18,18,74,8,66,269,230,39,1
2021,Cornwall 024C,E01019054,801,593,349,244,16,16,37,3,34,154,122,32,1
2021,Cornwall 024D,E01019055,613,307,168,139,7,7,187,63,124,112,95,17,0
2021,Cornwall 031A,E01019056,545,245,146,99,0,0,227,59,168,73,58,15,0
2021,Cornwall 031B,E01019057,818,562,338,224,6,6,14,4,10,236,212,24,0
2021,Cornwall 031C,E01019058,933,714,382,332,6,6,34,4,30,179,159,20,0
2021,Cornwall 031D,E01019059,671,459,281,178,4,4,109,19,90,98,86,12,1
2021,Cornwall 019A,E01019060,579,431,294,137,1,1,33,5,28,114,75,39,0
2021,Cornwall 019B,E01019061,787,539,320,219,18,18,68,7,61,161,148,13,1
2021,Cornwall 019C,E01019062,764,400,248,152,11,11,197,41,156,156,136,20,0
2021,Cornwall 019D,E01019063,900,611,345,266,11,11,41,10,31,237,210,27,0
2021,Cornwall 019E,E01019064,907,632,403,229,19,19,54,16,38,202,156,46,0
2021,Cornwall 019F,E01019065,533,384,221,163,1,1,55,21,34,93,80,13,0
2021,Cornwall 041D,E01019066,597,441,279,162,8,8,32,12,20,116,87,29,0
2021,Cornwall 041E,E01019067,607,430,284,146,7,7,31,14,17,139,114,25,0
2021,Cornwall 041F,E01019068,750,665,500,165,2,2,19,6,13,64,40,24,0
2021,Cornwall 030A,E01019069,540,375,181,194,18,18,49,11,38,98,83,15,0
2021,Cornwall 030B,E01019070,901,612,376,236,24,24,95,24,71,170,145,25,0
2021,Cornwall 030C,E01019071,725,517,320,197,19,19,63,10,53,126,105,21,0
2021,Cornwall 030D,E01019072,628,394,254,140,0,0,140,51,89,94,80,14,0
2021,Cornwall 030E,E01019073,671,501,323,178,21,21,57,9,48,92,66,26,0
2021,Cornwall 027D,E01019074,804,478,254,224,4,4,120,33,87,201,175,26,1
2021,Cornwall 027E,E01019075,750,561,321,240,2,2,49,4,45,138,111,27,0
2021,Cornwall 027F,E01019076,888,504,284,220,2,2,132,17,115,250,229,21,0
2021,Isles of Scilly 001A,E01019077,939,418,320,98,14,14,162,103,59,344,224,120,1
2021,Allerdale 007A,E01019078,647,584,405,179,3,3,19,2,17,41,37,4,0
2021,Allerdale 007B,E01019079,655,507,354,153,8,8,92,17,75,48,39,9,0
2021,Allerdale 007C,E01019080,907,516,289,227,6,6,242,25,217,143,122,21,0
2021,Allerdale 003A,E01019081,829,451,268,183,1,1,277,33,244,99,74,25,1
2021,Allerdale 003B,E01019082,678,485,304,181,4,4,58,2,56,131,102,29,0
2021,Allerdale 002A,E01019083,802,588,425,163,16,16,69,7,62,129,76,53,0
2021,Allerdale 006A,E01019084,718,491,279,212,6,6,160,18,142,61,49,12,0
2021,Allerdale 006B,E01019085,827,668,366,302,12,12,91,15,76,56,44,12,0
2021,Allerdale 006C,E01019086,457,384,254,130,1,1,26,3,23,46,41,5,0
2021,Allerdale 007D,E01019087,705,588,409,179,15,15,28,1,27,74,56,18,0
2021,Allerdale 006D,E01019088,1050,556,345,211,12,12,214,14,200,268,237,31,0
2021,Allerdale 011A,E01019089,744,473,272,201,0,0,223,30,193,48,34,14,0
2021,Allerdale 007E,E01019090,648,519,383,136,3,3,17,0,17,109,75,34,0
2021,Allerdale 006E,E01019091,778,661,440,221,2,2,16,1,15,99,82,17,0
2021,Allerdale 012A,E01019092,620,474,356,118,8,8,42,4,38,96,52,44,0
2021,Allerdale 004A,E01019093,664,536,332,204,2,2,71,11,60,55,44,11,0
2021,Allerdale 004B,E01019094,925,696,365,331,1,1,160,24,136,68,52,16,0
2021,Allerdale 005A,E01019095,642,255,154,101,3,3,293,50,243,91,79,12,0
2021,Allerdale 004C,E01019096,978,758,494,264,4,4,128,16,112,88,61,27,0
2021,Allerdale 005B,E01019097,770,238,137,101,2,2,482,68,414,48,33,15,0
2021,Allerdale 005C,E01019098,713,462,275,187,1,1,160,19,141,90,73,17,0
2021,Allerdale 005D,E01019099,785,480,283,197,1,1,218,29,189,86,72,14,0
2021,Allerdale 011B,E01019100,908,738,360,378,0,0,48,2,46,122,92,30,0
2021,Allerdale 011C,E01019101,623,595,387,208,0,0,5,1,4,23,13,10,0
2021,Allerdale 003C,E01019102,723,531,367,164,4,4,65,7,58,123,93,30,0
2021,Allerdale 012C,E01019104,722,338,257,81,21,21,287,25,262,76,55,21,0
2021,Allerdale 012E,E01019106,630,517,392,125,7,7,48,7,41,58,39,19,0
2021,Allerdale 002B,E01019107,698,604,422,182,1,1,16,5,11,77,53,24,0
2021,Allerdale 010A,E01019108,653,262,139,123,1,1,369,25,344,21,15,6,0
2021,Allerdale 010B,E01019109,737,463,273,190,6,6,221,43,178,47,39,8,0
2021,Allerdale 010C,E01019110,827,320,195,125,10,10,443,82,361,53,42,11,1
2021,Allerdale 009A,E01019111,823,456,201,255,3,3,298,48,250,66,54,12,0
2021,Allerdale 009B,E01019112,732,312,181,131,1,1,373,46,327,46,35,11,0
2021,Allerdale 009C,E01019113,810,217,112,105,1,1,536,89,447,55,46,9,1
2021,Allerdale 004D,E01019114,642,482,299,183,0,0,47,6,41,113,96,17,0
2021,Allerdale 004E,E01019115,792,417,257,160,4,4,199,24,175,171,153,18,1
2021,Allerdale 008A,E01019116,609,339,190,149,0,0,91,5,86,176,161,15,3
2021,Allerdale 010D,E01019117,641,563,314,249,1,1,13,2,11,64,48,16,0
2021,Allerdale 008B,E01019118,646,436,241,195,0,0,13,2,11,197,171,26,0
2021,Allerdale 010E,E01019119,643,570,401,169,26,26,14,0,14,33,26,7,0
2021,Allerdale 009D,E01019120,780,572,315,257,0,0,39,4,35,168,134,34,1
2021,Allerdale 009E,E01019121,1039,485,294,191,1,1,284,29,255,269,247,22,0
2021,Allerdale 008C,E01019122,671,280,165,115,6,6,301,44,257,84,68,16,0
2021,Allerdale 008D,E01019123,761,468,231,237,6,6,253,35,218,34,25,9,0
2021,Allerdale 008E,E01019124,845,788,464,324,0,0,21,3,18,36,22,14,0
2021,Allerdale 008F,E01019125,680,576,353,223,1,1,41,1,40,62,50,12,0
2021,Allerdale 001A,E01019126,758,440,276,164,4,4,180,27,153,134,105,29,0
2021,Allerdale 001B,E01019127,722,646,496,150,2,2,13,1,12,61,45,16,0
2021,Allerdale 003D,E01019128,693,556,360,196,1,1,66,7,59,70,47,23,0
2021,Allerdale 011D,E01019129,900,797,458,339,0,0,41,3,38,62,48,14,0
2021,Allerdale 002C,E01019130,760,630,410,220,5,5,57,9,48,67,50,17,1
2021,Allerdale 002D,E01019131,806,635,462,173,2,2,23,3,20,146,95,51,0
2021,Allerdale 001C,E01019132,761,643,437,206,3,3,44,4,40,71,48,23,0
2021,Allerdale 003E,E01019133,683,557,382,175,4,4,42,1,41,80,61,19,0
2021,Allerdale 001D,E01019134,657,501,349,152,1,1,103,16,87,52,32,20,0
2021,Allerdale 001E,E01019135,707,394,226,168,1,1,248,33,215,64,50,14,0
2021,Allerdale 001F,E01019136,862,663,349,314,9,9,73,10,63,117,105,12,0
2021,Allerdale 001G,E01019137,563,269,161,108,1,1,132,19,113,161,139,22,0
2021,Barrow-in-Furness 010A,E01019138,596,422,265,157,0,0,32,26,6,142,127,15,0
2021,Barrow-in-Furness 010B,E01019139,627,171,95,76,0,0,67,19,48,389,371,18,0
2021,Barrow-in-Furness 008A,E01019141,723,230,130,100,3,3,203,74,129,287,270,17,0
2021,Barrow-in-Furness 008B,E01019142,665,360,206,154,0,0,53,6,47,251,235,16,1
2021,Barrow-in-Furness 008C,E01019143,658,281,156,125,1,1,125,12,113,251,232,19,0
2021,Barrow-in-Furness 001A,E01019144,608,523,317,206,1,1,31,26,5,51,43,8,2
2021,Barrow-in-Furness 001B,E01019145,885,772,425,347,1,1,3,2,1,109,90,19,0
2021,Barrow-in-Furness 001C,E01019146,583,495,272,223,1,1,27,3,24,60,50,10,0
2021,Barrow-in-Furness 001D,E01019147,708,534,258,276,1,1,9,2,7,164,158,6,0
2021,Barrow-in-Furness 002A,E01019148,605,563,345,218,0,0,8,4,4,34,30,4,0
2021,Barrow-in-Furness 002B,E01019149,681,533,268,265,1,1,12,5,7,135,114,21,0
2021,Barrow-in-Furness 002C,E01019150,751,479,247,232,1,1,101,71,30,170,149,21,0
2021,Barrow-in-Furness 002D,E01019151,611,490,280,210,0,0,75,72,3,46,34,12,0
2021,Barrow-in-Furness 003A,E01019152,526,404,233,171,0,0,29,15,14,93,40,53,0
2021,Barrow-in-Furness 003B,E01019153,462,433,284,149,1,1,6,5,1,22,20,2,0
2021,Barrow-in-Furness 003C,E01019154,622,583,412,171,0,0,5,4,1,34,24,10,0
2021,Barrow-in-Furness 003D,E01019155,669,615,458,157,2,2,11,7,4,41,30,11,0
2021,Barrow-in-Furness 004A,E01019156,769,251,125,126,1,1,355,234,121,157,137,20,5
2021,Barrow-in-Furness 008D,E01019157,704,324,190,134,4,4,105,50,55,271,257,14,0
2021,Barrow-in-Furness 008E,E01019158,551,273,150,123,1,1,74,12,62,202,190,12,1
2021,Barrow-in-Furness 004B,E01019159,565,410,191,219,2,2,13,5,8,140,128,12,0
2021,Barrow-in-Furness 007B,E01019160,611,357,151,206,0,0,210,194,16,40,31,9,4
2021,Barrow-in-Furness 006A,E01019161,818,641,266,375,4,4,112,97,15,60,50,10,1
2021,Barrow-in-Furness 003E,E01019162,679,630,329,301,4,4,5,5,0,40,29,11,0
2021,Barrow-in-Furness 003F,E01019163,498,476,284,192,0,0,3,2,1,18,17,1,1
2021,Barrow-in-Furness 004C,E01019164,617,215,109,106,2,2,357,330,27,43,41,2,0
2021,Barrow-in-Furness 004D,E01019165,685,407,244,163,2,2,180,128,52,96,78,18,0
2021,Barrow-in-Furness 004E,E01019166,639,386,200,186,3,3,138,124,14,107,87,20,5
2021,Barrow-in-Furness 005A,E01019167,714,543,272,271,0,0,17,11,6,154,133,21,0
2021,Barrow-in-Furness 005B,E01019168,595,481,271,210,1,1,57,24,33,55,47,8,1
2021,Barrow-in-Furness 005C,E01019169,542,475,232,243,1,1,5,2,3,61,52,9,0
2021,Barrow-in-Furness 005D,E01019170,504,422,183,239,0,0,6,5,1,75,57,18,1
2021,Barrow-in-Furness 005E,E01019171,577,389,169,220,3,3,10,5,5,175,160,15,0
2021,Barrow-in-Furness 007C,E01019172,617,440,215,225,0,0,21,5,16,155,138,17,1
2021,Barrow-in-Furness 007D,E01019173,564,392,199,193,0,0,33,29,4,139,120,19,0
2021,Barrow-in-Furness 007F,E01019175,604,442,198,244,0,0,102,93,9,58,47,11,2
2021,Barrow-in-Furness 006B,E01019176,742,696,390,306,1,1,3,2,1,41,31,10,1
2021,Barrow-in-Furness 006C,E01019177,608,401,204,197,0,0,176,165,11,30,24,6,1
2021,Barrow-in-Furness 006D,E01019178,694,630,348,282,1,1,5,4,1,58,41,17,0
2021,Barrow-in-Furness 006E,E01019179,525,476,280,196,1,1,4,3,1,44,35,9,0
2021,Barrow-in-Furness 009A,E01019180,816,728,491,237,2,2,16,3,13,70,57,13,0
2021,Barrow-in-Furness 009C,E01019182,633,511,251,260,1,1,24,2,22,97,86,11,0
2021,Barrow-in-Furness 009E,E01019184,653,491,248,243,2,2,40,35,5,119,106,13,1
2021,Barrow-in-Furness 010C,E01019185,615,558,322,236,0,0,13,11,2,44,31,13,0
2021,Barrow-in-Furness 010D,E01019186,602,468,252,216,3,3,12,4,8,119,104,15,0
2021,Barrow-in-Furness 010E,E01019187,566,431,219,212,0,0,79,78,1,56,50,6,0
2021,Carlisle 003A,E01019188,698,462,282,180,13,13,115,25,90,108,91,17,0
2021,Carlisle 003B,E01019189,656,418,205,213,10,10,65,14,51,163,137,26,0
2021,Carlisle 003C,E01019190,778,696,445,251,19,19,3,0,3,60,54,6,0
2021,Carlisle 003D,E01019191,687,549,366,183,1,1,47,7,40,90,76,14,0
2021,Carlisle 005A,E01019192,603,551,356,195,2,2,11,1,10,39,31,8,0
2021,Carlisle 009A,E01019193,874,378,154,224,1,1,411,101,310,84,73,11,0
2021,Carlisle 009B,E01019194,891,542,245,297,2,2,235,37,198,112,97,15,0
2021,Carlisle 005B,E01019195,570,485,291,194,7,7,29,1,28,49,39,10,0
2021,Carlisle 004A,E01019196,839,587,324,263,3,3,91,20,71,158,138,20,0
2021,Carlisle 011A,E01019197,882,301,156,145,0,0,486,129,357,94,84,10,1
2021,Carlisle 011B,E01019198,615,349,163,186,1,1,151,36,115,113,102,11,1
2021,Carlisle 011C,E01019199,489,243,127,116,0,0,177,53,124,69,54,15,0
2021,Carlisle 002A,E01019200,763,539,369,170,4,4,97,14,83,123,99,24,0
2021,Carlisle 002B,E01019201,708,372,255,117,2,2,218,25,193,115,97,18,1
2021,Carlisle 002C,E01019202,720,427,243,184,1,1,162,21,141,128,105,23,2
2021,Carlisle 005C,E01019203,925,777,480,297,10,10,46,2,44,92,54,38,0
2021,Carlisle 006A,E01019204,601,219,118,101,3,3,55,7,48,324,293,31,0
2021,Carlisle 008A,E01019205,874,363,202,161,1,1,206,43,163,304,279,25,0
2021,Carlisle 006B,E01019206,919,297,163,134,3,3,77,5,72,542,520,22,0
2021,Carlisle 008B,E01019207,685,332,159,173,0,0,122,37,85,228,211,17,3
2021,Carlisle 012A,E01019208,609,377,184,193,0,0,165,45,120,67,55,12,0
2021,Carlisle 010A,E01019209,668,424,201,223,0,0,113,17,96,131,126,5,0
2021,Carlisle 012B,E01019210,558,332,183,149,2,2,166,46,120,58,49,9,0
2021,Carlisle 010B,E01019211,789,490,246,244,1,1,29,4,25,269,234,35,0
2021,Carlisle 013A,E01019212,740,576,392,184,2,2,16,1,15,146,116,30,0
2021,Carlisle 008C,E01019215,761,403,223,180,1,1,184,27,157,172,155,17,1
2021,Carlisle 010C,E01019216,851,389,188,201,3,3,138,13,125,321,288,33,0
2021,Carlisle 010D,E01019217,872,482,249,233,6,6,69,5,64,315,289,26,0
2021,Carlisle 008D,E01019218,632,379,185,194,0,0,129,32,97,124,108,16,0
2021,Carlisle 007A,E01019219,986,766,495,271,8,8,48,9,39,164,135,29,0
2021,Carlisle 010E,E01019220,692,467,232,235,1,1,45,9,36,179,166,13,0
2021,Carlisle 011D,E01019221,815,499,235,264,2,2,161,43,118,152,132,20,1
2021,Carlisle 011E,E01019222,785,449,203,246,0,0,220,40,180,114,97,17,2
2021,Carlisle 013D,E01019223,616,546,370,176,4,4,25,8,17,41,29,12,0
2021,Carlisle 007B,E01019224,885,746,505,241,1,1,49,8,41,88,72,16,1
2021,Carlisle 002D,E01019225,845,672,437,235,8,8,32,3,29,133,97,36,0
2021,Carlisle 001A,E01019226,489,388,254,134,3,3,8,1,7,90,75,15,0
2021,Carlisle 001B,E01019227,676,360,222,138,0,0,189,34,155,127,103,24,0
2021,Carlisle 001C,E01019228,714,512,311,201,7,7,14,0,14,181,133,48,0
2021,Carlisle 001D,E01019229,831,674,447,227,5,5,13,2,11,139,103,36,0
2021,Carlisle 009C,E01019230,798,448,245,203,1,1,250,50,200,98,84,14,1
2021,Carlisle 009D,E01019231,923,373,195,178,24,24,373,69,304,151,134,17,2
2021,Carlisle 009E,E01019232,635,469,269,200,2,2,83,17,66,81,70,11,0
2021,Carlisle 008E,E01019233,642,486,315,171,1,1,92,24,68,63,44,19,0
2021,Carlisle 006C,E01019234,806,255,151,104,1,1,268,41,227,282,264,18,0
2021,Carlisle 006D,E01019235,673,469,257,212,38,38,18,2,16,148,136,12,0
2021,Carlisle 010F,E01019236,798,342,154,188,12,12,57,4,53,387,352,35,0
2021,Carlisle 006E,E01019237,558,399,226,173,1,1,26,0,26,132,121,11,0
2021,Carlisle 004B,E01019238,675,580,334,246,1,1,23,2,21,71,61,10,0
2021,Carlisle 007C,E01019239,613,515,308,207,4,4,11,2,9,83,60,23,0
2021,Carlisle 004C,E01019240,897,762,369,393,2,2,31,3,28,102,89,13,0
2021,Carlisle 004D,E01019241,794,671,393,278,21,21,66,7,59,36,31,5,0
2021,Carlisle 006F,E01019242,603,405,242,163,28,28,61,5,56,108,95,13,1
2021,Carlisle 004E,E01019243,616,485,310,175,65,65,11,1,10,55,49,6,0
2021,Carlisle 003E,E01019244,670,623,408,215,0,0,6,1,5,41,37,4,0
2021,Carlisle 011F,E01019245,647,258,115,143,3,3,303,70,233,81,70,11,2
2021,Carlisle 012C,E01019246,593,319,169,150,24,24,189,41,148,58,43,15,3
2021,Carlisle 012D,E01019247,631,470,281,189,0,0,91,14,77,69,55,14,1
2021,Carlisle 012E,E01019248,515,223,111,112,3,3,225,50,175,64,59,5,0
2021,Carlisle 007D,E01019249,742,660,466,194,3,3,16,1,15,63,55,8,0
2021,Carlisle 007E,E01019250,719,622,365,257,2,2,33,0,33,62,47,15,0
2021,Carlisle 004F,E01019251,930,749,401,348,8,8,51,9,42,122,98,24,0
2021,Carlisle 009F,E01019252,651,447,269,178,4,4,126,15,111,74,58,16,0
2021,Carlisle 013E,E01019253,780,670,401,269,2,2,27,7,20,80,60,20,1
2021,Carlisle 005D,E01019254,596,520,327,193,2,2,46,11,35,28,22,6,0
2021,Carlisle 005E,E01019255,548,507,290,217,0,0,10,0,10,31,24,7,0
2021,Copeland 004A,E01019256,657,547,348,199,1,1,40,13,27,69,55,14,0
2021,Copeland 007A,E01019257,637,492,326,166,2,2,99,31,68,44,34,10,0
2021,Copeland 007B,E01019258,654,570,338,232,2,2,28,7,21,54,34,20,0
2021,Copeland 008A,E01019259,575,400,288,112,1,1,76,14,62,98,72,26,0
2021,Copeland 002A,E01019260,618,468,231,237,1,1,98,39,59,49,37,12,2
2021,Copeland 003A,E01019261,716,681,426,255,1,1,12,1,11,22,15,7,0
2021,Copeland 003B,E01019262,703,618,335,283,1,1,43,17,26,41,31,10,0
2021,Copeland 004C,E01019264,781,620,313,307,1,1,92,19,73,68,48,20,0
2021,Copeland 004D,E01019265,625,390,216,174,0,0,133,22,111,102,92,10,0
2021,Copeland 004E,E01019266,646,456,280,176,3,3,59,14,45,128,109,19,0
2021,Copeland 004F,E01019267,591,257,161,96,0,0,276,68,208,57,49,8,1
2021,Copeland 001B,E01019269,678,323,197,126,1,1,301,75,226,52,38,14,1
2021,Copeland 001C,E01019270,582,379,225,154,0,0,138,45,93,65,44,21,0
2021,Copeland 006A,E01019271,572,359,219,140,1,1,160,56,104,52,44,8,0
2021,Copeland 006B,E01019272,585,345,214,131,0,0,165,64,101,74,59,15,1
2021,Copeland 006C,E01019273,682,563,325,238,2,2,37,7,30,80,69,11,0
2021,Copeland 006D,E01019274,768,459,274,185,4,4,195,62,133,109,91,18,1
2021,Copeland 006E,E01019275,916,696,417,279,4,4,156,37,119,59,45,14,1
2021,Copeland 004H,E01019277,561,295,172,123,0,0,201,70,131,63,57,6,2
2021,Copeland 004I,E01019278,614,500,299,201,1,1,41,11,30,72,56,16,0
2021,Copeland 007C,E01019279,632,511,387,124,2,2,35,8,27,84,58,26,0
2021,Copeland 002B,E01019280,1033,329,231,98,21,21,395,95,300,286,254,32,2
2021,Copeland 002C,E01019281,571,383,234,149,25,25,90,16,74,73,59,14,0
2021,Copeland 002D,E01019282,493,391,202,189,0,0,58,14,44,44,38,6,0
2021,Copeland 008B,E01019283,570,457,305,152,3,3,57,5,52,53,43,10,0
2021,Copeland 003C,E01019284,571,340,170,170,1,1,189,49,140,41,33,8,0
2021,Copeland 003D,E01019285,604,405,209,196,0,0,125,58,67,74,63,11,0
2021,Copeland 003E,E01019286,637,479,279,200,1,1,86,27,59,70,55,15,1
2021,Copeland 003F,E01019287,498,459,280,179,1,1,13,4,9,25,17,8,0
2021,Copeland 003G,E01019288,539,508,267,241,0,0,13,6,7,18,15,3,0
2021,Copeland 008C,E01019289,573,396,235,161,3,3,131,32,99,42,36,6,1
2021,Copeland 008D,E01019290,464,353,205,148,1,1,42,15,27,68,51,17,0
2021,Copeland 005A,E01019291,664,432,209,223,2,2,148,40,108,80,67,13,2
2021,Copeland 005B,E01019292,501,438,284,154,0,0,13,4,9,50,40,10,0
2021,Copeland 008E,E01019293,558,476,334,142,3,3,25,3,22,54,32,22,0
2021,Copeland 005C,E01019294,606,418,240,178,0,0,143,66,77,45,30,15,0
2021,Copeland 005D,E01019295,597,265,140,125,0,0,285,144,141,45,38,7,2
2021,Copeland 005E,E01019296,602,393,215,178,0,0,177,61,116,32,22,10,0
2021,Copeland 008F,E01019298,682,523,353,170,1,1,80,26,54,77,65,12,1
2021,Copeland 008G,E01019299,921,531,328,203,1,1,167,38,129,219,191,28,3
2021,Copeland 007D,E01019300,751,605,366,239,4,4,33,5,28,109,89,20,0
2021,Copeland 005F,E01019301,723,251,130,121,1,1,400,166,234,68,61,7,3
2021,Copeland 005G,E01019302,660,535,187,348,0,0,60,26,34,64,52,12,1
2021,Copeland 007E,E01019303,683,611,349,262,0,0,10,4,6,61,47,14,1
2021,Copeland 007F,E01019304,536,438,318,120,3,3,31,1,30,64,46,18,0
2021,Eden 001A,E01019305,958,679,477,202,2,2,111,15,96,166,138,28,0
2021,Eden 006A,E01019306,670,394,297,97,5,5,100,4,96,171,139,32,0
2021,Eden 006B,E01019307,904,652,410,242,37,37,63,4,59,152,127,25,0
2021,Eden 005A,E01019308,594,334,229,105,1,1,101,18,83,158,114,44,0
2021,Eden 007A,E01019309,1032,773,545,228,8,8,47,13,34,204,158,46,0
2021,Eden 006C,E01019310,654,492,349,143,3,3,29,1,28,130,108,22,0
2021,Eden 005B,E01019311,635,499,344,155,7,7,29,5,24,100,64,36,0
2021,Eden 004A,E01019312,749,591,383,208,3,3,39,8,31,116,93,23,0
2021,Eden 005C,E01019313,652,491,368,123,1,1,51,9,42,109,79,30,0
2021,Eden 001B,E01019314,587,492,342,150,4,4,23,3,20,68,45,23,0
2021,Eden 002A,E01019315,797,615,407,208,4,4,34,4,30,144,120,24,0
2021,Eden 002B,E01019316,559,415,260,155,1,1,20,4,16,123,94,29,0
2021,Eden 007B,E01019317,594,481,356,125,5,5,13,2,11,95,75,20,0
2021,Eden 007C,E01019318,628,328,231,97,6,6,133,19,114,161,138,23,0
2021,Eden 006D,E01019319,684,468,286,182,4,4,77,10,67,135,105,30,0
2021,Eden 001C,E01019320,600,483,338,145,2,2,28,4,24,87,69,18,0
2021,Eden 001D,E01019321,676,483,326,157,12,12,63,12,51,118,83,35,0
2021,Eden 002C,E01019322,702,495,314,181,13,13,78,14,64,116,91,25,0
2021,Eden 006E,E01019323,544,422,289,133,4,4,12,3,9,106,72,34,0
2021,Eden 006F,E01019324,553,439,316,123,4,4,14,1,13,96,81,15,0
2021,Eden 007D,E01019325,632,479,314,165,6,6,46,7,39,101,79,22,0
2021,Eden 004B,E01019326,964,779,465,314,21,21,56,7,49,108,85,23,0
2021,Eden 003A,E01019327,850,452,298,154,23,23,233,45,188,142,134,8,0
2021,Eden 004C,E01019328,607,486,319,167,9,9,63,16,47,49,35,14,0
2021,Eden 004D,E01019329,494,413,296,117,0,0,5,0,5,76,52,24,0
2021,Eden 004E,E01019330,695,478,313,165,2,2,59,16,43,156,134,22,0
2021,Eden 004F,E01019331,800,588,374,214,3,3,102,25,77,107,89,18,0
2021,Eden 003B,E01019332,657,319,208,111,3,3,241,38,203,94,82,12,0
2021,Eden 003C,E01019333,678,283,171,112,15,15,221,29,192,159,136,23,0
2021,Eden 004G,E01019334,608,454,300,154,21,21,61,16,45,72,56,16,0
2021,Eden 003D,E01019335,641,355,178,177,8,8,136,17,119,142,123,19,0
2021,Eden 003E,E01019336,846,430,241,189,17,17,128,15,113,271,237,34,0
2021,Eden 006G,E01019337,617,462,319,143,1,1,60,6,54,94,72,22,0
2021,Eden 002D,E01019338,611,484,348,136,1,1,12,3,9,114,89,25,0
2021,Eden 005D,E01019339,575,418,306,112,4,4,42,9,33,111,53,58,0
2021,Eden 007E,E01019340,572,452,344,108,3,3,15,1,14,102,76,26,0
2021,South Lakeland 011C,E01019343,657,553,407,146,4,4,16,12,4,84,62,22,0
2021,South Lakeland 008A,E01019344,451,353,244,109,0,0,27,8,19,71,53,18,0
2021,South Lakeland 008B,E01019345,557,452,293,159,3,3,23,14,9,79,59,20,0
2021,South Lakeland 003A,E01019346,848,573,393,180,6,6,138,40,98,131,106,25,0
2021,South Lakeland 011D,E01019347,773,630,365,265,4,4,33,10,23,106,88,18,0
2021,South Lakeland 010A,E01019348,525,455,290,165,2,2,4,4,0,64,57,7,0
2021,South Lakeland 013A,E01019349,834,675,458,217,3,3,56,19,37,100,80,20,0
2021,South Lakeland 008C,E01019350,729,477,370,107,6,6,122,28,94,124,95,29,0
2021,South Lakeland 008D,E01019351,774,612,390,222,2,2,28,8,20,132,108,24,0
2021,South Lakeland 010B,E01019352,930,738,449,289,1,1,26,12,14,165,124,41,0
2021,South Lakeland 013B,E01019353,753,577,407,170,2,2,85,33,52,88,66,22,1
2021,South Lakeland 013C,E01019354,733,492,391,101,11,11,71,24,47,159,132,27,0
2021,South Lakeland 013D,E01019355,728,645,516,129,1,1,25,8,17,57,42,15,0
2021,South Lakeland 007A,E01019356,663,396,284,112,0,0,98,20,78,169,126,43,0
2021,South Lakeland 013E,E01019357,819,603,388,215,11,11,35,15,20,170,134,36,0
2021,South Lakeland 005A,E01019358,793,617,399,218,6,6,58,41,17,111,100,11,1
2021,South Lakeland 003B,E01019359,1136,663,334,329,4,4,326,144,182,142,120,22,1
2021,South Lakeland 004A,E01019360,1104,597,388,209,5,5,136,34,102,366,342,24,0
2021,South Lakeland 006A,E01019361,805,659,400,259,0,0,73,9,64,73,57,16,0
2021,South Lakeland 005B,E01019362,890,781,519,262,4,4,14,9,5,91,75,16,0
2021,South Lakeland 004B,E01019363,988,541,360,181,4,4,182,94,88,259,233,26,2
2021,South Lakeland 004C,E01019364,910,446,225,221,2,2,286,178,108,170,142,28,6
2021,South Lakeland 003C,E01019365,979,736,453,283,6,6,28,8,20,209,184,25,0
2021,South Lakeland 005C,E01019366,773,590,375,215,2,2,103,45,58,78,60,18,0
2021,South Lakeland 006C,E01019368,909,770,420,350,4,4,25,9,16,110,86,24,0
2021,South Lakeland 006D,E01019369,905,755,521,234,3,3,73,39,34,74,59,15,0
2021,South Lakeland 003D,E01019370,1111,809,503,306,5,5,70,45,25,226,197,29,1
2021,South Lakeland 004D,E01019371,943,560,293,267,3,3,273,102,171,106,92,14,1
2021,South Lakeland 009A,E01019372,578,339,256,83,2,2,95,47,48,142,119,23,0
2021,South Lakeland 009B,E01019373,588,438,300,138,18,18,24,9,15,108,87,21,0
2021,South Lakeland 001A,E01019374,653,298,208,90,4,4,196,70,126,155,127,28,0
2021,South Lakeland 001B,E01019375,669,422,340,82,3,3,105,27,78,139,91,48,0
2021,South Lakeland 001C,E01019376,537,244,188,56,2,2,156,21,135,135,88,47,0
2021,South Lakeland 010C,E01019377,851,704,482,222,1,1,38,10,28,108,87,21,0
2021,South Lakeland 014A,E01019378,680,590,331,259,0,0,39,24,15,50,39,11,1
2021,South Lakeland 014B,E01019379,647,544,343,201,2,2,34,24,10,67,50,17,0
2021,South Lakeland 014C,E01019380,503,444,267,177,7,7,6,4,2,46,37,9,0
2021,South Lakeland 007B,E01019381,962,752,519,233,4,4,34,13,21,172,143,29,0
2021,South Lakeland 011E,E01019382,948,641,362,279,5,5,172,108,64,130,109,21,0
2021,South Lakeland 010D,E01019383,982,837,596,241,6,6,32,13,19,107,89,18,0
2021,South Lakeland 009C,E01019384,1009,801,606,195,5,5,28,4,24,175,134,41,0
2021,South Lakeland 009D,E01019385,536,312,222,90,2,2,116,62,54,106,78,28,0
2021,South Lakeland 007C,E01019386,802,565,379,186,3,3,44,16,28,190,153,37,0
2021,South Lakeland 002A,E01019387,1005,714,522,192,14,14,89,28,61,186,147,39,2
2021,South Lakeland 012A,E01019388,839,572,329,243,0,0,152,111,41,115,95,20,0
2021,South Lakeland 012B,E01019389,1043,683,329,354,8,8,197,150,47,153,122,31,2
2021,South Lakeland 012C,E01019390,976,708,416,292,11,11,79,39,40,178,151,27,0
2021,South Lakeland 014D,E01019391,811,656,422,234,1,1,68,26,42,86,71,15,0
2021,South Lakeland 012D,E01019392,1013,581,335,246,0,0,140,70,70,289,255,34,3
2021,South Lakeland 014E,E01019393,946,823,569,254,3,3,22,5,17,98,80,18,0
2021,South Lakeland 005D,E01019394,941,794,521,273,3,3,13,6,7,131,86,45,0
2021,South Lakeland 001D,E01019395,888,502,384,118,3,3,133,26,107,250,211,39,0
2021,South Lakeland 002B,E01019396,879,588,406,182,2,2,97,24,73,192,167,25,0
2021,South Lakeland 002C,E01019397,832,479,340,139,9,9,84,27,57,260,211,49,0
2021,Amber Valley 001A,E01019400,763,409,227,182,17,17,162,54,108,175,159,16,0
2021,Amber Valley 001B,E01019401,832,397,204,193,2,2,288,80,208,145,138,7,0
2021,Amber Valley 001C,E01019402,804,608,290,318,0,0,118,36,82,78,62,16,0
2021,Amber Valley 003A,E01019403,649,309,179,130,1,1,240,100,140,96,86,10,3
2021,Amber Valley 001D,E01019404,929,637,354,283,6,6,133,32,101,152,129,23,1
2021,Amber Valley 007A,E01019405,659,563,410,153,1,1,5,0,5,90,71,19,0
2021,Amber Valley 002A,E01019406,484,372,265,107,5,5,51,18,33,56,41,15,0
2021,Amber Valley 010A,E01019407,1044,645,372,273,8,8,76,16,60,315,287,28,0
2021,Amber Valley 009A,E01019408,737,576,281,295,2,2,68,16,52,90,80,10,1
2021,Amber Valley 009B,E01019409,749,624,439,185,11,11,49,2,47,64,53,11,1
2021,Amber Valley 011A,E01019410,632,524,301,223,2,2,11,5,6,95,90,5,0
2021,Amber Valley 011B,E01019411,642,463,262,201,6,6,89,24,65,84,70,14,0
2021,Amber Valley 009C,E01019412,697,572,286,286,9,9,54,11,43,62,51,11,0
2021,Amber Valley 009D,E01019413,546,436,202,234,1,1,10,4,6,99,92,7,0
2021,Amber Valley 007B,E01019414,711,631,427,204,2,2,22,11,11,56,48,8,0
2021,Amber Valley 010B,E01019415,793,575,331,244,4,4,72,16,56,142,128,14,0
2021,Amber Valley 009E,E01019416,647,556,360,196,3,3,10,4,6,75,61,14,3
2021,Amber Valley 010C,E01019417,927,536,310,226,2,2,236,90,146,152,136,16,1
2021,Amber Valley 011C,E01019418,733,563,281,282,3,3,75,32,43,91,81,10,1
2021,Amber Valley 010D,E01019419,904,728,423,305,4,4,23,6,17,149,131,18,0
2021,Amber Valley 005A,E01019420,622,417,223,194,2,2,68,20,48,135,122,13,0
2021,Amber Valley 008A,E01019421,914,681,396,285,4,4,132,36,96,96,80,16,1
2021,Amber Valley 008B,E01019422,648,561,355,206,2,2,15,6,9,70,58,12,0
2021,Amber Valley 002B,E01019423,687,542,330,212,11,11,42,10,32,92,75,17,0
2021,Amber Valley 002C,E01019424,517,352,245,107,1,1,122,35,87,41,35,6,1
2021,Amber Valley 016A,E01019425,650,575,368,207,0,0,31,13,18,44,39,5,0
2021,Amber Valley 016B,E01019426,702,516,336,180,10,10,70,20,50,105,80,25,1
2021,Amber Valley 016C,E01019427,738,593,326,267,3,3,37,10,27,104,95,9,1
2021,Amber Valley 007C,E01019428,636,475,311,164,2,2,90,39,51,69,57,12,0
2021,Amber Valley 006A,E01019429,712,613,378,235,0,0,8,1,7,91,69,22,0
2021,Amber Valley 007D,E01019430,817,718,426,292,2,2,23,8,15,74,51,23,0
2021,Amber Valley 012A,E01019431,610,450,222,228,0,0,69,31,38,91,78,13,0
2021,Amber Valley 008C,E01019432,852,648,388,260,3,3,135,51,84,63,49,14,3
2021,Amber Valley 012B,E01019433,813,635,328,307,1,1,27,11,16,150,131,19,0
2021,Amber Valley 013A,E01019434,558,411,243,168,2,2,47,21,26,98,86,12,0
2021,Amber Valley 013B,E01019435,715,510,210,300,1,1,78,23,55,126,121,5,0
2021,Amber Valley 013C,E01019436,589,443,257,186,4,4,26,12,14,116,98,18,0
2021,Amber Valley 017A,E01019437,610,371,204,167,2,2,179,76,103,56,43,13,2
2021,Amber Valley 012C,E01019438,685,465,246,219,4,4,51,20,31,163,146,17,2
2021,Amber Valley 013D,E01019439,653,565,268,297,0,0,12,2,10,76,64,12,0
2021,Amber Valley 013E,E01019440,758,462,273,189,3,3,118,27,91,173,159,14,2
2021,Amber Valley 017B,E01019441,778,328,164,164,4,4,215,86,129,228,216,12,3
2021,Amber Valley 005B,E01019442,658,493,307,186,0,0,54,27,27,111,99,12,0
2021,Amber Valley 004A,E01019443,804,603,362,241,7,7,84,31,53,110,98,12,0
2021,Amber Valley 003B,E01019444,640,199,100,99,1,1,371,91,280,69,60,9,0
2021,Amber Valley 005C,E01019445,700,470,230,240,11,11,52,16,36,167,158,9,0
2021,Amber Valley 015A,E01019446,504,451,275,176,0,0,25,6,19,27,22,5,1
2021,Amber Valley 011D,E01019447,653,535,344,191,2,2,46,16,30,69,59,10,1
2021,Amber Valley 015B,E01019448,857,682,329,353,15,15,93,26,67,66,59,7,1
2021,Amber Valley 011E,E01019449,790,637,334,303,1,1,36,11,25,116,97,19,0
2021,Amber Valley 015C,E01019450,670,385,193,192,4,4,210,47,163,71,58,13,0
2021,Amber Valley 012D,E01019451,922,687,316,371,4,4,82,24,58,149,133,16,0
2021,Amber Valley 017C,E01019452,721,333,181,152,2,2,334,126,208,51,44,7,1
2021,Amber Valley 017D,E01019453,952,433,218,215,2,2,170,65,105,347,327,20,0
2021,Amber Valley 006B,E01019454,614,491,360,131,6,6,93,42,51,22,17,5,2
2021,Amber Valley 005D,E01019455,659,441,263,178,7,7,44,9,35,166,143,23,1
2021,Amber Valley 005E,E01019456,840,572,280,292,16,16,83,28,55,169,156,13,0
2021,Amber Valley 005F,E01019457,618,522,284,238,6,6,30,10,20,60,50,10,0
2021,Amber Valley 008D,E01019458,942,554,273,281,14,14,110,29,81,264,245,19,0
2021,Amber Valley 008E,E01019459,596,332,191,141,1,1,192,69,123,66,51,15,5
2021,Amber Valley 006C,E01019460,660,521,278,243,0,0,51,13,38,88,78,10,0
2021,Amber Valley 006D,E01019461,653,475,293,182,2,2,99,34,65,76,65,11,1
2021,Amber Valley 006E,E01019462,532,483,345,138,3,3,12,2,10,34,25,9,0
2021,Amber Valley 008F,E01019463,631,286,157,129,4,4,261,93,168,78,69,9,2
2021,Amber Valley 012E,E01019464,1034,893,439,454,9,9,53,11,42,79,70,9,0
2021,Amber Valley 015D,E01019465,533,374,231,143,2,2,115,35,80,40,33,7,2
2021,Amber Valley 015E,E01019467,680,570,337,233,3,3,30,9,21,77,53,24,0
2021,Amber Valley 003C,E01019468,652,406,228,178,0,0,138,48,90,108,91,17,0
2021,Amber Valley 003D,E01019469,682,322,149,173,2,2,263,94,169,93,75,18,2
2021,Amber Valley 004B,E01019470,740,545,288,257,4,4,49,21,28,141,128,13,1
2021,Amber Valley 003E,E01019471,659,299,150,149,3,3,185,54,131,172,153,19,0
2021,Amber Valley 004C,E01019473,535,494,309,185,1,1,6,2,4,34,22,12,0
2021,Amber Valley 004D,E01019474,539,451,271,180,2,2,14,2,12,72,65,7,0
2021,Amber Valley 004E,E01019475,571,405,212,193,4,4,78,26,52,84,67,17,0
2021,Amber Valley 004F,E01019476,619,559,386,173,0,0,16,1,15,44,30,14,0
2021,Amber Valley 002D,E01019477,1050,845,546,299,1,1,104,37,67,100,83,17,0
2021,Bolsover 001A,E01019478,657,562,282,280,0,0,12,12,0,83,74,9,0
2021,Bolsover 001B,E01019479,689,524,291,233,1,1,94,81,13,70,58,12,0
2021,Bolsover 008A,E01019480,689,509,319,190,1,1,67,60,7,112,94,18,0
2021,Bolsover 009A,E01019481,511,326,151,175,1,1,145,142,3,39,32,7,0
2021,Bolsover 008B,E01019482,711,540,316,224,0,0,97,92,5,69,60,9,5
2021,Bolsover 004A,E01019483,847,498,259,239,2,2,158,136,22,189,179,10,0
2021,Bolsover 004B,E01019484,984,707,379,328,5,5,125,95,30,147,130,17,0
2021,Bolsover 004C,E01019485,597,353,198,155,5,5,140,102,38,99,91,8,0
2021,Bolsover 005A,E01019486,446,390,250,140,0,0,11,11,0,45,39,6,0
2021,Bolsover 005B,E01019487,786,443,197,246,9,9,259,204,55,73,58,15,2
2021,Bolsover 004D,E01019488,675,314,165,149,4,4,168,126,42,189,176,13,0
2021,Bolsover 005C,E01019489,573,476,308,168,2,2,59,39,20,36,30,6,0
2021,Bolsover 005D,E01019490,476,372,221,151,0,0,61,60,1,42,33,9,1
2021,Bolsover 001C,E01019491,1076,757,368,389,2,2,64,52,12,251,230,21,2
2021,Bolsover 002A,E01019492,787,498,261,237,1,1,191,181,10,97,87,10,0
2021,Bolsover 001D,E01019493,673,570,360,210,1,1,28,25,3,74,65,9,0
2021,Bolsover 002B,E01019495,709,466,258,208,4,4,177,163,14,62,47,15,0
2021,Bolsover 003A,E01019496,623,373,186,187,0,0,117,50,67,131,113,18,2
2021,Bolsover 003B,E01019497,794,432,213,219,1,1,169,155,14,186,169,17,6
2021,Bolsover 003C,E01019498,809,373,177,196,3,3,136,78,58,297,288,9,0
2021,Bolsover 010A,E01019499,618,399,215,184,0,0,97,53,44,122,112,10,0
2021,Bolsover 010B,E01019500,626,347,181,166,0,0,187,173,14,89,74,15,3
2021,Bolsover 010C,E01019501,661,500,307,193,1,1,56,50,6,104,85,19,0
2021,Bolsover 005E,E01019502,701,513,299,214,1,1,127,123,4,56,47,9,4
2021,Bolsover 007A,E01019503,1179,883,495,388,5,5,119,97,22,172,152,20,0
2021,Bolsover 005F,E01019504,620,423,257,166,6,6,59,48,11,132,122,10,0
2021,Bolsover 007B,E01019505,616,360,188,172,1,1,87,40,47,168,160,8,0
2021,Bolsover 007C,E01019506,617,409,204,205,1,1,113,96,17,92,74,18,2
2021,Bolsover 007D,E01019507,872,297,197,100,0,0,266,168,98,308,289,19,1
2021,Bolsover 006A,E01019508,842,453,254,199,2,2,254,248,6,131,116,15,2
2021,Bolsover 006B,E01019509,536,214,107,107,0,0,274,189,85,46,41,5,2
2021,Bolsover 006C,E01019510,578,262,158,104,17,17,249,208,41,50,38,12,0
2021,Bolsover 007E,E01019511,932,480,296,184,3,3,84,63,21,364,339,25,1
2021,Bolsover 010D,E01019513,706,540,259,281,3,3,59,15,44,103,92,11,1
2021,Bolsover 009B,E01019514,668,469,202,267,1,1,73,67,6,124,108,16,1
2021,Bolsover 009C,E01019515,696,396,180,216,1,1,204,192,12,89,79,10,6
2021,Bolsover 009D,E01019516,759,456,287,169,1,1,78,24,54,224,203,21,0
2021,Bolsover 010E,E01019517,712,589,285,304,0,0,14,12,2,108,88,20,1
2021,Bolsover 010F,E01019518,704,582,285,297,1,1,6,1,5,115,102,13,0
2021,Bolsover 009E,E01019519,786,506,266,240,8,8,103,55,48,168,141,27,1
2021,Bolsover 008C,E01019520,861,591,251,340,11,11,145,133,12,113,92,21,1
2021,Bolsover 008D,E01019521,778,587,295,292,0,0,88,84,4,101,83,18,2
2021,Bolsover 008E,E01019522,724,440,185,255,9,9,131,120,11,141,125,16,3
2021,Bolsover 003D,E01019523,525,248,149,99,1,1,181,176,5,93,82,11,2
2021,Bolsover 002C,E01019524,622,489,295,194,0,0,53,48,5,80,67,13,0
2021,Bolsover 002D,E01019525,663,463,264,199,2,2,118,94,24,78,65,13,2
2021,Chesterfield 001A,E01019526,625,421,244,177,1,1,75,49,26,128,119,9,0
2021,Chesterfield 003A,E01019527,654,276,161,115,0,0,288,282,6,87,74,13,3
2021,Chesterfield 001B,E01019528,706,577,372,205,1,1,76,76,0,50,41,9,2
2021,Chesterfield 003B,E01019529,686,450,235,215,0,0,88,50,38,146,133,13,2
2021,Chesterfield 003C,E01019530,730,405,220,185,0,0,134,29,105,188,167,21,3
2021,Chesterfield 003D,E01019531,674,419,186,233,4,4,78,52,26,172,151,21,1
2021,Chesterfield 005A,E01019532,541,387,215,172,0,0,73,69,4,81,73,8,0
2021,Chesterfield 005B,E01019533,625,557,311,246,0,0,13,6,7,55,46,9,0
2021,Chesterfield 005C,E01019534,622,483,346,137,0,0,98,81,17,40,33,7,1
2021,Chesterfield 005D,E01019535,670,559,363,196,0,0,40,29,11,70,56,14,1
2021,Chesterfield 005E,E01019536,857,454,193,261,2,2,284,243,41,115,100,15,2
2021,Chesterfield 007A,E01019537,698,595,360,235,8,8,55,41,14,40,36,4,0
2021,Chesterfield 010A,E01019538,977,534,289,245,4,4,45,14,31,394,367,27,0
2021,Chesterfield 009A,E01019539,722,572,379,193,1,1,37,6,31,112,98,14,0
2021,Chesterfield 009B,E01019540,644,535,311,224,2,2,7,4,3,100,87,13,0
2021,Chesterfield 004A,E01019541,678,404,231,173,0,0,217,198,19,54,42,12,3
2021,Chesterfield 004B,E01019542,862,301,173,128,2,2,373,360,13,185,171,14,1
2021,Chesterfield 004C,E01019543,912,439,208,231,8,8,388,360,28,77,61,16,0
2021,Chesterfield 004D,E01019544,721,432,265,167,0,0,202,196,6,84,77,7,3
2021,Chesterfield 012A,E01019545,623,478,304,174,3,3,54,26,28,88,79,9,0
2021,Chesterfield 012B,E01019546,653,489,305,184,1,1,62,59,3,100,89,11,1
2021,Chesterfield 012C,E01019547,647,274,133,141,6,6,252,133,119,115,106,9,0
2021,Chesterfield 012D,E01019548,975,762,422,340,4,4,33,21,12,176,161,15,0
2021,Chesterfield 006A,E01019549,553,322,179,143,0,0,171,155,16,58,54,4,2
2021,Chesterfield 006B,E01019550,672,460,249,211,2,2,156,96,60,54,47,7,0
2021,Chesterfield 006C,E01019551,696,615,432,183,2,2,37,23,14,42,32,10,0
2021,Chesterfield 006D,E01019552,514,360,165,195,0,0,92,88,4,62,52,10,0
2021,Chesterfield 003E,E01019553,808,638,270,368,3,3,19,8,11,148,129,19,0
2021,Chesterfield 010B,E01019554,731,355,184,171,0,0,44,29,15,332,303,29,0
2021,Chesterfield 009C,E01019555,733,362,193,169,1,1,230,223,7,137,111,26,3
2021,Chesterfield 010C,E01019556,726,245,102,143,1,1,235,170,65,244,218,26,1
2021,Chesterfield 008A,E01019557,667,450,250,200,8,8,154,106,48,54,49,5,1
2021,Chesterfield 008B,E01019558,572,528,337,191,3,3,4,1,3,37,32,5,0
2021,Chesterfield 008C,E01019559,486,432,285,147,2,2,23,2,21,28,20,8,1
2021,Chesterfield 008D,E01019560,621,389,220,169,0,0,186,181,5,43,35,8,3
2021,Chesterfield 008E,E01019561,723,190,107,83,9,9,469,429,40,54,42,12,1
2021,Chesterfield 008F,E01019562,622,303,171,132,22,22,244,239,5,50,42,8,3
2021,Chesterfield 002A,E01019563,653,314,133,181,0,0,236,221,15,102,93,9,1
2021,Chesterfield 002B,E01019564,712,594,351,243,3,3,22,21,1,93,83,10,0
2021,Chesterfield 002C,E01019565,615,311,178,133,0,0,243,237,6,60,53,7,1
2021,Chesterfield 002D,E01019566,784,294,159,135,2,2,342,333,9,146,135,11,0
2021,Chesterfield 006E,E01019567,789,401,224,177,7,7,262,168,94,117,104,13,2
2021,Chesterfield 002E,E01019568,562,200,87,113,0,0,318,314,4,40,37,3,4
2021,Chesterfield 007B,E01019569,852,419,240,179,0,0,135,124,11,297,269,28,1
2021,Chesterfield 007C,E01019570,597,435,273,162,3,3,104,101,3,55,49,6,0
2021,Chesterfield 004E,E01019571,645,303,144,159,0,0,245,220,25,96,77,19,1
2021,Chesterfield 001C,E01019572,645,246,140,106,1,1,315,268,47,81,74,7,2
2021,Chesterfield 001D,E01019573,701,450,243,207,3,3,93,57,36,153,141,12,2
2021,Chesterfield 001E,E01019574,626,404,254,150,1,1,133,120,13,85,70,15,3
2021,Chesterfield 013A,E01019575,696,242,111,131,1,1,365,334,31,86,78,8,2
2021,Chesterfield 013B,E01019576,770,403,260,143,0,0,301,265,36,59,42,17,7
2021,Chesterfield 013C,E01019577,746,484,315,169,0,0,175,171,4,87,81,6,0
2021,Chesterfield 013D,E01019578,798,144,84,60,1,1,603,545,58,48,44,4,2
2021,Chesterfield 010D,E01019579,859,347,153,194,2,2,161,94,67,348,327,21,1
2021,Chesterfield 007D,E01019580,757,429,200,229,0,0,237,228,9,87,79,8,4
2021,Chesterfield 007E,E01019581,651,308,134,174,2,2,231,185,46,104,90,14,6
2021,Chesterfield 012E,E01019582,675,501,280,221,3,3,69,65,4,99,88,11,3
2021,Chesterfield 012F,E01019583,629,524,308,216,5,5,12,9,3,87,77,10,1
2021,Chesterfield 012G,E01019585,1028,668,364,304,2,2,31,10,21,327,280,47,0
2021,Chesterfield 011A,E01019586,639,570,365,205,1,1,15,15,0,53,43,10,0
2021,Chesterfield 011B,E01019587,633,534,326,208,3,3,9,5,4,87,68,19,0
2021,Chesterfield 011C,E01019588,615,571,412,159,1,1,7,5,2,36,26,10,0
2021,Chesterfield 011D,E01019589,603,537,352,185,0,0,14,10,4,52,39,13,0
2021,Chesterfield 009D,E01019590,862,750,503,247,2,2,22,8,14,87,68,19,1
2021,Chesterfield 009E,E01019591,654,504,288,216,0,0,42,37,5,108,95,13,0
2021,Chesterfield 011E,E01019592,704,638,412,226,1,1,5,3,2,60,54,6,0
2021,Chesterfield 011F,E01019593,487,448,288,160,1,1,3,2,1,35,25,10,0
2021,Derbyshire Dales 009A,E01019594,798,424,234,190,10,10,281,91,190,83,67,16,0
2021,Derbyshire Dales 008A,E01019595,928,649,455,194,4,4,53,16,37,222,188,34,0
2021,Derbyshire Dales 009B,E01019596,865,604,357,247,20,20,132,45,87,109,96,13,0
2021,Derbyshire Dales 009C,E01019597,855,618,316,302,45,45,116,18,98,76,64,12,0
2021,Derbyshire Dales 009D,E01019598,818,440,246,194,12,12,196,60,136,170,151,19,0
2021,Derbyshire Dales 011B,E01019599,638,513,392,121,11,11,49,6,43,65,48,17,0
2021,Derbyshire Dales 002A,E01019600,691,479,356,123,3,3,51,7,44,158,136,22,0
2021,Derbyshire Dales 011A,E01019601,706,422,308,114,6,6,218,58,160,60,47,13,0
2021,Derbyshire Dales 001A,E01019602,837,632,415,217,5,5,107,26,81,93,72,21,0
2021,Derbyshire Dales 010A,E01019603,873,686,412,274,11,11,47,1,46,129,105,24,0
2021,Derbyshire Dales 002B,E01019604,829,665,448,217,0,0,82,14,68,82,52,30,0
2021,Derbyshire Dales 008B,E01019605,779,632,413,219,3,3,43,11,32,101,71,30,0
2021,Derbyshire Dales 002C,E01019606,734,461,318,143,5,5,66,7,59,202,122,80,0
2021,Derbyshire Dales 010B,E01019607,787,582,389,193,1,1,22,7,15,182,152,30,0
2021,Derbyshire Dales 011G,E01019608,815,452,294,158,10,10,257,58,199,93,73,20,3
2021,Derbyshire Dales 005A,E01019609,1184,931,625,306,15,15,80,18,62,158,143,15,0
2021,Derbyshire Dales 011D,E01019610,679,582,411,171,2,2,11,3,8,84,67,17,0
2021,Derbyshire Dales 008C,E01019611,703,488,362,126,2,2,63,14,49,150,129,21,0
2021,Derbyshire Dales 010C,E01019612,934,718,413,305,5,5,48,6,42,161,140,21,2
2021,Derbyshire Dales 011C,E01019613,703,552,404,148,4,4,39,9,30,108,76,32,0
2021,Derbyshire Dales 001B,E01019614,720,625,423,202,4,4,31,5,26,60,42,18,0
2021,Derbyshire Dales 001C,E01019615,951,631,422,209,11,11,169,32,137,140,107,33,0
2021,Derbyshire Dales 008D,E01019616,820,688,467,221,17,17,35,6,29,80,56,24,0
2021,Derbyshire Dales 011F,E01019617,704,480,355,125,5,5,93,21,72,126,99,27,0
2021,Derbyshire Dales 002D,E01019618,694,531,377,154,1,1,37,8,29,125,97,28,0
2021,Derbyshire Dales 006A,E01019619,682,487,338,149,1,1,95,27,68,99,79,20,0
2021,Derbyshire Dales 006B,E01019620,639,510,334,176,1,1,27,5,22,101,83,18,0
2021,Derbyshire Dales 005B,E01019621,612,471,307,164,15,15,75,11,64,51,43,8,0
2021,Derbyshire Dales 005C,E01019622,677,556,340,216,3,3,25,6,19,93,77,16,0
2021,Derbyshire Dales 006C,E01019623,733,393,252,141,2,2,158,17,141,180,160,20,0
2021,Derbyshire Dales 005D,E01019624,569,441,302,139,4,4,77,12,65,47,40,7,0
2021,Derbyshire Dales 006D,E01019625,701,230,156,74,8,8,422,124,298,37,28,9,4
2021,Derbyshire Dales 006E,E01019626,686,525,368,157,1,1,54,14,40,106,83,23,0
2021,Derbyshire Dales 005E,E01019627,523,412,294,118,4,4,54,6,48,53,40,13,0
2021,Derbyshire Dales 005F,E01019628,662,501,291,210,9,9,91,23,68,60,43,17,1
2021,Derbyshire Dales 010D,E01019629,712,575,351,224,2,2,33,6,27,102,76,26,0
2021,Derbyshire Dales 011E,E01019630,784,575,349,226,1,1,57,13,44,150,126,24,1
2021,Derbyshire Dales 001D,E01019631,799,548,368,180,19,19,115,21,94,117,89,28,0
2021,Derbyshire Dales 006F,E01019632,740,568,419,149,3,3,69,13,56,100,81,19,0
2021,Derbyshire Dales 007A,E01019633,678,416,264,152,17,17,205,55,150,40,34,6,0
2021,Derbyshire Dales 007B,E01019634,700,543,357,186,1,1,87,17,70,69,52,17,0
2021,Derbyshire Dales 007C,E01019635,556,490,373,117,0,0,5,1,4,61,53,8,0
2021,Derbyshire Dales 007D,E01019636,773,505,332,173,16,16,97,19,78,155,136,19,0
2021,Erewash 016A,E01019638,518,455,250,205,2,2,13,1,12,48,34,14,0
2021,Erewash 016B,E01019639,637,441,189,252,7,7,99,27,72,90,83,7,0
2021,Erewash 016C,E01019640,578,459,202,257,4,4,3,0,3,112,103,9,0
2021,Erewash 011A,E01019641,640,586,373,213,0,0,8,1,7,46,36,10,0
2021,Erewash 013A,E01019642,634,481,310,171,0,0,90,24,66,62,49,13,1
2021,Erewash 013B,E01019643,694,590,404,186,1,1,45,18,27,58,37,21,0
2021,Erewash 001A,E01019644,703,383,202,181,1,1,162,51,111,154,145,9,3
2021,Erewash 016D,E01019645,799,514,277,237,26,26,108,38,70,151,133,18,0
2021,Erewash 001B,E01019646,625,286,155,131,1,1,163,64,99,175,165,10,0
2021,Erewash 012A,E01019647,1047,456,211,245,18,18,219,39,180,353,324,29,1
2021,Erewash 010A,E01019648,651,483,243,240,2,2,62,17,45,103,91,12,1
2021,Erewash 010B,E01019649,789,496,218,278,0,0,40,3,37,253,242,11,0
2021,Erewash 010C,E01019650,744,303,135,168,4,4,348,115,233,87,73,14,2
2021,Erewash 010D,E01019651,619,491,263,228,6,6,65,12,53,57,46,11,0
2021,Erewash 011B,E01019652,632,499,254,245,2,2,17,4,13,113,104,9,1
2021,Erewash 011C,E01019653,594,525,331,194,1,1,5,0,5,63,50,13,0
2021,Erewash 013C,E01019654,720,513,291,222,0,0,119,29,90,87,78,9,1
2021,Erewash 013D,E01019655,745,438,220,218,0,0,82,23,59,222,208,14,3
2021,Erewash 008A,E01019656,503,411,250,161,0,0,31,4,27,61,45,16,0
2021,Erewash 003A,E01019657,883,506,226,280,11,11,191,45,146,173,156,17,2
2021,Erewash 006A,E01019658,830,596,239,357,7,7,94,11,83,133,117,16,0
2021,Erewash 006B,E01019659,982,842,291,551,17,17,31,7,24,92,81,11,0
2021,Erewash 003B,E01019660,892,604,350,254,4,4,49,4,45,235,215,20,0
2021,Erewash 003C,E01019661,660,374,210,164,4,4,40,5,35,242,225,17,0
2021,Erewash 003D,E01019662,792,315,165,150,0,0,188,52,136,289,266,23,0
2021,Erewash 001C,E01019663,707,167,74,93,0,0,478,177,301,58,51,7,4
2021,Erewash 001D,E01019664,484,260,149,111,0,0,157,71,86,67,52,15,0
2021,Erewash 001E,E01019665,642,465,302,163,3,3,43,14,29,131,116,15,0
2021,Erewash 007A,E01019666,602,391,198,193,0,0,140,41,99,69,62,7,2
2021,Erewash 007B,E01019667,679,454,216,238,0,0,130,50,80,95,79,16,0
2021,Erewash 007C,E01019668,648,282,151,131,1,1,310,114,196,54,50,4,1
2021,Erewash 007D,E01019669,689,523,321,202,3,3,71,14,57,92,75,17,0
2021,Erewash 004A,E01019670,732,634,361,273,1,1,49,4,45,47,44,3,1
2021,Erewash 004B,E01019671,806,651,407,244,4,4,69,15,54,82,63,19,0
2021,Erewash 003E,E01019672,794,465,256,209,2,2,44,8,36,283,261,22,0
2021,Erewash 005A,E01019673,537,474,272,202,2,2,14,5,9,47,38,9,0
2021,Erewash 006C,E01019674,506,414,256,158,0,0,8,0,8,84,68,16,0
2021,Erewash 012B,E01019675,762,369,172,197,3,3,170,48,122,219,203,16,1
2021,Erewash 014A,E01019676,677,450,246,204,3,3,97,13,84,125,109,16,2
2021,Erewash 014B,E01019677,634,519,332,187,1,1,13,4,9,101,90,11,0
2021,Erewash 014C,E01019678,764,556,256,300,2,2,8,0,8,198,181,17,0
2021,Erewash 012C,E01019679,757,482,209,273,7,7,56,8,48,212,184,28,0
2021,Erewash 014D,E01019680,791,613,252,361,12,12,66,9,57,100,92,8,0
2021,Erewash 014E,E01019681,688,574,382,192,5,5,16,2,14,93,79,14,0
2021,Erewash 012D,E01019682,913,344,164,180,2,2,220,56,164,347,325,22,0
2021,Erewash 009A,E01019683,537,438,251,187,2,2,33,15,18,64,58,6,0
2021,Erewash 009B,E01019684,708,581,325,256,10,10,31,4,27,86,76,10,0
2021,Erewash 009C,E01019685,684,554,342,212,2,2,17,8,9,111,97,14,0
2021,Erewash 009D,E01019686,598,497,307,190,2,2,38,11,27,61,47,14,0
2021,Erewash 009E,E01019687,623,360,195,165,9,9,206,55,151,46,40,6,2
2021,Erewash 006D,E01019688,636,354,186,168,0,0,111,34,77,171,161,10,0
2021,Erewash 006E,E01019689,636,470,247,223,0,0,83,20,63,83,71,12,0
2021,Erewash 003F,E01019690,561,381,194,187,4,4,16,3,13,159,147,12,1
2021,Erewash 008B,E01019691,657,544,283,261,5,5,49,23,26,59,48,11,0
2021,Erewash 008C,E01019692,660,350,165,185,2,2,237,52,185,70,58,12,1
2021,Erewash 008D,E01019693,863,482,208,274,13,13,141,42,99,227,211,16,0
2021,Erewash 008E,E01019694,506,465,306,159,0,0,11,5,6,30,21,9,0
2021,Erewash 010E,E01019695,638,497,230,267,3,3,16,3,13,122,107,15,0
2021,Erewash 008F,E01019696,615,527,317,210,1,1,12,4,8,75,64,11,0
2021,Erewash 015A,E01019697,616,502,299,203,1,1,57,14,43,56,48,8,0
2021,Erewash 014F,E01019698,630,527,268,259,2,2,5,1,4,96,82,14,0
2021,Erewash 015B,E01019699,712,277,118,159,11,11,338,110,228,83,71,12,3
2021,Erewash 015C,E01019700,1013,775,420,355,4,4,110,34,76,124,106,18,0
2021,Erewash 004C,E01019701,978,705,435,270,2,2,172,37,135,99,81,18,0
2021,Erewash 005B,E01019702,756,698,440,258,2,2,10,3,7,46,38,8,0
2021,Erewash 005C,E01019703,663,556,297,259,1,1,14,5,9,92,79,13,0
2021,Erewash 005D,E01019704,639,553,352,201,3,3,16,6,10,67,51,16,0
2021,Erewash 015D,E01019705,804,587,285,302,15,15,52,7,45,150,137,13,0
2021,Erewash 015E,E01019706,517,464,261,203,1,1,3,0,3,49,45,4,0
2021,Erewash 011D,E01019707,625,504,249,255,0,0,14,2,12,107,97,10,0
2021,Erewash 011E,E01019708,735,655,350,305,0,0,25,8,17,55,48,7,0
2021,Erewash 015F,E01019709,525,304,124,180,6,6,142,19,123,73,64,9,0
2021,High Peak 010A,E01019710,871,517,308,209,8,8,99,66,33,246,212,34,1
2021,High Peak 006A,E01019711,607,434,252,182,18,18,66,54,12,89,75,14,0
2021,High Peak 008A,E01019712,641,546,343,203,0,0,17,4,13,78,68,10,0
2021,High Peak 008B,E01019713,704,588,332,256,23,23,41,6,35,52,35,17,0
2021,High Peak 012A,E01019714,1061,897,462,435,7,7,20,2,18,137,119,18,0
2021,High Peak 010B,E01019715,660,324,172,152,3,3,45,6,39,288,271,17,0
2021,High Peak 011A,E01019716,559,408,267,141,2,2,32,13,19,117,101,16,0
2021,High Peak 010C,E01019717,672,230,168,62,2,2,134,112,22,305,286,19,1
2021,High Peak 013E,E01019718,973,700,417,283,18,18,102,92,10,153,134,19,0
2021,High Peak 013F,E01019719,884,593,282,311,17,17,87,68,19,186,166,20,1
2021,High Peak 013G,E01019720,669,525,337,188,21,21,36,31,5,87,73,14,0
2021,High Peak 013H,E01019721,643,544,310,234,15,15,45,3,42,39,25,14,0
2021,High Peak 010D,E01019722,786,610,375,235,10,10,29,7,22,137,122,15,0
2021,High Peak 010E,E01019723,874,577,433,144,11,11,161,22,139,124,111,13,1
2021,High Peak 011B,E01019724,500,284,161,123,3,3,136,134,2,75,64,11,2
2021,High Peak 012B,E01019725,641,527,314,213,3,3,42,20,22,69,54,15,0
2021,High Peak 012C,E01019726,614,476,218,258,9,9,59,47,12,70,58,12,0
2021,High Peak 004A,E01019727,936,840,482,358,0,0,54,15,39,42,31,11,0
2021,High Peak 002A,E01019728,513,128,46,82,0,0,329,296,33,50,45,5,6
2021,High Peak 002B,E01019729,504,206,85,121,0,0,253,243,10,40,36,4,5
2021,High Peak 002C,E01019730,867,495,249,246,3,3,235,216,19,132,113,19,2
2021,High Peak 002D,E01019731,498,453,247,206,0,0,6,1,5,39,30,9,0
2021,High Peak 002E,E01019732,630,486,248,238,1,1,78,72,6,64,52,12,1
2021,High Peak 001A,E01019733,669,463,274,189,1,1,88,81,7,117,107,10,0
2021,High Peak 006B,E01019734,909,692,427,265,9,9,123,94,29,84,67,17,1
2021,High Peak 013A,E01019735,658,486,339,147,2,2,92,63,29,77,62,15,1
2021,High Peak 013B,E01019736,466,372,253,119,4,4,22,11,11,68,39,29,0
2021,High Peak 013C,E01019737,554,388,267,121,1,1,96,62,34,66,53,13,3
2021,High Peak 003A,E01019738,695,428,230,198,8,8,60,4,56,199,177,22,0
2021,High Peak 003B,E01019739,1027,516,288,228,3,3,97,57,40,410,372,38,1
2021,High Peak 003C,E01019740,556,398,193,205,2,2,13,2,11,143,127,16,0
2021,High Peak 013I,E01019741,497,381,214,167,7,7,52,48,4,57,44,13,0
2021,High Peak 013D,E01019742,455,334,185,149,0,0,44,41,3,77,62,15,0
2021,High Peak 006C,E01019743,655,327,165,162,9,9,243,163,80,75,65,10,1
2021,High Peak 006D,E01019744,654,504,283,221,0,0,66,61,5,84,70,14,0
2021,High Peak 006E,E01019745,500,300,136,164,4,4,142,119,23,51,46,5,3
2021,High Peak 005A,E01019746,720,504,288,216,1,1,22,9,13,192,174,18,1
2021,High Peak 005B,E01019747,514,436,262,174,1,1,5,2,3,72,54,18,0
2021,High Peak 005C,E01019748,723,505,264,241,5,5,3,2,1,210,190,20,0
2021,High Peak 004B,E01019749,488,449,285,164,1,1,7,5,2,31,26,5,0
2021,High Peak 003D,E01019750,607,359,195,164,3,3,144,115,29,100,87,13,1
2021,High Peak 003E,E01019751,929,788,386,402,0,0,15,9,6,126,107,19,0
2021,High Peak 001B,E01019752,583,358,153,205,5,5,95,21,74,125,113,12,0
2021,High Peak 001C,E01019753,625,458,246,212,3,3,14,7,7,150,132,18,0
2021,High Peak 004C,E01019754,842,686,404,282,1,1,34,27,7,121,97,24,0
2021,High Peak 005D,E01019755,834,710,426,284,2,2,9,8,1,112,91,21,1
2021,High Peak 004D,E01019756,643,596,293,303,0,0,2,1,1,45,39,6,0
2021,High Peak 004E,E01019757,567,470,251,219,0,0,30,25,5,67,58,9,0
2021,High Peak 004F,E01019758,596,540,264,276,8,8,4,3,1,44,40,4,0
2021,High Peak 011C,E01019759,650,376,196,180,5,5,180,157,23,86,73,13,3
2021,High Peak 011D,E01019760,615,439,229,210,1,1,79,74,5,96,82,14,0
2021,High Peak 011E,E01019761,573,200,103,97,4,4,299,184,115,69,61,8,1
2021,High Peak 012D,E01019762,794,694,491,203,1,1,30,3,27,69,54,15,0
2021,High Peak 001D,E01019763,972,698,319,379,4,4,126,99,27,140,115,25,4
2021,High Peak 008C,E01019764,664,492,290,202,2,2,122,122,0,47,33,14,1
2021,High Peak 008D,E01019765,854,620,352,268,5,5,17,6,11,211,182,29,1
2021,High Peak 005E,E01019766,643,494,300,194,4,4,57,56,1,87,75,12,1
2021,High Peak 008E,E01019767,693,569,347,222,0,0,47,46,1,73,52,21,4
2021,High Peak 003F,E01019768,1052,517,266,251,5,5,366,291,75,159,133,26,5
2021,North East Derbyshire 010A,E01019769,850,670,458,212,2,2,91,67,24,87,64,23,0
2021,North East Derbyshire 005A,E01019770,857,648,408,240,2,2,132,104,28,73,49,24,2
2021,North East Derbyshire 008A,E01019771,949,740,497,243,0,0,113,86,27,95,79,16,1
2021,North East Derbyshire 008B,E01019772,641,570,360,210,3,3,26,19,7,42,32,10,0
2021,North East Derbyshire 010B,E01019774,883,759,511,248,5,5,33,27,6,86,76,10,0
2021,North East Derbyshire 012B,E01019775,1069,567,226,341,6,6,380,324,56,114,102,12,2
2021,North East Derbyshire 012C,E01019776,640,424,302,122,1,1,120,106,14,94,83,11,1
2021,North East Derbyshire 012D,E01019777,1070,511,278,233,12,12,451,416,35,93,62,31,3
2021,North East Derbyshire 002A,E01019778,767,662,441,221,2,2,62,57,5,41,30,11,0
2021,North East Derbyshire 002B,E01019779,769,681,476,205,2,2,6,5,1,80,66,14,0
2021,North East Derbyshire 004A,E01019780,624,326,172,154,8,8,244,190,54,46,41,5,0
2021,North East Derbyshire 004B,E01019781,673,575,314,261,0,0,49,40,9,49,43,6,0
2021,North East Derbyshire 004C,E01019782,635,298,147,151,8,8,258,127,131,67,55,12,4
2021,North East Derbyshire 006A,E01019783,519,479,283,196,2,2,7,3,4,31,24,7,0
2021,North East Derbyshire 006B,E01019784,509,464,250,214,0,0,2,0,2,43,36,7,0
2021,North East Derbyshire 006C,E01019785,513,491,299,192,0,0,5,4,1,17,9,8,0
2021,North East Derbyshire 004D,E01019786,748,474,236,238,1,1,136,99,37,137,115,22,0
2021,North East Derbyshire 005B,E01019787,763,642,385,257,3,3,44,35,9,74,61,13,0
2021,North East Derbyshire 005C,E01019788,715,684,436,248,2,2,2,2,0,27,21,6,0
2021,North East Derbyshire 002C,E01019790,911,791,470,321,0,0,17,4,13,103,90,13,0
2021,North East Derbyshire 014A,E01019791,868,515,237,278,10,10,184,156,28,155,133,22,4
2021,North East Derbyshire 014B,E01019792,920,409,211,198,9,9,416,329,87,81,69,12,5
2021,North East Derbyshire 006D,E01019793,639,583,394,189,2,2,19,7,12,35,27,8,0
2021,North East Derbyshire 005D,E01019794,598,572,424,148,2,2,3,0,3,21,16,5,0
2021,North East Derbyshire 006E,E01019795,982,753,411,342,14,14,115,82,33,100,81,19,0
2021,North East Derbyshire 009A,E01019796,507,139,82,57,0,0,325,296,29,38,36,2,5
2021,North East Derbyshire 009B,E01019797,826,508,260,248,8,8,198,128,70,112,107,5,0
2021,North East Derbyshire 007A,E01019798,701,562,332,230,20,20,71,28,43,48,35,13,0
2021,North East Derbyshire 009C,E01019799,1154,536,241,295,2,2,439,383,56,177,158,19,0
2021,North East Derbyshire 009D,E01019800,745,519,305,214,1,1,124,114,10,101,89,12,0
2021,North East Derbyshire 001A,E01019801,503,384,207,177,8,8,49,29,20,62,57,5,0
2021,North East Derbyshire 001B,E01019802,578,412,231,181,1,1,49,39,10,116,86,30,0
2021,North East Derbyshire 001C,E01019803,521,323,172,151,0,0,157,140,17,40,31,9,1
2021,North East Derbyshire 001D,E01019804,554,503,289,214,0,0,4,3,1,47,41,6,0
2021,North East Derbyshire 001E,E01019805,568,509,276,233,2,2,23,22,1,34,27,7,0
2021,North East Derbyshire 001F,E01019806,659,484,251,233,5,5,124,112,12,46,39,7,0
2021,North East Derbyshire 001G,E01019807,608,226,146,80,2,2,328,298,30,48,41,7,4
2021,North East Derbyshire 009E,E01019808,740,279,141,138,13,13,380,321,59,63,54,9,5
2021,North East Derbyshire 011A,E01019809,521,372,255,117,2,2,99,97,2,47,42,5,1
2021,North East Derbyshire 011B,E01019810,752,414,225,189,8,8,212,161,51,116,105,11,2
2021,North East Derbyshire 011C,E01019811,648,558,333,225,3,3,4,2,2,83,70,13,0
2021,North East Derbyshire 011D,E01019812,814,673,355,318,4,4,16,11,5,120,100,20,1
2021,North East Derbyshire 011E,E01019813,730,440,223,217,2,2,205,191,14,75,60,15,8
2021,North East Derbyshire 013A,E01019814,832,661,384,277,4,4,79,60,19,87,65,22,1
2021,North East Derbyshire 014C,E01019815,1133,672,306,366,1,1,267,251,16,190,171,19,3
2021,North East Derbyshire 002D,E01019816,785,582,375,207,2,2,130,120,10,70,49,21,1
2021,North East Derbyshire 013B,E01019817,553,240,119,121,2,2,276,240,36,29,21,8,6
2021,North East Derbyshire 013C,E01019818,716,350,204,146,12,12,296,266,30,55,47,8,3
2021,North East Derbyshire 013D,E01019819,766,550,338,212,7,7,127,69,58,81,69,12,1
2021,North East Derbyshire 013E,E01019820,676,574,343,231,1,1,48,35,13,51,43,8,2
2021,North East Derbyshire 007B,E01019821,613,514,336,178,1,1,23,14,9,74,61,13,1
2021,North East Derbyshire 007C,E01019822,710,517,310,207,2,2,123,34,89,68,54,14,0
2021,North East Derbyshire 007D,E01019823,533,289,148,141,1,1,183,149,34,57,45,12,3
2021,North East Derbyshire 010C,E01019824,807,613,265,348,26,26,125,107,18,42,32,10,1
2021,North East Derbyshire 011F,E01019825,600,528,299,229,2,2,38,32,6,32,26,6,0
2021,North East Derbyshire 009F,E01019826,648,317,169,148,1,1,278,267,11,50,40,10,2
2021,North East Derbyshire 004E,E01019827,854,540,324,216,0,0,247,222,25,62,53,9,5
2021,North East Derbyshire 008C,E01019828,671,652,510,142,0,0,5,3,2,14,9,5,0
2021,North East Derbyshire 008D,E01019829,606,529,337,192,2,2,37,28,9,38,27,11,0
2021,North East Derbyshire 010D,E01019830,658,581,356,225,24,24,25,3,22,27,23,4,1
2021,North East Derbyshire 010E,E01019831,610,554,324,230,1,1,4,0,4,51,43,8,0
2021,South Derbyshire 004A,E01019832,785,621,354,267,1,1,66,50,16,97,81,16,0
2021,South Derbyshire 004B,E01019833,909,790,491,299,4,4,36,19,17,79,65,14,0
2021,South Derbyshire 004C,E01019834,1018,787,359,428,28,28,90,35,55,112,99,13,1
2021,South Derbyshire 012A,E01019837,892,580,255,325,14,14,105,10,95,193,176,17,0
2021,South Derbyshire 012B,E01019838,696,414,207,207,1,1,142,114,28,135,118,17,4
2021,South Derbyshire 001A,E01019839,1108,893,343,550,9,9,58,5,53,148,128,20,0
2021,South Derbyshire 002A,E01019840,744,553,297,256,5,5,119,94,25,67,49,18,0
2021,South Derbyshire 002B,E01019841,791,673,381,292,16,16,30,7,23,72,63,9,0
2021,South Derbyshire 013A,E01019842,664,385,218,167,2,2,223,149,74,53,46,7,1
2021,South Derbyshire 006A,E01019843,687,481,304,177,1,1,67,45,22,137,122,15,1
2021,South Derbyshire 007A,E01019844,660,494,302,192,1,1,99,98,1,65,58,7,1
2021,South Derbyshire 001B,E01019845,565,453,238,215,2,2,8,6,2,102,91,11,0
2021,South Derbyshire 001C,E01019846,594,418,228,190,0,0,93,89,4,81,63,18,2
2021,South Derbyshire 002C,E01019847,611,471,285,186,0,0,69,67,2,71,63,8,0
2021,South Derbyshire 002D,E01019848,1042,773,231,542,24,24,65,16,49,180,170,10,0
2021,South Derbyshire 011A,E01019850,972,841,410,431,15,15,56,31,25,60,43,17,0
2021,South Derbyshire 011B,E01019851,726,494,252,242,5,5,127,101,26,97,90,7,3
2021,South Derbyshire 011C,E01019852,854,671,316,355,2,2,62,43,19,118,105,13,1
2021,South Derbyshire 006B,E01019853,731,570,340,230,10,10,72,35,37,78,66,12,1
2021,South Derbyshire 006C,E01019854,958,577,314,263,6,6,150,107,43,223,199,24,2
2021,South Derbyshire 006D,E01019855,670,534,333,201,1,1,27,23,4,108,93,15,0
2021,South Derbyshire 007B,E01019856,642,371,199,172,2,2,191,176,15,77,62,15,1
2021,South Derbyshire 007C,E01019857,535,482,178,304,0,0,7,4,3,46,38,8,0
2021,South Derbyshire 007D,E01019858,628,311,187,124,1,1,202,158,44,111,101,10,3
2021,South Derbyshire 007E,E01019859,724,621,378,243,1,1,23,19,4,79,68,11,0
2021,South Derbyshire 008A,E01019860,502,460,274,186,0,0,1,0,1,41,36,5,0
2021,South Derbyshire 008B,E01019861,777,553,279,274,0,0,64,57,7,158,142,16,2
2021,South Derbyshire 008C,E01019862,685,512,283,229,6,6,34,22,12,133,118,15,0
2021,South Derbyshire 008D,E01019863,693,311,160,151,4,4,280,183,97,93,84,9,5
2021,South Derbyshire 008E,E01019864,584,377,185,192,1,1,81,73,8,125,117,8,0
2021,South Derbyshire 008F,E01019865,556,425,210,215,0,0,34,33,1,97,89,8,0
2021,South Derbyshire 001D,E01019866,861,739,450,289,2,2,9,4,5,111,82,29,0
2021,South Derbyshire 005A,E01019867,699,598,368,230,10,10,30,2,28,61,50,11,0
2021,South Derbyshire 005B,E01019868,816,632,315,317,9,9,89,52,37,85,66,19,1
2021,South Derbyshire 005C,E01019869,490,370,233,137,1,1,9,5,4,110,74,36,0
2021,South Derbyshire 011D,E01019870,688,453,271,182,5,5,143,128,15,87,71,16,0
2021,South Derbyshire 011E,E01019871,743,574,309,265,1,1,77,62,15,89,68,21,2
2021,South Derbyshire 011F,E01019872,906,752,383,369,3,3,17,10,7,133,109,24,1
2021,South Derbyshire 003A,E01019873,1040,755,250,505,24,24,80,12,68,180,162,18,1
2021,South Derbyshire 003B,E01019874,570,492,303,189,1,1,2,0,2,75,65,10,0
2021,South Derbyshire 003C,E01019875,475,393,218,175,0,0,14,2,12,68,58,10,0
2021,South Derbyshire 009A,E01019876,808,582,317,265,10,10,117,102,15,98,86,12,1
2021,South Derbyshire 009B,E01019877,1036,470,228,242,17,17,308,168,140,232,216,16,9
2021,South Derbyshire 009C,E01019878,646,478,282,196,6,6,76,63,13,86,74,12,0
2021,South Derbyshire 009D,E01019879,897,761,385,376,0,0,40,31,9,93,76,17,3
2021,South Derbyshire 005D,E01019880,720,655,363,292,5,5,9,3,6,51,41,10,0
2021,South Derbyshire 003E,E01019882,895,704,434,270,3,3,103,70,33,85,70,15,0
2021,South Derbyshire 013C,E01019885,709,562,258,304,0,0,27,23,4,119,108,11,1
2021,East Devon 005B,E01019887,782,441,275,166,11,11,176,100,76,153,137,16,1
2021,East Devon 005C,E01019888,865,585,414,171,2,2,26,7,19,252,227,25,0
2021,East Devon 005D,E01019889,826,658,436,222,14,14,51,29,22,103,90,13,0
2021,East Devon 009A,E01019890,815,550,398,152,5,5,93,69,24,167,125,42,0
2021,East Devon 021B,E01019891,663,407,237,170,8,8,94,24,70,154,121,33,0
2021,East Devon 017A,E01019894,759,626,519,107,1,1,33,20,13,99,82,17,0
2021,East Devon 017B,E01019895,717,589,454,135,10,10,36,19,17,82,60,22,0
2021,East Devon 017C,E01019896,772,639,504,135,1,1,34,27,7,98,82,16,0
2021,East Devon 017D,E01019897,712,445,263,182,18,18,144,100,44,103,95,8,2
2021,East Devon 014A,E01019898,1169,966,594,372,15,15,31,5,26,156,126,30,1
2021,East Devon 007A,E01019899,669,425,279,146,3,3,141,94,47,99,84,15,1
2021,East Devon 007B,E01019900,848,710,561,149,2,2,45,13,32,91,65,26,0
2021,East Devon 009B,E01019901,601,477,349,128,2,2,28,24,4,94,73,21,0
2021,East Devon 001A,E01019902,999,771,491,280,12,12,65,15,50,151,122,29,0
2021,East Devon 021A,E01019903,937,702,455,247,3,3,66,57,9,161,137,24,5
2021,East Devon 015A,E01019904,643,399,251,148,6,6,155,123,32,82,68,14,1
2021,East Devon 015B,E01019905,764,686,421,265,2,2,3,0,3,73,57,16,0
2021,East Devon 015C,E01019906,667,532,321,211,5,5,9,5,4,121,109,12,0
2021,East Devon 015D,E01019907,689,573,401,172,2,2,35,6,29,79,55,24,0
2021,East Devon 016A,E01019908,710,461,208,253,1,1,98,14,84,150,135,15,0
2021,East Devon 016B,E01019909,816,718,497,221,4,4,16,3,13,78,66,12,0
2021,East Devon 016C,E01019910,700,566,357,209,6,6,45,35,10,82,61,21,1
2021,East Devon 016D,E01019911,807,664,500,164,6,6,38,14,24,98,68,30,1
2021,East Devon 020A,E01019912,849,561,420,141,3,3,86,69,17,199,181,18,0
2021,East Devon 020B,E01019913,898,768,634,134,0,0,13,5,8,117,97,20,0
2021,East Devon 020C,E01019914,1096,584,367,217,6,6,403,355,48,100,82,18,3
2021,East Devon 020D,E01019915,838,708,498,210,8,8,30,22,8,92,81,11,0
2021,East Devon 019A,E01019916,1003,415,220,195,3,3,62,30,32,523,486,37,0
2021,East Devon 019B,E01019917,675,478,269,209,3,3,12,3,9,182,164,18,0
2021,East Devon 019C,E01019918,913,477,316,161,7,7,28,12,16,398,354,44,3
2021,East Devon 019D,E01019919,783,446,220,226,9,9,69,17,52,259,226,33,0
2021,East Devon 018A,E01019920,701,468,235,233,11,11,129,62,67,93,76,17,0
2021,East Devon 018B,E01019921,641,538,312,226,3,3,43,25,18,57,42,15,0
2021,East Devon 018C,E01019922,651,319,170,149,17,17,259,180,79,53,39,14,3
2021,East Devon 018D,E01019923,540,392,229,163,3,3,92,56,36,52,42,10,1
2021,East Devon 018E,E01019924,620,371,176,195,0,0,140,104,36,109,100,9,0
2021,East Devon 004A,E01019925,548,444,225,219,6,6,20,8,12,77,63,14,1
2021,East Devon 002A,E01019927,657,297,219,78,2,2,148,117,31,210,192,18,0
2021,East Devon 003A,E01019928,621,422,232,190,5,5,113,68,45,80,72,8,1
2021,East Devon 003B,E01019929,627,435,239,196,4,4,49,40,9,139,122,17,0
2021,East Devon 003C,E01019930,702,542,363,179,9,9,30,15,15,121,107,14,0
2021,East Devon 003D,E01019931,526,455,302,153,3,3,3,2,1,65,57,8,0
2021,East Devon 002B,E01019932,865,404,243,161,4,4,247,191,56,208,193,15,2
2021,East Devon 002C,E01019933,665,438,276,162,4,4,64,47,17,159,141,18,0
2021,East Devon 002D,E01019934,837,728,519,209,0,0,40,6,34,69,55,14,0
2021,East Devon 007C,E01019935,598,474,360,114,3,3,57,41,16,64,44,20,0
2021,East Devon 007D,E01019936,516,391,282,109,0,0,64,49,15,61,45,16,0
2021,East Devon 013A,E01019937,992,780,508,272,4,4,93,66,27,113,98,15,2
2021,East Devon 001B,E01019938,944,774,556,218,6,6,50,31,19,114,79,35,0
2021,East Devon 008A,E01019939,705,597,408,189,16,16,41,29,12,51,46,5,0
2021,East Devon 008B,E01019940,706,630,426,204,9,9,18,15,3,49,38,11,0
2021,East Devon 008C,E01019942,1070,682,400,282,39,39,192,124,68,156,133,23,1
2021,East Devon 008D,E01019943,727,599,377,222,12,12,49,27,22,65,52,13,2
2021,East Devon 008E,E01019944,807,527,286,241,15,15,56,4,52,209,188,21,0
2021,East Devon 013B,E01019945,903,608,418,190,4,4,61,44,17,229,191,38,1
2021,East Devon 010A,E01019946,659,583,481,102,1,1,33,7,26,42,38,4,0
2021,East Devon 010B,E01019947,1178,685,504,181,13,13,21,13,8,459,422,37,0
2021,East Devon 010C,E01019948,641,531,395,136,3,3,51,24,27,56,43,13,0
2021,East Devon 010D,E01019949,764,632,476,156,11,11,13,7,6,108,93,15,0
2021,East Devon 010E,E01019950,640,391,299,92,3,3,177,134,43,66,53,13,3
2021,East Devon 009C,E01019951,1002,820,653,167,1,1,49,41,8,132,95,37,0
2021,East Devon 011A,E01019952,842,646,469,177,3,3,66,49,17,127,117,10,0
2021,East Devon 011B,E01019953,747,615,476,139,4,4,98,90,8,26,22,4,4
2021,East Devon 011C,E01019954,894,489,342,147,59,59,244,73,171,102,91,11,0
2021,East Devon 011D,E01019955,784,542,402,140,2,2,138,129,9,101,89,12,1
2021,East Devon 012A,E01019956,929,613,495,118,12,12,54,35,19,247,212,35,3
2021,East Devon 012B,E01019957,946,796,716,80,3,3,27,6,21,120,87,33,0
2021,East Devon 012C,E01019958,833,704,522,182,1,1,45,33,12,81,61,20,2
2021,East Devon 004D,E01019959,521,367,231,136,2,2,50,49,1,102,75,27,0
2021,East Devon 004E,E01019960,566,480,302,178,2,2,13,11,2,69,44,25,2
2021,East Devon 007E,E01019961,1112,909,654,255,4,4,59,42,17,140,104,36,0
2021,East Devon 004F,E01019962,1013,785,481,304,9,9,88,44,44,131,109,22,0
2021,East Devon 013C,E01019963,781,574,338,236,5,5,81,55,26,120,102,18,1
2021,East Devon 014B,E01019964,432,361,239,122,1,1,2,2,0,68,55,13,0
2021,East Devon 014C,E01019965,783,525,346,179,16,16,97,74,23,142,79,63,3
2021,East Devon 005E,E01019966,496,422,300,122,2,2,23,13,10,49,39,10,0
2021,East Devon 001C,E01019967,570,435,291,144,1,1,18,10,8,116,90,26,0
2021,Exeter 014A,E01019968,682,483,321,162,3,3,72,47,25,124,110,14,0
2021,Exeter 014B,E01019969,603,413,236,177,3,3,48,43,5,139,120,19,0
2021,Exeter 014C,E01019970,509,371,212,159,0,0,22,11,11,116,102,14,0
2021,Exeter 014D,E01019971,799,326,177,149,12,12,114,18,96,347,333,14,0
2021,Exeter 014E,E01019972,607,347,154,193,5,5,94,34,60,160,150,10,1
2021,Exeter 012A,E01019973,635,488,287,201,2,2,80,34,46,65,59,6,0
2021,Exeter 012B,E01019974,622,457,269,188,2,2,76,54,22,83,70,13,4
2021,Exeter 010A,E01019975,487,301,134,167,1,1,124,50,74,61,53,8,0
2021,Exeter 012C,E01019976,626,530,342,188,4,4,37,6,31,55,40,15,0
2021,Exeter 012D,E01019977,612,492,292,200,2,2,56,43,13,61,53,8,1
2021,Exeter 005A,E01019980,739,347,142,205,13,13,175,21,154,204,192,12,0
2021,Exeter 012E,E01019981,596,375,204,171,2,2,149,70,79,70,63,7,0
2021,Exeter 005B,E01019982,737,379,162,217,5,5,109,66,43,243,223,20,1
2021,Exeter 005C,E01019983,635,474,300,174,0,0,72,6,66,89,78,11,0
2021,Exeter 005D,E01019984,549,446,221,225,5,5,10,9,1,88,77,11,0
2021,Exeter 005E,E01019985,583,200,102,98,24,24,294,46,248,65,57,8,0
2021,Exeter 007A,E01019986,604,483,285,198,4,4,15,9,6,102,92,10,0
2021,Exeter 006A,E01019987,685,320,191,129,5,5,73,38,35,285,263,22,2
2021,Exeter 013A,E01019988,632,474,297,177,9,9,48,25,23,101,88,13,0
2021,Exeter 006B,E01019989,522,370,192,178,4,4,8,7,1,140,124,16,0
2021,Exeter 002A,E01019990,622,277,120,157,3,3,270,243,27,69,55,14,3
2021,Exeter 002B,E01019991,634,296,133,163,3,3,231,178,53,102,95,7,2
2021,Exeter 003A,E01019992,637,411,224,187,7,7,99,92,7,115,104,11,5
2021,Exeter 002C,E01019993,496,424,241,183,1,1,4,1,3,67,60,7,0
2021,Exeter 008A,E01019994,644,252,141,111,1,1,135,37,98,256,249,7,0
2021,Exeter 008B,E01019995,853,183,106,77,15,15,380,156,224,274,257,17,1
2021,Exeter 009A,E01019996,534,183,100,83,3,3,71,12,59,277,266,11,0
2021,Exeter 004A,E01019997,609,229,111,118,3,3,13,4,9,364,349,15,0
2021,Exeter 001C,E01019998,594,414,230,184,1,1,49,38,11,130,126,4,0
2021,Exeter 001D,E01019999,514,359,214,145,1,1,20,6,14,134,127,7,0
2021,Exeter 002D,E01020000,583,272,138,134,5,5,204,180,24,98,86,12,4
2021,Exeter 001E,E01020001,601,467,293,174,0,0,5,3,2,129,119,10,0
2021,Exeter 003B,E01020002,904,595,280,315,18,18,191,49,142,100,83,17,0
2021,Exeter 003C,E01020003,739,605,382,223,16,16,51,21,30,67,54,13,0
2021,Exeter 003D,E01020004,996,735,346,389,32,32,75,7,68,154,137,17,0
2021,Exeter 003E,E01020005,826,479,248,231,26,26,267,113,154,53,45,8,1
2021,Exeter 006C,E01020006,847,398,156,242,19,19,215,8,207,215,196,19,0
2021,Exeter 002E,E01020007,497,157,73,84,2,2,8,1,7,330,321,9,0
2021,Exeter 006D,E01020008,602,236,96,140,3,3,22,12,10,341,331,10,0
2021,Exeter 006E,E01020009,600,390,201,189,3,3,16,12,4,190,171,19,1
2021,Exeter 013B,E01020010,807,383,194,189,19,19,279,204,75,125,113,12,1
2021,Exeter 015A,E01020011,570,450,282,168,3,3,45,43,2,72,63,9,0
2021,Exeter 015B,E01020012,627,347,174,173,5,5,206,169,37,65,55,10,4
2021,Exeter 013C,E01020013,595,341,178,163,0,0,86,57,29,167,118,49,1
2021,Exeter 013D,E01020014,638,275,104,171,6,6,278,261,17,79,72,7,0
2021,Exeter 013E,E01020015,855,400,233,167,0,0,359,340,19,90,71,19,6
2021,Exeter 008D,E01020017,990,290,149,141,21,21,140,10,130,539,509,30,0
2021,Exeter 008E,E01020018,1127,297,194,103,19,19,289,101,188,520,492,28,2
2021,Exeter 004B,E01020019,605,169,117,52,1,1,46,5,41,389,377,12,0
2021,Exeter 004C,E01020020,608,178,101,77,1,1,42,7,35,387,369,18,0
2021,Exeter 004D,E01020021,542,282,163,119,2,2,5,4,1,253,240,13,0
2021,Exeter 004E,E01020022,704,89,45,44,8,8,180,41,139,427,412,15,0
2021,Exeter 009B,E01020023,984,647,375,272,8,8,113,42,71,214,198,16,2
2021,Exeter 009C,E01020024,672,463,284,179,3,3,43,24,19,163,148,15,0
2021,Exeter 009D,E01020025,737,360,194,166,4,4,62,25,37,311,289,22,0
2021,Exeter 011A,E01020026,745,627,388,239,5,5,2,1,1,111,104,7,0
2021,Exeter 011B,E01020027,701,510,278,232,0,0,64,53,11,127,114,13,0
2021,Exeter 010B,E01020029,673,464,219,245,3,3,42,12,30,164,141,23,0
2021,Exeter 010C,E01020030,970,480,245,235,9,9,138,91,47,342,311,31,1
2021,Exeter 010D,E01020031,685,461,194,267,6,6,44,4,40,174,158,16,0
2021,Exeter 010E,E01020032,686,395,190,205,1,1,69,14,55,220,204,16,1
2021,Exeter 007B,E01020036,647,418,243,175,6,6,142,135,7,81,66,15,0
2021,Exeter 007C,E01020037,605,289,153,136,1,1,256,210,46,54,39,15,5
2021,Exeter 011E,E01020038,1046,767,324,443,30,30,113,41,72,136,125,11,0
2021,Exeter 007D,E01020039,849,296,136,160,1,1,461,430,31,82,69,13,9
2021,Exeter 007E,E01020040,567,394,220,174,4,4,111,102,9,56,46,10,2
2021,Mid Devon 011A,E01020041,1090,595,274,321,37,37,254,166,88,201,184,17,3
2021,Mid Devon 011B,E01020042,779,596,370,226,7,7,20,7,13,156,140,16,0
2021,Mid Devon 008A,E01020043,853,560,302,258,1,1,156,104,52,136,106,30,0
2021,Mid Devon 008B,E01020044,710,543,348,195,8,8,56,44,12,101,82,19,2
2021,Mid Devon 006A,E01020045,720,546,348,198,6,6,60,49,11,108,83,25,0
2021,Mid Devon 001A,E01020046,646,502,284,218,2,2,29,26,3,112,87,25,1
2021,Mid Devon 002A,E01020047,955,710,480,230,3,3,33,10,23,209,186,23,0
2021,Mid Devon 005A,E01020048,1100,522,302,220,6,6,119,19,100,451,415,36,2
2021,Mid Devon 001B,E01020049,570,447,304,143,6,6,24,17,7,93,64,29,0
2021,Mid Devon 001C,E01020050,1007,691,488,203,9,9,112,84,28,193,163,30,2
2021,Mid Devon 002B,E01020051,815,698,508,190,4,4,30,8,22,83,64,19,0
2021,Mid Devon 004A,E01020052,914,436,244,192,11,11,217,111,106,248,221,27,2
2021,Mid Devon 004B,E01020053,608,369,226,143,2,2,159,145,14,76,65,11,2
2021,Mid Devon 007A,E01020054,1084,786,376,410,17,17,107,25,82,174,161,13,0
2021,Mid Devon 007B,E01020055,826,466,259,207,9,9,154,97,57,196,174,22,1
2021,Mid Devon 008C,E01020056,1169,845,398,447,34,34,76,22,54,214,167,47,0
2021,Mid Devon 007C,E01020057,998,549,232,317,15,15,224,117,107,204,187,17,6
2021,Mid Devon 007D,E01020058,892,669,394,275,15,15,40,19,21,167,153,14,1
2021,Mid Devon 006B,E01020059,903,657,384,273,16,16,87,46,41,141,115,26,2
2021,Mid Devon 011C,E01020060,929,425,278,147,1,1,187,64,123,315,290,25,1
2021,Mid Devon 011D,E01020061,915,692,407,285,12,12,77,39,38,134,129,5,0
2021,Mid Devon 006C,E01020062,717,586,357,229,0,0,31,7,24,100,84,16,0
2021,Mid Devon 003A,E01020063,1055,680,398,282,25,25,224,110,114,121,104,17,5
2021,Mid Devon 006D,E01020064,755,453,184,269,6,6,149,105,44,146,136,10,1
2021,Mid Devon 004C,E01020065,782,418,225,193,1,1,150,96,54,211,191,20,2
2021,Mid Devon 004D,E01020067,765,271,132,139,43,43,309,294,15,135,130,5,7
2021,Mid Devon 010A,E01020068,681,475,292,183,5,5,89,73,16,112,84,28,0
2021,Mid Devon 010B,E01020069,637,471,304,167,2,2,62,50,12,101,75,26,1
2021,Mid Devon 010C,E01020070,778,632,431,201,3,3,36,34,2,107,78,29,0
2021,Mid Devon 008D,E01020071,885,686,419,267,0,0,87,60,27,112,97,15,0
2021,Mid Devon 009A,E01020072,691,559,351,208,0,0,41,34,7,90,68,22,1
2021,Mid Devon 009B,E01020073,762,592,379,213,3,3,82,60,22,85,73,12,0
2021,Mid Devon 003B,E01020074,962,741,459,282,10,10,54,19,35,157,116,41,0
2021,Mid Devon 003C,E01020075,827,580,366,214,11,11,86,69,17,150,120,30,0
2021,Mid Devon 009C,E01020076,744,553,332,221,0,0,50,33,17,141,116,25,0
2021,Mid Devon 001D,E01020077,680,542,335,207,5,5,31,26,5,101,77,24,1
2021,Mid Devon 005B,E01020078,657,244,97,147,3,3,224,108,116,186,166,20,0
2021,Mid Devon 005C,E01020079,598,330,191,139,1,1,208,193,15,59,50,9,0
2021,Mid Devon 002D,E01020080,772,606,337,269,2,2,68,10,58,96,77,19,0
2021,Mid Devon 005D,E01020081,594,392,239,153,3,3,151,143,8,44,40,4,4
2021,Mid Devon 009D,E01020082,519,391,252,139,0,0,47,30,17,81,57,24,0
2021,Mid Devon 010D,E01020083,1031,766,407,359,9,9,76,57,19,177,155,22,3
2021,North Devon 012A,E01020084,669,466,302,164,4,4,100,17,83,99,90,9,0
2021,North Devon 012B,E01020085,653,412,206,206,31,31,31,6,25,179,164,15,0
2021,North Devon 014A,E01020087,944,713,497,216,3,3,64,8,56,163,120,43,1
2021,North Devon 006A,E01020088,853,623,396,227,7,7,75,11,64,148,115,33,0
2021,North Devon 005A,E01020089,961,714,408,306,2,2,65,14,51,180,153,27,0
2021,North Devon 004A,E01020090,740,650,403,247,2,2,9,4,5,79,58,21,0
2021,North Devon 005B,E01020091,562,460,318,142,3,3,6,0,6,93,82,11,0
2021,North Devon 005C,E01020092,641,548,399,149,1,1,16,4,12,76,56,20,0
2021,North Devon 005D,E01020093,707,405,247,158,15,15,118,19,99,167,147,20,2
2021,North Devon 008A,E01020094,1065,244,152,92,2,2,377,75,302,440,397,43,2
2021,North Devon 008B,E01020095,665,337,159,178,2,2,132,42,90,194,174,20,0
2021,North Devon 009A,E01020096,827,466,259,207,4,4,124,15,109,233,202,31,0
2021,North Devon 013A,E01020097,982,731,499,232,6,6,39,6,33,206,148,58,0
2021,North Devon 014B,E01020098,1090,767,528,239,19,19,114,22,92,190,143,47,0
2021,North Devon 002A,E01020099,616,489,360,129,0,0,6,0,6,121,100,21,0
2021,North Devon 002B,E01020100,491,373,270,103,4,4,38,6,32,76,56,20,0
2021,North Devon 002C,E01020101,636,463,325,138,0,0,39,12,27,134,111,23,0
2021,North Devon 010A,E01020102,655,467,241,226,1,1,14,2,12,173,157,16,0
2021,North Devon 010B,E01020103,601,258,122,136,16,16,259,104,155,68,59,9,0
2021,North Devon 010C,E01020104,581,210,116,94,13,13,144,61,83,214,197,17,0
2021,North Devon 011A,E01020105,927,679,380,299,27,27,131,28,103,90,72,18,0
2021,North Devon 011B,E01020106,618,553,410,143,10,10,23,4,19,32,24,8,0
2021,North Devon 011C,E01020107,738,624,469,155,14,14,28,6,22,72,51,21,0
2021,North Devon 004B,E01020108,885,677,437,240,2,2,32,8,24,174,114,60,0
2021,North Devon 004C,E01020109,563,440,267,173,3,3,30,6,24,90,69,21,0
2021,North Devon 005E,E01020110,999,499,267,232,30,30,163,44,119,307,129,178,0
2021,North Devon 001A,E01020111,627,278,163,115,2,2,163,52,111,182,165,17,2
2021,North Devon 001B,E01020112,735,256,146,110,7,7,69,10,59,402,368,34,1
2021,North Devon 003A,E01020113,663,330,212,118,0,0,25,3,22,308,286,22,0
2021,North Devon 001C,E01020114,567,371,235,136,3,3,16,2,14,177,163,14,0
2021,North Devon 001D,E01020115,515,387,242,145,4,4,7,3,4,117,99,18,0
2021,North Devon 003B,E01020116,697,456,260,196,4,4,70,10,60,167,142,25,0
2021,North Devon 003C,E01020117,694,563,365,198,1,1,31,7,24,99,74,25,0
2021,North Devon 003D,E01020118,542,327,183,144,0,0,135,37,98,80,73,7,0
2021,North Devon 011D,E01020119,678,486,350,136,1,1,34,8,26,157,130,27,0
2021,North Devon 006B,E01020120,899,741,428,313,16,16,22,2,20,120,102,18,0
2021,North Devon 012D,E01020121,838,638,342,296,3,3,84,19,65,113,89,24,0
2021,North Devon 012E,E01020122,949,660,361,299,16,16,88,19,69,185,148,37,0
2021,North Devon 009B,E01020123,629,430,298,132,9,9,140,34,106,50,43,7,0
2021,North Devon 009C,E01020124,627,510,330,180,9,9,12,2,10,96,84,12,0
2021,North Devon 009D,E01020125,616,526,379,147,3,3,2,0,2,85,72,13,0
2021,North Devon 002D,E01020126,750,514,358,156,3,3,57,9,48,175,142,33,1
2021,North Devon 006C,E01020127,866,673,440,233,9,9,38,12,26,146,114,32,0
2021,North Devon 010D,E01020128,592,475,289,186,10,10,35,5,30,72,62,10,0
2021,North Devon 010E,E01020129,535,294,170,124,1,1,153,21,132,85,78,7,2
2021,North Devon 010F,E01020130,682,389,187,202,1,1,67,16,51,225,212,13,0
2021,North Devon 013B,E01020131,933,611,402,209,7,7,86,14,72,228,187,41,1
2021,North Devon 007A,E01020132,807,614,373,241,18,18,48,9,39,127,111,16,0
2021,North Devon 007B,E01020133,670,511,311,200,13,13,40,8,32,106,95,11,0
2021,North Devon 007C,E01020134,474,225,125,100,1,1,164,36,128,84,68,16,0
2021,North Devon 013C,E01020135,765,446,275,171,3,3,169,39,130,145,128,17,2
2021,North Devon 013D,E01020136,1072,747,489,258,30,30,139,16,123,156,138,18,0
2021,North Devon 013E,E01020137,859,507,309,198,8,8,74,20,54,270,241,29,0
2021,North Devon 014C,E01020138,1067,808,515,293,8,8,100,29,71,151,106,45,0
2021,North Devon 007D,E01020139,631,369,189,180,3,3,149,33,116,108,103,5,2
2021,North Devon 008C,E01020140,572,403,267,136,0,0,73,29,44,96,85,11,0
2021,North Devon 008D,E01020141,732,335,150,185,0,0,220,59,161,177,164,13,0
2021,South Hams 006A,E01020142,1144,804,478,326,27,27,97,28,69,215,172,43,1
2021,South Hams 006B,E01020143,1052,746,477,269,17,17,67,10,57,222,194,28,0
2021,South Hams 001A,E01020144,620,492,228,264,5,5,7,0,7,116,104,12,0
2021,South Hams 001B,E01020145,830,628,346,282,17,17,50,11,39,135,114,21,0
2021,South Hams 001C,E01020146,547,375,176,199,2,2,8,0,8,159,144,15,3
2021,South Hams 008A,E01020147,908,696,486,210,2,2,90,15,75,120,89,31,0
2021,South Hams 002A,E01020148,497,372,233,139,0,0,42,4,38,82,69,13,1
2021,South Hams 001D,E01020149,614,389,202,187,9,9,92,20,72,124,97,27,0
2021,South Hams 006C,E01020150,915,629,443,186,15,15,128,11,117,142,119,23,1
2021,South Hams 007A,E01020151,753,601,463,138,3,3,40,2,38,109,94,15,0
2021,South Hams 007B,E01020152,778,444,327,117,2,2,131,17,114,201,167,34,0
2021,South Hams 004A,E01020153,535,438,318,120,2,2,21,4,17,74,55,19,0
2021,South Hams 007C,E01020154,499,254,141,113,12,12,134,20,114,99,61,38,0
2021,South Hams 007D,E01020155,485,202,124,78,6,6,235,76,159,42,37,5,0
2021,South Hams 004B,E01020156,949,739,499,240,10,10,46,4,42,154,125,29,0
2021,South Hams 002B,E01020157,1002,765,530,235,7,7,67,12,55,162,117,45,1
2021,South Hams 008B,E01020158,902,626,388,238,32,32,106,21,85,138,113,25,0
2021,South Hams 008C,E01020159,655,448,278,170,8,8,47,9,38,152,126,26,0
2021,South Hams 002C,E01020160,1010,766,375,391,27,27,84,3,81,133,108,25,0
2021,South Hams 005A,E01020161,1097,715,435,280,15,15,190,25,165,177,151,26,0
2021,South Hams 005B,E01020162,646,514,258,256,5,5,19,2,17,108,94,14,0
2021,South Hams 005C,E01020163,708,571,293,278,2,2,42,2,40,93,83,10,0
2021,South Hams 005D,E01020164,653,410,214,196,14,14,126,14,112,103,94,9,0
2021,South Hams 005E,E01020165,622,448,240,208,6,6,23,5,18,145,132,13,0
2021,South Hams 005F,E01020166,589,527,297,230,2,2,8,1,7,52,45,7,0
2021,South Hams 005G,E01020167,659,541,237,304,20,20,33,6,27,65,59,6,0
2021,South Hams 010A,E01020168,910,655,464,191,6,6,119,34,85,129,106,23,1
2021,South Hams 010B,E01020169,1036,652,413,239,9,9,82,20,62,293,265,28,0
2021,South Hams 004C,E01020170,993,822,530,292,10,10,59,6,53,102,80,22,0
2021,South Hams 009A,E01020171,833,648,456,192,13,13,70,14,56,102,82,20,0
2021,South Hams 012A,E01020172,920,639,447,192,17,17,131,20,111,133,103,30,0
2021,South Hams 012B,E01020173,631,446,329,117,3,3,112,19,93,69,53,16,1
2021,South Hams 011A,E01020174,726,538,400,138,5,5,68,10,58,115,86,29,0
2021,South Hams 011B,E01020175,989,747,550,197,5,5,96,7,89,140,105,35,1
2021,South Hams 002D,E01020176,523,405,274,131,2,2,26,3,23,90,77,13,0
2021,South Hams 002E,E01020177,658,394,256,138,28,28,171,22,149,65,44,21,0
2021,South Hams 011C,E01020178,945,757,560,197,9,9,58,10,48,121,101,20,0
2021,South Hams 012C,E01020179,859,632,451,181,7,7,97,13,84,123,84,39,0
2021,South Hams 003A,E01020180,1044,523,357,166,32,32,319,42,277,170,144,26,0
2021,South Hams 003B,E01020181,868,568,382,186,13,13,195,28,167,92,71,21,0
2021,South Hams 003C,E01020182,677,405,246,159,36,36,125,17,108,109,99,10,2
2021,South Hams 003D,E01020183,826,462,352,110,9,9,52,8,44,303,272,31,0
2021,South Hams 003E,E01020184,925,512,361,151,24,24,196,14,182,193,175,18,0
2021,South Hams 009B,E01020185,663,563,363,200,6,6,38,3,35,56,42,14,0
2021,South Hams 009C,E01020186,655,594,431,163,1,1,5,0,5,55,42,13,0
2021,South Hams 009D,E01020187,1059,691,309,382,72,72,162,22,140,134,122,12,0
2021,South Hams 004D,E01020188,929,698,518,180,25,25,65,7,58,141,110,31,0
2021,South Hams 010C,E01020189,983,494,312,182,17,17,328,61,267,142,116,26,2
2021,South Hams 008D,E01020190,1017,723,458,265,15,15,145,27,118,134,112,22,0
2021,Teignbridge 013A,E01020191,602,410,227,183,15,15,45,7,38,131,113,18,1
2021,Teignbridge 019A,E01020192,651,558,372,186,2,2,31,8,23,60,48,12,0
2021,Teignbridge 019B,E01020193,648,491,297,194,9,9,40,14,26,108,78,30,0
2021,Teignbridge 013B,E01020194,618,531,278,253,7,7,5,1,4,75,64,11,0
2021,Teignbridge 017A,E01020195,750,558,360,198,8,8,66,16,50,118,100,18,0
2021,Teignbridge 017B,E01020196,834,452,263,189,3,3,133,37,96,243,223,20,3
2021,Teignbridge 017C,E01020197,582,452,328,124,2,2,35,13,22,93,62,31,0
2021,Teignbridge 017D,E01020198,639,309,187,122,12,12,176,52,124,140,125,15,2
2021,Teignbridge 017E,E01020199,718,448,269,179,10,10,80,25,55,179,153,26,1
2021,Teignbridge 011A,E01020200,534,459,321,138,1,1,7,1,6,67,54,13,0
2021,Teignbridge 011B,E01020201,717,618,486,132,19,19,30,1,29,50,39,11,0
2021,Teignbridge 007A,E01020202,1090,837,580,257,26,26,129,23,106,95,81,14,3
2021,Teignbridge 004A,E01020203,859,730,543,187,10,10,13,0,13,106,84,22,0
2021,Teignbridge 007B,E01020204,655,377,136,241,8,8,102,29,73,168,154,14,0
2021,Teignbridge 003A,E01020205,628,552,398,154,0,0,12,4,8,64,49,15,0
2021,Teignbridge 004B,E01020206,710,462,273,189,2,2,83,19,64,162,140,22,1
2021,Teignbridge 012A,E01020208,528,312,140,172,2,2,162,49,113,50,44,6,2
2021,Teignbridge 012B,E01020209,636,461,263,198,3,3,20,6,14,150,136,14,2
2021,Teignbridge 012C,E01020210,596,503,324,179,22,22,31,6,25,40,32,8,0
2021,Teignbridge 014A,E01020211,694,330,151,179,19,19,270,106,164,75,69,6,0
2021,Teignbridge 016A,E01020212,504,297,139,158,3,3,163,73,90,40,33,7,1
2021,Teignbridge 016B,E01020213,655,501,314,187,2,2,58,15,43,94,84,10,0
2021,Teignbridge 016C,E01020214,680,560,348,212,2,2,35,9,26,83,69,14,0
2021,Teignbridge 016D,E01020215,576,538,349,189,1,1,3,1,2,34,27,7,0
2021,Teignbridge 015A,E01020216,692,343,174,169,5,5,209,57,152,134,122,12,1
2021,Teignbridge 014B,E01020217,919,516,318,198,14,14,49,14,35,340,302,38,0
2021,Teignbridge 014C,E01020218,806,323,152,171,2,2,162,29,133,318,303,15,1
2021,Teignbridge 012D,E01020219,888,605,294,311,24,24,99,4,95,159,150,9,1
2021,Teignbridge 004C,E01020220,744,488,232,256,18,18,160,27,133,78,71,7,0
2021,Teignbridge 004D,E01020221,761,541,291,250,13,13,55,12,43,152,126,26,0
2021,Teignbridge 004E,E01020222,542,446,256,190,2,2,3,1,2,91,85,6,0
2021,Teignbridge 004F,E01020223,795,603,346,257,5,5,81,16,65,106,91,15,0
2021,Teignbridge 014D,E01020224,546,308,119,189,5,5,11,3,8,222,207,15,0
2021,Teignbridge 015B,E01020225,603,302,152,150,5,5,101,11,90,195,179,16,0
2021,Teignbridge 015C,E01020226,628,478,281,197,4,4,54,3,51,92,86,6,0
2021,Teignbridge 015D,E01020227,628,453,280,173,3,3,51,2,49,121,101,20,0
2021,Teignbridge 006A,E01020228,964,431,302,129,26,26,118,18,100,389,352,37,0
2021,Teignbridge 005B,E01020230,831,597,392,205,1,1,74,6,68,158,142,16,1
2021,Teignbridge 005C,E01020231,676,539,364,175,4,4,37,3,34,96,86,10,0
2021,Teignbridge 005D,E01020232,763,530,298,232,16,16,93,15,78,124,109,15,0
2021,Teignbridge 006B,E01020233,915,782,607,175,30,30,16,5,11,87,77,10,0
2021,Teignbridge 006C,E01020234,603,374,240,134,6,6,157,59,98,66,57,9,0
2021,Teignbridge 006D,E01020235,850,506,338,168,2,2,97,18,79,245,221,24,0
2021,Teignbridge 007C,E01020236,544,497,332,165,3,3,5,1,4,39,36,3,0
2021,Teignbridge 007D,E01020237,674,511,316,195,3,3,42,7,35,118,100,18,0
2021,Teignbridge 019C,E01020238,546,405,248,157,4,4,56,16,40,81,73,8,0
2021,Teignbridge 019D,E01020239,557,469,311,158,0,0,10,3,7,78,59,19,0
2021,Teignbridge 002A,E01020240,807,553,295,258,16,16,123,24,99,115,98,17,0
2021,Teignbridge 002B,E01020241,833,576,324,252,1,1,33,10,23,223,198,25,0
2021,Teignbridge 002C,E01020242,805,613,314,299,28,28,59,4,55,105,96,9,0
2021,Teignbridge 001A,E01020243,534,400,251,149,7,7,44,21,23,83,68,15,0
2021,Teignbridge 002D,E01020244,633,425,259,166,2,2,100,21,79,106,92,14,0
2021,Teignbridge 002E,E01020245,727,557,358,199,0,0,28,7,21,142,128,14,0
2021,Teignbridge 018A,E01020246,576,456,255,201,12,12,44,3,41,64,52,12,0
2021,Teignbridge 018B,E01020247,696,462,287,175,15,15,108,24,84,111,96,15,0
2021,Teignbridge 018C,E01020248,782,674,431,243,8,8,18,4,14,82,74,8,0
2021,Teignbridge 018D,E01020249,633,560,345,215,4,4,7,1,6,62,57,5,0
2021,Teignbridge 009A,E01020250,704,591,361,230,2,2,20,7,13,91,79,12,0
2021,Teignbridge 011C,E01020251,616,502,288,214,4,4,8,2,6,102,87,15,0
2021,Teignbridge 009B,E01020252,957,516,238,278,60,60,196,22,174,185,163,22,0
2021,Teignbridge 009C,E01020253,599,439,210,229,2,2,30,3,27,128,115,13,0
2021,Teignbridge 009D,E01020254,585,352,176,176,2,2,130,46,84,101,89,12,0
2021,Teignbridge 009E,E01020255,631,458,269,189,3,3,66,4,62,104,83,21,0
2021,Teignbridge 013D,E01020256,839,659,334,325,16,16,24,4,20,140,122,18,0
2021,Teignbridge 009F,E01020257,502,448,260,188,1,1,4,0,4,49,34,15,0
2021,Teignbridge 003B,E01020258,790,544,368,176,1,1,73,20,53,172,150,22,0
2021,Teignbridge 003C,E01020259,503,380,275,105,2,2,16,0,16,105,73,32,0
2021,Teignbridge 011D,E01020260,595,469,345,124,1,1,19,6,13,106,92,14,0
2021,Teignbridge 011E,E01020261,531,438,293,145,0,0,19,9,10,74,62,12,0
2021,Teignbridge 001B,E01020262,548,442,288,154,0,0,16,7,9,90,74,16,0
2021,Teignbridge 001C,E01020263,755,629,498,131,8,8,39,12,27,79,68,11,0
2021,Teignbridge 010A,E01020264,703,401,261,140,3,3,78,22,56,221,201,20,0
2021,Teignbridge 008A,E01020265,790,669,417,252,8,8,18,2,16,94,83,11,1
2021,Teignbridge 008B,E01020266,717,586,333,253,2,2,19,3,16,110,96,14,0
2021,Teignbridge 008C,E01020267,675,528,375,153,1,1,7,3,4,139,131,8,0
2021,Teignbridge 008D,E01020268,813,666,479,187,13,13,52,4,48,82,75,7,0
2021,Teignbridge 010B,E01020269,1122,492,376,116,6,6,102,31,71,522,477,45,0
2021,Teignbridge 008E,E01020270,725,593,326,267,7,7,9,0,9,115,101,14,1
2021,Teignbridge 010C,E01020271,683,387,197,190,10,10,126,15,111,160,146,14,0
2021,Teignbridge 010D,E01020272,746,409,220,189,4,4,234,77,157,98,75,23,1
2021,Teignbridge 003D,E01020273,650,491,312,179,11,11,80,21,59,68,53,15,0
2021,Teignbridge 001D,E01020274,550,443,285,158,3,3,9,3,6,95,77,18,0
2021,Torridge 001A,E01020275,628,408,284,124,1,1,69,15,54,150,131,19,0
2021,Torridge 001B,E01020276,686,528,355,173,19,19,50,12,38,89,71,18,0
2021,Torridge 004A,E01020277,940,444,269,175,7,7,349,58,291,140,129,11,0
2021,Torridge 004B,E01020278,653,511,300,211,10,10,26,4,22,106,81,25,0
2021,Torridge 004C,E01020279,1197,770,397,373,35,35,144,29,115,248,223,25,0
2021,Torridge 003A,E01020280,1144,503,275,228,8,8,98,15,83,535,479,56,0
2021,Torridge 003B,E01020281,868,738,468,270,7,7,6,0,6,117,100,17,0
2021,Torridge 003C,E01020282,773,427,276,151,4,4,164,13,151,178,160,18,0
2021,Torridge 004D,E01020283,1099,844,454,390,35,35,103,12,91,117,92,25,0
2021,Torridge 004E,E01020284,898,522,271,251,14,14,139,17,122,223,203,20,0
2021,Torridge 004F,E01020285,829,430,212,218,11,11,213,70,143,172,154,18,3
2021,Torridge 009A,E01020286,782,568,387,181,3,3,44,7,37,167,126,41,0
2021,Torridge 007A,E01020287,676,511,364,147,1,1,21,0,21,143,112,31,0
2021,Torridge 005A,E01020288,704,443,291,152,2,2,50,5,45,209,157,52,0
2021,Torridge 009B,E01020289,699,579,429,150,3,3,23,4,19,93,71,22,1
2021,Torridge 009C,E01020290,777,601,424,177,3,3,50,5,45,123,85,38,0
2021,Torridge 008A,E01020291,702,523,358,165,3,3,41,4,37,135,106,29,0
2021,Torridge 005B,E01020292,707,452,305,147,5,5,79,13,66,171,132,39,0
2021,Torridge 008B,E01020293,1120,737,522,215,9,9,57,12,45,317,277,40,0
2021,Torridge 008C,E01020294,1009,563,369,194,10,10,204,29,175,232,218,14,0
2021,Torridge 005C,E01020295,702,551,369,182,7,7,25,2,23,119,71,48,0
2021,Torridge 005D,E01020296,662,546,371,175,1,1,19,6,13,96,79,17,0
2021,Torridge 001C,E01020297,774,420,272,148,4,4,197,36,161,152,124,28,1
2021,Torridge 002A,E01020298,997,822,583,239,10,10,34,4,30,131,117,14,0
2021,Torridge 001D,E01020299,921,717,503,214,4,4,16,2,14,184,162,22,0
2021,Torridge 002B,E01020300,778,661,453,208,2,2,4,0,4,111,92,19,0
2021,Torridge 009D,E01020301,849,683,455,228,3,3,45,5,40,118,85,33,0
2021,Torridge 008D,E01020302,764,594,439,155,5,5,35,3,32,130,103,27,0
2021,Torridge 007B,E01020303,781,637,442,195,3,3,34,6,28,107,80,27,0
2021,Torridge 006A,E01020304,739,486,287,199,3,3,107,14,93,143,123,20,0
2021,Torridge 006B,E01020305,523,302,192,110,1,1,26,3,23,194,175,19,0
2021,Torridge 006C,E01020306,559,437,268,169,7,7,13,1,12,102,91,11,0
2021,Torridge 006D,E01020307,697,408,242,166,3,3,154,33,121,131,112,19,1
2021,Torridge 007C,E01020308,797,645,440,205,4,4,46,5,41,102,72,30,0
2021,Torridge 008E,E01020309,780,624,436,188,4,4,37,8,29,115,77,38,0
2021,Torridge 007D,E01020311,994,702,491,211,0,0,72,13,59,220,183,37,0
2021,West Devon 007A,E01020312,756,621,461,160,9,9,33,3,30,93,75,18,0
2021,West Devon 007B,E01020313,654,398,227,171,6,6,135,38,97,114,96,18,1
2021,West Devon 004A,E01020314,722,557,392,165,3,3,29,8,21,133,100,33,0
2021,West Devon 007C,E01020315,711,467,300,167,0,0,134,21,113,110,100,10,0
2021,West Devon 007D,E01020316,781,657,438,219,3,3,15,1,14,105,63,42,1
2021,West Devon 006A,E01020317,649,558,394,164,2,2,22,3,19,67,51,16,0
2021,West Devon 003A,E01020318,764,495,371,124,8,8,91,20,71,170,147,23,0
2021,West Devon 003B,E01020319,748,567,377,190,3,3,55,11,44,123,97,26,0
2021,West Devon 001A,E01020320,753,608,428,180,0,0,13,0,13,132,86,46,0
2021,West Devon 001B,E01020321,1015,661,437,224,10,10,102,14,88,242,218,24,0
2021,West Devon 003C,E01020323,679,478,292,186,5,5,66,18,48,130,111,19,0
2021,West Devon 006B,E01020324,701,578,404,174,3,3,45,14,31,75,61,14,0
2021,West Devon 004B,E01020325,710,513,315,198,3,3,18,8,10,176,144,32,0
2021,West Devon 001D,E01020326,994,697,432,265,4,4,95,24,71,198,168,30,0
2021,West Devon 002A,E01020327,848,597,385,212,5,5,60,2,58,186,177,9,0
2021,West Devon 002B,E01020328,984,535,249,286,5,5,157,20,137,286,255,31,1
2021,West Devon 002C,E01020329,760,514,350,164,2,2,120,18,102,124,104,20,0
2021,West Devon 002D,E01020330,926,516,357,159,2,2,128,26,102,280,253,27,0
2021,West Devon 004C,E01020331,707,528,360,168,1,1,43,12,31,135,110,25,0
2021,West Devon 005A,E01020332,973,530,354,176,1,1,87,14,73,355,335,20,0
2021,West Devon 005B,E01020333,964,761,482,279,10,10,75,13,62,118,101,17,0
2021,West Devon 005C,E01020334,871,560,356,204,8,8,138,23,115,164,144,20,1
2021,West Devon 005D,E01020335,719,560,391,169,4,4,96,28,68,59,50,9,0
2021,West Devon 005E,E01020336,630,568,425,143,1,1,13,2,11,48,36,12,0
2021,West Devon 005F,E01020337,591,356,238,118,5,5,135,39,96,92,75,17,3
2021,West Devon 005G,E01020338,1085,714,439,275,23,23,172,28,144,174,152,22,2
2021,West Devon 003D,E01020339,722,546,360,186,0,0,67,13,54,108,88,20,1
2021,West Devon 004D,E01020340,756,551,371,180,3,3,51,15,36,151,118,33,0
2021,West Devon 006C,E01020341,687,601,407,194,2,2,8,3,5,76,67,9,0
2021,West Devon 006D,E01020342,676,429,254,175,2,2,155,41,114,89,71,18,1
2021,"Bournemouth, Christchurch and Poole 002A",E01020343,663,528,328,200,2,2,82,4,78,51,45,6,0
2021,"Bournemouth, Christchurch and Poole 002B",E01020344,578,433,190,243,15,15,45,6,39,84,75,9,1
2021,"Bournemouth, Christchurch and Poole 002C",E01020345,586,421,259,162,3,3,80,7,73,82,67,15,0
2021,"Bournemouth, Christchurch and Poole 024A",E01020346,716,409,229,180,26,26,202,18,184,79,73,6,0
2021,"Bournemouth, Christchurch and Poole 024B",E01020347,779,300,145,155,3,3,392,51,341,84,75,9,0
2021,"Bournemouth, Christchurch and Poole 024C",E01020348,640,272,143,129,9,9,312,45,267,46,37,9,1
2021,"Bournemouth, Christchurch and Poole 019A",E01020349,1086,706,559,147,12,12,140,14,126,228,214,14,0
2021,"Bournemouth, Christchurch and Poole 019B",E01020350,1013,887,722,165,6,6,20,5,15,100,87,13,0
2021,"Bournemouth, Christchurch and Poole 014A",E01020351,523,420,233,187,2,2,33,6,27,68,53,15,0
2021,"Bournemouth, Christchurch and Poole 014B",E01020352,564,447,234,213,12,12,41,1,40,64,56,8,0
2021,"Bournemouth, Christchurch and Poole 014C",E01020353,700,415,225,190,12,12,199,24,175,74,59,15,0
2021,"Bournemouth, Christchurch and Poole 033A",E01020354,713,473,299,174,5,5,89,5,84,146,131,15,0
2021,"Bournemouth, Christchurch and Poole 033B",E01020355,937,829,642,187,0,0,11,0,11,97,81,16,0
2021,"Bournemouth, Christchurch and Poole 033C",E01020356,778,626,488,138,0,0,36,4,32,116,94,22,0
2021,"Bournemouth, Christchurch and Poole 019C",E01020357,931,723,398,325,4,4,110,43,67,93,75,18,1
2021,"Bournemouth, Christchurch and Poole 019D",E01020358,695,636,447,189,1,1,10,4,6,48,40,8,0
2021,"Bournemouth, Christchurch and Poole 014D",E01020359,540,340,167,173,20,20,103,10,93,77,70,7,0
2021,"Bournemouth, Christchurch and Poole 031A",E01020360,729,487,235,252,4,4,74,11,63,164,148,16,0
2021,"Bournemouth, Christchurch and Poole 031B",E01020361,747,481,233,248,33,33,30,3,27,203,184,19,0
2021,"Bournemouth, Christchurch and Poole 033D",E01020362,686,610,425,185,1,1,14,5,9,61,53,8,0
2021,"Bournemouth, Christchurch and Poole 024D",E01020363,514,279,164,115,11,11,148,8,140,76,71,5,0
2021,"Bournemouth, Christchurch and Poole 031C",E01020364,830,513,344,169,4,4,175,16,159,136,120,16,2
2021,"Bournemouth, Christchurch and Poole 002D",E01020365,858,682,491,191,1,1,51,3,48,124,107,17,0
2021,"Bournemouth, Christchurch and Poole 014E",E01020366,959,869,573,296,1,1,7,4,3,82,66,16,0
2021,"Bournemouth, Christchurch and Poole 031D",E01020367,942,697,516,181,4,4,39,8,31,202,178,24,0
2021,"Bournemouth, Christchurch and Poole 018A",E01020369,653,544,366,178,0,0,10,5,5,99,90,9,0
2021,"Bournemouth, Christchurch and Poole 018B",E01020370,722,579,321,258,20,20,23,3,20,100,82,18,0
2021,"Bournemouth, Christchurch and Poole 018C",E01020371,753,715,515,200,0,0,4,3,1,34,27,7,0
2021,"Bournemouth, Christchurch and Poole 018D",E01020372,721,606,411,195,13,13,27,5,22,75,64,11,0
2021,Dorset 007A,E01020373,513,387,187,200,0,0,55,7,48,71,62,9,0
2021,Dorset 007B,E01020374,663,626,398,228,2,2,3,0,3,32,24,8,0
2021,Dorset 020A,E01020375,626,499,329,170,5,5,49,6,43,73,57,16,0
2021,Dorset 020B,E01020376,488,432,267,165,3,3,14,2,12,39,32,7,0
2021,Dorset 017A,E01020377,640,585,346,239,3,3,5,0,5,46,37,9,1
2021,Dorset 020C,E01020378,642,548,294,254,1,1,20,3,17,73,59,14,0
2021,Dorset 017B,E01020379,670,474,286,188,2,2,148,14,134,46,38,8,0
2021,Dorset 017C,E01020380,700,550,279,271,19,19,54,9,45,77,56,21,0
2021,Dorset 017D,E01020381,508,465,292,173,3,3,2,1,1,38,35,3,0
2021,Dorset 025A,E01020382,638,528,273,255,2,2,12,2,10,96,83,13,0
2021,Dorset 025B,E01020383,826,752,479,273,2,2,9,0,9,63,53,10,0
2021,Dorset 025C,E01020384,628,496,221,275,4,4,32,2,30,96,82,14,0
2021,Dorset 025D,E01020385,515,371,217,154,0,0,84,5,79,60,47,13,0
2021,Dorset 025E,E01020386,574,510,307,203,1,1,35,7,28,28,23,5,0
2021,Dorset 025F,E01020387,474,444,297,147,1,1,4,1,3,25,16,9,0
2021,Dorset 025G,E01020388,636,440,232,208,0,0,123,10,113,73,63,10,0
2021,Dorset 007C,E01020389,870,489,308,181,2,2,112,13,99,267,225,42,0
2021,Dorset 018A,E01020390,710,570,446,124,5,5,66,4,62,69,54,15,0
2021,Dorset 018B,E01020391,687,607,460,147,1,1,8,1,7,71,63,8,0
2021,Dorset 018C,E01020392,898,656,492,164,4,4,60,8,52,178,162,16,0
2021,Dorset 018D,E01020393,563,286,107,179,2,2,161,26,135,114,96,18,0
2021,Dorset 018E,E01020394,816,572,452,120,1,1,179,16,163,64,50,14,0
2021,Dorset 024A,E01020395,951,838,681,157,1,1,13,0,13,99,90,9,0
2021,Dorset 013A,E01020396,482,281,177,104,2,2,27,0,27,172,148,24,0
2021,Dorset 007D,E01020397,643,416,249,167,3,3,91,13,78,133,117,16,0
2021,Dorset 013B,E01020398,966,795,489,306,2,2,42,2,40,127,95,32,0
2021,Dorset 024B,E01020400,687,622,399,223,2,2,2,0,2,61,49,12,0
2021,Dorset 024C,E01020401,784,696,515,181,7,7,18,4,14,63,52,11,0
2021,Dorset 024D,E01020402,649,601,382,219,1,1,4,1,3,43,32,11,0
2021,Dorset 015A,E01020403,678,618,406,212,2,2,21,6,15,37,18,19,0
2021,Dorset 015B,E01020404,744,641,445,196,3,3,45,8,37,55,38,17,0
2021,Dorset 015C,E01020405,914,713,463,250,34,34,54,6,48,112,88,24,1
2021,Dorset 015D,E01020406,1145,1093,815,278,3,3,5,0,5,44,35,9,0
2021,Dorset 020D,E01020407,519,469,285,184,1,1,5,1,4,44,37,7,0
2021,Dorset 020E,E01020408,488,423,267,156,1,1,34,4,30,30,23,7,0
2021,Dorset 013C,E01020409,513,433,253,180,4,4,17,3,14,59,48,11,0
2021,Dorset 013D,E01020410,518,217,136,81,1,1,136,13,123,164,116,48,0
2021,Dorset 012A,E01020411,434,295,177,118,3,3,91,8,83,45,37,8,0
2021,Dorset 012B,E01020412,575,306,139,167,0,0,181,13,168,86,74,12,2
2021,Dorset 012C,E01020413,621,554,342,212,2,2,14,0,14,51,44,7,0
2021,Dorset 012D,E01020414,854,657,410,247,1,1,78,8,70,118,105,13,0
2021,Dorset 012E,E01020415,613,574,349,225,0,0,10,0,10,29,23,6,0
2021,Dorset 010A,E01020416,674,504,208,296,2,2,6,1,5,162,140,22,0
2021,Dorset 010B,E01020417,477,414,226,188,0,0,7,0,7,56,48,8,0
2021,Dorset 010C,E01020418,705,664,470,194,1,1,4,0,4,36,25,11,0
2021,Dorset 010D,E01020419,854,734,398,336,16,16,29,6,23,75,66,9,0
2021,Dorset 010E,E01020420,579,492,262,230,3,3,38,5,33,46,36,10,0
2021,Dorset 016A,E01020421,521,416,284,132,1,1,41,3,38,63,26,37,0
2021,Dorset 016B,E01020422,883,635,507,128,5,5,143,19,124,100,81,19,0
2021,Dorset 016C,E01020423,653,588,419,169,0,0,26,2,24,39,28,11,0
2021,Dorset 016D,E01020424,655,572,382,190,1,1,50,8,42,32,20,12,0
2021,Dorset 016E,E01020425,822,706,548,158,6,6,36,3,33,74,53,21,0
2021,Dorset 021A,E01020426,815,627,453,174,4,4,34,5,29,150,124,26,0
2021,Dorset 021B,E01020427,986,447,211,236,30,30,429,40,389,80,63,17,0
2021,Dorset 021C,E01020428,1104,604,452,152,7,7,199,12,187,293,252,41,1
2021,Dorset 021D,E01020429,971,570,317,253,33,33,176,11,165,192,164,28,0
2021,Dorset 014A,E01020430,652,501,348,153,3,3,69,6,63,79,63,16,0
2021,Dorset 014B,E01020431,447,308,195,113,0,0,58,3,55,81,73,8,0
2021,Dorset 014C,E01020432,570,374,223,151,2,2,88,12,76,106,85,21,0
2021,Dorset 005A,E01020433,781,595,414,181,4,4,47,4,43,135,101,34,0
2021,Dorset 005B,E01020434,838,580,409,171,6,6,169,16,153,83,66,17,0
2021,Dorset 011A,E01020435,796,592,320,272,6,6,72,3,69,124,111,13,2
2021,Dorset 011B,E01020436,907,612,295,317,29,29,142,9,133,124,117,7,0
2021,Dorset 011C,E01020437,832,610,354,256,9,9,131,15,116,82,59,23,0
2021,Dorset 011D,E01020438,1122,558,347,211,19,19,231,18,213,311,272,39,3
2021,Dorset 011E,E01020439,1110,641,349,292,0,0,308,29,279,157,135,22,4
2021,Dorset 002A,E01020440,878,699,469,230,6,6,82,4,78,91,78,13,0
2021,Dorset 014D,E01020441,866,642,435,207,8,8,124,8,116,92,66,26,0
2021,Dorset 009A,E01020442,884,658,440,218,3,3,59,4,55,164,122,42,0
2021,Dorset 001A,E01020443,1148,601,352,249,14,14,220,39,181,313,287,26,0
2021,Dorset 006A,E01020444,774,498,317,181,7,7,164,13,151,105,88,17,0
2021,Dorset 006B,E01020445,517,399,288,111,2,2,35,1,34,81,53,28,0
2021,Dorset 006C,E01020446,704,583,409,174,6,6,58,3,55,57,42,15,0
2021,Dorset 001B,E01020447,850,605,412,193,2,2,151,21,130,92,74,18,0
2021,Dorset 014E,E01020448,862,651,428,223,10,10,83,9,74,118,77,41,0
2021,Dorset 005C,E01020449,947,748,575,173,4,4,108,8,100,87,70,17,0
2021,Dorset 002B,E01020450,973,706,398,308,13,13,43,6,37,211,181,30,0
2021,Dorset 009B,E01020452,853,489,272,217,9,9,214,9,205,141,108,33,0
2021,Dorset 009C,E01020453,773,622,379,243,6,6,59,6,53,85,70,15,1
2021,Dorset 003A,E01020454,1045,567,391,176,5,5,215,16,199,257,228,29,1
2021,Dorset 003B,E01020456,785,505,279,226,13,13,110,16,94,157,139,18,0
2021,Dorset 003C,E01020457,793,604,456,148,0,0,59,3,56,130,117,13,0
2021,Dorset 005D,E01020458,947,740,496,244,7,7,22,4,18,178,151,27,0
2021,Dorset 006D,E01020460,869,680,470,210,3,3,76,14,62,110,88,22,0
2021,Dorset 002C,E01020462,833,682,472,210,3,3,52,3,49,96,72,24,0
2021,Dorset 001C,E01020463,759,641,394,247,1,1,18,0,18,99,83,16,0
2021,Dorset 001D,E01020464,696,547,347,200,3,3,42,2,40,104,90,14,0
2021,Dorset 027A,E01020465,873,526,319,207,8,8,164,27,137,173,145,28,2
2021,Dorset 039A,E01020466,758,445,337,108,11,11,135,6,129,167,130,37,0
2021,Dorset 039B,E01020467,798,623,452,171,3,3,38,6,32,134,110,24,0
2021,Dorset 039C,E01020468,689,532,400,132,3,3,58,3,55,96,70,26,0
2021,Dorset 027B,E01020469,857,524,258,266,5,5,174,34,140,154,132,22,0
2021,Dorset 027C,E01020470,777,707,455,252,2,2,5,0,5,63,48,15,0
2021,Dorset 028A,E01020471,537,334,128,206,12,12,90,19,71,101,94,7,0
2021,Dorset 028B,E01020472,658,449,275,174,16,16,111,10,101,82,73,9,0
2021,Dorset 028C,E01020473,701,535,299,236,4,4,21,2,19,141,121,20,0
2021,Dorset 028D,E01020474,866,742,516,226,5,5,13,3,10,106,90,16,0
2021,Dorset 028E,E01020475,940,747,401,346,13,13,67,15,52,113,98,15,0
2021,Dorset 033A,E01020476,515,422,301,121,0,0,23,14,9,70,53,17,0
2021,Dorset 033B,E01020477,583,407,236,171,2,2,125,17,108,48,42,6,1
2021,Dorset 042A,E01020478,495,410,283,127,3,3,10,1,9,71,55,16,1
2021,Dorset 042B,E01020479,627,430,354,76,1,1,64,7,57,132,113,19,0
2021,Dorset 042C,E01020480,826,639,506,133,8,8,74,13,61,105,86,19,0
2021,Dorset 042D,E01020481,689,493,374,119,6,6,50,3,47,140,119,21,0
2021,Dorset 042E,E01020482,759,452,307,145,3,3,71,6,65,233,193,40,0
2021,Dorset 042F,E01020483,479,307,193,114,3,3,127,17,110,42,35,7,0
2021,Dorset 042G,E01020484,639,414,277,137,5,5,151,22,129,68,58,10,1
2021,Dorset 033C,E01020485,747,365,277,88,0,0,202,31,171,180,162,18,0
2021,Dorset 033D,E01020486,814,542,407,135,12,12,151,19,132,109,96,13,0
2021,Dorset 033E,E01020487,519,438,269,169,8,8,18,2,16,55,47,8,0
2021,Dorset 033F,E01020488,669,463,317,146,4,4,104,17,87,98,89,9,0
2021,Dorset 035A,E01020489,567,302,217,85,2,2,53,6,47,210,118,92,0
2021,Dorset 035B,E01020490,727,495,334,161,1,1,77,15,62,154,112,42,0
2021,Dorset 035C,E01020491,710,503,333,170,18,18,90,9,81,99,77,22,0
2021,Dorset 035D,E01020492,552,394,272,122,9,9,86,13,73,61,50,11,2
2021,Dorset 035E,E01020493,781,309,98,211,1,1,206,34,172,265,81,184,0
2021,Dorset 019A,E01020494,549,399,262,137,16,16,50,3,47,84,64,20,0
2021,Dorset 019B,E01020495,675,489,367,122,1,1,53,1,52,132,105,27,0
2021,Dorset 019C,E01020496,818,489,384,105,1,1,226,21,205,102,80,22,0
2021,Dorset 008A,E01020497,825,663,433,230,4,4,56,6,50,101,81,20,1
2021,Dorset 026A,E01020498,951,733,523,210,4,4,99,6,93,115,86,29,0
2021,Dorset 026B,E01020499,630,268,161,107,1,1,280,33,247,81,61,20,0
2021,Dorset 026C,E01020500,923,575,448,127,9,9,131,7,124,208,177,31,0
2021,Dorset 026D,E01020501,607,493,348,145,0,0,43,1,42,71,56,15,0
2021,Dorset 030A,E01020502,869,381,267,114,8,8,364,30,334,116,102,14,0
2021,Dorset 030B,E01020503,913,538,408,130,8,8,122,9,113,245,212,33,0
2021,Dorset 030C,E01020504,1078,913,727,186,18,18,23,1,22,124,95,29,0
2021,Dorset 036A,E01020505,848,677,447,230,12,12,82,5,77,77,58,19,0
2021,Dorset 019D,E01020506,797,603,464,139,3,3,70,4,66,120,82,38,1
2021,Dorset 029A,E01020507,887,674,550,124,8,8,88,4,84,117,88,29,0
2021,Dorset 008B,E01020508,888,662,484,178,17,17,59,5,54,150,108,42,0
2021,Dorset 022A,E01020509,1192,914,606,308,13,13,63,4,59,202,155,47,0
2021,Dorset 022B,E01020510,1118,733,451,282,25,25,233,17,216,127,111,16,0
2021,Dorset 023A,E01020511,808,574,444,130,12,12,119,4,115,103,79,24,0
2021,Dorset 037A,E01020512,958,655,466,189,12,12,86,7,79,205,171,34,0
2021,Dorset 037B,E01020513,744,489,298,191,6,6,157,6,151,92,79,13,0
2021,Dorset 037C,E01020514,820,592,335,257,43,43,78,3,75,107,88,19,0
2021,Dorset 037D,E01020515,509,384,229,155,2,2,37,4,33,86,71,15,0
2021,Dorset 037E,E01020516,693,532,363,169,1,1,71,18,53,89,61,28,0
2021,Dorset 029B,E01020517,844,657,514,143,3,3,32,4,28,152,118,34,0
2021,Dorset 034A,E01020518,823,397,233,164,13,13,272,18,254,141,131,10,0
2021,Dorset 034B,E01020519,802,520,358,162,2,2,111,2,109,169,156,13,0
2021,Dorset 034C,E01020520,680,489,301,188,4,4,81,7,74,106,93,13,0
2021,Dorset 034D,E01020523,527,417,246,171,1,1,16,1,15,93,87,6,0
2021,Dorset 034E,E01020524,621,526,343,183,2,2,42,1,41,51,40,11,0
2021,Dorset 034F,E01020525,515,482,303,179,1,1,13,0,13,19,17,2,0
2021,Dorset 032A,E01020526,527,412,281,131,1,1,75,6,69,39,31,8,0
2021,Dorset 032B,E01020527,615,363,192,171,9,9,100,6,94,143,117,26,0
2021,Dorset 032C,E01020528,1102,636,417,219,23,23,256,15,241,187,168,19,0
2021,Dorset 022C,E01020529,1011,747,480,267,5,5,82,4,78,177,142,35,0
2021,Dorset 019E,E01020530,824,548,381,167,8,8,45,5,40,223,179,44,0
2021,Dorset 029C,E01020531,793,586,434,152,3,3,63,5,58,141,114,27,0
2021,Dorset 023B,E01020532,832,686,557,129,0,0,19,1,18,127,105,22,0
2021,Dorset 023C,E01020533,1007,612,424,188,23,23,280,12,268,92,63,29,0
2021,Dorset 019F,E01020534,929,634,421,213,7,7,108,2,106,180,148,32,0
2021,Dorset 023D,E01020535,784,602,455,147,6,6,66,6,60,110,79,31,0
2021,Dorset 029D,E01020536,969,652,447,205,31,31,127,6,121,159,132,27,0
2021,Dorset 036B,E01020537,896,681,439,242,2,2,51,2,49,162,118,44,0
2021,Dorset 036C,E01020538,837,597,359,238,8,8,146,11,135,86,74,12,0
2021,Dorset 022D,E01020539,897,620,406,214,14,14,96,18,78,167,111,56,0
2021,Dorset 022E,E01020540,1122,808,507,301,12,12,111,8,103,191,141,50,0
2021,Dorset 008C,E01020541,946,581,396,185,6,6,104,8,96,254,211,43,1
2021,Dorset 004A,E01020542,711,465,369,96,2,2,109,4,105,135,123,12,0
2021,Dorset 004B,E01020543,653,353,237,116,6,6,192,13,179,102,85,17,0
2021,Dorset 004C,E01020544,856,580,462,118,5,5,73,4,69,198,168,30,0
2021,Dorset 004D,E01020546,541,204,159,45,4,4,111,8,103,222,193,29,0
2021,Dorset 004E,E01020547,585,302,199,103,0,0,210,13,197,73,56,17,0
2021,Dorset 036D,E01020549,932,644,425,219,14,14,76,0,76,198,154,44,0
2021,Dorset 008D,E01020550,780,589,400,189,11,11,86,4,82,92,74,18,2
2021,Dorset 038A,E01020551,1015,575,279,296,16,16,161,34,127,262,231,31,1
2021,Dorset 038B,E01020552,765,238,114,124,6,6,453,88,365,68,62,6,0
2021,Dorset 044A,E01020553,679,314,145,169,7,7,108,18,90,250,227,23,0
2021,Dorset 044B,E01020554,1075,364,279,85,5,5,61,19,42,645,605,40,0
2021,Dorset 044C,E01020555,744,336,212,124,6,6,53,11,42,349,333,16,0
2021,Dorset 044D,E01020556,852,402,306,96,6,6,93,1,92,351,328,23,0
2021,Dorset 040A,E01020557,802,710,557,153,3,3,4,0,4,85,74,11,0
2021,Dorset 040B,E01020558,820,711,512,199,1,1,10,5,5,98,84,14,0
2021,Dorset 040C,E01020559,822,785,618,167,8,8,5,0,5,24,22,2,0
2021,Dorset 040D,E01020560,818,697,479,218,2,2,15,1,14,104,87,17,0
2021,Dorset 040E,E01020561,853,516,285,231,31,31,106,4,102,200,180,20,0
2021,Dorset 048A,E01020562,990,736,425,311,3,3,20,5,15,231,203,28,0
2021,Dorset 047A,E01020563,544,390,234,156,3,3,44,5,39,107,101,6,0
2021,Dorset 048B,E01020564,661,391,194,197,11,11,156,32,124,103,92,11,0
2021,Dorset 048C,E01020565,689,513,318,195,3,3,53,8,45,120,101,19,0
2021,Dorset 048D,E01020566,955,782,519,263,8,8,29,6,23,136,117,19,0
2021,Dorset 047B,E01020569,813,232,169,63,1,1,332,65,267,247,234,13,1
2021,Dorset 038C,E01020570,733,614,399,215,2,2,10,0,10,107,88,19,0
2021,Dorset 038D,E01020571,968,595,281,314,7,7,193,41,152,172,148,24,1
2021,Dorset 043A,E01020572,894,586,276,310,1,1,33,3,30,274,253,21,0
2021,Dorset 043B,E01020573,922,505,315,190,12,12,198,31,167,205,186,19,2
2021,Dorset 041A,E01020574,784,536,325,211,9,9,154,24,130,85,73,12,0
2021,Dorset 041B,E01020575,749,300,132,168,3,3,372,82,290,73,62,11,1
2021,Dorset 041C,E01020576,759,638,435,203,0,0,40,0,40,81,66,15,0
2021,Dorset 043C,E01020577,788,573,289,284,22,22,97,20,77,96,86,10,0
2021,Dorset 043D,E01020578,930,563,323,240,3,3,270,57,213,94,88,6,0
2021,Dorset 041D,E01020579,910,743,493,250,5,5,29,2,27,133,111,22,0
2021,Dorset 041E,E01020580,645,565,354,211,3,3,13,2,11,64,42,22,0
2021,Dorset 044E,E01020581,928,619,469,150,5,5,53,2,51,251,224,27,0
2021,Dorset 044F,E01020582,780,376,267,109,2,2,219,34,185,183,169,14,0
2021,Dorset 045A,E01020583,820,652,414,238,4,4,22,9,13,142,126,16,0
2021,Dorset 045B,E01020584,750,506,273,233,5,5,104,16,88,135,119,16,0
2021,Dorset 045C,E01020585,604,379,205,174,7,7,175,33,142,43,32,11,0
2021,Dorset 046A,E01020586,536,413,251,162,1,1,54,9,45,68,54,14,0
2021,Dorset 046B,E01020587,661,406,246,160,8,8,104,15,89,143,123,20,0
2021,Dorset 046C,E01020588,595,449,291,158,2,2,14,3,11,130,119,11,0
2021,Dorset 046D,E01020589,638,424,261,163,4,4,111,15,96,99,83,16,0
2021,County Durham 015A,E01020590,585,425,272,153,1,1,46,3,43,113,104,9,0
2021,County Durham 015B,E01020591,658,326,195,131,0,0,220,85,135,111,99,12,1
2021,County Durham 011A,E01020592,626,183,83,100,10,10,390,183,207,42,29,13,1
2021,County Durham 011B,E01020593,672,309,158,151,0,0,148,51,97,215,184,31,0
2021,County Durham 013A,E01020594,777,513,293,220,0,0,18,9,9,246,226,20,0
2021,County Durham 013B,E01020595,778,637,392,245,3,3,35,12,23,103,76,27,0
2021,County Durham 007A,E01020596,742,371,169,202,4,4,258,103,155,108,89,19,1
2021,County Durham 007B,E01020597,659,567,339,228,3,3,24,11,13,65,54,11,0
2021,County Durham 007C,E01020598,818,611,378,233,5,5,55,16,39,145,127,18,2
2021,County Durham 011C,E01020599,882,334,162,172,3,3,425,150,275,119,105,14,1
2021,County Durham 013C,E01020600,634,596,378,218,5,5,9,8,1,24,17,7,0
2021,County Durham 011D,E01020601,633,474,251,223,0,0,104,45,59,55,48,7,0
2021,County Durham 011E,E01020602,904,375,185,190,9,9,411,160,251,109,103,6,0
2021,County Durham 013D,E01020603,667,641,361,280,0,0,2,2,0,24,20,4,0
2021,County Durham 019A,E01020604,648,445,271,174,3,3,126,51,75,74,62,12,0
2021,County Durham 013E,E01020605,801,676,383,293,2,2,10,3,7,113,102,11,0
2021,County Durham 005A,E01020606,691,384,234,150,1,1,94,49,45,211,192,19,1
2021,County Durham 019B,E01020607,820,494,250,244,5,5,221,77,144,99,85,14,1
2021,County Durham 015C,E01020608,837,554,266,288,0,0,211,71,140,72,57,15,0
2021,County Durham 015D,E01020609,596,433,264,169,1,1,124,39,85,37,29,8,1
2021,County Durham 015E,E01020610,617,518,316,202,0,0,49,19,30,50,42,8,0
2021,County Durham 007D,E01020611,790,667,341,326,19,19,48,6,42,56,47,9,0
2021,County Durham 007E,E01020612,668,625,417,208,2,2,12,8,4,29,23,6,0
2021,County Durham 002A,E01020613,555,510,300,210,2,2,17,8,9,26,20,6,0
2021,County Durham 002B,E01020614,685,472,293,179,8,8,122,46,76,83,72,11,0
2021,County Durham 005B,E01020615,747,336,147,189,5,5,304,119,185,101,88,13,1
2021,County Durham 005C,E01020616,788,399,192,207,0,0,256,89,167,133,119,14,0
2021,County Durham 005D,E01020617,1129,881,360,521,2,2,89,34,55,157,136,21,0
2021,County Durham 011F,E01020618,898,506,172,334,17,17,264,106,158,109,98,11,2
2021,County Durham 019C,E01020619,722,497,245,252,3,3,96,39,57,125,115,10,1
2021,County Durham 019D,E01020620,700,416,212,204,0,0,161,70,91,123,110,13,0
2021,County Durham 019E,E01020621,945,492,257,235,1,1,312,118,194,140,130,10,0
2021,County Durham 002C,E01020622,680,573,298,275,0,0,32,8,24,75,64,11,0
2021,County Durham 002D,E01020623,670,563,279,284,1,1,12,4,8,94,82,12,0
2021,County Durham 009A,E01020624,842,498,219,279,2,2,60,26,34,282,258,24,0
2021,County Durham 009B,E01020625,741,447,254,193,2,2,128,53,75,163,150,13,1
2021,County Durham 006A,E01020626,761,333,192,141,1,1,248,98,150,179,167,12,0
2021,County Durham 003A,E01020627,701,527,305,222,2,2,31,18,13,141,129,12,0
2021,County Durham 003B,E01020628,820,667,396,271,0,0,36,5,31,117,99,18,0
2021,County Durham 003C,E01020629,769,536,253,283,1,1,158,72,86,74,63,11,0
2021,County Durham 014A,E01020630,578,360,199,161,1,1,156,41,115,61,46,15,0
2021,County Durham 014B,E01020631,770,393,201,192,1,1,271,67,204,103,88,15,2
2021,County Durham 010A,E01020632,816,567,312,255,1,1,60,20,40,188,171,17,0
2021,County Durham 020A,E01020633,719,453,260,193,0,0,150,68,82,115,96,19,1
2021,County Durham 001A,E01020634,693,575,302,273,7,7,42,12,30,69,60,9,0
2021,County Durham 001B,E01020635,617,510,282,228,2,2,27,13,14,77,63,14,1
2021,County Durham 001C,E01020636,807,459,223,236,1,1,231,101,130,115,101,14,1
2021,County Durham 014C,E01020637,732,607,351,256,0,0,36,15,21,89,68,21,0
2021,County Durham 006B,E01020638,708,426,263,163,0,0,134,63,71,147,140,7,1
2021,County Durham 006C,E01020639,759,366,159,207,3,3,243,120,123,147,134,13,0
2021,County Durham 010B,E01020640,995,700,339,361,13,13,37,10,27,245,212,33,0
2021,County Durham 010C,E01020641,1050,580,305,275,2,2,166,37,129,299,276,23,3
2021,County Durham 010D,E01020642,629,469,258,211,2,2,46,17,29,112,97,15,0
2021,County Durham 010E,E01020643,1051,515,229,286,2,2,217,63,154,317,283,34,0
2021,County Durham 014E,E01020645,677,345,167,178,0,0,219,109,110,113,102,11,0
2021,County Durham 024A,E01020646,711,479,270,209,1,1,160,65,95,71,54,17,0
2021,County Durham 008A,E01020647,831,359,153,206,0,0,369,175,194,102,94,8,1
2021,County Durham 008B,E01020648,1093,676,190,486,1,1,280,141,139,136,128,8,0
2021,County Durham 008C,E01020649,742,404,220,184,0,0,175,76,99,163,150,13,0
2021,County Durham 012A,E01020650,991,718,326,392,1,1,101,44,57,171,155,16,0
2021,County Durham 012B,E01020651,799,561,345,216,2,2,106,46,60,130,108,22,0
2021,County Durham 012C,E01020652,856,534,244,290,2,2,181,66,115,139,128,11,0
2021,County Durham 006D,E01020653,687,392,203,189,2,2,193,78,115,100,84,16,0
2021,County Durham 001D,E01020654,802,627,290,337,1,1,85,26,59,89,68,21,0
2021,County Durham 003D,E01020655,866,657,376,281,1,1,133,43,90,75,59,16,0
2021,County Durham 003E,E01020656,680,447,257,190,3,3,157,56,101,73,55,18,0
2021,County Durham 003F,E01020657,618,513,269,244,0,0,30,11,19,75,59,16,0
2021,County Durham 024B,E01020658,880,426,199,227,4,4,248,100,148,202,175,27,0
2021,County Durham 024C,E01020659,638,516,301,215,1,1,17,4,13,104,89,15,0
2021,County Durham 024D,E01020660,695,491,298,193,1,1,117,38,79,86,73,13,0
2021,County Durham 004A,E01020661,801,447,221,226,1,1,112,42,70,241,228,13,0
2021,County Durham 004B,E01020662,783,455,227,228,0,0,219,84,135,109,101,8,0
2021,County Durham 004C,E01020663,858,642,377,265,1,1,74,28,46,141,117,24,0
2021,County Durham 020B,E01020664,754,626,393,233,0,0,15,5,10,113,85,28,0
2021,County Durham 020C,E01020665,664,433,268,165,0,0,158,55,103,73,52,21,0
2021,County Durham 020D,E01020666,628,557,360,197,1,1,18,7,11,52,35,17,0
2021,County Durham 010F,E01020667,835,576,334,242,5,5,100,24,76,153,131,22,1
2021,County Durham 012D,E01020668,662,361,191,170,1,1,115,49,66,185,163,22,0
2021,County Durham 012E,E01020669,622,410,220,190,0,0,140,58,82,71,60,11,1
2021,County Durham 009C,E01020670,759,408,255,153,0,0,182,90,92,169,161,8,0
2021,County Durham 009D,E01020671,639,279,162,117,2,2,63,10,53,294,278,16,1
2021,County Durham 009E,E01020672,815,483,277,206,1,1,125,21,104,206,194,12,0
2021,County Durham 008D,E01020673,775,323,176,147,0,0,298,151,147,153,136,17,1
2021,County Durham 004D,E01020674,734,394,249,145,2,2,232,127,105,106,93,13,0
2021,County Durham 008E,E01020675,836,371,194,177,2,2,292,159,133,171,153,18,0
2021,County Durham 001E,E01020676,685,499,275,224,2,2,69,30,39,115,99,16,0
2021,County Durham 006E,E01020677,699,397,233,164,1,1,243,96,147,58,49,9,0
2021,County Durham 004E,E01020678,571,388,226,162,3,3,85,42,43,95,86,9,0
2021,County Durham 026A,E01020679,725,383,178,205,1,1,243,134,109,93,80,13,5
2021,County Durham 026B,E01020680,716,611,327,284,2,2,19,6,13,82,69,13,2
2021,County Durham 026C,E01020681,696,392,197,195,1,1,212,108,104,89,75,14,2
2021,County Durham 028A,E01020682,825,749,509,240,3,3,18,5,13,55,45,10,0
2021,County Durham 028B,E01020683,684,576,329,247,1,1,10,4,6,97,84,13,0
2021,County Durham 038A,E01020685,717,528,314,214,0,0,106,60,46,83,68,15,0
2021,County Durham 038B,E01020686,779,302,144,158,1,1,381,208,173,93,81,12,2
2021,County Durham 038C,E01020687,675,455,288,167,1,1,176,58,118,43,34,9,0
2021,County Durham 038D,E01020688,676,394,218,176,2,2,178,100,78,102,87,15,0
2021,County Durham 038E,E01020689,698,281,132,149,1,1,323,182,141,93,84,9,0
2021,County Durham 028C,E01020690,637,530,357,173,2,2,18,8,10,87,70,17,0
2021,County Durham 028D,E01020691,639,398,221,177,2,2,119,71,48,119,107,12,1
2021,County Durham 028E,E01020692,717,615,385,230,0,0,11,3,8,91,74,17,0
2021,County Durham 029A,E01020693,621,310,184,126,3,3,148,51,97,160,148,12,0
2021,County Durham 041A,E01020694,714,350,178,172,2,2,276,146,130,85,79,6,1
2021,County Durham 044A,E01020695,993,663,272,391,0,0,212,88,124,118,91,27,0
2021,County Durham 041B,E01020696,606,370,205,165,1,1,131,77,54,104,90,14,0
2021,County Durham 041C,E01020697,685,427,240,187,33,33,28,4,24,197,183,14,0
2021,County Durham 044B,E01020698,673,558,295,263,1,1,34,3,31,80,70,10,0
2021,County Durham 044C,E01020699,646,326,156,170,6,6,215,126,89,99,89,10,0
2021,County Durham 044D,E01020700,712,412,257,155,2,2,208,124,84,90,63,27,0
2021,County Durham 044E,E01020701,644,440,238,202,1,1,98,50,48,105,87,18,0
2021,County Durham 033B,E01020702,1021,738,374,364,1,1,25,8,17,257,240,17,0
2021,County Durham 030A,E01020703,726,123,79,44,5,5,131,22,109,467,451,16,0
2021,County Durham 033C,E01020704,539,313,212,101,4,4,11,5,6,211,203,8,0
2021,County Durham 031A,E01020705,787,371,184,187,0,0,341,165,176,75,63,12,0
2021,County Durham 031B,E01020706,903,650,434,216,1,1,94,17,77,158,125,33,0
2021,County Durham 023A,E01020708,586,450,280,170,1,1,16,8,8,119,106,13,0
2021,County Durham 022A,E01020709,692,556,287,269,6,6,38,10,28,92,78,14,0
2021,County Durham 023B,E01020710,788,517,265,252,1,1,103,51,52,167,147,20,0
2021,County Durham 023C,E01020711,887,483,230,253,1,1,296,132,164,105,93,12,2
2021,County Durham 033D,E01020712,676,492,300,192,3,3,16,4,12,165,148,17,0
2021,County Durham 026D,E01020714,706,565,346,219,2,2,49,29,20,90,80,10,0
2021,County Durham 026E,E01020716,745,270,129,141,1,1,359,196,163,115,111,4,0
2021,County Durham 022B,E01020717,740,656,455,201,4,4,18,7,11,61,52,9,1
2021,County Durham 022C,E01020718,604,469,304,165,1,1,38,9,29,96,89,7,0
2021,County Durham 022D,E01020719,525,445,269,176,1,1,11,7,4,67,59,8,1
2021,County Durham 023D,E01020720,699,408,227,181,4,4,185,66,119,100,85,15,2
2021,County Durham 022E,E01020721,475,406,248,158,0,0,11,2,9,58,52,6,0
2021,County Durham 029B,E01020722,920,325,192,133,3,3,356,196,160,233,209,24,3
2021,County Durham 029C,E01020723,723,234,156,78,3,3,202,67,135,284,274,10,0
2021,County Durham 029D,E01020724,700,140,87,53,2,2,452,57,395,106,100,6,0
2021,County Durham 027A,E01020725,675,517,298,219,0,0,87,52,35,71,59,12,0
2021,County Durham 027B,E01020726,527,428,233,195,0,0,37,27,10,62,54,8,0
2021,County Durham 027C,E01020727,579,269,131,138,0,0,234,128,106,73,58,15,3
2021,County Durham 027D,E01020729,1022,610,282,328,2,2,247,143,104,163,140,23,0
2021,County Durham 027E,E01020730,789,452,233,219,10,10,233,125,108,91,76,15,3
2021,County Durham 027F,E01020731,665,490,271,219,0,0,103,55,48,72,55,17,0
2021,County Durham 041D,E01020732,1046,870,455,415,3,3,89,18,71,84,74,10,0
2021,County Durham 035A,E01020733,493,264,145,119,2,2,128,104,24,99,90,9,0
2021,County Durham 035B,E01020734,522,261,125,136,1,1,164,112,52,92,87,5,4
2021,County Durham 035C,E01020735,674,469,208,261,1,1,109,61,48,93,81,12,2
2021,County Durham 039B,E01020737,606,456,269,187,1,1,35,19,16,114,100,14,0
2021,County Durham 039D,E01020739,672,230,153,77,2,2,192,43,149,248,227,21,0
2021,County Durham 017A,E01020740,567,425,230,195,0,0,47,27,20,95,73,22,0
2021,County Durham 017B,E01020741,509,281,173,108,2,2,32,19,13,194,181,13,0
2021,County Durham 017C,E01020742,709,433,226,207,1,1,71,43,28,204,182,22,0
2021,County Durham 018A,E01020743,700,316,92,224,0,0,287,178,109,96,87,9,1
2021,County Durham 039E,E01020744,540,357,206,151,4,4,105,44,61,73,64,9,1
2021,County Durham 032A,E01020745,607,237,135,102,1,1,242,188,54,126,111,15,1
2021,County Durham 037A,E01020746,478,337,196,141,2,2,87,57,30,51,41,10,1
2021,County Durham 018B,E01020747,470,143,83,60,1,1,263,200,63,60,55,5,3
2021,County Durham 018C,E01020748,493,236,109,127,0,0,173,134,39,84,70,14,0
2021,County Durham 018D,E01020749,730,360,257,103,1,1,245,177,68,118,88,30,6
2021,County Durham 016A,E01020750,518,460,327,133,0,0,19,12,7,39,30,9,0
2021,County Durham 025A,E01020751,765,507,273,234,1,1,57,19,38,200,174,26,0
2021,County Durham 025B,E01020752,562,192,131,61,1,1,157,21,136,212,201,11,0
2021,County Durham 032B,E01020753,889,477,264,213,5,5,284,158,126,123,106,17,0
2021,County Durham 025C,E01020754,664,444,256,188,0,0,160,85,75,58,40,18,2
2021,County Durham 025D,E01020756,704,615,319,296,0,0,32,4,28,57,41,16,0
2021,County Durham 032C,E01020757,519,215,114,101,0,0,194,154,40,109,100,9,1
2021,County Durham 032D,E01020758,633,234,113,121,2,2,255,187,68,137,124,13,5
2021,County Durham 032E,E01020759,655,265,110,155,1,1,264,184,80,120,117,3,5
2021,County Durham 034A,E01020760,869,642,328,314,0,0,145,45,100,82,63,19,0
2021,County Durham 034B,E01020761,689,346,168,178,2,2,185,79,106,155,137,18,1
2021,County Durham 034C,E01020762,643,261,150,111,1,1,283,156,127,96,71,25,2
2021,County Durham 034D,E01020763,835,509,289,220,3,3,211,93,118,107,89,18,5
2021,County Durham 036A,E01020764,598,243,174,69,1,1,109,7,102,245,222,23,0
2021,County Durham 032F,E01020765,761,372,207,165,1,1,281,206,75,107,96,11,0
2021,County Durham 036B,E01020766,703,405,238,167,1,1,175,74,101,122,106,16,0
2021,County Durham 036C,E01020767,812,307,187,120,2,2,238,110,128,265,253,12,0
2021,County Durham 036D,E01020768,656,453,272,181,1,1,56,38,18,145,120,25,1
2021,County Durham 037B,E01020769,471,307,178,129,2,2,88,69,19,74,67,7,0
2021,County Durham 035D,E01020770,489,291,157,134,1,1,91,62,29,106,99,7,0
2021,County Durham 035E,E01020771,450,194,109,85,9,9,157,103,54,89,86,3,1
2021,County Durham 043A,E01020772,872,668,367,301,0,0,85,51,34,117,94,23,2
2021,County Durham 018E,E01020773,706,369,194,175,2,2,261,167,94,72,59,13,2
2021,County Durham 018F,E01020775,771,283,162,121,2,2,415,236,179,70,58,12,1
2021,County Durham 021C,E01020776,803,597,374,223,0,0,116,80,36,89,67,22,1
2021,County Durham 037C,E01020777,714,271,140,131,0,0,323,197,126,113,102,11,7
2021,County Durham 037D,E01020778,539,441,289,152,0,0,34,22,12,64,57,7,0
2021,County Durham 037E,E01020779,668,636,371,265,0,0,7,4,3,25,19,6,0
2021,County Durham 035F,E01020780,565,331,184,147,0,0,165,113,52,69,64,5,0
2021,County Durham 017D,E01020782,551,415,240,175,0,0,87,52,35,49,35,14,0
2021,County Durham 017E,E01020783,588,389,228,161,0,0,85,57,28,112,92,20,2
2021,County Durham 017F,E01020784,750,327,181,146,0,0,255,128,127,166,144,22,2
2021,County Durham 016D,E01020786,664,595,369,226,1,1,20,9,11,48,39,9,0
2021,County Durham 016E,E01020787,798,447,188,259,0,0,248,189,59,100,88,12,3
2021,County Durham 040A,E01020788,625,372,238,134,2,2,139,82,57,109,93,16,3
2021,County Durham 040B,E01020789,766,487,254,233,3,3,176,64,112,99,81,18,1
2021,County Durham 040C,E01020790,642,374,174,200,2,2,185,134,51,80,68,12,1
2021,County Durham 040D,E01020791,580,363,194,169,0,0,148,106,42,69,60,9,0
2021,County Durham 040E,E01020792,645,383,200,183,0,0,127,56,71,134,125,9,1
2021,County Durham 043B,E01020793,743,384,213,171,3,3,250,194,56,103,95,8,3
2021,County Durham 043C,E01020794,835,642,310,332,6,6,100,48,52,87,75,12,0
2021,County Durham 043D,E01020795,805,461,233,228,1,1,122,93,29,221,195,26,0
2021,County Durham 054A,E01020796,560,429,229,200,0,0,74,33,41,57,45,12,0
2021,County Durham 050A,E01020797,1188,601,359,242,0,0,341,159,182,246,211,35,0
2021,County Durham 050B,E01020798,752,273,153,120,0,0,383,193,190,95,80,15,1
2021,County Durham 050C,E01020799,709,395,221,174,0,0,171,90,81,143,135,8,0
2021,County Durham 059A,E01020801,678,471,281,190,2,2,54,16,38,151,134,17,0
2021,County Durham 059B,E01020802,903,466,253,213,3,3,212,60,152,221,205,16,1
2021,County Durham 053D,E01020805,922,435,211,224,1,1,371,217,154,114,101,13,1
2021,County Durham 049A,E01020806,634,349,223,126,0,0,195,96,99,90,70,20,0
2021,County Durham 049B,E01020807,674,253,181,72,2,2,117,27,90,302,272,30,0
2021,County Durham 050D,E01020808,655,394,252,142,1,1,112,38,74,148,130,18,0
2021,County Durham 048A,E01020809,617,293,150,143,3,3,256,145,111,64,55,9,1
2021,County Durham 048B,E01020810,540,378,192,186,1,1,54,22,32,104,90,14,3
2021,County Durham 048C,E01020811,560,336,162,174,0,0,154,80,74,70,61,9,0
2021,County Durham 048D,E01020812,670,452,263,189,0,0,113,69,44,103,88,15,2
2021,County Durham 060A,E01020813,513,467,266,201,0,0,8,3,5,38,29,9,0
2021,County Durham 060B,E01020814,593,392,170,222,3,3,123,21,102,75,65,10,0
2021,County Durham 060C,E01020815,569,411,237,174,0,0,85,53,32,73,63,10,0
2021,County Durham 061A,E01020816,580,198,110,88,1,1,269,151,118,112,105,7,0
2021,County Durham 047A,E01020817,538,480,298,182,0,0,4,2,2,54,47,7,0
2021,County Durham 047B,E01020818,695,427,260,167,1,1,171,91,80,96,79,17,0
2021,County Durham 047C,E01020819,467,196,121,75,3,3,217,88,129,51,41,10,0
2021,County Durham 049C,E01020820,936,402,141,261,11,11,359,111,248,164,147,17,0
2021,County Durham 052A,E01020821,881,675,336,339,1,1,100,57,43,105,92,13,0
2021,County Durham 052B,E01020822,942,736,383,353,22,22,72,29,43,112,92,20,0
2021,County Durham 052C,E01020823,921,378,216,162,1,1,375,190,185,167,151,16,0
2021,County Durham 063A,E01020824,755,397,206,191,2,2,223,116,107,133,119,14,0
2021,County Durham 062A,E01020825,794,470,211,259,14,14,231,116,115,79,65,14,0
2021,County Durham 063B,E01020826,670,411,251,160,0,0,192,94,98,65,55,10,2
2021,County Durham 048E,E01020827,793,511,294,217,1,1,143,78,65,138,121,17,0
2021,County Durham 054B,E01020828,670,579,360,219,1,1,20,11,9,70,51,19,0
2021,County Durham 054C,E01020829,1043,804,455,349,3,3,37,16,21,198,167,31,1
2021,County Durham 054D,E01020830,886,572,298,274,12,12,192,73,119,109,86,23,1
2021,County Durham 062B,E01020831,651,353,190,163,2,2,202,112,90,93,82,11,1
2021,County Durham 063C,E01020832,643,435,261,174,0,0,127,84,43,81,68,13,0
2021,County Durham 062C,E01020833,503,349,195,154,3,3,79,40,39,72,62,10,0
2021,County Durham 062D,E01020834,621,286,141,145,0,0,230,136,94,103,94,9,2
2021,County Durham 052D,E01020835,695,415,245,170,0,0,91,36,55,189,178,11,0
2021,County Durham 047D,E01020837,746,641,414,227,4,4,38,5,33,63,44,19,0
2021,County Durham 059C,E01020838,821,495,307,188,3,3,71,34,37,252,232,20,0
2021,County Durham 059D,E01020839,760,363,220,143,1,1,259,136,123,136,122,14,1
2021,County Durham 059E,E01020840,949,629,297,332,2,2,159,91,68,158,132,26,1
2021,County Durham 059F,E01020841,820,233,131,102,0,0,414,246,168,172,152,20,1
2021,County Durham 047E,E01020843,731,561,327,234,1,1,65,25,40,104,83,21,0
2021,County Durham 061B,E01020844,695,199,96,103,4,4,366,181,185,125,114,11,1
2021,County Durham 063D,E01020845,633,282,153,129,0,0,227,130,97,123,110,13,1
2021,County Durham 063E,E01020846,535,369,246,123,0,0,109,55,54,57,49,8,0
2021,County Durham 061C,E01020847,603,207,93,114,0,0,245,132,113,151,143,8,0
2021,County Durham 060D,E01020848,567,411,216,195,0,0,78,39,39,78,63,15,0
2021,County Durham 061D,E01020849,526,180,88,92,1,1,226,111,115,119,109,10,0
2021,County Durham 060E,E01020850,980,827,342,485,2,2,50,27,23,101,90,11,0
2021,County Durham 060F,E01020851,633,541,342,199,0,0,9,6,3,83,70,13,0
2021,County Durham 067E,E01020852,854,470,330,140,3,3,241,33,208,140,122,18,0
2021,County Durham 067D,E01020853,774,555,338,217,3,3,128,17,111,88,71,17,0
2021,County Durham 067F,E01020854,1117,765,488,277,13,13,123,19,104,216,192,24,0
2021,County Durham 067C,E01020855,557,455,318,137,0,0,43,5,38,59,52,7,0
2021,County Durham 064A,E01020856,740,484,316,168,0,0,128,34,94,127,103,24,1
2021,County Durham 067B,E01020857,648,464,327,137,5,5,73,14,59,106,82,24,0
2021,County Durham 064B,E01020858,486,360,216,144,3,3,76,21,55,47,37,10,0
2021,County Durham 064C,E01020859,547,465,305,160,1,1,12,7,5,68,55,13,1
2021,County Durham 064D,E01020860,483,234,143,91,4,4,150,41,109,95,84,11,0
2021,County Durham 064E,E01020861,544,405,247,158,1,1,44,14,30,94,75,19,0
2021,County Durham 064F,E01020862,1091,798,525,273,3,3,99,23,76,191,157,34,0
2021,County Durham 067G,E01020863,596,418,272,146,1,1,14,4,10,163,125,38,0
2021,County Durham 064G,E01020864,959,706,455,251,2,2,87,19,68,164,122,42,0
2021,County Durham 064H,E01020867,996,594,413,181,3,3,146,19,127,253,203,50,0
2021,County Durham 055A,E01020868,1061,611,284,327,13,13,138,40,98,297,272,25,2
2021,County Durham 055B,E01020869,649,390,222,168,1,1,34,7,27,224,213,11,0
2021,County Durham 056A,E01020870,599,560,385,175,0,0,7,2,5,32,21,11,0
2021,County Durham 056B,E01020871,623,451,276,175,1,1,22,13,9,149,135,14,0
2021,County Durham 056C,E01020872,824,528,304,224,0,0,78,13,65,218,192,26,0
2021,County Durham 051A,E01020873,671,248,153,95,0,0,328,196,132,93,76,17,2
2021,County Durham 055C,E01020874,744,393,205,188,2,2,127,85,42,222,204,18,0
2021,County Durham 051B,E01020875,612,441,262,179,2,2,74,12,62,95,83,12,0
2021,County Durham 045A,E01020876,801,488,256,232,2,2,173,52,121,138,122,16,0
2021,County Durham 046A,E01020877,726,469,299,170,2,2,48,23,25,207,188,19,0
2021,County Durham 045B,E01020878,755,349,156,193,0,0,332,172,160,72,55,17,2
2021,County Durham 046B,E01020879,1000,803,436,367,2,2,65,12,53,130,101,29,0
2021,County Durham 055D,E01020880,747,433,267,166,3,3,117,88,29,194,182,12,0
2021,County Durham 055E,E01020881,688,500,282,218,13,13,102,53,49,72,62,10,1
2021,County Durham 057A,E01020882,632,498,312,186,2,2,43,24,19,89,71,18,0
2021,County Durham 056D,E01020883,693,642,368,274,1,1,2,2,0,48,37,11,0
2021,County Durham 058A,E01020884,599,404,243,161,1,1,96,35,61,98,91,7,0
2021,County Durham 058B,E01020885,584,258,111,147,0,0,281,148,133,45,38,7,0
2021,County Durham 056E,E01020886,556,346,196,150,1,1,39,16,23,170,145,25,0
2021,County Durham 045C,E01020887,881,619,360,259,1,1,119,46,73,142,121,21,0
2021,County Durham 057B,E01020888,837,657,356,301,2,2,53,19,34,125,99,26,0
2021,County Durham 042A,E01020889,715,602,395,207,2,2,22,5,17,88,63,25,1
2021,County Durham 042B,E01020890,801,532,361,171,2,2,99,31,68,167,131,36,1
2021,County Durham 042C,E01020891,786,546,376,170,0,0,129,42,87,111,79,32,0
2021,County Durham 045D,E01020892,498,313,217,96,1,1,94,8,86,90,74,16,0
2021,County Durham 046C,E01020893,867,604,315,289,0,0,81,39,42,182,150,32,0
2021,County Durham 045E,E01020894,493,261,151,110,2,2,147,21,126,83,66,17,0
2021,County Durham 057C,E01020895,711,330,188,142,3,3,220,136,84,158,140,18,0
2021,County Durham 057D,E01020896,613,444,298,146,0,0,79,51,28,90,78,12,0
2021,County Durham 045F,E01020898,743,214,111,103,0,0,429,263,166,98,83,15,2
2021,County Durham 046D,E01020899,675,441,246,195,2,2,111,66,45,120,101,19,1
2021,County Durham 051C,E01020900,702,514,256,258,0,0,123,67,56,65,54,11,0
2021,County Durham 051D,E01020901,625,281,161,120,0,0,203,105,98,140,125,15,1
2021,County Durham 051E,E01020902,648,222,134,88,0,0,355,200,155,71,60,11,0
2021,County Durham 046E,E01020903,506,382,230,152,2,2,35,16,19,87,70,17,0
2021,County Durham 046F,E01020904,782,532,293,239,0,0,44,7,37,206,189,17,0
2021,County Durham 042D,E01020905,702,467,305,162,1,1,117,52,65,117,102,15,0
2021,County Durham 042E,E01020906,753,568,372,196,3,3,56,23,33,126,103,23,0
2021,County Durham 058C,E01020907,685,368,215,153,1,1,165,113,52,151,135,16,0
2021,County Durham 058D,E01020908,597,327,148,179,0,0,200,133,67,70,56,14,0
2021,County Durham 058E,E01020909,728,166,100,66,0,0,491,254,237,70,68,2,1
2021,Eastbourne 010A,E01020910,996,302,151,151,25,25,179,103,76,490,461,29,0
2021,Eastbourne 010B,E01020911,1098,239,116,123,7,7,59,30,29,791,749,42,2
2021,Eastbourne 010C,E01020912,1147,187,90,97,0,0,276,125,151,680,661,19,4
2021,Eastbourne 013A,E01020913,1060,616,360,256,9,9,232,137,95,202,190,12,1
2021,Eastbourne 007A,E01020914,808,428,201,227,4,4,22,4,18,354,335,19,0
2021,Eastbourne 007B,E01020915,821,468,276,192,6,6,77,6,71,270,248,22,0
2021,Eastbourne 010D,E01020916,779,363,177,186,6,6,33,13,20,377,351,26,0
2021,Eastbourne 002A,E01020917,579,206,88,118,1,1,280,142,138,91,82,9,1
2021,Eastbourne 002B,E01020918,622,415,198,217,2,2,49,19,30,156,146,10,0
2021,Eastbourne 002C,E01020919,591,351,176,175,3,3,95,86,9,141,129,12,1
2021,Eastbourne 004A,E01020920,727,219,111,108,2,2,322,234,88,178,170,8,6
2021,Eastbourne 004B,E01020921,582,382,196,186,0,0,134,127,7,66,54,12,0
2021,Eastbourne 004C,E01020922,609,265,139,126,2,2,215,49,166,127,122,5,0
2021,Eastbourne 002D,E01020923,549,170,71,99,0,0,293,111,182,84,80,4,2
2021,Eastbourne 001A,E01020924,543,373,188,185,3,3,90,53,37,74,60,14,3
2021,Eastbourne 001B,E01020925,584,235,103,132,2,2,242,209,33,103,93,10,2
2021,Eastbourne 003A,E01020926,608,458,256,202,4,4,98,16,82,48,42,6,0
2021,Eastbourne 001C,E01020927,561,348,165,183,15,15,110,90,20,86,80,6,2
2021,Eastbourne 001D,E01020928,781,549,372,177,2,2,68,36,32,162,145,17,0
2021,Eastbourne 003B,E01020929,793,339,182,157,12,12,289,209,80,152,139,13,1
2021,Eastbourne 001E,E01020930,495,187,54,133,29,29,210,121,89,68,57,11,1
2021,Eastbourne 012A,E01020931,782,569,443,126,6,6,42,8,34,165,144,21,0
2021,Eastbourne 012B,E01020932,787,609,527,82,1,1,63,4,59,114,97,17,0
2021,Eastbourne 011A,E01020935,1147,389,241,148,1,1,45,8,37,706,670,36,6
2021,Eastbourne 011B,E01020936,1004,609,522,87,9,9,10,3,7,376,345,31,0
2021,Eastbourne 011C,E01020937,848,359,263,96,2,2,66,20,46,418,368,50,3
2021,Eastbourne 009A,E01020938,622,428,211,217,4,4,102,89,13,86,77,9,2
2021,Eastbourne 009B,E01020939,640,504,275,229,7,7,11,4,7,118,105,13,0
2021,Eastbourne 006A,E01020940,617,513,295,218,0,0,19,2,17,85,76,9,0
2021,Eastbourne 006B,E01020941,636,324,163,161,1,1,249,239,10,60,54,6,2
2021,Eastbourne 006C,E01020942,622,531,289,242,2,2,14,11,3,75,65,10,0
2021,Eastbourne 009C,E01020943,749,496,263,233,0,0,72,32,40,180,169,11,1
2021,Eastbourne 012E,E01020944,601,522,326,196,1,1,21,21,0,57,47,10,0
2021,Eastbourne 004D,E01020945,789,714,490,224,1,1,14,4,10,60,50,10,0
2021,Eastbourne 006D,E01020946,736,665,447,218,0,0,4,2,2,67,58,9,0
2021,Eastbourne 006E,E01020947,698,433,231,202,2,2,156,124,32,106,99,7,1
2021,Eastbourne 008A,E01020948,683,461,340,121,3,3,83,11,72,136,88,48,0
2021,Eastbourne 002E,E01020949,679,556,322,234,4,4,42,36,6,77,65,12,0
2021,Eastbourne 004E,E01020950,728,576,397,179,6,6,80,64,16,66,59,7,0
2021,Eastbourne 013B,E01020951,660,393,162,231,1,1,110,91,19,155,144,11,1
2021,Eastbourne 007C,E01020952,780,457,211,246,15,15,141,83,58,167,152,15,0
2021,Eastbourne 007D,E01020953,579,498,230,268,0,0,8,6,2,73,60,13,0
2021,Eastbourne 007E,E01020954,622,514,247,267,0,0,39,3,36,69,62,7,0
2021,Eastbourne 003C,E01020955,688,367,189,178,2,2,198,177,21,117,104,13,4
2021,Eastbourne 003D,E01020956,810,695,508,187,1,1,15,4,11,99,87,12,0
2021,Eastbourne 003E,E01020957,635,420,248,172,3,3,105,74,31,105,92,13,2
2021,Eastbourne 013C,E01020959,607,440,225,215,3,3,56,3,53,107,92,15,1
2021,Eastbourne 014A,E01020960,1184,734,453,281,1,1,7,3,4,442,414,28,0
2021,Eastbourne 013D,E01020961,644,567,399,168,4,4,4,1,3,69,49,20,0
2021,Eastbourne 013E,E01020962,971,693,433,260,1,1,40,3,37,237,218,19,0
2021,Eastbourne 008B,E01020963,739,502,239,263,18,18,64,6,58,155,143,12,0
2021,Eastbourne 009D,E01020964,859,530,339,191,1,1,54,43,11,274,245,29,0
2021,Eastbourne 008C,E01020965,965,440,221,219,1,1,37,17,20,487,456,31,0
2021,Eastbourne 008D,E01020966,885,425,256,169,1,1,106,35,71,352,334,18,1
2021,Eastbourne 009E,E01020967,999,581,397,184,3,3,190,20,170,223,205,18,2
2021,Eastbourne 011D,E01020968,1045,458,285,173,2,2,67,27,40,518,479,39,0
2021,Hastings 001A,E01020969,640,495,313,182,1,1,80,12,68,64,54,10,0
2021,Hastings 001B,E01020970,1060,941,458,483,4,4,3,2,1,112,89,23,0
2021,Hastings 001C,E01020971,859,521,262,259,3,3,150,29,121,185,171,14,0
2021,Hastings 005A,E01020972,749,184,76,108,0,0,447,76,371,118,107,11,0
2021,Hastings 005B,E01020973,740,484,250,234,23,23,134,20,114,99,87,12,0
2021,Hastings 002A,E01020974,711,550,353,197,11,11,80,11,69,70,62,8,0
2021,Hastings 008A,E01020975,775,460,252,208,2,2,90,10,80,223,207,16,0
2021,Hastings 008B,E01020976,872,596,371,225,2,2,21,6,15,253,234,19,0
2021,Hastings 005C,E01020977,709,362,186,176,1,1,9,1,8,337,318,19,0
2021,Hastings 009A,E01020978,1036,376,245,131,5,5,59,7,52,595,562,33,1
2021,Hastings 009B,E01020979,1076,281,163,118,4,4,122,34,88,669,630,39,0
2021,Hastings 009C,E01020980,781,318,165,153,3,3,96,11,85,364,342,22,0
2021,Hastings 009D,E01020981,681,453,256,197,2,2,28,7,21,197,182,15,1
2021,Hastings 011A,E01020982,985,224,131,93,1,1,176,23,153,584,556,28,0
2021,Hastings 011B,E01020983,913,204,112,92,1,1,295,28,267,413,384,29,0
2021,Hastings 011C,E01020984,1030,372,204,168,2,2,55,8,47,600,568,32,1
2021,Hastings 011D,E01020985,910,416,259,157,4,4,40,9,31,449,415,34,1
2021,Hastings 002B,E01020986,636,541,348,193,0,0,6,1,5,89,82,7,0
2021,Hastings 001D,E01020987,786,474,202,272,10,10,33,4,29,269,223,46,0
2021,Hastings 002C,E01020988,743,670,451,219,4,4,10,2,8,59,48,11,0
2021,Hastings 011E,E01020989,815,307,142,165,0,0,63,7,56,444,422,22,1
2021,Hastings 008C,E01020990,693,345,173,172,2,2,18,1,17,328,311,17,0
2021,Hastings 008D,E01020991,652,384,202,182,0,0,7,1,6,261,244,17,0
2021,Hastings 008E,E01020992,916,330,156,174,16,16,126,12,114,442,425,17,2
2021,Hastings 003A,E01020993,588,212,90,122,2,2,290,58,232,83,67,16,1
2021,Hastings 003B,E01020994,592,236,112,124,0,0,241,54,187,115,107,8,0
2021,Hastings 003C,E01020995,573,223,89,134,3,3,250,38,212,97,91,6,0
2021,Hastings 003D,E01020996,713,435,200,235,6,6,186,21,165,86,77,9,0
2021,Hastings 010A,E01020997,670,433,246,187,1,1,125,6,119,111,96,15,0
2021,Hastings 010B,E01020998,925,453,268,185,6,6,57,5,52,409,383,26,0
2021,Hastings 010C,E01020999,757,628,396,232,2,2,28,3,25,99,91,8,0
2021,Hastings 007A,E01021000,611,463,243,220,2,2,27,1,26,119,103,16,0
2021,Hastings 007B,E01021001,492,387,210,177,1,1,3,1,2,101,80,21,0
2021,Hastings 007C,E01021002,620,444,269,175,0,0,41,8,33,135,118,17,0
2021,Hastings 007D,E01021003,811,412,303,109,1,1,103,13,90,293,256,37,2
2021,Hastings 004A,E01021004,808,616,360,256,2,2,25,6,19,165,145,20,0
2021,Hastings 004B,E01021005,626,225,107,118,1,1,314,70,244,85,80,5,1
2021,Hastings 004C,E01021006,801,481,261,220,6,6,30,7,23,282,266,16,2
2021,Hastings 002D,E01021007,678,619,423,196,5,5,7,2,5,47,39,8,0
2021,Hastings 002E,E01021008,767,441,278,163,0,0,178,18,160,148,135,13,0
2021,Hastings 002F,E01021009,806,707,417,290,2,2,9,1,8,88,73,15,0
2021,Hastings 006A,E01021010,625,535,319,216,1,1,4,1,3,85,73,12,0
2021,Hastings 006B,E01021011,669,432,210,222,2,2,34,7,27,200,186,14,1
2021,Hastings 006C,E01021012,768,406,213,193,2,2,157,20,137,203,178,25,0
2021,Hastings 004D,E01021013,736,533,251,282,0,0,32,6,26,171,162,9,0
2021,Hastings 007E,E01021014,790,406,211,195,1,1,91,16,75,292,275,17,0
2021,Hastings 005D,E01021015,718,158,73,85,0,0,463,82,381,96,85,11,1
2021,Hastings 010D,E01021016,749,409,234,175,17,17,104,14,90,219,201,18,0
2021,Hastings 010E,E01021017,650,503,246,257,7,7,18,3,15,122,106,16,0
2021,Hastings 010F,E01021018,737,596,288,308,2,2,34,4,30,105,96,9,0
2021,Hastings 003E,E01021019,796,253,104,149,4,4,444,75,369,95,82,13,0
2021,Hastings 006D,E01021020,759,407,199,208,11,11,268,45,223,73,61,12,0
2021,Hastings 006E,E01021021,830,549,291,258,14,14,50,6,44,217,203,14,0
2021,Lewes 001A,E01021022,889,604,323,281,10,10,128,107,21,146,119,27,1
2021,Lewes 002A,E01021023,1165,898,404,494,58,58,116,45,71,91,78,13,2
2021,Lewes 001B,E01021024,478,313,152,161,7,7,113,57,56,44,38,6,1
2021,Lewes 001C,E01021025,714,592,318,274,13,13,28,11,17,81,65,16,0
2021,Lewes 002B,E01021026,1054,875,611,264,3,3,65,51,14,110,94,16,1
2021,Lewes 006A,E01021027,657,582,336,246,5,5,6,2,4,64,52,12,0
2021,Lewes 006B,E01021028,601,470,224,246,3,3,35,32,3,93,80,13,0
2021,Lewes 006C,E01021029,614,521,268,253,1,1,18,6,12,74,63,11,0
2021,Lewes 006D,E01021030,567,478,267,211,1,1,6,3,3,81,72,9,1
2021,Lewes 006E,E01021031,729,414,203,211,2,2,132,58,74,179,159,20,2
2021,Lewes 002C,E01021032,834,636,431,205,3,3,54,50,4,141,106,35,0
2021,Lewes 003A,E01021033,844,542,301,241,17,17,137,119,18,147,124,23,1
2021,Lewes 003B,E01021034,542,317,172,145,5,5,107,98,9,113,105,8,0
2021,Lewes 003C,E01021035,1004,550,375,175,4,4,132,14,118,318,286,32,0
2021,Lewes 003D,E01021036,604,439,261,178,2,2,88,75,13,74,64,10,1
2021,Lewes 003E,E01021037,602,258,132,126,6,6,285,263,22,49,39,10,4
2021,Lewes 003F,E01021038,797,528,324,204,1,1,83,77,6,185,164,21,0
2021,Lewes 005A,E01021039,636,457,320,137,1,1,30,27,3,148,128,20,0
2021,Lewes 005B,E01021040,655,453,288,165,1,1,63,59,4,138,125,13,0
2021,Lewes 005C,E01021041,629,472,284,188,3,3,102,45,57,52,45,7,0
2021,Lewes 005D,E01021042,482,409,211,198,0,0,33,29,4,39,35,4,1
2021,Lewes 005E,E01021043,604,402,213,189,3,3,145,137,8,54,44,10,0
2021,Lewes 009A,E01021044,733,387,136,251,2,2,207,192,15,136,118,18,1
2021,Lewes 008A,E01021045,915,619,407,212,8,8,96,90,6,191,174,17,1
2021,Lewes 008B,E01021046,613,523,271,252,1,1,5,2,3,84,80,4,0
2021,Lewes 008C,E01021047,668,497,287,210,1,1,68,28,40,93,83,10,9
2021,Lewes 008D,E01021048,788,408,223,185,3,3,62,45,17,315,305,10,0
2021,Lewes 009B,E01021049,671,287,130,157,4,4,76,61,15,303,290,13,1
2021,Lewes 009C,E01021050,510,309,147,162,4,4,135,62,73,61,52,9,1
2021,Lewes 009D,E01021051,496,348,166,182,6,6,49,48,1,92,86,6,1
2021,Lewes 001D,E01021052,518,462,265,197,6,6,3,3,0,47,37,10,0
2021,Lewes 001E,E01021053,528,354,207,147,14,14,107,85,22,53,37,16,0
2021,Lewes 004A,E01021054,619,386,241,145,4,4,73,53,20,156,134,22,0
2021,Lewes 004B,E01021055,763,574,355,219,5,5,105,82,23,78,67,11,1
2021,Lewes 004C,E01021056,728,612,407,205,8,8,12,2,10,96,82,14,0
2021,Lewes 004D,E01021057,670,250,134,116,1,1,189,33,156,230,191,39,0
2021,Lewes 010A,E01021058,859,616,343,273,19,19,27,6,21,197,176,21,0
2021,Lewes 010B,E01021059,812,631,403,228,9,9,44,26,18,127,110,17,1
2021,Lewes 010C,E01021060,976,630,329,301,27,27,171,140,31,146,133,13,2
2021,Lewes 007A,E01021061,600,495,257,238,2,2,8,3,5,95,87,8,0
2021,Lewes 010D,E01021062,726,396,165,231,28,28,236,88,148,66,59,7,0
2021,Lewes 007B,E01021063,698,582,341,241,3,3,28,1,27,85,73,12,0
2021,Lewes 007C,E01021064,865,619,395,224,2,2,30,20,10,213,196,17,1
2021,Lewes 007D,E01021065,620,304,173,131,2,2,110,76,34,204,192,12,0
2021,Lewes 007E,E01021066,638,496,309,187,0,0,52,47,5,88,74,14,2
2021,Lewes 002D,E01021067,454,369,227,142,4,4,54,34,20,27,23,4,0
2021,Lewes 002E,E01021068,429,317,166,151,2,2,26,24,2,83,60,23,1
2021,Lewes 011A,E01021069,669,562,393,169,1,1,12,9,3,94,85,9,0
2021,Lewes 013A,E01021070,829,516,304,212,40,40,48,16,32,225,209,16,0
2021,Lewes 013B,E01021071,1094,564,377,187,5,5,63,19,44,462,440,22,0
2021,Lewes 012A,E01021072,739,680,526,154,2,2,7,5,2,50,42,8,0
2021,Lewes 012B,E01021073,630,565,381,184,1,1,11,9,2,53,47,6,0
2021,Lewes 012C,E01021074,764,540,333,207,1,1,165,148,17,55,40,15,3
2021,Lewes 011B,E01021075,748,620,382,238,16,16,35,19,16,77,70,7,0
2021,Lewes 012D,E01021076,788,468,240,228,5,5,214,153,61,99,83,16,2
2021,Lewes 011C,E01021077,673,551,387,164,2,2,59,23,36,60,50,10,1
2021,Lewes 012E,E01021078,619,502,358,144,9,9,44,1,43,64,51,13,0
2021,Lewes 013C,E01021079,784,510,341,169,2,2,113,71,42,157,141,16,2
2021,Lewes 013D,E01021080,669,494,323,171,12,12,77,45,32,85,73,12,1
2021,Lewes 011D,E01021081,732,590,405,185,2,2,28,24,4,111,99,12,1
2021,Lewes 011E,E01021082,787,710,521,189,1,1,5,4,1,71,55,16,0
2021,Lewes 011F,E01021083,560,519,351,168,1,1,4,0,4,36,31,5,0
2021,Rother 006A,E01021084,906,509,332,177,5,5,194,42,152,198,172,26,0
2021,Rother 006B,E01021085,701,555,330,225,0,0,21,3,18,125,119,6,0
2021,Rother 006C,E01021086,728,576,375,201,1,1,79,18,61,72,64,8,0
2021,Rother 005A,E01021087,795,683,442,241,3,3,10,1,9,99,74,25,0
2021,Rother 005B,E01021088,703,574,384,190,10,10,51,9,42,68,49,19,0
2021,Rother 005C,E01021089,671,471,295,176,7,7,129,12,117,64,56,8,0
2021,Rother 011A,E01021090,802,414,230,184,1,1,20,4,16,367,345,22,0
2021,Rother 011B,E01021091,1095,558,354,204,0,0,16,6,10,521,478,43,0
2021,Rother 011C,E01021092,1197,546,399,147,27,27,224,24,200,400,367,33,0
2021,Rother 009A,E01021093,676,618,476,142,4,4,4,1,3,50,42,8,0
2021,Rother 010A,E01021094,818,635,502,133,4,4,48,5,43,131,116,15,0
2021,Rother 009B,E01021095,631,575,457,118,2,2,4,2,2,50,45,5,0
2021,Rother 006D,E01021096,513,367,236,131,2,2,32,5,27,112,89,23,0
2021,Rother 006E,E01021097,542,445,278,167,5,5,33,5,28,59,49,10,0
2021,Rother 003A,E01021098,762,564,347,217,5,5,94,16,78,99,74,25,0
2021,Rother 003B,E01021099,688,572,341,231,5,5,18,1,17,93,71,22,0
2021,Rother 003C,E01021100,664,518,295,223,1,1,53,8,45,92,77,15,0
2021,Rother 004A,E01021101,804,585,418,167,3,3,132,14,118,84,62,22,0
2021,Rother 004B,E01021102,683,478,345,133,4,4,72,8,64,129,99,30,0
2021,Rother 002A,E01021103,655,461,319,142,8,8,70,11,59,116,92,24,0
2021,Rother 003D,E01021104,637,499,314,185,6,6,51,8,43,81,56,25,0
2021,Rother 003E,E01021105,555,390,266,124,9,9,92,13,79,64,51,13,0
2021,Rother 010B,E01021106,938,755,620,135,1,1,74,14,60,108,96,12,0
2021,Rother 010C,E01021107,735,665,519,146,2,2,10,0,10,58,48,10,0
2021,Rother 010D,E01021108,633,496,299,197,2,2,40,3,37,95,82,13,0
2021,Rother 005D,E01021109,738,642,439,203,5,5,38,5,33,53,40,13,0
2021,Rother 005E,E01021110,1110,984,735,249,1,1,30,4,26,95,68,27,0
2021,Rother 007A,E01021111,519,345,229,116,7,7,81,8,73,86,79,7,0
2021,Rother 008A,E01021112,641,527,346,181,3,3,9,0,9,102,94,8,0
2021,Rother 007B,E01021113,737,510,240,270,25,25,95,10,85,106,97,9,1
2021,Rother 002B,E01021114,771,541,363,178,15,15,154,18,136,60,45,15,1
2021,Rother 002C,E01021115,756,646,453,193,0,0,22,2,20,88,71,17,0
2021,Rother 002D,E01021116,706,478,332,146,15,15,124,12,112,89,64,25,0
2021,Rother 004C,E01021117,771,532,383,149,4,4,48,5,43,187,174,13,0
2021,Rother 004D,E01021118,879,608,408,200,22,22,62,7,55,186,162,24,1
2021,Rother 004E,E01021119,501,164,106,58,3,3,306,63,243,27,24,3,1
2021,Rother 008B,E01021120,802,618,491,127,10,10,34,3,31,140,124,16,0
2021,Rother 011D,E01021121,813,569,385,184,2,2,20,4,16,221,195,26,1
2021,Rother 011E,E01021122,866,516,390,126,3,3,34,5,29,313,282,31,0
2021,Rother 009C,E01021123,701,635,472,163,1,1,13,3,10,52,47,5,0
2021,Rother 009D,E01021124,1023,838,593,245,38,38,35,6,29,112,85,27,0
2021,Rother 009E,E01021125,563,505,384,121,0,0,9,1,8,49,45,4,0
2021,Rother 008C,E01021126,676,473,286,187,3,3,32,10,22,168,155,13,0
2021,Rother 008D,E01021127,682,463,318,145,4,4,126,8,118,89,80,9,0
2021,Rother 008E,E01021128,883,728,472,256,7,7,27,0,27,121,101,20,0
2021,Rother 009F,E01021129,802,736,515,221,2,2,13,1,12,51,46,5,0
2021,Rother 010E,E01021130,685,553,364,189,2,2,15,3,12,115,96,19,0
2021,Rother 007C,E01021131,613,350,154,196,5,5,132,17,115,126,106,20,0
2021,Rother 001A,E01021132,504,434,272,162,0,0,36,6,30,34,28,6,0
2021,Rother 001B,E01021133,698,450,252,198,8,8,119,13,106,121,97,24,0
2021,Rother 001C,E01021134,622,477,232,245,5,5,74,10,64,66,49,17,0
2021,Rother 007D,E01021135,808,322,156,166,17,17,280,48,232,189,166,23,0
2021,Rother 007E,E01021136,582,192,113,79,5,5,319,66,253,66,54,12,0
2021,Rother 007F,E01021137,673,382,200,182,4,4,181,38,143,106,98,8,0
2021,Rother 009G,E01021138,486,393,269,124,2,2,50,7,43,41,30,11,0
2021,Rother 001D,E01021139,615,393,239,154,27,27,160,24,136,35,30,5,0
2021,Rother 001E,E01021140,732,604,347,257,12,12,13,2,11,103,83,20,0
2021,Rother 001F,E01021141,610,494,288,206,8,8,22,2,20,86,65,21,0
2021,Wealden 018A,E01021142,616,555,462,93,1,1,7,2,5,53,39,14,0
2021,Wealden 018B,E01021143,553,397,281,116,5,5,41,29,12,110,86,24,0
2021,Wealden 008A,E01021144,700,624,371,253,2,2,10,4,6,64,45,19,0
2021,Wealden 008B,E01021145,903,665,376,289,21,21,105,71,34,111,93,18,1
2021,Wealden 013A,E01021146,925,711,402,309,22,22,131,50,81,61,50,11,0
2021,Wealden 013B,E01021147,688,551,336,215,3,3,21,1,20,113,86,27,0
2021,Wealden 013C,E01021148,614,457,278,179,9,9,46,18,28,101,79,22,1
2021,Wealden 011A,E01021149,590,462,267,195,1,1,61,30,31,66,51,15,0
2021,Wealden 010A,E01021150,572,478,259,219,9,9,46,2,44,39,33,6,0
2021,Wealden 006A,E01021151,735,629,331,298,9,9,34,3,31,63,49,14,0
2021,Wealden 006B,E01021152,586,323,161,162,12,12,207,132,75,43,33,10,1
2021,Wealden 006C,E01021153,895,642,306,336,11,11,70,55,15,171,157,14,1
2021,Wealden 006D,E01021154,622,398,196,202,9,9,174,156,18,40,34,6,1
2021,Wealden 006E,E01021155,511,368,162,206,11,11,15,2,13,117,106,11,0
2021,Wealden 003A,E01021156,866,643,420,223,29,29,40,8,32,154,136,18,0
2021,Wealden 003B,E01021157,732,628,411,217,0,0,33,2,31,71,62,9,0
2021,Wealden 003C,E01021158,893,729,368,361,24,24,67,22,45,73,66,7,0
2021,Wealden 004A,E01021159,997,876,569,307,2,2,47,6,41,72,56,16,0
2021,Wealden 004B,E01021160,763,527,333,194,10,10,75,7,68,151,137,14,0
2021,Wealden 004C,E01021161,703,583,302,281,1,1,7,3,4,112,99,13,0
2021,Wealden 004D,E01021162,634,578,357,221,0,0,2,2,0,54,43,11,0
2021,Wealden 007A,E01021163,812,743,455,288,0,0,4,0,4,65,43,22,0
2021,Wealden 007B,E01021164,753,554,315,239,6,6,81,62,19,111,85,26,1
2021,Wealden 013D,E01021165,522,416,242,174,2,2,34,12,22,70,60,10,0
2021,Wealden 018C,E01021166,1036,868,637,231,3,3,27,20,7,138,111,27,0
2021,Wealden 001A,E01021167,991,649,393,256,0,0,157,129,28,184,164,20,1
2021,Wealden 001B,E01021168,662,514,316,198,0,0,5,2,3,143,105,38,0
2021,Wealden 001C,E01021169,508,390,245,145,0,0,18,6,12,100,79,21,0
2021,Wealden 008C,E01021170,1150,967,588,379,5,5,44,20,24,134,93,41,0
2021,Wealden 002A,E01021171,834,652,362,290,6,6,66,38,28,108,82,26,2
2021,Wealden 002B,E01021172,728,555,299,256,5,5,64,38,26,104,79,25,0
2021,Wealden 002C,E01021173,578,460,252,208,1,1,8,5,3,109,86,23,0
2021,Wealden 015A,E01021174,851,684,349,335,37,37,37,5,32,93,78,15,0
2021,Wealden 015B,E01021175,623,539,306,233,4,4,5,2,3,75,61,14,0
2021,Wealden 015C,E01021176,677,566,373,193,5,5,14,5,9,92,77,15,0
2021,Wealden 015D,E01021177,747,414,235,179,10,10,96,44,52,226,199,27,1
2021,Wealden 017A,E01021178,691,378,227,151,39,39,210,148,62,64,48,16,0
2021,Wealden 017B,E01021179,703,314,160,154,9,9,302,203,99,76,68,8,2
2021,Wealden 016A,E01021180,618,525,300,225,19,19,18,11,7,56,43,13,0
2021,Wealden 016B,E01021181,603,481,269,212,6,6,21,1,20,95,86,9,0
2021,Wealden 016C,E01021182,717,542,341,201,9,9,90,61,29,76,58,18,0
2021,Wealden 016D,E01021183,542,202,102,100,5,5,271,47,224,64,56,8,0
2021,Wealden 017C,E01021184,697,573,346,227,4,4,20,5,15,100,88,12,0
2021,Wealden 017D,E01021185,636,353,181,172,7,7,179,87,92,96,86,10,1
2021,Wealden 001D,E01021186,516,390,229,161,0,0,72,47,25,54,36,18,0
2021,Wealden 007C,E01021187,585,487,311,176,4,4,16,10,6,78,46,32,0
2021,Wealden 014A,E01021188,476,403,261,142,0,0,18,3,15,55,40,15,0
2021,Wealden 011B,E01021189,548,471,272,199,0,0,6,2,4,71,50,21,0
2021,Wealden 011C,E01021190,659,549,332,217,2,2,7,6,1,101,83,18,0
2021,Wealden 010B,E01021191,866,615,401,214,8,8,13,6,7,230,218,12,0
2021,Wealden 010C,E01021192,661,562,321,241,4,4,3,3,0,92,78,14,0
2021,Wealden 010D,E01021193,793,479,236,243,12,12,185,161,24,117,107,10,0
2021,Wealden 010E,E01021194,668,567,293,274,7,7,1,1,0,93,81,12,0
2021,Wealden 018E,E01021196,874,725,411,314,8,8,45,19,26,96,81,15,0
2021,Wealden 014B,E01021198,689,489,278,211,13,13,90,42,48,97,82,15,0
2021,Wealden 014C,E01021199,588,516,376,140,3,3,5,3,2,64,46,18,0
2021,Wealden 011D,E01021200,635,413,215,198,23,23,115,72,43,83,71,12,1
2021,Wealden 011E,E01021201,663,583,334,249,5,5,9,0,9,66,56,10,0
2021,Wealden 005A,E01021202,543,362,241,121,2,2,52,6,46,127,110,17,0
2021,Wealden 005B,E01021203,653,546,321,225,6,6,31,19,12,70,49,21,0
2021,Wealden 014D,E01021204,495,391,236,155,0,0,46,39,7,57,44,13,1
2021,Wealden 014E,E01021205,506,428,272,156,1,1,16,11,5,61,38,23,0
2021,Wealden 020A,E01021206,713,528,348,180,12,12,89,69,20,84,66,18,0
2021,Wealden 020B,E01021207,653,552,333,219,3,3,2,0,2,96,78,18,0
2021,Wealden 020C,E01021208,1005,772,319,453,13,13,86,21,65,134,118,16,0
2021,Wealden 020D,E01021209,994,831,454,377,32,32,75,16,59,55,44,11,1
2021,Wealden 020E,E01021210,601,533,225,308,3,3,0,0,0,65,64,1,0
2021,Wealden 020F,E01021211,800,616,440,176,3,3,6,4,2,175,145,30,0
2021,Wealden 019B,E01021213,862,517,266,251,30,30,66,4,62,249,228,21,0
2021,Wealden 019C,E01021214,817,635,408,227,6,6,25,13,12,150,123,27,1
2021,Wealden 019D,E01021215,631,517,348,169,1,1,53,46,7,60,53,7,0
2021,Wealden 019E,E01021216,503,395,242,153,4,4,57,55,2,46,31,15,1
2021,Wealden 008D,E01021217,564,447,269,178,5,5,53,49,4,57,49,8,2
2021,Wealden 002D,E01021218,493,439,253,186,1,1,13,3,10,40,32,8,0
2021,Wealden 009A,E01021219,548,507,298,209,0,0,1,0,1,40,31,9,0
2021,Wealden 009B,E01021220,816,530,361,169,2,2,119,80,39,164,147,17,1
2021,Wealden 012A,E01021221,574,395,202,193,4,4,61,20,41,114,104,10,0
2021,Wealden 012B,E01021222,705,446,223,223,9,9,108,68,40,141,130,11,1
2021,Wealden 009C,E01021223,479,372,204,168,5,5,7,0,7,95,89,6,0
2021,Wealden 009D,E01021224,657,359,174,185,6,6,240,183,57,52,40,12,0
2021,Wealden 009E,E01021225,681,516,276,240,7,7,20,5,15,138,122,16,0
2021,Wealden 009F,E01021226,527,383,177,206,4,4,23,3,20,117,107,10,0
2021,Wealden 012C,E01021227,775,608,273,335,9,9,57,6,51,101,85,16,0
2021,Wealden 012D,E01021228,697,584,299,285,17,17,20,2,18,76,70,6,0
2021,Wealden 005C,E01021229,757,601,357,244,5,5,6,0,6,145,118,27,0
2021,Wealden 005D,E01021230,709,624,349,275,6,6,5,0,5,74,57,17,0
2021,Wealden 005E,E01021231,806,532,321,211,4,4,182,118,64,88,75,13,0
2021,Wealden 021A,E01021232,818,665,431,234,8,8,10,4,6,135,116,19,0
2021,Wealden 021B,E01021233,648,571,359,212,3,3,7,3,4,66,52,14,1
2021,Wealden 021C,E01021234,659,607,399,208,0,0,4,4,0,48,39,9,0
2021,Wealden 021D,E01021235,641,582,418,164,0,0,4,1,3,55,39,16,0
2021,Wealden 021E,E01021236,731,587,368,219,0,0,82,61,21,62,51,11,0
2021,Basildon 001A,E01021237,516,483,273,210,0,0,2,2,0,31,22,9,0
2021,Basildon 001B,E01021238,510,462,226,236,2,2,6,3,3,40,38,2,0
2021,Basildon 003A,E01021239,536,501,270,231,0,0,6,2,4,29,23,6,0
2021,Basildon 003B,E01021240,832,503,251,252,4,4,135,5,130,190,167,23,0
2021,Basildon 003C,E01021241,656,418,166,252,2,2,164,158,6,72,68,4,0
2021,Basildon 001C,E01021242,477,425,225,200,1,1,5,2,3,46,40,6,0
2021,Basildon 003D,E01021243,667,603,291,312,2,2,5,2,3,57,50,7,0
2021,Basildon 004A,E01021244,678,543,319,224,0,0,8,2,6,127,108,19,0
2021,Basildon 002A,E01021245,637,281,122,159,2,2,278,202,76,74,68,6,2
2021,Basildon 002B,E01021246,656,556,300,256,2,2,7,4,3,90,81,9,1
2021,Basildon 003E,E01021247,660,510,285,225,1,1,63,56,7,86,77,9,0
2021,Basildon 002C,E01021248,619,505,245,260,2,2,6,0,6,106,102,4,0
2021,Basildon 002D,E01021249,621,558,288,270,2,2,4,0,4,57,46,11,0
2021,Basildon 001D,E01021250,629,546,316,230,1,1,3,2,1,79,69,10,0
2021,Basildon 001E,E01021251,607,555,286,269,0,0,2,2,0,50,43,7,0
2021,Basildon 002E,E01021252,629,498,254,244,2,2,4,3,1,125,110,15,0
2021,Basildon 004B,E01021253,684,627,373,254,0,0,5,2,3,52,40,12,0
2021,Basildon 009A,E01021254,571,535,302,233,0,0,5,2,3,31,30,1,0
2021,Basildon 004C,E01021255,672,588,376,212,5,5,23,18,5,56,48,8,0
2021,Basildon 004D,E01021256,609,578,320,258,0,0,7,5,2,24,20,4,0
2021,Basildon 009B,E01021257,626,552,319,233,1,1,9,2,7,64,56,8,0
2021,Basildon 004E,E01021258,794,532,287,245,3,3,189,182,7,69,56,13,1
2021,Basildon 009C,E01021259,636,505,259,246,2,2,52,44,8,77,68,9,0
2021,Basildon 009D,E01021260,725,628,353,275,4,4,8,5,3,85,68,17,0
2021,Basildon 010A,E01021261,695,523,233,290,4,4,70,33,37,98,94,4,0
2021,Basildon 010B,E01021262,731,416,198,218,2,2,205,150,55,108,95,13,0
2021,Basildon 010C,E01021263,806,538,207,331,10,10,102,4,98,156,145,11,0
2021,Basildon 006A,E01021264,535,486,264,222,1,1,21,17,4,25,21,4,2
2021,Basildon 012A,E01021265,678,429,182,247,2,2,165,123,42,80,69,11,2
2021,Basildon 015A,E01021266,720,424,194,230,5,5,178,152,26,113,97,16,0
2021,Basildon 012B,E01021267,812,469,194,275,12,12,258,186,72,70,59,11,3
2021,Basildon 015B,E01021268,682,253,95,158,19,19,335,214,121,70,59,11,5
2021,Basildon 012C,E01021269,796,531,177,354,6,6,172,123,49,87,78,9,0
2021,Basildon 012D,E01021270,879,446,143,303,14,14,329,169,160,88,79,9,2
2021,Basildon 013A,E01021271,680,190,74,116,23,23,378,234,144,88,84,4,1
2021,Basildon 012E,E01021272,647,386,158,228,4,4,156,122,34,99,87,12,2
2021,Basildon 014A,E01021273,799,411,194,217,7,7,295,233,62,85,74,11,1
2021,Basildon 010D,E01021274,763,456,203,253,6,6,177,85,92,121,107,14,3
2021,Basildon 014B,E01021275,695,554,329,225,2,2,79,25,54,60,39,21,0
2021,Basildon 014C,E01021276,679,345,157,188,15,15,221,196,25,96,88,8,2
2021,Basildon 014D,E01021277,647,438,267,171,7,7,116,97,19,81,73,8,5
2021,Basildon 010E,E01021279,668,316,138,178,2,2,286,139,147,63,53,10,1
2021,Basildon 021A,E01021280,603,458,179,279,6,6,36,4,32,103,98,5,0
2021,Basildon 021B,E01021281,592,482,248,234,7,7,21,9,12,82,67,15,0
2021,Basildon 021C,E01021282,624,540,327,213,19,19,19,9,10,46,35,11,0
2021,Basildon 021D,E01021283,640,333,133,200,0,0,228,195,33,79,71,8,0
2021,Basildon 021E,E01021284,577,493,221,272,8,8,9,4,5,67,64,3,0
2021,Basildon 021F,E01021285,531,455,182,273,0,0,12,9,3,64,58,6,0
2021,Basildon 016A,E01021286,872,398,208,190,1,1,300,184,116,170,159,11,3
2021,Basildon 017A,E01021287,608,405,191,214,8,8,104,88,16,91,81,10,0
2021,Basildon 016B,E01021288,584,111,40,71,3,3,405,146,259,64,61,3,1
2021,Basildon 016C,E01021289,748,343,134,209,24,24,296,85,211,84,78,6,1
2021,Basildon 016D,E01021290,691,101,41,60,12,12,524,114,410,53,49,4,1
2021,Basildon 016E,E01021291,901,454,161,293,10,10,265,227,38,169,159,10,3
2021,Basildon 017B,E01021292,659,378,180,198,1,1,181,137,44,98,91,7,1
2021,Basildon 017C,E01021293,749,375,184,191,21,21,197,166,31,156,146,10,0
2021,Basildon 020A,E01021294,686,531,232,299,1,1,87,72,15,66,59,7,1
2021,Basildon 020B,E01021295,681,397,172,225,0,0,167,139,28,117,100,17,0
2021,Basildon 020D,E01021297,885,522,157,365,23,23,162,111,51,176,138,38,2
2021,Basildon 017D,E01021298,640,423,221,202,0,0,115,98,17,101,92,9,1
2021,Basildon 020E,E01021299,602,542,310,232,0,0,17,9,8,41,30,11,2
2021,Basildon 022A,E01021300,845,435,172,263,3,3,269,207,62,136,118,18,2
2021,Basildon 011A,E01021301,598,234,88,146,5,5,266,252,14,93,86,7,0
2021,Basildon 013B,E01021302,672,155,58,97,10,10,436,384,52,70,58,12,1
2021,Basildon 011B,E01021303,644,322,137,185,38,38,196,155,41,83,75,8,5
2021,Basildon 013C,E01021304,615,243,97,146,0,0,299,248,51,73,56,17,0
2021,Basildon 013D,E01021305,596,262,138,124,1,1,242,203,39,90,78,12,1
2021,Basildon 013E,E01021306,584,267,124,143,2,2,226,183,43,88,77,11,1
2021,Basildon 011C,E01021307,586,322,137,185,49,49,126,60,66,87,80,7,2
2021,Basildon 011D,E01021308,486,350,110,240,59,59,14,5,9,63,62,1,0
2021,Basildon 011E,E01021309,607,352,132,220,58,58,65,46,19,132,122,10,0
2021,Basildon 022B,E01021310,691,431,226,205,3,3,22,9,13,233,222,11,2
2021,Basildon 022C,E01021311,593,297,143,154,0,0,225,198,27,70,62,8,1
2021,Basildon 011F,E01021312,601,493,289,204,1,1,15,4,11,92,72,20,0
2021,Basildon 018A,E01021313,607,548,341,207,4,4,7,6,1,48,42,6,0
2021,Basildon 018B,E01021314,568,231,100,131,4,4,260,175,85,67,59,8,6
2021,Basildon 018C,E01021315,637,282,127,155,4,4,285,220,65,66,62,4,0
2021,Basildon 018D,E01021316,814,292,159,133,47,47,376,266,110,93,84,9,6
2021,Basildon 018E,E01021317,655,300,113,187,1,1,251,210,41,103,94,9,0
2021,Basildon 015C,E01021318,1165,408,174,234,26,26,444,318,126,281,258,23,6
2021,Basildon 017E,E01021319,994,452,153,299,4,4,259,201,58,279,259,20,0
2021,Basildon 015D,E01021320,640,299,127,172,1,1,227,190,37,112,101,11,1
2021,Basildon 015E,E01021321,681,350,150,200,1,1,228,181,47,102,97,5,0
2021,Basildon 019A,E01021322,613,293,126,167,3,3,227,190,37,89,78,11,1
2021,Basildon 019B,E01021323,664,222,82,140,22,22,349,104,245,71,64,7,0
2021,Basildon 019C,E01021324,657,216,91,125,18,18,380,68,312,42,37,5,1
2021,Basildon 019D,E01021325,639,189,65,124,12,12,334,119,215,103,89,14,1
2021,Basildon 022D,E01021326,718,403,155,248,2,2,206,147,59,105,97,8,2
2021,Basildon 019E,E01021327,728,266,127,139,17,17,360,104,256,84,77,7,1
2021,Basildon 022E,E01021328,601,357,173,184,3,3,160,112,48,80,75,5,1
2021,Basildon 006B,E01021329,671,451,275,176,10,10,123,92,31,85,73,12,2
2021,Basildon 006C,E01021330,656,573,321,252,4,4,6,1,5,73,57,16,0
2021,Basildon 008A,E01021331,816,583,277,306,21,21,32,22,10,179,161,18,1
2021,Basildon 006D,E01021332,606,563,351,212,0,0,5,1,4,38,30,8,0
2021,Basildon 006E,E01021333,650,604,361,243,1,1,7,4,3,38,30,8,0
2021,Basildon 005A,E01021334,725,563,315,248,0,0,45,20,25,117,105,12,0
2021,Basildon 007A,E01021335,524,455,215,240,1,1,19,0,19,49,43,6,0
2021,Basildon 005B,E01021336,758,583,314,269,2,2,65,53,12,108,100,8,0
2021,Basildon 007B,E01021337,631,557,342,215,1,1,6,4,2,67,52,15,0
2021,Basildon 005C,E01021338,822,554,245,309,16,16,152,119,33,100,87,13,0
2021,Basildon 005D,E01021339,656,364,176,188,2,2,213,209,4,76,68,8,1
2021,Basildon 007C,E01021340,722,583,276,307,8,8,16,2,14,115,106,9,0
2021,Basildon 007D,E01021341,661,581,314,267,1,1,11,1,10,68,56,12,0
2021,Basildon 008B,E01021342,700,403,165,238,3,3,204,143,61,87,81,6,3
2021,Basildon 008C,E01021343,746,454,159,295,32,32,110,1,109,150,145,5,0
2021,Basildon 008D,E01021344,850,638,259,379,10,10,37,6,31,165,146,19,0
2021,Basildon 007E,E01021345,767,635,209,426,2,2,4,1,3,126,115,11,0
2021,Basildon 008E,E01021346,918,722,322,400,1,1,6,4,2,188,175,13,1
2021,Braintree 013A,E01021347,1036,803,347,456,13,13,98,13,85,122,101,21,0
2021,Braintree 018A,E01021348,657,411,246,165,0,0,75,12,63,170,150,20,1
2021,Braintree 007A,E01021349,500,419,186,233,0,0,12,0,12,69,63,6,0
2021,Braintree 009A,E01021350,785,616,344,272,3,3,27,3,24,139,129,10,0
2021,Braintree 007B,E01021351,572,507,190,317,0,0,9,1,8,56,49,7,0
2021,Braintree 007C,E01021352,600,500,277,223,3,3,25,2,23,72,64,8,0
2021,Braintree 009B,E01021353,764,505,249,256,2,2,120,15,105,137,122,15,0
2021,Braintree 008A,E01021354,511,264,138,126,0,0,206,60,146,41,34,7,0
2021,Braintree 007D,E01021355,873,599,287,312,0,0,130,29,101,144,133,11,0
2021,Braintree 007E,E01021356,593,453,270,183,0,0,82,17,65,58,46,12,0
2021,Braintree 008B,E01021357,685,453,265,188,8,8,130,26,104,93,86,7,1
2021,Braintree 008C,E01021358,1025,460,204,256,28,28,390,101,289,146,131,15,1
2021,Braintree 008D,E01021359,873,417,182,235,3,3,373,96,277,77,61,16,3
2021,Braintree 012A,E01021360,738,436,189,247,3,3,252,52,200,45,35,10,2
2021,Braintree 012B,E01021361,733,537,244,293,15,15,80,15,65,100,82,18,1
2021,Braintree 015A,E01021362,911,685,260,425,32,32,133,22,111,61,48,13,0
2021,Braintree 010A,E01021364,699,547,267,280,16,16,27,5,22,109,98,11,0
2021,Braintree 009D,E01021365,1178,572,255,317,16,16,201,44,157,389,368,21,0
2021,Braintree 010B,E01021366,639,563,337,226,1,1,17,6,11,58,45,13,0
2021,Braintree 012C,E01021367,568,285,137,148,15,15,231,21,210,36,35,1,1
2021,Braintree 011A,E01021368,708,405,224,181,1,1,150,31,119,152,136,16,0
2021,Braintree 012D,E01021369,1013,677,228,449,6,6,168,23,145,162,148,14,0
2021,Braintree 011B,E01021370,720,287,115,172,2,2,317,77,240,112,101,11,2
2021,Braintree 013B,E01021371,772,549,309,240,2,2,66,17,49,155,133,22,0
2021,Braintree 011C,E01021372,877,635,279,356,3,3,85,14,71,154,142,12,0
2021,Braintree 011E,E01021374,617,326,170,156,1,1,231,58,173,56,47,9,3
2021,Braintree 001A,E01021375,469,351,193,158,0,0,65,11,54,53,38,15,0
2021,Braintree 001B,E01021376,574,491,286,205,2,2,27,2,25,54,43,11,0
2021,Braintree 014A,E01021377,748,549,307,242,8,8,94,15,79,97,81,16,0
2021,Braintree 014B,E01021378,765,444,263,181,3,3,212,35,177,104,93,11,2
2021,Braintree 014C,E01021379,730,607,335,272,0,0,37,1,36,86,66,20,0
2021,Braintree 012E,E01021380,1112,800,420,380,16,16,194,43,151,102,76,26,0
2021,Braintree 007F,E01021381,545,483,328,155,1,1,32,5,27,29,22,7,0
2021,Braintree 003A,E01021382,809,624,299,325,34,34,74,21,53,77,58,19,0
2021,Braintree 010C,E01021383,798,666,305,361,0,0,77,4,73,55,46,9,0
2021,Braintree 013C,E01021384,863,727,328,399,0,0,38,4,34,98,86,12,0
2021,Braintree 013D,E01021385,513,363,129,234,7,7,57,3,54,86,81,5,0
2021,Braintree 013E,E01021386,575,506,243,263,9,9,21,2,19,39,35,4,0
2021,Braintree 004A,E01021387,1070,570,291,279,9,9,177,39,138,312,287,25,2
2021,Braintree 004B,E01021388,726,441,210,231,2,2,152,37,115,128,122,6,3
2021,Braintree 006A,E01021389,927,732,400,332,10,10,90,18,72,95,81,14,0
2021,Braintree 006B,E01021390,770,626,335,291,7,7,42,5,37,95,86,9,0
2021,Braintree 004C,E01021391,663,282,131,151,10,10,323,84,239,45,35,10,3
2021,Braintree 004D,E01021392,778,517,261,256,2,2,107,24,83,152,136,16,0
2021,Braintree 004E,E01021393,668,445,227,218,3,3,122,37,85,98,82,16,0
2021,Braintree 018B,E01021394,676,410,219,191,3,3,171,44,127,92,73,19,0
2021,Braintree 018C,E01021395,625,492,287,205,1,1,95,18,77,37,26,11,0
2021,Braintree 018D,E01021396,538,425,262,163,5,5,17,5,12,91,77,14,0
2021,Braintree 003B,E01021397,1011,726,330,396,2,2,96,13,83,187,166,21,0
2021,Braintree 002A,E01021398,641,488,303,185,2,2,77,14,63,74,55,19,0
2021,Braintree 003C,E01021399,698,477,260,217,4,4,159,35,124,58,48,10,0
2021,Braintree 003D,E01021400,760,546,289,257,2,2,103,23,80,109,89,20,0
2021,Braintree 014D,E01021401,697,377,213,164,1,1,236,45,191,83,72,11,0
2021,Braintree 014E,E01021402,848,637,330,307,2,2,76,25,51,133,125,8,0
2021,Braintree 014F,E01021403,637,557,283,274,3,3,6,0,6,71,60,11,0
2021,Braintree 005A,E01021404,941,714,451,263,4,4,102,15,87,121,96,25,0
2021,Braintree 010D,E01021405,935,761,424,337,8,8,82,9,73,84,73,11,0
2021,Braintree 002B,E01021406,1007,757,457,300,7,7,87,17,70,156,137,19,0
2021,Braintree 002C,E01021407,939,750,468,282,4,4,70,8,62,115,86,29,0
2021,Braintree 006C,E01021408,756,626,371,255,6,6,44,5,39,80,63,17,0
2021,Braintree 006D,E01021409,738,598,310,288,0,0,48,11,37,92,78,14,0
2021,Braintree 006E,E01021410,796,408,220,188,8,8,247,53,194,133,125,8,0
2021,Braintree 005B,E01021411,598,414,216,198,7,7,108,27,81,68,59,9,1
2021,Braintree 005C,E01021412,595,404,223,181,4,4,68,15,53,119,53,66,0
2021,Braintree 005D,E01021413,541,451,256,195,0,0,39,5,34,51,40,11,0
2021,Braintree 001C,E01021414,923,711,414,297,5,5,118,21,97,89,65,24,0
2021,Braintree 017A,E01021415,838,420,254,166,4,4,261,38,223,152,128,24,1
2021,Braintree 017B,E01021416,984,611,298,313,2,2,57,9,48,314,298,16,0
2021,Braintree 015B,E01021417,664,402,206,196,3,3,173,43,130,86,74,12,0
2021,Braintree 015C,E01021418,560,297,115,182,2,2,185,65,120,76,62,14,0
2021,Braintree 015D,E01021419,714,484,241,243,1,1,151,34,117,78,66,12,0
2021,Braintree 017C,E01021420,749,444,206,238,3,3,138,45,93,162,153,9,2
2021,Braintree 017E,E01021422,790,443,228,215,1,1,243,66,177,103,88,15,0
2021,Braintree 016A,E01021423,615,313,114,199,0,0,191,50,141,111,101,10,0
2021,Braintree 018E,E01021424,903,646,274,372,9,9,113,12,101,135,124,11,0
2021,Braintree 016B,E01021425,586,310,123,187,0,0,187,46,141,86,79,7,3
2021,Braintree 015E,E01021426,556,353,176,177,8,8,138,12,126,57,48,9,0
2021,Braintree 016C,E01021427,523,271,104,167,1,1,193,52,141,58,52,6,0
2021,Braintree 015F,E01021428,622,572,368,204,1,1,10,1,9,39,34,5,0
2021,Braintree 016D,E01021429,515,325,144,181,1,1,124,32,92,65,62,3,0
2021,Braintree 001D,E01021430,914,652,313,339,3,3,141,32,109,118,99,19,0
2021,Brentwood 004A,E01021431,642,507,228,279,2,2,11,8,3,122,101,21,0
2021,Brentwood 004B,E01021432,757,407,166,241,14,14,273,139,134,62,56,6,1
2021,Brentwood 007A,E01021433,1088,664,352,312,6,6,58,29,29,350,321,29,10
2021,Brentwood 004C,E01021434,667,454,191,263,16,16,92,29,63,103,97,6,2
2021,Brentwood 008A,E01021435,766,491,231,260,1,1,186,182,4,87,76,11,1
2021,Brentwood 008B,E01021437,736,360,116,244,0,0,281,263,18,93,84,9,2
2021,Brentwood 006A,E01021438,885,780,287,493,0,0,4,1,3,101,87,14,0
2021,Brentwood 001A,E01021441,583,473,263,210,3,3,75,25,50,31,25,6,1
2021,Brentwood 001B,E01021442,509,484,281,203,0,0,3,2,1,22,17,5,0
2021,Brentwood 001C,E01021443,571,443,235,208,4,4,43,39,4,81,59,22,0
2021,Brentwood 001D,E01021444,650,517,282,235,1,1,76,63,13,56,43,13,0
2021,Brentwood 009A,E01021445,848,717,393,324,2,2,29,26,3,99,79,20,1
2021,Brentwood 009B,E01021446,699,586,291,295,0,0,18,18,0,95,86,9,0
2021,Brentwood 005A,E01021447,970,859,484,375,1,1,12,11,1,98,85,13,0
2021,Brentwood 003A,E01021448,681,374,191,183,0,0,217,200,17,86,78,8,4
2021,Brentwood 003B,E01021449,652,449,208,241,3,3,124,121,3,75,57,18,1
2021,Brentwood 003C,E01021450,794,705,359,346,5,5,6,4,2,78,73,5,0
2021,Brentwood 003D,E01021451,623,275,109,166,1,1,260,221,39,86,78,8,1
2021,Brentwood 003E,E01021452,625,538,306,232,3,3,5,2,3,79,70,9,0
2021,Brentwood 005B,E01021453,533,397,233,164,1,1,35,30,5,100,92,8,0
2021,Brentwood 009C,E01021454,529,433,227,206,0,0,15,1,14,81,70,11,0
2021,Brentwood 005C,E01021455,531,497,292,205,2,2,3,2,1,29,24,5,0
2021,Brentwood 009D,E01021456,507,396,216,180,1,1,7,2,5,103,97,6,0
2021,Brentwood 002A,E01021457,657,411,247,164,3,3,147,136,11,90,67,23,6
2021,Brentwood 002B,E01021458,841,569,344,225,12,12,55,37,18,205,186,19,0
2021,Brentwood 002C,E01021459,517,480,298,182,0,0,5,0,5,32,31,1,0
2021,Brentwood 002D,E01021460,760,540,266,274,19,19,105,87,18,95,80,15,1
2021,Brentwood 004D,E01021461,642,322,152,170,4,4,245,224,21,70,61,9,1
2021,Brentwood 006B,E01021462,578,502,276,226,2,2,22,18,4,52,43,9,0
2021,Brentwood 006C,E01021463,635,479,263,216,2,2,85,81,4,65,51,14,4
2021,Brentwood 004E,E01021464,615,451,215,236,0,0,104,93,11,59,47,12,1
2021,Brentwood 005D,E01021465,847,597,339,258,1,1,6,3,3,242,221,21,1
2021,Brentwood 005E,E01021466,644,604,348,256,0,0,2,1,1,38,29,9,0
2021,Brentwood 005F,E01021467,677,615,320,295,6,6,6,4,2,50,46,4,0
2021,Brentwood 006D,E01021468,791,641,318,323,2,2,26,10,16,122,101,21,0
2021,Brentwood 001E,E01021469,465,403,245,158,0,0,30,27,3,31,21,10,1
2021,Brentwood 001F,E01021470,430,338,190,148,5,5,65,27,38,21,15,6,1
2021,Brentwood 001G,E01021471,622,573,336,237,0,0,23,16,7,26,21,5,0
2021,Brentwood 008C,E01021472,922,457,182,275,14,14,201,172,29,249,237,12,1
2021,Brentwood 008D,E01021473,609,450,249,201,5,5,56,25,31,98,83,15,0
2021,Brentwood 008E,E01021474,609,557,301,256,0,0,6,4,2,46,38,8,0
2021,Brentwood 007E,E01021475,685,453,191,262,2,2,45,25,20,185,175,10,0
2021,Castle Point 003A,E01021476,790,608,322,286,6,6,86,75,11,89,80,9,1
2021,Castle Point 003B,E01021477,631,571,341,230,5,5,2,1,1,53,40,13,0
2021,Castle Point 003C,E01021478,679,617,324,293,2,2,4,3,1,56,45,11,0
2021,Castle Point 004A,E01021479,589,530,271,259,1,1,14,12,2,44,38,6,0
2021,Castle Point 007A,E01021480,708,602,309,293,2,2,1,1,0,103,91,12,0
2021,Castle Point 004B,E01021481,620,546,269,277,11,11,1,1,0,62,54,8,0
2021,Castle Point 006A,E01021482,595,503,290,213,1,1,26,3,23,65,53,12,0
2021,Castle Point 004C,E01021483,725,661,364,297,0,0,4,2,2,60,48,12,0
2021,Castle Point 011A,E01021484,599,479,304,175,4,4,23,11,12,93,79,14,0
2021,Castle Point 010A,E01021485,487,306,166,140,2,2,122,117,5,53,47,6,4
2021,Castle Point 010B,E01021486,456,262,127,135,1,1,84,75,9,109,105,4,0
2021,Castle Point 008A,E01021487,596,491,283,208,0,0,13,13,0,92,73,19,0
2021,Castle Point 010C,E01021488,637,395,198,197,5,5,159,145,14,77,57,20,1
2021,Castle Point 012A,E01021489,622,531,303,228,1,1,3,0,3,87,73,14,0
2021,Castle Point 012B,E01021490,614,458,269,189,0,0,68,68,0,86,78,8,2
2021,Castle Point 012C,E01021491,686,584,319,265,0,0,8,4,4,94,78,16,0
2021,Castle Point 009A,E01021492,712,582,318,264,2,2,20,18,2,108,95,13,0
2021,Castle Point 009B,E01021493,704,566,358,208,3,3,20,18,2,115,98,17,0
2021,Castle Point 008B,E01021494,582,462,231,231,0,0,33,21,12,87,77,10,0
2021,Castle Point 009C,E01021495,1178,1065,888,177,3,3,17,10,7,92,78,14,1
2021,Castle Point 009D,E01021496,595,458,250,208,1,1,24,21,3,112,101,11,0
2021,Castle Point 012D,E01021497,661,548,318,230,2,2,11,7,4,100,87,13,0
2021,Castle Point 011B,E01021498,667,487,294,193,1,1,36,29,7,143,128,15,0
2021,Castle Point 011C,E01021499,660,564,347,217,2,2,31,27,4,63,55,8,0
2021,Castle Point 012E,E01021500,1147,721,472,249,1,1,87,45,42,337,314,23,1
2021,Castle Point 011D,E01021501,624,489,311,178,3,3,35,18,17,97,82,15,0
2021,Castle Point 011E,E01021502,842,648,364,284,1,1,14,11,3,179,165,14,0
2021,Castle Point 010D,E01021503,547,420,221,199,0,0,43,25,18,84,75,9,0
2021,Castle Point 008C,E01021504,495,382,165,217,4,4,35,5,30,74,66,8,0
2021,Castle Point 008D,E01021505,495,410,207,203,4,4,33,10,23,48,42,6,0
2021,Castle Point 008E,E01021506,520,371,152,219,1,1,19,5,14,129,121,8,0
2021,Castle Point 010E,E01021507,601,246,116,130,0,0,246,146,100,106,97,9,3
2021,Castle Point 010F,E01021508,443,303,132,171,1,1,35,5,30,104,97,7,0
2021,Castle Point 002A,E01021509,641,543,311,232,1,1,40,15,25,56,42,14,1
2021,Castle Point 002B,E01021510,669,583,340,243,1,1,5,3,2,80,70,10,0
2021,Castle Point 002C,E01021511,772,639,314,325,29,29,31,11,20,73,64,9,0
2021,Castle Point 004D,E01021512,644,557,333,224,0,0,9,3,6,78,68,10,0
2021,Castle Point 001A,E01021513,641,572,325,247,2,2,19,17,2,48,38,10,0
2021,Castle Point 001B,E01021514,613,479,226,253,4,4,55,52,3,74,65,9,1
2021,Castle Point 001C,E01021515,492,417,212,205,0,0,16,15,1,59,49,10,0
2021,Castle Point 003D,E01021516,543,473,265,208,1,1,1,1,0,68,62,6,0
2021,Castle Point 005A,E01021517,728,638,384,254,4,4,14,6,8,71,57,14,1
2021,Castle Point 006B,E01021518,1063,637,341,296,2,2,81,38,43,339,310,29,4
2021,Castle Point 005B,E01021519,652,581,354,227,1,1,12,10,2,58,45,13,0
2021,Castle Point 006C,E01021520,671,540,333,207,6,6,16,6,10,109,99,10,0
2021,Castle Point 007B,E01021521,608,561,307,254,2,2,3,2,1,42,36,6,0
2021,Castle Point 007C,E01021522,770,512,278,234,0,0,78,62,16,179,160,19,1
2021,Castle Point 007D,E01021523,589,524,313,211,1,1,23,2,21,41,31,10,0
2021,Castle Point 007E,E01021524,640,547,296,251,1,1,19,19,0,73,63,10,0
2021,Castle Point 001D,E01021525,703,477,227,250,1,1,42,12,30,183,166,17,0
2021,Castle Point 004E,E01021526,641,584,317,267,2,2,5,3,2,50,41,9,0
2021,Castle Point 001E,E01021527,674,613,354,259,0,0,3,1,2,58,46,12,0
2021,Castle Point 002D,E01021528,618,551,347,204,1,1,1,0,1,65,55,10,0
2021,Castle Point 006D,E01021529,639,366,168,198,1,1,181,172,9,90,76,14,1
2021,Castle Point 005C,E01021530,621,542,333,209,2,2,17,12,5,60,49,11,0
2021,Castle Point 002E,E01021531,607,529,268,261,3,3,17,8,9,57,49,8,1
2021,Castle Point 005D,E01021532,635,593,389,204,1,1,5,1,4,34,31,3,2
2021,Chelmsford 016A,E01021533,913,778,428,350,1,1,49,3,46,85,73,12,0
2021,Chelmsford 016B,E01021535,702,548,275,273,8,8,76,13,63,70,56,14,0
2021,Chelmsford 005A,E01021536,722,407,199,208,2,2,215,28,187,97,80,17,1
2021,Chelmsford 005B,E01021537,911,745,372,373,13,13,40,9,31,113,99,14,0
2021,Chelmsford 001A,E01021538,1120,818,365,453,23,23,155,21,134,124,101,23,0
2021,Chelmsford 001B,E01021539,570,398,222,176,1,1,114,20,94,57,45,12,0
2021,Chelmsford 001C,E01021540,881,664,316,348,19,19,103,13,90,95,77,18,0
2021,Chelmsford 002A,E01021542,1003,602,296,306,17,17,271,19,252,113,91,22,0
2021,Chelmsford 002B,E01021543,670,593,310,283,3,3,15,3,12,59,48,11,0
2021,Chelmsford 008A,E01021544,619,429,187,242,4,4,8,6,2,178,168,10,0
2021,Chelmsford 008B,E01021545,631,526,204,322,2,2,12,2,10,91,81,10,0
2021,Chelmsford 008C,E01021546,601,382,172,210,0,0,133,26,107,86,82,4,0
2021,Chelmsford 008D,E01021547,697,449,187,262,4,4,67,4,63,177,166,11,0
2021,Chelmsford 013A,E01021548,536,402,208,194,0,0,52,9,43,82,72,10,0
2021,Chelmsford 003A,E01021550,689,534,277,257,9,9,49,7,42,97,68,29,0
2021,Chelmsford 011A,E01021551,588,448,265,183,1,1,75,14,61,64,50,14,0
2021,Chelmsford 017A,E01021552,670,501,296,205,2,2,122,26,96,44,35,9,1
2021,Chelmsford 017B,E01021553,564,409,230,179,1,1,99,14,85,54,49,5,1
2021,Chelmsford 017C,E01021554,636,356,208,148,3,3,209,52,157,67,63,4,1
2021,Chelmsford 017D,E01021555,530,458,269,189,1,1,28,6,22,42,33,9,1
2021,Chelmsford 012A,E01021556,915,671,304,367,30,30,70,10,60,144,125,19,0
2021,Chelmsford 015A,E01021557,491,443,238,205,4,4,6,0,6,38,37,1,0
2021,Chelmsford 015B,E01021558,491,447,280,167,2,2,6,3,3,36,32,4,0
2021,Chelmsford 017E,E01021559,561,498,283,215,1,1,20,1,19,42,37,5,0
2021,Chelmsford 013B,E01021560,816,668,408,260,3,3,44,9,35,101,86,15,0
2021,Chelmsford 013C,E01021561,769,691,406,285,7,7,23,1,22,48,40,8,0
2021,Chelmsford 014A,E01021562,802,461,241,220,4,4,253,44,209,83,72,11,1
2021,Chelmsford 014B,E01021563,801,375,151,224,4,4,270,69,201,151,137,14,1
2021,Chelmsford 013D,E01021564,646,535,314,221,4,4,41,8,33,66,59,7,0
2021,Chelmsford 014C,E01021565,686,256,118,138,5,5,370,22,348,55,49,6,0
2021,Chelmsford 014D,E01021566,694,543,300,243,12,12,69,7,62,66,60,6,4
2021,Chelmsford 005D,E01021568,644,569,348,221,0,0,28,5,23,47,38,9,0
2021,Chelmsford 016C,E01021569,686,629,360,269,1,1,5,0,5,51,36,15,0
2021,Chelmsford 016D,E01021570,786,709,460,249,3,3,25,4,21,49,43,6,0
2021,Chelmsford 013E,E01021571,604,505,278,227,3,3,48,9,39,48,38,10,0
2021,Chelmsford 016E,E01021572,647,373,198,175,3,3,224,38,186,47,39,8,0
2021,Chelmsford 009A,E01021573,700,490,234,256,2,2,108,28,80,100,89,11,0
2021,Chelmsford 009B,E01021575,725,336,126,210,25,25,163,17,146,201,184,17,0
2021,Chelmsford 006A,E01021576,638,174,62,112,0,0,400,81,319,63,59,4,1
2021,Chelmsford 012B,E01021577,639,517,250,267,2,2,22,6,16,98,86,12,0
2021,Chelmsford 023D,E01021578,854,404,175,229,34,34,87,20,67,329,309,20,0
2021,Chelmsford 012C,E01021579,693,494,205,289,6,6,32,6,26,161,149,12,0
2021,Chelmsford 012D,E01021580,512,455,196,259,1,1,17,2,15,39,35,4,0
2021,Chelmsford 023C,E01021582,1083,553,277,276,7,7,82,12,70,441,409,32,0
2021,Chelmsford 015C,E01021583,614,449,213,236,11,11,81,4,77,73,62,11,0
2021,Chelmsford 012E,E01021584,477,446,253,193,2,2,4,1,3,25,24,1,0
2021,Chelmsford 015D,E01021585,494,438,230,208,1,1,8,3,5,47,45,2,0
2021,Chelmsford 015E,E01021586,605,540,272,268,0,0,7,1,6,58,52,6,0
2021,Chelmsford 002C,E01021587,622,564,336,228,1,1,12,1,11,45,41,4,0
2021,Chelmsford 006B,E01021588,597,323,182,141,1,1,216,57,159,55,49,6,2
2021,Chelmsford 006C,E01021589,664,366,175,191,0,0,146,21,125,150,140,10,2
2021,Chelmsford 002D,E01021590,583,508,289,219,0,0,8,5,3,67,59,8,0
2021,Chelmsford 002E,E01021591,655,526,269,257,3,3,5,1,4,121,113,8,0
2021,Chelmsford 006D,E01021592,701,193,95,98,1,1,391,46,345,116,104,12,0
2021,Chelmsford 021A,E01021593,681,620,369,251,0,0,9,4,5,52,46,6,0
2021,Chelmsford 021C,E01021595,746,671,408,263,2,2,7,0,7,66,49,17,0
2021,Chelmsford 006E,E01021596,676,228,104,124,5,5,386,89,297,56,48,8,1
2021,Chelmsford 003B,E01021597,603,373,182,191,3,3,159,34,125,68,59,9,0
2021,Chelmsford 003C,E01021598,658,382,185,197,2,2,213,40,173,60,58,2,1
2021,Chelmsford 009C,E01021599,725,563,312,251,7,7,39,11,28,115,109,6,1
2021,Chelmsford 003D,E01021600,441,395,239,156,0,0,14,3,11,32,30,2,0
2021,Chelmsford 003E,E01021601,659,308,162,146,17,17,256,61,195,77,63,14,1
2021,Chelmsford 018B,E01021602,768,508,294,214,1,1,144,17,127,115,92,23,0
2021,Chelmsford 018D,E01021604,883,785,406,379,2,2,42,7,35,54,37,17,0
2021,Chelmsford 020A,E01021605,464,419,219,200,0,0,8,0,8,37,34,3,0
2021,Chelmsford 020B,E01021606,596,468,215,253,2,2,99,14,85,27,26,1,0
2021,Chelmsford 020C,E01021607,645,456,183,273,0,0,75,12,63,114,101,13,0
2021,Chelmsford 020D,E01021608,547,321,150,171,2,2,76,3,73,148,141,7,0
2021,Chelmsford 020E,E01021609,514,482,246,236,1,1,1,0,1,30,27,3,0
2021,Chelmsford 020F,E01021610,555,385,176,209,1,1,15,7,8,153,142,11,1
2021,Chelmsford 019A,E01021611,522,467,223,244,1,1,2,0,2,52,45,7,0
2021,Chelmsford 019B,E01021612,610,543,313,230,3,3,10,0,10,54,45,9,0
2021,Chelmsford 019C,E01021613,861,547,261,286,23,23,49,5,44,241,222,19,1
2021,Chelmsford 019D,E01021614,664,576,314,262,2,2,10,3,7,76,63,13,0
2021,Chelmsford 019E,E01021615,622,512,282,230,2,2,15,1,14,93,79,14,0
2021,Chelmsford 004B,E01021617,584,350,177,173,3,3,176,35,141,54,51,3,1
2021,Chelmsford 007A,E01021618,586,454,216,238,3,3,34,0,34,95,87,8,0
2021,Chelmsford 004C,E01021619,619,490,252,238,8,8,29,6,23,92,82,10,0
2021,Chelmsford 004D,E01021620,645,421,211,210,3,3,21,6,15,200,190,10,0
2021,Chelmsford 007B,E01021621,615,441,154,287,1,1,14,2,12,157,142,15,2
2021,Chelmsford 007C,E01021622,623,533,331,202,3,3,20,6,14,67,58,9,0
2021,Chelmsford 004E,E01021623,507,409,217,192,1,1,5,4,1,92,83,9,0
2021,Chelmsford 004F,E01021624,495,442,278,164,2,2,7,2,5,44,35,9,0
2021,Chelmsford 007D,E01021625,602,505,301,204,3,3,24,5,19,70,61,9,0
2021,Chelmsford 007E,E01021626,585,486,251,235,3,3,9,0,9,87,78,9,0
2021,Chelmsford 022B,E01021627,571,343,186,157,0,0,95,11,84,132,122,10,1
2021,Chelmsford 008E,E01021628,731,479,222,257,3,3,103,21,82,146,135,11,0
2021,Chelmsford 008F,E01021629,681,376,164,212,10,10,178,40,138,117,109,8,0
2021,Chelmsford 009E,E01021631,774,321,129,192,4,4,342,69,273,107,95,12,0
2021,Chelmsford 011B,E01021632,648,558,348,210,3,3,56,5,51,31,28,3,0
2021,Chelmsford 011C,E01021633,524,412,255,157,4,4,23,3,20,85,67,18,0
2021,Chelmsford 011D,E01021634,600,509,301,208,1,1,27,11,16,63,51,12,0
2021,Chelmsford 011E,E01021635,652,496,317,179,5,5,79,17,62,72,61,11,0
2021,Chelmsford 011F,E01021636,517,250,138,112,1,1,230,38,192,36,32,4,0
2021,Colchester 018A,E01021637,486,346,197,149,1,1,73,61,12,64,57,7,2
2021,Colchester 018B,E01021638,756,426,133,293,3,3,213,158,55,113,98,15,1
2021,Colchester 018C,E01021639,949,515,166,349,6,6,201,107,94,226,213,13,1
2021,Colchester 018D,E01021640,487,354,167,187,2,2,70,31,39,61,52,9,0
2021,Colchester 018E,E01021641,600,420,207,213,1,1,103,76,27,76,65,11,0
2021,Colchester 018F,E01021642,876,458,179,279,4,4,211,130,81,201,182,19,2
2021,Colchester 019A,E01021643,955,854,436,418,0,0,25,19,6,76,64,12,0
2021,Colchester 019B,E01021644,677,500,272,228,4,4,74,59,15,98,80,18,1
2021,Colchester 019C,E01021645,589,527,320,207,3,3,23,13,10,36,27,9,0
2021,Colchester 007A,E01021646,1043,481,249,232,10,10,117,15,102,435,401,34,0
2021,Colchester 007B,E01021647,981,641,327,314,4,4,106,14,92,228,206,22,2
2021,Colchester 007C,E01021648,1168,619,346,273,11,11,123,15,108,415,393,22,0
2021,Colchester 007E,E01021650,1023,403,179,224,2,2,65,27,38,551,524,27,2
2021,Colchester 013A,E01021651,1125,592,259,333,16,16,105,7,98,412,385,27,0
2021,Colchester 013B,E01021652,647,497,258,239,1,1,22,3,19,127,107,20,0
2021,Colchester 013C,E01021653,497,425,200,225,0,0,6,3,3,66,61,5,0
2021,Colchester 001A,E01021655,539,466,287,179,4,4,20,14,6,49,42,7,0
2021,Colchester 001B,E01021656,725,547,340,207,5,5,86,55,31,87,71,16,0
2021,Colchester 016A,E01021657,951,712,300,412,2,2,71,44,27,166,148,18,0
2021,Colchester 016B,E01021658,445,292,144,148,2,2,101,80,21,50,40,10,0
2021,Colchester 001C,E01021659,862,689,385,304,0,0,88,72,16,85,60,25,0
2021,Colchester 003A,E01021660,589,452,271,181,3,3,65,42,23,68,58,10,1
2021,Colchester 001D,E01021661,753,625,302,323,1,1,50,12,38,77,64,13,0
2021,Colchester 010B,E01021662,640,550,304,246,1,1,38,28,10,51,41,10,0
2021,Colchester 010C,E01021663,480,398,227,171,3,3,47,35,12,32,27,5,0
2021,Colchester 016C,E01021664,919,525,265,260,5,5,109,47,62,280,262,18,0
2021,Colchester 016D,E01021665,644,278,139,139,1,1,292,222,70,70,64,6,3
2021,Colchester 016E,E01021666,638,374,174,200,1,1,53,40,13,209,201,8,1
2021,Colchester 016F,E01021667,633,347,182,165,0,0,193,161,32,92,75,17,1
2021,Colchester 002A,E01021668,797,410,185,225,2,2,72,6,66,313,296,17,0
2021,Colchester 002B,E01021669,702,290,116,174,7,7,180,46,134,224,206,18,1
2021,Colchester 002C,E01021670,619,350,184,166,2,2,139,10,129,128,114,14,0
2021,Colchester 002D,E01021671,592,453,265,188,1,1,65,31,34,72,70,2,1
2021,Colchester 009A,E01021673,634,550,364,186,1,1,7,5,2,76,69,7,0
2021,Colchester 009B,E01021674,552,342,128,214,3,3,132,87,45,75,66,9,0
2021,Colchester 009C,E01021675,544,445,253,192,3,3,23,11,12,72,61,11,1
2021,Colchester 009D,E01021676,686,520,292,228,0,0,54,43,11,112,100,12,0
2021,Colchester 010D,E01021677,497,456,283,173,3,3,10,2,8,28,23,5,0
2021,Colchester 010E,E01021678,616,443,202,241,0,0,42,39,3,130,116,14,1
2021,Colchester 011A,E01021683,1046,513,170,343,0,0,54,18,36,478,445,33,1
2021,Colchester 011B,E01021684,702,429,179,250,2,2,69,8,61,202,190,12,0
2021,Colchester 011E,E01021687,816,413,170,243,2,2,57,24,33,342,320,22,2
2021,Colchester 011F,E01021688,745,473,190,283,2,2,41,8,33,229,219,10,0
2021,Colchester 014A,E01021689,621,449,261,188,0,0,104,92,12,67,60,7,1
2021,Colchester 014B,E01021690,505,439,231,208,0,0,8,3,5,58,48,10,0
2021,Colchester 014C,E01021691,656,542,320,222,3,3,64,28,36,47,42,5,0
2021,Colchester 014D,E01021692,609,536,343,193,0,0,7,3,4,66,54,12,0
2021,Colchester 014E,E01021693,719,643,426,217,0,0,16,7,9,60,50,10,0
2021,Colchester 019D,E01021694,608,520,319,201,2,2,32,20,12,53,36,17,1
2021,Colchester 019E,E01021695,486,417,247,170,1,1,19,17,2,49,38,11,0
2021,Colchester 008A,E01021696,697,147,82,65,3,3,420,373,47,125,117,8,2
2021,Colchester 008B,E01021697,716,309,148,161,4,4,284,262,22,118,111,7,1
2021,Colchester 008C,E01021698,479,195,119,76,2,2,133,113,20,149,141,8,0
2021,Colchester 008D,E01021699,599,191,121,70,0,0,273,252,21,132,132,0,3
2021,Colchester 008E,E01021700,534,104,58,46,0,0,280,210,70,147,137,10,3
2021,Colchester 022D,E01021702,589,414,234,180,6,6,34,14,20,135,118,17,0
2021,Colchester 022E,E01021703,492,187,74,113,1,1,248,232,16,53,47,6,3
2021,Colchester 022F,E01021704,658,386,185,201,4,4,143,122,21,125,119,6,0
2021,Colchester 022G,E01021705,783,620,339,281,1,1,68,4,64,94,87,7,0
2021,Colchester 022H,E01021706,601,293,151,142,2,2,55,23,32,251,242,9,0
2021,Colchester 022I,E01021707,590,421,236,185,4,4,87,61,26,75,66,9,3
2021,Colchester 022A,E01021708,635,525,315,210,2,2,54,30,24,53,42,11,1
2021,Colchester 022B,E01021709,624,550,372,178,1,1,9,2,7,64,54,10,0
2021,Colchester 022C,E01021710,912,806,457,349,5,5,25,8,17,76,61,15,0
2021,Colchester 015A,E01021711,582,282,144,138,3,3,239,218,21,53,46,7,5
2021,Colchester 015C,E01021713,492,291,144,147,4,4,150,121,29,45,37,8,2
2021,Colchester 015D,E01021714,715,381,136,245,6,6,80,12,68,248,169,79,0
2021,Colchester 015E,E01021715,595,401,186,215,2,2,124,96,28,68,58,10,0
2021,Colchester 013D,E01021717,1077,625,256,369,3,3,145,47,98,304,202,102,0
2021,Colchester 012A,E01021718,793,579,243,336,4,4,36,8,28,174,156,18,0
2021,Colchester 012B,E01021719,720,597,356,241,1,1,18,2,16,104,85,19,0
2021,Colchester 012C,E01021720,708,405,205,200,8,8,209,134,75,86,77,9,0
2021,Colchester 012D,E01021721,786,661,375,286,3,3,39,3,36,83,71,12,0
2021,Colchester 012E,E01021722,1007,758,287,471,13,13,146,96,50,89,73,16,1
2021,Colchester 020A,E01021723,833,636,395,241,5,5,68,14,54,124,93,31,0
2021,Colchester 020B,E01021724,754,636,395,241,2,2,11,8,3,105,90,15,0
2021,Colchester 020C,E01021725,608,487,295,192,6,6,22,5,17,93,52,41,0
2021,Colchester 020D,E01021726,652,411,227,184,4,4,150,118,32,85,75,10,2
2021,Colchester 020E,E01021727,695,588,364,224,3,3,18,12,6,86,67,19,0
2021,Colchester 003B,E01021728,680,629,390,239,3,3,2,2,0,46,40,6,0
2021,Colchester 003C,E01021729,679,504,260,244,0,0,83,71,12,91,79,12,1
2021,Colchester 003D,E01021730,728,561,320,241,1,1,85,78,7,80,64,16,1
2021,Colchester 021A,E01021731,660,582,410,172,1,1,13,8,5,64,49,15,0
2021,Colchester 021B,E01021732,724,460,283,177,3,3,156,116,40,105,85,20,0
2021,Colchester 021C,E01021733,675,583,379,204,4,4,34,11,23,54,42,12,0
2021,Colchester 021D,E01021734,627,536,384,152,2,2,23,5,18,66,54,12,0
2021,Colchester 021E,E01021735,678,574,442,132,1,1,15,10,5,88,71,17,0
2021,Colchester 017A,E01021736,411,318,180,138,0,0,26,3,23,67,56,11,0
2021,Colchester 017B,E01021737,559,420,262,158,3,3,10,4,6,125,108,17,1
2021,Colchester 017C,E01021738,1031,766,469,297,12,12,27,12,15,226,203,23,0
2021,Colchester 017D,E01021739,667,584,368,216,1,1,3,2,1,79,66,13,0
2021,Colchester 017E,E01021740,734,541,300,241,3,3,84,69,15,106,89,17,0
2021,Epping Forest 002A,E01021741,849,671,326,345,5,5,64,49,15,109,77,32,0
2021,Epping Forest 015A,E01021742,501,358,160,198,0,0,106,104,2,36,33,3,1
2021,Epping Forest 015B,E01021743,792,495,230,265,1,1,149,89,60,146,135,11,1
2021,Epping Forest 015C,E01021744,662,477,231,246,5,5,55,53,2,125,115,10,0
2021,Epping Forest 015D,E01021745,687,504,247,257,9,9,17,2,15,157,139,18,0
2021,Epping Forest 015E,E01021746,863,631,323,308,3,3,29,23,6,200,178,22,0
2021,Epping Forest 015F,E01021747,648,550,286,264,0,0,19,9,10,79,69,10,0
2021,Epping Forest 015G,E01021748,729,507,250,257,1,1,12,11,1,209,187,22,0
2021,Epping Forest 016A,E01021749,915,729,390,339,1,1,56,49,7,127,108,19,2
2021,Epping Forest 016B,E01021750,612,481,218,263,4,4,23,4,19,104,75,29,0
2021,Epping Forest 016C,E01021751,460,433,211,222,0,0,5,4,1,22,17,5,0
2021,Epping Forest 016D,E01021752,560,435,192,243,0,0,33,32,1,91,74,17,1
2021,Epping Forest 004A,E01021753,719,433,224,209,0,0,132,118,14,152,139,13,2
2021,Epping Forest 004B,E01021754,616,562,349,213,1,1,8,6,2,45,28,17,0
2021,Epping Forest 004C,E01021755,536,486,301,185,1,1,10,3,7,38,33,5,1
2021,Epping Forest 006A,E01021756,630,514,269,245,2,2,49,47,2,65,57,8,0
2021,Epping Forest 006B,E01021757,857,601,364,237,0,0,7,1,6,249,230,19,0
2021,Epping Forest 006C,E01021758,709,328,171,157,3,3,191,81,110,184,175,9,3
2021,Epping Forest 006D,E01021759,620,441,177,264,2,2,125,123,2,51,47,4,1
2021,Epping Forest 005A,E01021760,639,487,269,218,2,2,88,66,22,60,49,11,2
2021,Epping Forest 005B,E01021761,808,566,282,284,4,4,105,71,34,133,115,18,0
2021,Epping Forest 005C,E01021762,646,357,194,163,1,1,200,159,41,88,82,6,0
2021,Epping Forest 005D,E01021763,825,616,269,347,14,14,136,78,58,58,46,12,1
2021,Epping Forest 017A,E01021764,720,206,96,110,3,3,396,299,97,114,102,12,1
2021,Epping Forest 017B,E01021765,754,523,251,272,29,29,36,5,31,166,155,11,0
2021,Epping Forest 017C,E01021766,506,409,188,221,1,1,17,13,4,78,69,9,1
2021,Epping Forest 017D,E01021767,690,548,281,267,1,1,13,13,0,127,115,12,1
2021,Epping Forest 001A,E01021768,935,713,358,355,4,4,100,91,9,116,94,22,2
2021,Epping Forest 003A,E01021769,939,680,379,301,11,11,136,103,33,112,84,28,0
2021,Epping Forest 010A,E01021770,879,640,374,266,4,4,141,104,37,94,70,24,0
2021,Epping Forest 013A,E01021771,727,286,102,184,4,4,348,331,17,86,74,12,3
2021,Epping Forest 013B,E01021772,606,412,221,191,1,1,118,116,2,73,65,8,2
2021,Epping Forest 013C,E01021773,603,360,147,213,0,0,138,127,11,104,92,12,1
2021,Epping Forest 011A,E01021774,629,317,121,196,1,1,189,151,38,121,111,10,1
2021,Epping Forest 011B,E01021775,655,350,143,207,1,1,214,175,39,90,80,10,0
2021,Epping Forest 011C,E01021776,841,286,106,180,5,5,390,382,8,150,128,22,10
2021,Epping Forest 011D,E01021777,566,347,163,184,0,0,165,156,9,53,48,5,1
2021,Epping Forest 011E,E01021778,608,387,157,230,1,1,131,94,37,89,78,11,0
2021,Epping Forest 011F,E01021779,695,327,139,188,3,3,214,182,32,148,138,10,3
2021,Epping Forest 014A,E01021780,502,441,219,222,1,1,5,3,2,55,45,10,0
2021,Epping Forest 014B,E01021781,653,534,255,279,0,0,10,7,3,109,94,15,0
2021,Epping Forest 014C,E01021782,632,499,287,212,2,2,3,2,1,128,114,14,0
2021,Epping Forest 013D,E01021783,650,538,259,279,3,3,31,29,2,78,70,8,0
2021,Epping Forest 013E,E01021784,626,521,250,271,1,1,11,8,3,93,82,11,0
2021,Epping Forest 014D,E01021785,651,390,160,230,4,4,181,133,48,74,66,8,2
2021,Epping Forest 012A,E01021786,547,403,201,202,0,0,4,2,2,140,130,10,0
2021,Epping Forest 012B,E01021787,661,573,281,292,2,2,10,5,5,76,64,12,0
2021,Epping Forest 012C,E01021788,632,548,277,271,0,0,18,15,3,66,63,3,0
2021,Epping Forest 012D,E01021789,562,517,290,227,0,0,7,6,1,38,32,6,0
2021,Epping Forest 012E,E01021790,704,395,131,264,18,18,164,114,50,125,113,12,2
2021,Epping Forest 012F,E01021791,716,490,236,254,4,4,9,8,1,213,200,13,0
2021,Epping Forest 002B,E01021792,538,473,277,196,0,0,10,7,3,54,40,14,1
2021,Epping Forest 002C,E01021793,665,601,365,236,1,1,7,5,2,56,43,13,0
2021,Epping Forest 002D,E01021794,515,350,189,161,1,1,115,94,21,49,28,21,0
2021,Epping Forest 001B,E01021795,1045,673,310,363,0,0,22,9,13,350,326,24,0
2021,Epping Forest 003B,E01021796,955,723,417,306,2,2,93,85,8,137,112,25,0
2021,Epping Forest 001C,E01021797,529,430,242,188,20,20,39,36,3,39,37,2,1
2021,Epping Forest 001D,E01021798,650,517,296,221,2,2,80,49,31,51,41,10,0
2021,Epping Forest 001E,E01021799,795,465,226,239,7,7,224,116,108,98,91,7,1
2021,Epping Forest 003C,E01021800,945,726,384,342,5,5,51,46,5,163,120,43,0
2021,Epping Forest 002E,E01021801,930,747,422,325,1,1,93,84,9,87,61,26,2
2021,Epping Forest 004D,E01021802,1050,595,259,336,31,31,330,244,86,88,72,16,6
2021,Epping Forest 010B,E01021803,530,401,238,163,2,2,102,77,25,25,19,6,0
2021,Epping Forest 010C,E01021804,621,478,266,212,0,0,24,14,10,119,108,11,0
2021,Epping Forest 010D,E01021805,498,465,246,219,1,1,5,5,0,27,23,4,0
2021,Epping Forest 009A,E01021806,1140,879,568,311,43,43,80,18,62,138,103,35,0
2021,Epping Forest 008A,E01021807,587,465,209,256,3,3,38,34,4,81,69,12,0
2021,Epping Forest 008B,E01021808,620,336,162,174,3,3,224,218,6,57,51,6,0
2021,Epping Forest 008C,E01021809,605,398,209,189,1,1,155,142,13,49,44,5,2
2021,Epping Forest 008D,E01021810,779,521,191,330,8,8,60,39,21,189,168,21,1
2021,Epping Forest 007A,E01021811,592,285,137,148,7,7,251,113,138,47,41,6,2
2021,Epping Forest 009B,E01021812,594,474,329,145,1,1,57,23,34,61,42,19,1
2021,Epping Forest 007B,E01021813,614,501,311,190,2,2,23,18,5,88,77,11,0
2021,Epping Forest 007C,E01021814,689,461,211,250,26,26,156,115,41,46,41,5,0
2021,Epping Forest 007D,E01021815,589,347,147,200,4,4,180,172,8,56,47,9,2
2021,Epping Forest 007E,E01021816,624,232,91,141,0,0,332,320,12,56,54,2,4
2021,Epping Forest 008E,E01021817,1088,656,251,405,3,3,283,189,94,144,128,16,2
2021,Epping Forest 009C,E01021818,995,484,222,262,11,11,152,94,58,342,316,26,6
2021,Harlow 006A,E01021819,639,345,165,180,3,3,229,227,2,61,55,6,1
2021,Harlow 006B,E01021820,638,372,195,177,1,1,198,196,2,66,55,11,1
2021,Harlow 008A,E01021821,635,263,111,152,5,5,286,274,12,78,70,8,3
2021,Harlow 006C,E01021822,621,345,145,200,0,0,198,193,5,78,71,7,0
2021,Harlow 006D,E01021823,757,291,118,173,2,2,352,334,18,110,101,9,2
2021,Harlow 005A,E01021824,638,526,182,344,2,2,6,3,3,104,93,11,0
2021,Harlow 005B,E01021825,631,482,162,320,5,5,9,7,2,135,124,11,0
2021,Harlow 005C,E01021826,633,475,222,253,7,7,73,10,63,77,73,4,1
2021,Harlow 005D,E01021827,707,478,191,287,1,1,76,6,70,151,138,13,1
2021,Harlow 005E,E01021828,871,713,238,475,1,1,10,7,3,147,132,15,0
2021,Harlow 009A,E01021829,652,357,161,196,2,2,213,141,72,79,70,9,1
2021,Harlow 009B,E01021830,505,414,247,167,1,1,40,40,0,50,47,3,0
2021,Harlow 007A,E01021831,635,334,164,170,2,2,231,219,12,67,59,8,1
2021,Harlow 009C,E01021832,521,410,193,217,3,3,49,44,5,59,51,8,0
2021,Harlow 009D,E01021833,530,302,167,135,2,2,161,154,7,63,55,8,2
2021,Harlow 008B,E01021834,641,343,153,190,1,1,215,207,8,81,73,8,1
2021,Harlow 008C,E01021835,593,359,181,178,2,2,164,157,7,66,54,12,2
2021,Harlow 008D,E01021836,647,283,118,165,5,5,281,214,67,75,66,9,3
2021,Harlow 008E,E01021837,661,400,177,223,5,5,189,177,12,65,59,6,2
2021,Harlow 010A,E01021838,603,402,187,215,3,3,154,151,3,42,38,4,2
2021,Harlow 004A,E01021839,795,412,179,233,19,19,226,185,41,135,119,16,3
2021,Harlow 004B,E01021840,758,272,112,160,3,3,347,317,30,134,125,9,2
2021,Harlow 004C,E01021841,549,311,148,163,1,1,176,158,18,61,59,2,0
2021,Harlow 004D,E01021842,660,271,117,154,2,2,258,236,22,128,112,16,1
2021,Harlow 004E,E01021843,1142,453,145,308,55,55,344,179,165,287,270,17,3
2021,Harlow 002A,E01021844,520,283,131,152,2,2,177,164,13,57,49,8,1
2021,Harlow 002B,E01021845,663,246,106,140,0,0,340,290,50,75,68,7,2
2021,Harlow 002C,E01021846,584,214,92,122,2,2,251,242,9,112,105,7,5
2021,Harlow 002D,E01021847,603,301,137,164,4,4,243,239,4,54,46,8,1
2021,Harlow 002E,E01021848,842,366,156,210,16,16,298,251,47,158,147,11,4
2021,Harlow 003A,E01021849,682,333,158,175,4,4,253,212,41,90,83,7,2
2021,Harlow 003B,E01021850,600,258,97,161,1,1,265,260,5,76,71,5,0
2021,Harlow 003C,E01021851,768,246,106,140,13,13,297,270,27,202,185,17,10
2021,Harlow 003D,E01021852,670,309,141,168,0,0,272,256,16,86,80,6,3
2021,Harlow 003E,E01021853,829,400,172,228,2,2,195,168,27,232,217,15,0
2021,Harlow 001A,E01021854,980,637,240,397,23,23,215,184,31,105,94,11,0
2021,Harlow 001B,E01021855,650,384,191,193,9,9,174,172,2,80,67,13,3
2021,Harlow 001C,E01021856,655,403,222,181,1,1,142,134,8,108,95,13,1
2021,Harlow 010B,E01021858,693,342,130,212,35,35,234,34,200,82,75,7,0
2021,Harlow 010C,E01021859,620,255,101,154,1,1,255,245,10,109,102,7,0
2021,Harlow 010D,E01021860,622,313,149,164,11,11,198,104,94,98,89,9,2
2021,Harlow 010E,E01021861,557,318,132,186,29,29,169,56,113,41,34,7,0
2021,Harlow 011A,E01021862,641,312,148,164,4,4,209,142,67,110,96,14,6
2021,Harlow 011B,E01021863,650,335,163,172,0,0,214,192,22,100,92,8,1
2021,Harlow 011C,E01021864,560,240,107,133,3,3,196,190,6,121,111,10,0
2021,Harlow 009E,E01021865,571,310,140,170,1,1,160,150,10,96,92,4,4
2021,Harlow 011D,E01021866,613,338,139,199,10,10,175,159,16,90,83,7,0
2021,Harlow 011E,E01021867,591,487,254,233,3,3,40,35,5,61,53,8,0
2021,Harlow 007B,E01021868,668,375,168,207,2,2,197,194,3,91,82,9,3
2021,Harlow 007C,E01021869,554,372,193,179,5,5,113,104,9,64,54,10,0
2021,Harlow 006E,E01021870,568,324,150,174,1,1,174,166,8,67,52,15,2
2021,Harlow 007D,E01021871,615,251,123,128,8,8,275,205,70,77,71,6,4
2021,Maldon 007A,E01021873,535,479,281,198,0,0,6,2,4,50,44,6,0
2021,Maldon 007B,E01021874,613,428,211,217,4,4,109,10,99,72,58,14,0
2021,Maldon 007C,E01021875,684,602,429,173,5,5,13,0,13,64,41,23,0
2021,Maldon 008C,E01021878,639,507,328,179,4,4,63,1,62,65,54,11,0
2021,Maldon 008D,E01021879,646,466,241,225,3,3,72,12,60,105,85,20,0
2021,Maldon 008E,E01021880,815,478,310,168,1,1,149,13,136,186,156,30,1
2021,Maldon 008F,E01021881,535,408,255,153,0,0,10,1,9,117,102,15,0
2021,Maldon 002A,E01021882,873,752,479,273,1,1,38,4,34,82,59,23,0
2021,Maldon 002B,E01021883,669,549,272,277,1,1,63,6,57,56,50,6,0
2021,Maldon 003A,E01021884,615,476,229,247,0,0,31,0,31,108,100,8,0
2021,Maldon 003B,E01021885,471,418,251,167,3,3,3,0,3,47,33,14,0
2021,Maldon 003C,E01021886,652,540,307,233,7,7,42,2,40,62,47,15,1
2021,Maldon 003D,E01021887,955,785,372,413,17,17,86,4,82,67,47,20,0
2021,Maldon 003E,E01021888,982,520,223,297,21,21,345,26,319,95,84,11,1
2021,Maldon 004A,E01021889,1076,579,311,268,24,24,315,20,295,158,140,18,0
2021,Maldon 004B,E01021890,975,523,345,178,6,6,111,9,102,335,297,38,0
2021,Maldon 004C,E01021891,776,594,438,156,2,2,58,3,55,122,103,19,0
2021,Maldon 004D,E01021892,492,275,182,93,0,0,172,16,156,45,35,10,0
2021,Maldon 005A,E01021893,588,558,324,234,1,1,2,0,2,27,25,2,0
2021,Maldon 005B,E01021894,490,320,170,150,0,0,114,12,102,56,44,12,0
2021,Maldon 005C,E01021895,484,386,225,161,0,0,27,0,27,71,57,14,0
2021,Maldon 005D,E01021896,737,604,300,304,35,35,46,6,40,52,47,5,0
2021,Maldon 005E,E01021897,481,387,229,158,0,0,33,2,31,61,53,8,0
2021,Maldon 005F,E01021898,592,442,289,153,4,4,114,7,107,32,23,9,0
2021,Maldon 007D,E01021899,529,478,252,226,2,2,11,0,11,38,29,9,0
2021,Maldon 007E,E01021900,464,353,178,175,0,0,48,0,48,63,51,12,0
2021,Maldon 006A,E01021901,804,690,418,272,1,1,37,4,33,76,57,19,0
2021,Maldon 007F,E01021902,720,639,356,283,3,3,19,0,19,59,43,16,0
2021,Maldon 007G,E01021903,654,524,303,221,0,0,73,5,68,57,38,19,0
2021,Maldon 006B,E01021904,770,608,269,339,7,7,105,6,99,50,42,8,0
2021,Maldon 006C,E01021905,494,347,180,167,0,0,87,11,76,59,48,11,1
2021,Maldon 006D,E01021906,669,445,241,204,3,3,76,4,72,145,127,18,0
2021,Maldon 006E,E01021907,937,721,406,315,5,5,88,9,79,123,91,32,0
2021,Maldon 001A,E01021908,875,733,450,283,2,2,33,3,30,107,91,16,0
2021,Maldon 001B,E01021909,580,437,270,167,8,8,85,17,68,50,30,20,0
2021,Maldon 001C,E01021910,690,491,288,203,5,5,108,11,97,86,73,13,0
2021,Maldon 001D,E01021911,497,425,264,161,0,0,27,4,23,45,29,16,0
2021,Maldon 002C,E01021912,866,748,487,261,5,5,62,5,57,51,42,9,0
2021,Maldon 002D,E01021913,633,530,326,204,2,2,41,13,28,60,42,18,0
2021,Rochford 002A,E01021914,815,733,429,304,6,6,13,4,9,63,52,11,0
2021,Rochford 004A,E01021915,525,382,204,178,2,2,50,7,43,91,63,28,0
2021,Rochford 004B,E01021916,469,371,161,210,19,19,52,3,49,27,24,3,0
2021,Rochford 010A,E01021917,711,553,290,263,2,2,52,12,40,104,83,21,0
2021,Rochford 005A,E01021918,575,521,275,246,1,1,4,0,4,49,44,5,0
2021,Rochford 005B,E01021919,542,487,297,190,0,0,9,0,9,46,40,6,0
2021,Rochford 006A,E01021920,825,656,291,365,4,4,77,5,72,88,66,22,0
2021,Rochford 010B,E01021921,602,422,219,203,1,1,62,16,46,117,69,48,0
2021,Rochford 010C,E01021922,697,443,254,189,6,6,185,34,151,63,48,15,0
2021,Rochford 010D,E01021923,529,457,245,212,0,0,26,9,17,46,41,5,0
2021,Rochford 010E,E01021924,709,584,240,344,19,19,44,2,42,62,51,11,0
2021,Rochford 005C,E01021925,709,588,317,271,2,2,9,0,9,110,100,10,0
2021,Rochford 006B,E01021926,872,696,311,385,1,1,38,6,32,137,124,13,0
2021,Rochford 002B,E01021927,482,454,268,186,0,0,2,0,2,26,21,5,0
2021,Rochford 002C,E01021928,680,544,320,224,7,7,54,10,44,75,60,15,0
2021,Rochford 002D,E01021929,589,545,265,280,2,2,4,0,4,38,35,3,0
2021,Rochford 007A,E01021930,667,433,201,232,0,0,61,3,58,173,160,13,0
2021,Rochford 002E,E01021931,674,594,328,266,7,7,23,2,21,50,39,11,0
2021,Rochford 007B,E01021932,650,553,315,238,2,2,9,1,8,86,80,6,0
2021,Rochford 012E,E01021933,718,615,283,332,11,11,61,4,57,31,23,8,0
2021,Rochford 012D,E01021934,560,515,302,213,3,3,5,1,4,37,29,8,0
2021,Rochford 012C,E01021935,531,504,316,188,0,0,3,1,2,24,22,2,0
2021,Rochford 012B,E01021936,792,550,318,232,2,2,129,17,112,111,96,15,0
2021,Rochford 012A,E01021937,685,539,292,247,1,1,11,2,9,134,124,10,0
2021,Rochford 011B,E01021938,654,600,341,259,0,0,5,1,4,49,40,9,0
2021,Rochford 011D,E01021939,680,622,352,270,1,1,4,0,4,53,44,9,0
2021,Rochford 011A,E01021940,786,699,382,317,3,3,39,6,33,45,35,10,0
2021,Rochford 011C,E01021941,864,791,408,383,5,5,18,2,16,50,37,13,0
2021,Rochford 001A,E01021942,918,819,669,150,2,2,26,4,22,71,57,14,0
2021,Rochford 001B,E01021943,703,597,357,240,2,2,45,2,43,59,51,8,0
2021,Rochford 001C,E01021944,652,593,343,250,0,0,2,1,1,57,43,14,0
2021,Rochford 001D,E01021945,635,584,330,254,3,3,9,2,7,39,27,12,0
2021,Rochford 009A,E01021946,574,547,315,232,0,0,3,0,3,24,21,3,0
2021,Rochford 009B,E01021947,518,458,289,169,1,1,29,11,18,30,26,4,0
2021,Rochford 009C,E01021948,524,430,227,203,2,2,14,2,12,78,64,14,0
2021,Rochford 009D,E01021949,586,542,314,228,2,2,2,0,2,40,29,11,0
2021,Rochford 008A,E01021950,594,448,257,191,0,0,101,13,88,45,38,7,0
2021,Rochford 008B,E01021951,512,434,245,189,1,1,47,4,43,30,24,6,0
2021,Rochford 007C,E01021952,637,522,291,231,1,1,23,1,22,91,76,15,0
2021,Rochford 004C,E01021953,534,187,76,111,1,1,306,31,275,40,30,10,0
2021,Rochford 007D,E01021954,1144,795,305,490,45,45,156,17,139,148,123,25,0
2021,Rochford 004D,E01021955,891,368,172,196,3,3,299,32,267,218,201,17,3
2021,Rochford 007E,E01021956,638,443,234,209,4,4,97,11,86,94,80,14,0
2021,Rochford 006C,E01021957,741,443,198,245,10,10,230,26,204,58,52,6,0
2021,Rochford 006D,E01021958,517,434,168,266,2,2,2,0,2,79,71,8,0
2021,Rochford 006E,E01021959,632,499,231,268,1,1,52,14,38,80,75,5,0
2021,Rochford 005D,E01021960,781,732,424,308,1,1,6,2,4,42,32,10,0
2021,Rochford 005E,E01021961,655,566,300,266,2,2,38,6,32,49,41,8,0
2021,Rochford 008C,E01021962,546,338,203,135,6,6,111,13,98,91,83,8,0
2021,Rochford 008D,E01021963,525,459,265,194,0,0,4,0,4,62,57,5,0
2021,Rochford 008E,E01021964,688,577,305,272,1,1,24,5,19,86,79,7,0
2021,Rochford 009E,E01021965,981,902,536,366,3,3,6,1,5,70,57,13,0
2021,Rochford 008F,E01021966,831,501,286,215,7,7,182,17,165,141,119,22,0
2021,Tendring 009A,E01021967,1043,882,530,352,28,28,32,23,9,100,73,27,1
2021,Tendring 017A,E01021968,806,448,259,189,3,3,75,37,38,280,254,26,0
2021,Tendring 017B,E01021969,603,381,226,155,2,2,40,32,8,180,164,16,0
2021,Tendring 016A,E01021970,916,366,231,135,5,5,219,95,124,323,305,18,3
2021,Tendring 005A,E01021971,635,531,247,284,11,11,18,2,16,75,53,22,0
2021,Tendring 005B,E01021972,544,412,218,194,1,1,64,49,15,66,53,13,1
2021,Tendring 007A,E01021973,540,508,313,195,1,1,1,0,1,30,24,6,0
2021,Tendring 007B,E01021974,554,390,213,177,5,5,65,42,23,94,62,32,0
2021,Tendring 013A,E01021975,668,463,295,168,6,6,88,4,84,111,103,8,0
2021,Tendring 013B,E01021976,664,546,333,213,2,2,5,2,3,111,97,14,0
2021,Tendring 013C,E01021977,1168,846,509,337,2,2,152,8,144,168,147,21,0
2021,Tendring 003A,E01021978,986,832,533,299,4,4,44,27,17,104,75,29,2
2021,Tendring 011A,E01021979,638,475,278,197,0,0,96,93,3,67,62,5,0
2021,Tendring 011B,E01021980,793,625,422,203,4,4,51,3,48,113,99,14,0
2021,Tendring 011C,E01021981,901,721,428,293,4,4,42,13,29,134,113,21,0
2021,Tendring 011D,E01021982,1006,590,319,271,2,2,23,16,7,390,369,21,1
2021,Tendring 009B,E01021983,650,525,337,188,1,1,13,2,11,111,98,13,0
2021,Tendring 010A,E01021984,1042,937,680,257,3,3,6,3,3,96,80,16,0
2021,Tendring 006A,E01021985,715,538,428,110,3,3,10,4,6,164,139,25,0
2021,Tendring 006B,E01021986,761,565,464,101,1,1,16,11,5,179,146,33,0
2021,Tendring 008A,E01021987,639,533,408,125,4,4,23,18,5,79,68,11,0
2021,Tendring 018A,E01021988,1182,519,448,71,2,2,50,6,44,611,576,35,0
2021,Tendring 018B,E01021989,782,665,528,137,2,2,7,3,4,108,84,24,0
2021,Tendring 018C,E01021990,847,659,528,131,1,1,3,0,3,184,160,24,0
2021,Tendring 004A,E01021991,445,389,228,161,1,1,13,13,0,42,29,13,0
2021,Tendring 004B,E01021992,484,377,227,150,0,0,56,54,2,51,43,8,0
2021,Tendring 009C,E01021993,1037,874,514,360,2,2,56,41,15,105,82,23,0
2021,Tendring 008B,E01021994,616,509,420,89,2,2,34,5,29,71,57,14,0
2021,Tendring 008C,E01021995,627,540,389,151,2,2,5,0,5,80,72,8,0
2021,Tendring 008D,E01021996,605,462,342,120,17,17,44,28,16,82,75,7,0
2021,Tendring 001A,E01021997,671,264,153,111,0,0,193,158,35,210,198,12,4
2021,Tendring 001B,E01021998,686,369,210,159,5,5,36,19,17,276,263,13,0
2021,Tendring 001C,E01021999,739,469,268,201,4,4,95,42,53,170,156,14,1
2021,Tendring 002A,E01022000,692,513,281,232,3,3,38,22,16,138,121,17,0
2021,Tendring 001D,E01022001,959,438,275,163,2,2,75,21,54,444,420,24,0
2021,Tendring 004C,E01022002,800,660,379,281,3,3,26,12,14,110,88,22,1
2021,Tendring 004D,E01022004,826,665,466,199,5,5,37,28,9,118,105,13,1
2021,Tendring 004E,E01022005,775,664,419,245,1,1,3,2,1,106,94,12,1
2021,Tendring 002C,E01022006,855,447,254,193,6,6,228,111,117,169,145,24,5
2021,Tendring 002D,E01022007,706,440,208,232,1,1,147,128,19,117,105,12,1
2021,Tendring 012A,E01022008,1038,889,688,201,6,6,35,15,20,108,71,37,0
2021,Tendring 008E,E01022009,694,588,397,191,17,17,5,3,2,84,73,11,0
2021,Tendring 008F,E01022010,793,669,456,213,6,6,7,3,4,111,89,22,0
2021,Tendring 008G,E01022011,780,622,423,199,1,1,60,48,12,96,78,18,1
2021,Tendring 008H,E01022012,1030,772,606,166,0,0,95,1,94,162,136,26,1
2021,Tendring 003B,E01022013,822,685,368,317,4,4,22,7,15,111,95,16,0
2021,Tendring 003C,E01022014,645,433,229,204,2,2,138,124,14,70,60,10,2
2021,Tendring 003D,E01022015,610,441,219,222,1,1,28,25,3,140,128,12,0
2021,Tendring 007C,E01022016,888,777,585,192,6,6,12,10,2,93,76,17,0
2021,Tendring 007D,E01022017,704,635,377,258,2,2,9,8,1,58,40,18,0
2021,Tendring 007E,E01022018,780,648,390,258,3,3,62,56,6,67,57,10,0
2021,Tendring 003E,E01022019,642,519,274,245,1,1,33,15,18,88,57,31,1
2021,Tendring 003F,E01022020,936,573,364,209,3,3,82,38,44,278,261,17,0
2021,Tendring 003G,E01022021,683,452,234,218,1,1,142,124,18,86,74,12,2
2021,Tendring 013D,E01022022,613,461,254,207,3,3,17,6,11,132,117,15,0
2021,Tendring 015A,E01022023,643,429,255,174,3,3,19,2,17,190,177,13,2
2021,Tendring 015B,E01022024,632,414,243,171,1,1,97,5,92,120,109,11,0
2021,Tendring 016B,E01022025,1003,335,234,101,1,1,64,14,50,603,582,21,0
2021,Tendring 016C,E01022026,705,257,135,122,2,2,99,30,69,347,326,21,0
2021,Tendring 016D,E01022027,867,438,277,161,4,4,11,5,6,414,404,10,0
2021,Tendring 004F,E01022028,572,449,256,193,1,1,74,37,37,48,43,5,0
2021,Tendring 015C,E01022030,775,417,317,100,2,2,240,198,42,115,102,13,1
2021,Tendring 015D,E01022031,593,202,120,82,0,0,282,220,62,108,97,11,1
2021,Tendring 015E,E01022032,747,443,299,144,7,7,162,10,152,135,123,12,0
2021,Tendring 012B,E01022033,752,673,534,139,1,1,8,3,5,70,56,14,0
2021,Tendring 012C,E01022034,777,629,476,153,0,0,6,2,4,142,121,21,0
2021,Tendring 012D,E01022035,722,632,503,129,1,1,9,6,3,80,62,18,0
2021,Tendring 017C,E01022036,580,465,326,139,1,1,2,0,2,112,100,12,0
2021,Tendring 017D,E01022037,644,488,367,121,2,2,15,8,7,139,131,8,0
2021,Tendring 017E,E01022038,631,433,302,131,7,7,112,55,57,79,67,12,0
2021,Tendring 010B,E01022039,681,423,256,167,5,5,128,7,121,125,106,19,0
2021,Tendring 010C,E01022040,854,734,547,187,2,2,34,6,28,84,63,21,0
2021,Tendring 010D,E01022041,730,588,404,184,2,2,13,6,7,127,113,14,0
2021,Tendring 014A,E01022042,734,414,287,127,2,2,101,36,65,216,202,14,1
2021,Tendring 014B,E01022043,774,400,197,203,4,4,72,39,33,298,281,17,0
2021,Tendring 013E,E01022044,735,560,391,169,0,0,82,52,30,93,76,17,0
2021,Tendring 018D,E01022045,829,489,323,166,4,4,165,50,115,169,140,29,2
2021,Tendring 011E,E01022046,736,606,437,169,0,0,5,1,4,125,111,14,0
2021,Tendring 018E,E01022047,681,549,366,183,4,4,13,10,3,115,94,21,0
2021,Tendring 014C,E01022048,704,565,414,151,1,1,11,4,7,127,112,15,0
2021,Tendring 014D,E01022049,638,480,330,150,2,2,16,6,10,140,117,23,0
2021,Tendring 014E,E01022050,940,666,503,163,2,2,85,8,77,187,161,26,0
2021,Tendring 005C,E01022051,605,512,287,225,2,2,28,12,16,63,49,14,0
2021,Tendring 005D,E01022052,654,525,283,242,1,1,61,35,26,66,51,15,1
2021,Tendring 009D,E01022053,805,701,417,284,14,14,29,10,19,61,48,13,0
2021,Tendring 006C,E01022054,697,508,353,155,13,13,39,35,4,136,112,24,1
2021,Tendring 006D,E01022055,747,437,327,110,3,3,209,51,158,97,78,19,1
2021,Tendring 006E,E01022056,845,484,286,198,5,5,44,33,11,312,286,26,0
2021,Uttlesford 001A,E01022057,709,539,311,228,22,22,70,45,25,78,65,13,0
2021,Uttlesford 008A,E01022058,654,492,277,215,8,8,72,60,12,80,67,13,2
2021,Uttlesford 009A,E01022059,662,475,257,218,5,5,55,45,10,126,109,17,1
2021,Uttlesford 009B,E01022060,754,589,278,311,3,3,75,58,17,87,66,21,0
2021,Uttlesford 003A,E01022061,647,521,312,209,7,7,57,38,19,60,48,12,2
2021,Uttlesford 005A,E01022062,977,814,403,411,14,14,60,18,42,89,71,18,0
2021,Uttlesford 005B,E01022063,993,683,281,402,62,62,163,54,109,85,70,15,0
2021,Uttlesford 008B,E01022064,774,648,376,272,3,3,36,21,15,86,62,24,1
2021,Uttlesford 007B,E01022067,1032,562,286,276,14,14,146,84,62,309,285,24,1
2021,Uttlesford 007C,E01022068,791,565,267,298,22,22,126,54,72,77,65,12,1
2021,Uttlesford 008D,E01022069,722,529,313,216,2,2,55,16,39,134,120,14,2
2021,Uttlesford 009C,E01022070,767,542,283,259,9,9,131,108,23,83,67,16,2
2021,Uttlesford 003B,E01022071,693,506,272,234,8,8,61,46,15,118,97,21,0
2021,Uttlesford 003C,E01022072,835,649,314,335,14,14,68,46,22,104,83,21,0
2021,Uttlesford 003D,E01022073,866,542,300,242,27,27,215,125,90,81,65,16,1
2021,Uttlesford 002A,E01022074,599,325,166,159,4,4,174,110,64,96,84,12,0
2021,Uttlesford 001B,E01022075,738,595,360,235,6,6,6,3,3,131,114,17,0
2021,Uttlesford 002B,E01022076,956,515,340,175,1,1,164,42,122,276,244,32,0
2021,Uttlesford 001C,E01022077,838,594,311,283,24,24,119,55,64,101,91,10,0
2021,Uttlesford 002C,E01022078,636,329,184,145,0,0,235,140,95,70,63,7,2
2021,Uttlesford 002D,E01022079,945,601,326,275,25,25,133,61,72,185,162,23,1
2021,Uttlesford 002E,E01022080,629,461,226,235,4,4,32,13,19,132,121,11,0
2021,Uttlesford 002F,E01022081,1124,706,391,315,20,20,217,120,97,180,157,23,1
2021,Uttlesford 002G,E01022082,925,677,363,314,33,33,105,38,67,110,96,14,0
2021,Uttlesford 005C,E01022083,748,571,306,265,2,2,52,44,8,123,107,16,0
2021,Uttlesford 005D,E01022084,789,676,336,340,18,18,39,4,35,56,44,12,0
2021,Uttlesford 005E,E01022085,740,499,214,285,2,2,62,53,9,177,166,11,0
2021,Uttlesford 006A,E01022086,663,353,126,227,9,9,203,130,73,98,86,12,0
2021,Uttlesford 005F,E01022087,1068,723,273,450,26,26,171,52,119,148,137,11,0
2021,Uttlesford 008E,E01022088,682,539,307,232,7,7,63,51,12,71,60,11,2
2021,Uttlesford 005G,E01022089,636,467,238,229,0,0,70,56,14,98,91,7,1
2021,Uttlesford 004A,E01022092,757,586,325,261,4,4,28,20,8,139,110,29,0
2021,Uttlesford 004B,E01022093,910,572,306,266,42,42,221,144,77,75,66,9,0
2021,Uttlesford 001D,E01022094,812,598,293,305,17,17,86,54,32,110,95,15,1
2021,Uttlesford 006D,E01022095,672,517,275,242,1,1,45,34,11,109,97,12,0
2021,Uttlesford 009D,E01022096,850,607,316,291,13,13,102,79,23,128,108,20,0
2021,Uttlesford 004C,E01022097,777,602,320,282,10,10,86,63,23,79,58,21,0
2021,Uttlesford 003E,E01022098,628,480,275,205,0,0,67,47,20,81,67,14,0
2021,Uttlesford 004D,E01022099,843,513,269,244,6,6,89,49,40,235,96,139,0
2021,Cheltenham 008A,E01022100,761,538,274,264,0,0,20,9,11,203,188,15,0
2021,Cheltenham 008B,E01022101,835,546,251,295,21,21,58,19,39,210,191,19,0
2021,Cheltenham 008C,E01022102,1167,369,147,222,4,4,36,12,24,758,726,32,0
2021,Cheltenham 012B,E01022104,718,543,245,298,4,4,41,32,9,130,112,18,0
2021,Cheltenham 012C,E01022105,587,520,301,219,0,0,5,4,1,62,53,9,0
2021,Cheltenham 010A,E01022106,729,639,354,285,1,1,6,2,4,83,71,12,0
2021,Cheltenham 010B,E01022107,646,519,300,219,1,1,3,3,0,123,117,6,0
2021,Cheltenham 010C,E01022108,723,616,387,229,5,5,45,27,18,56,47,9,1
2021,Cheltenham 012D,E01022109,629,567,324,243,1,1,5,3,2,56,48,8,0
2021,Cheltenham 012E,E01022110,624,414,182,232,0,0,103,92,11,105,87,18,2
2021,Cheltenham 012F,E01022111,605,479,237,242,1,1,34,26,8,91,78,13,0
2021,Cheltenham 012G,E01022112,472,416,207,209,0,0,11,10,1,45,43,2,0
2021,Cheltenham 014A,E01022113,728,633,411,222,3,3,45,3,42,47,40,7,0
2021,Cheltenham 014B,E01022114,661,602,372,230,0,0,1,1,0,58,51,7,0
2021,Cheltenham 014C,E01022115,757,567,355,212,1,1,26,7,19,163,151,12,0
2021,Cheltenham 009A,E01022116,582,309,176,133,0,0,16,7,9,257,237,20,0
2021,Cheltenham 009B,E01022117,973,401,264,137,2,2,26,6,20,544,521,23,0
2021,Cheltenham 014D,E01022118,618,509,272,237,0,0,22,5,17,87,75,12,0
2021,Cheltenham 009C,E01022119,572,415,195,220,1,1,16,13,3,140,121,19,0
2021,Cheltenham 005A,E01022120,720,255,121,134,4,4,367,291,76,93,82,11,1
2021,Cheltenham 005B,E01022121,734,289,125,164,16,16,277,182,95,150,134,16,2
2021,Cheltenham 003A,E01022122,576,172,72,100,0,0,328,185,143,76,71,5,0
2021,Cheltenham 010D,E01022123,1015,650,373,277,19,19,56,21,35,290,274,16,0
2021,Cheltenham 009D,E01022124,753,262,166,96,9,9,183,16,167,299,285,14,0
2021,Cheltenham 009E,E01022125,576,391,232,159,2,2,11,8,3,172,160,12,0
2021,Cheltenham 009F,E01022126,874,313,183,130,0,0,71,8,63,489,474,15,1
2021,Cheltenham 009G,E01022127,738,252,150,102,4,4,44,29,15,438,409,29,0
2021,Cheltenham 015A,E01022128,641,584,370,214,0,0,7,3,4,50,43,7,0
2021,Cheltenham 015B,E01022129,973,794,465,329,4,4,72,41,31,103,90,13,0
2021,Cheltenham 015C,E01022130,738,588,346,242,0,0,14,8,6,136,118,18,0
2021,Cheltenham 006A,E01022131,560,276,124,152,1,1,217,205,12,59,47,12,7
2021,Cheltenham 006B,E01022132,609,347,161,186,1,1,201,152,49,59,54,5,1
2021,Cheltenham 006C,E01022133,498,236,87,149,3,3,219,197,22,36,29,7,4
2021,Cheltenham 006D,E01022134,797,428,237,191,4,4,189,129,60,174,164,10,2
2021,Cheltenham 011A,E01022135,643,491,325,166,1,1,33,3,30,118,102,16,0
2021,Cheltenham 011B,E01022136,768,522,360,162,0,0,84,16,68,162,147,15,0
2021,Cheltenham 011C,E01022137,853,510,308,202,3,3,22,13,9,318,288,30,0
2021,Cheltenham 011D,E01022138,751,532,341,191,3,3,22,19,3,194,183,11,0
2021,Cheltenham 004A,E01022139,682,521,319,202,22,22,69,5,64,70,61,9,0
2021,Cheltenham 008D,E01022140,670,528,299,229,16,16,37,14,23,89,82,7,0
2021,Cheltenham 008E,E01022141,786,405,235,170,0,0,21,8,13,360,338,22,0
2021,Cheltenham 008F,E01022142,766,322,130,192,5,5,131,88,43,308,285,23,0
2021,Cheltenham 002A,E01022143,807,659,441,218,15,15,33,5,28,100,87,13,0
2021,Cheltenham 002B,E01022144,670,507,281,226,9,9,100,49,51,54,50,4,0
2021,Cheltenham 002C,E01022145,520,455,258,197,0,0,14,9,5,51,44,7,0
2021,Cheltenham 002D,E01022146,633,559,394,165,1,1,13,8,5,60,51,9,0
2021,Cheltenham 005C,E01022147,766,212,103,109,13,13,437,320,117,98,85,13,6
2021,Cheltenham 007A,E01022148,664,467,222,245,3,3,84,78,6,108,95,13,2
2021,Cheltenham 007B,E01022149,564,358,147,211,4,4,130,97,33,72,62,10,0
2021,Cheltenham 007C,E01022150,670,418,196,222,2,2,108,96,12,142,128,14,0
2021,Cheltenham 004B,E01022151,678,267,125,142,5,5,109,59,50,297,275,22,0
2021,Cheltenham 004C,E01022152,534,133,63,70,9,9,282,208,74,107,101,6,3
2021,Cheltenham 004D,E01022153,711,188,82,106,3,3,86,13,73,433,418,15,1
2021,Cheltenham 004E,E01022154,741,232,110,122,6,6,72,39,33,429,410,19,2
2021,Cheltenham 007D,E01022155,670,490,243,247,6,6,44,37,7,130,116,14,0
2021,Cheltenham 007E,E01022156,807,407,135,272,27,27,138,81,57,232,214,18,3
2021,Cheltenham 005D,E01022157,646,315,154,161,9,9,224,205,19,98,86,12,0
2021,Cheltenham 005E,E01022159,651,370,160,210,3,3,167,149,18,110,93,17,1
2021,Cheltenham 003B,E01022160,908,331,97,234,27,27,364,197,167,179,166,13,7
2021,Cheltenham 003C,E01022161,638,389,168,221,7,7,74,54,20,168,156,12,0
2021,Cheltenham 003D,E01022162,721,535,326,209,10,10,72,24,48,104,93,11,0
2021,Cheltenham 001A,E01022163,612,479,250,229,1,1,38,4,34,94,79,15,0
2021,Cheltenham 001B,E01022164,626,255,130,125,1,1,219,195,24,146,132,14,5
2021,Cheltenham 001C,E01022165,712,538,327,211,8,8,7,5,2,159,147,12,0
2021,Cheltenham 001D,E01022166,533,475,284,191,3,3,4,2,2,51,47,4,0
2021,Cheltenham 013A,E01022167,545,501,341,160,4,4,8,2,6,32,29,3,0
2021,Cheltenham 013B,E01022168,476,411,232,179,1,1,17,14,3,47,38,9,0
2021,Cheltenham 013C,E01022169,671,471,249,222,5,5,80,61,19,111,105,6,4
2021,Cheltenham 013D,E01022170,609,495,303,192,1,1,4,2,2,109,104,5,0
2021,Cheltenham 013E,E01022171,553,416,225,191,2,2,9,6,3,126,121,5,0
2021,Cheltenham 013F,E01022172,712,601,416,185,17,17,10,5,5,84,64,20,0
2021,Cheltenham 013G,E01022173,617,375,213,162,0,0,123,87,36,119,110,9,0
2021,Cheltenham 011E,E01022174,595,514,283,231,1,1,12,5,7,68,59,9,0
2021,Cotswold 005A,E01022175,814,507,330,177,1,1,107,7,100,199,131,68,0
2021,Cotswold 011A,E01022176,820,534,306,228,12,12,100,12,88,174,146,28,0
2021,Cotswold 002A,E01022177,968,647,465,182,7,7,184,29,155,129,96,33,1
2021,Cotswold 002B,E01022178,583,416,264,152,0,0,47,3,44,120,78,42,0
2021,Cotswold 001A,E01022179,898,613,358,255,15,15,153,22,131,116,95,21,1
2021,Cotswold 003B,E01022181,839,617,449,168,16,16,52,8,44,154,135,19,0
2021,Cotswold 001B,E01022182,776,556,368,188,14,14,98,13,85,108,82,26,0
2021,Cotswold 001C,E01022183,762,495,356,139,40,40,136,10,126,91,68,23,0
2021,Cotswold 001D,E01022184,698,474,329,145,10,10,92,9,83,122,96,26,0
2021,Cotswold 001E,E01022185,875,605,360,245,26,26,168,22,146,76,57,19,0
2021,Cotswold 004A,E01022186,694,491,296,195,2,2,43,8,35,158,102,56,0
2021,Cotswold 004B,E01022187,752,491,320,171,4,4,82,11,71,175,140,35,0
2021,Cotswold 006A,E01022188,889,404,192,212,61,61,328,37,291,96,87,9,0
2021,Cotswold 006B,E01022189,509,422,253,169,1,1,40,8,32,46,36,10,0
2021,Cotswold 006C,E01022190,586,384,196,188,47,47,91,8,83,64,57,7,0
2021,Cotswold 008A,E01022191,660,352,204,148,3,3,110,9,101,195,177,18,0
2021,Cotswold 008B,E01022192,515,248,137,111,4,4,197,19,178,66,59,7,0
2021,Cotswold 008C,E01022193,418,338,211,127,18,18,14,1,13,48,42,6,0
2021,Cotswold 007A,E01022194,1068,517,392,125,6,6,201,18,183,344,301,43,0
2021,Cotswold 007B,E01022195,663,401,274,127,9,9,71,6,65,182,161,21,0
2021,Cotswold 006D,E01022196,770,591,361,230,0,0,85,9,76,94,81,13,0
2021,Cotswold 006E,E01022197,774,671,392,279,5,5,26,3,23,72,60,12,0
2021,Cotswold 008D,E01022198,598,340,195,145,2,2,101,13,88,154,142,12,1
2021,Cotswold 007C,E01022199,841,516,332,184,3,3,102,8,94,218,207,11,2
2021,Cotswold 007D,E01022200,581,160,92,68,9,9,352,32,320,59,51,8,1
2021,Cotswold 004C,E01022201,793,576,346,230,3,3,41,4,37,173,126,47,0
2021,Cotswold 009A,E01022202,553,395,217,178,19,19,77,7,70,62,54,8,0
2021,Cotswold 009B,E01022203,941,668,415,253,42,42,122,5,117,109,84,25,0
2021,Cotswold 009C,E01022204,609,396,214,182,2,2,143,16,127,67,53,14,1
2021,Cotswold 002C,E01022205,836,498,338,160,10,10,99,10,89,229,168,61,0
2021,Cotswold 005B,E01022207,732,559,371,188,2,2,66,5,61,105,68,37,0
2021,Cotswold 009D,E01022208,722,596,378,218,26,26,16,4,12,84,76,8,0
2021,Cotswold 009E,E01022209,490,345,194,151,4,4,60,9,51,81,44,37,0
2021,Cotswold 009F,E01022210,767,477,340,137,9,9,197,21,176,84,75,9,0
2021,Cotswold 002D,E01022211,1025,614,422,192,23,23,205,24,181,183,152,31,0
2021,Cotswold 005C,E01022213,860,576,358,218,6,6,138,18,120,139,107,32,1
2021,Cotswold 005D,E01022215,806,448,281,167,5,5,90,2,88,263,204,59,0
2021,Cotswold 004D,E01022216,858,597,352,245,7,7,71,8,63,183,150,33,0
2021,Cotswold 011C,E01022217,558,380,216,164,14,14,110,21,89,53,46,7,1
2021,Cotswold 011D,E01022218,525,248,139,109,7,7,220,19,201,50,43,7,0
2021,Cotswold 011E,E01022219,670,529,341,188,18,18,64,7,57,59,51,8,0
2021,Cotswold 011F,E01022220,842,568,376,192,8,8,89,16,73,177,147,30,0
2021,Cotswold 010A,E01022221,859,550,310,240,25,25,137,10,127,147,123,24,0
2021,Cotswold 003D,E01022222,864,524,343,181,9,9,84,5,79,247,169,78,0
2021,Cotswold 010C,E01022224,690,562,369,193,6,6,26,0,26,96,80,16,0
2021,Cotswold 008E,E01022225,1044,521,308,213,45,45,252,51,201,226,104,122,0
2021,Forest of Dean 009A,E01022226,687,440,266,174,7,7,99,10,89,141,123,18,0
2021,Forest of Dean 009B,E01022227,720,556,352,204,2,2,57,6,51,105,86,19,0
2021,Forest of Dean 005A,E01022228,705,539,320,219,4,4,67,11,56,95,75,20,0
2021,Forest of Dean 007A,E01022229,679,512,298,214,2,2,115,18,97,48,43,5,2
2021,Forest of Dean 005B,E01022230,750,645,404,241,2,2,19,4,15,84,64,20,0
2021,Forest of Dean 008A,E01022231,719,469,272,197,6,6,186,31,155,58,56,2,0
2021,Forest of Dean 008B,E01022232,688,530,316,214,6,6,39,8,31,113,94,19,0
2021,Forest of Dean 001A,E01022233,815,614,397,217,12,12,65,8,57,123,99,24,1
2021,Forest of Dean 006A,E01022234,680,585,406,179,3,3,37,11,26,55,39,16,0
2021,Forest of Dean 001B,E01022235,765,621,417,204,7,7,48,7,41,89,74,15,0
2021,Forest of Dean 004A,E01022236,888,648,376,272,4,4,61,9,52,175,144,31,0
2021,Forest of Dean 004B,E01022237,637,368,208,160,2,2,178,32,146,88,78,10,1
2021,Forest of Dean 004C,E01022238,735,319,189,130,6,6,334,47,287,75,63,12,1
2021,Forest of Dean 004D,E01022239,692,551,323,228,1,1,42,6,36,98,80,18,0
2021,Forest of Dean 004E,E01022240,981,607,335,272,3,3,98,16,82,273,252,21,0
2021,Forest of Dean 007B,E01022241,971,586,394,192,4,4,157,25,132,224,199,25,0
2021,Forest of Dean 007C,E01022242,774,516,302,214,18,18,152,24,128,87,70,17,1
2021,Forest of Dean 007D,E01022243,596,390,248,142,3,3,141,30,111,62,52,10,0
2021,Forest of Dean 007E,E01022244,673,452,261,191,2,2,165,30,135,53,47,6,1
2021,Forest of Dean 007F,E01022245,620,334,204,130,2,2,141,24,117,143,134,9,0
2021,Forest of Dean 007G,E01022246,552,492,300,192,3,3,3,0,3,54,44,10,0
2021,Forest of Dean 001C,E01022247,708,575,368,207,9,9,32,4,28,92,62,30,0
2021,Forest of Dean 010A,E01022248,709,595,402,193,6,6,49,6,43,59,40,19,0
2021,Forest of Dean 004F,E01022249,890,733,445,288,4,4,52,5,47,100,76,24,1
2021,Forest of Dean 004G,E01022250,906,578,314,264,0,0,210,42,168,118,97,21,0
2021,Forest of Dean 003A,E01022251,638,419,257,162,4,4,155,33,122,60,44,16,0
2021,Forest of Dean 003B,E01022252,737,654,417,237,5,5,24,5,19,53,40,13,1
2021,Forest of Dean 006B,E01022253,739,598,368,230,0,0,55,8,47,86,64,22,0
2021,Forest of Dean 009C,E01022254,1048,554,278,276,19,19,336,53,283,139,122,17,0
2021,Forest of Dean 009D,E01022255,945,754,389,365,22,22,47,9,38,122,106,16,0
2021,Forest of Dean 009E,E01022256,837,450,279,171,9,9,226,50,176,152,135,17,0
2021,Forest of Dean 009F,E01022257,784,701,471,230,0,0,8,3,5,75,54,21,0
2021,Forest of Dean 003C,E01022258,535,317,161,156,20,20,115,26,89,83,72,11,0
2021,Forest of Dean 003D,E01022259,640,560,330,230,6,6,14,2,12,60,46,14,0
2021,Forest of Dean 003E,E01022260,782,587,352,235,9,9,127,24,103,59,51,8,0
2021,Forest of Dean 002A,E01022261,990,668,394,274,8,8,180,37,143,134,116,18,0
2021,Forest of Dean 002B,E01022262,1052,556,324,232,20,20,199,32,167,276,246,30,1
2021,Forest of Dean 006C,E01022263,815,665,419,246,3,3,58,2,56,88,67,21,1
2021,Forest of Dean 008C,E01022264,661,502,307,195,4,4,73,14,59,82,60,22,0
2021,Forest of Dean 005C,E01022265,755,561,362,199,7,7,58,6,52,128,100,28,1
2021,Forest of Dean 005D,E01022266,535,402,262,140,4,4,46,11,35,83,58,25,0
2021,Forest of Dean 002C,E01022267,781,612,416,196,12,12,53,12,41,104,74,30,0
2021,Forest of Dean 008D,E01022268,731,549,334,215,7,7,121,22,99,54,41,13,0
2021,Forest of Dean 008E,E01022269,804,693,424,269,6,6,47,5,42,58,45,13,0
2021,Forest of Dean 001D,E01022270,797,629,365,264,11,11,75,13,62,82,61,21,0
2021,Forest of Dean 001E,E01022271,718,597,406,191,2,2,24,5,19,95,67,28,0
2021,Forest of Dean 010B,E01022272,599,372,236,136,5,5,154,32,122,67,59,8,1
2021,Forest of Dean 010C,E01022273,436,273,168,105,3,3,31,4,27,129,30,99,0
2021,Forest of Dean 010D,E01022274,497,428,255,173,3,3,8,2,6,58,52,6,0
2021,Forest of Dean 010E,E01022275,816,662,374,288,14,14,56,12,44,84,69,15,0
2021,Gloucester 010A,E01022276,670,585,360,225,5,5,8,3,5,72,58,14,0
2021,Gloucester 010B,E01022277,637,537,321,216,4,4,39,12,27,55,43,12,2
2021,Gloucester 007A,E01022278,662,540,303,237,0,0,49,10,39,73,68,5,0
2021,Gloucester 007B,E01022279,568,475,221,254,3,3,5,2,3,85,71,14,0
2021,Gloucester 010C,E01022280,694,457,175,282,7,7,23,3,20,207,197,10,0
2021,Gloucester 010D,E01022281,688,590,293,297,0,0,28,3,25,70,62,8,0
2021,Gloucester 007C,E01022282,1035,840,366,474,21,21,45,6,39,129,115,14,0
2021,Gloucester 006A,E01022283,640,531,327,204,2,2,51,18,33,56,48,8,0
2021,Gloucester 007D,E01022284,523,326,144,182,1,1,100,45,55,94,86,8,2
2021,Gloucester 007E,E01022285,505,304,160,144,0,0,153,90,63,48,39,9,0
2021,Gloucester 007F,E01022286,647,388,161,227,2,2,143,97,46,113,97,16,1
2021,Gloucester 007G,E01022287,840,591,299,292,8,8,87,32,55,154,140,14,0
2021,Gloucester 005A,E01022288,822,394,159,235,7,7,120,38,82,300,280,20,1
2021,Gloucester 005B,E01022289,705,271,165,106,4,4,145,42,103,285,265,20,0
2021,Gloucester 005C,E01022290,540,252,139,113,2,2,124,15,109,162,141,21,0
2021,Gloucester 005D,E01022291,662,274,158,116,5,5,51,16,35,329,318,11,3
2021,Gloucester 005E,E01022292,513,285,174,111,1,1,15,5,10,212,190,22,0
2021,Gloucester 008A,E01022293,645,311,173,138,8,8,44,9,35,279,252,27,3
2021,Gloucester 008B,E01022294,724,361,179,182,10,10,77,9,68,275,253,22,1
2021,Gloucester 003A,E01022295,593,528,299,229,1,1,12,5,7,52,41,11,0
2021,Gloucester 003B,E01022296,620,415,192,223,3,3,88,56,32,112,104,8,2
2021,Gloucester 003C,E01022297,536,480,260,220,0,0,6,2,4,50,47,3,0
2021,Gloucester 003D,E01022298,623,494,226,268,6,6,29,8,21,94,86,8,0
2021,Gloucester 013A,E01022299,625,529,326,203,2,2,12,4,8,82,62,20,0
2021,Gloucester 013B,E01022300,628,540,358,182,3,3,10,4,6,75,66,9,0
2021,Gloucester 013C,E01022301,669,409,198,211,7,7,87,55,32,166,153,13,0
2021,Gloucester 013D,E01022302,632,523,320,203,2,2,28,9,19,79,69,10,0
2021,Gloucester 006B,E01022303,638,455,280,175,2,2,88,43,45,92,80,12,1
2021,Gloucester 006C,E01022304,829,707,454,253,5,5,15,1,14,102,90,12,0
2021,Gloucester 006D,E01022305,594,526,315,211,2,2,18,12,6,48,42,6,0
2021,Gloucester 010E,E01022306,583,488,241,247,2,2,9,1,8,84,73,11,0
2021,Gloucester 010F,E01022307,632,514,218,296,2,2,5,2,3,111,102,9,0
2021,Gloucester 006E,E01022308,644,550,333,217,4,4,12,5,7,78,64,14,0
2021,Gloucester 002A,E01022309,605,434,227,207,1,1,50,6,44,120,108,12,0
2021,Gloucester 002B,E01022310,722,408,234,174,3,3,102,15,87,209,185,24,0
2021,Gloucester 002C,E01022311,1062,277,149,128,15,15,328,119,209,442,418,24,0
2021,Gloucester 002D,E01022312,1016,484,250,234,6,6,70,13,57,455,433,22,1
2021,Gloucester 001A,E01022313,715,580,316,264,1,1,21,3,18,113,86,27,0
2021,Gloucester 002E,E01022314,725,646,377,269,9,9,17,3,14,53,36,17,0
2021,Gloucester 001B,E01022315,631,546,337,209,0,0,7,2,5,78,67,11,0
2021,Gloucester 001C,E01022316,684,526,286,240,5,5,26,11,15,127,115,12,0
2021,Gloucester 001D,E01022317,604,534,281,253,1,1,11,8,3,58,47,11,0
2021,Gloucester 001E,E01022318,659,609,361,248,1,1,2,0,2,47,40,7,0
2021,Gloucester 011A,E01022319,743,179,81,98,0,0,490,317,173,67,61,6,7
2021,Gloucester 011B,E01022320,682,450,203,247,4,4,143,77,66,83,72,11,2
2021,Gloucester 011C,E01022321,660,475,227,248,3,3,97,42,55,80,70,10,5
2021,Gloucester 011D,E01022322,620,292,145,147,1,1,261,158,103,65,59,6,1
2021,Gloucester 008C,E01022323,657,238,75,163,1,1,352,126,226,65,60,5,1
2021,Gloucester 011E,E01022324,693,330,151,179,8,8,268,137,131,87,79,8,0
2021,Gloucester 011F,E01022325,581,420,240,180,5,5,83,46,37,72,63,9,1
2021,Gloucester 009A,E01022326,561,346,132,214,3,3,14,3,11,198,184,14,0
2021,Gloucester 009B,E01022327,606,413,199,214,3,3,37,12,25,153,131,22,0
2021,Gloucester 008D,E01022328,536,303,129,174,5,5,141,80,61,85,75,10,2
2021,Gloucester 008E,E01022329,606,300,135,165,2,2,169,91,78,133,120,13,2
2021,Gloucester 009C,E01022330,617,395,171,224,1,1,27,7,20,194,175,19,0
2021,Gloucester 009D,E01022331,515,368,168,200,1,1,82,46,36,64,57,7,0
2021,Gloucester 004A,E01022332,763,304,140,164,2,2,94,26,68,360,342,18,3
2021,Gloucester 009E,E01022333,683,205,98,107,3,3,396,183,213,74,65,9,5
2021,Gloucester 009F,E01022334,789,583,267,316,2,2,126,35,91,77,69,8,1
2021,Gloucester 015A,E01022335,649,498,287,211,14,14,43,19,24,93,78,15,1
2021,Gloucester 015B,E01022336,500,409,235,174,0,0,12,4,8,79,74,5,0
2021,Gloucester 015D,E01022338,648,356,157,199,1,1,8,3,5,283,271,12,0
2021,Gloucester 014A,E01022339,683,577,267,310,4,4,12,3,9,90,82,8,0
2021,Gloucester 014B,E01022340,618,408,145,263,4,4,12,2,10,194,185,9,0
2021,Gloucester 014C,E01022341,1021,627,251,376,15,15,113,5,108,265,241,24,1
2021,Gloucester 014D,E01022342,685,518,180,338,2,2,5,1,4,160,145,15,0
2021,Gloucester 012A,E01022343,539,416,238,178,1,1,54,34,20,68,56,12,0
2021,Gloucester 012B,E01022344,630,475,253,222,1,1,77,47,30,76,61,15,1
2021,Gloucester 012C,E01022345,696,547,310,237,25,25,83,31,52,41,33,8,0
2021,Gloucester 012D,E01022346,665,236,115,121,7,7,357,181,176,62,48,14,3
2021,Stroud 010A,E01022350,940,788,516,272,6,6,53,44,9,93,69,24,0
2021,Stroud 012A,E01022351,686,442,218,224,9,9,127,86,41,104,85,19,4
2021,Stroud 012B,E01022352,594,471,306,165,3,3,35,21,14,85,67,18,0
2021,Stroud 012C,E01022353,733,476,245,231,24,24,109,88,21,123,111,12,1
2021,Stroud 002A,E01022354,966,785,515,270,11,11,67,43,24,102,74,28,1
2021,Stroud 004A,E01022355,668,504,279,225,5,5,81,70,11,77,71,6,1
2021,Stroud 004B,E01022356,1072,708,344,364,3,3,98,33,65,262,228,34,1
2021,Stroud 004C,E01022357,860,621,362,259,14,14,96,57,39,129,118,11,0
2021,Stroud 004D,E01022358,673,369,207,162,8,8,236,214,22,56,52,4,4
2021,Stroud 011A,E01022359,668,554,326,228,1,1,35,21,14,77,67,10,1
2021,Stroud 011B,E01022360,635,548,350,198,13,13,33,6,27,41,33,8,0
2021,Stroud 011C,E01022361,584,362,222,140,6,6,153,133,20,59,46,13,4
2021,Stroud 011D,E01022362,532,448,288,160,3,3,38,35,3,42,34,8,1
2021,Stroud 011E,E01022363,899,680,361,319,31,31,76,58,18,112,99,13,0
2021,Stroud 011F,E01022364,509,240,113,127,3,3,234,210,24,28,22,6,4
2021,Stroud 008A,E01022366,682,633,321,312,2,2,2,1,1,45,39,6,0
2021,Stroud 008B,E01022367,692,608,362,246,2,2,38,38,0,42,34,8,2
2021,Stroud 008C,E01022368,591,531,334,197,4,4,5,2,3,51,36,15,0
2021,Stroud 008D,E01022369,739,475,211,264,2,2,49,39,10,213,193,20,0
2021,Stroud 009A,E01022370,550,402,243,159,4,4,78,58,20,65,58,7,1
2021,Stroud 009B,E01022371,453,383,248,135,2,2,42,25,17,26,22,4,0
2021,Stroud 014A,E01022372,1033,810,391,419,22,22,34,12,22,167,151,16,0
2021,Stroud 014B,E01022373,747,542,306,236,0,0,116,116,0,84,70,14,5
2021,Stroud 014C,E01022374,982,584,315,269,21,21,192,113,79,182,160,22,3
2021,Stroud 014D,E01022375,487,222,96,126,1,1,217,182,35,47,40,7,0
2021,Stroud 003A,E01022376,1108,784,370,414,62,62,166,68,98,94,76,18,2
2021,Stroud 004E,E01022377,978,627,362,265,2,2,252,213,39,95,81,14,2
2021,Stroud 001A,E01022378,924,709,324,385,22,22,39,10,29,153,133,20,1
2021,Stroud 001B,E01022379,662,373,166,207,3,3,85,70,15,200,192,8,1
2021,Stroud 015A,E01022381,869,691,364,327,14,14,67,43,24,96,78,18,1
2021,Stroud 010B,E01022382,683,616,402,214,1,1,12,8,4,54,42,12,0
2021,Stroud 010C,E01022383,660,373,236,137,10,10,221,169,52,51,42,9,5
2021,Stroud 010D,E01022384,633,520,364,156,2,2,30,26,4,81,70,11,0
2021,Stroud 013A,E01022385,673,534,318,216,2,2,57,42,15,78,62,16,2
2021,Stroud 013B,E01022386,745,517,328,189,1,1,71,39,32,152,134,18,4
2021,Stroud 013C,E01022387,714,477,267,210,13,13,110,39,71,113,100,13,1
2021,Stroud 013D,E01022388,751,500,285,215,4,4,157,128,29,90,84,6,0
2021,Stroud 004F,E01022389,729,624,374,250,2,2,48,43,5,55,47,8,0
2021,Stroud 002B,E01022390,589,411,273,138,5,5,73,60,13,98,81,17,2
2021,Stroud 002C,E01022391,683,597,402,195,0,0,7,5,2,79,61,18,0
2021,Stroud 002D,E01022392,681,555,374,181,1,1,19,12,7,106,87,19,0
2021,Stroud 007A,E01022393,620,545,326,219,2,2,21,20,1,50,34,16,2
2021,Stroud 007B,E01022394,677,434,209,225,0,0,52,30,22,191,171,20,0
2021,Stroud 007C,E01022395,665,583,336,247,2,2,25,10,15,55,41,14,0
2021,Stroud 003B,E01022396,764,590,360,230,8,8,43,17,26,123,97,26,0
2021,Stroud 003C,E01022397,793,634,342,292,1,1,83,78,5,71,54,17,4
2021,Stroud 003D,E01022398,501,407,262,145,6,6,42,24,18,45,33,12,1
2021,Stroud 006B,E01022399,975,573,333,240,7,7,253,187,66,139,126,13,3
2021,Stroud 005A,E01022400,840,603,326,277,5,5,92,64,28,140,121,19,0
2021,Stroud 005B,E01022401,597,369,212,157,7,7,150,123,27,68,60,8,3
2021,Stroud 005C,E01022402,647,492,260,232,4,4,56,45,11,95,77,18,0
2021,Stroud 005D,E01022403,684,352,185,167,14,14,258,227,31,57,51,6,3
2021,Stroud 005E,E01022404,668,468,247,221,14,14,57,28,29,129,110,19,0
2021,Stroud 009C,E01022405,876,577,313,264,36,36,200,165,35,59,50,9,4
2021,Stroud 009D,E01022406,565,483,304,179,5,5,28,8,20,49,39,10,0
2021,Stroud 009E,E01022407,579,471,308,163,1,1,41,29,12,65,55,10,1
2021,Stroud 007D,E01022408,436,389,234,155,5,5,21,18,3,21,17,4,0
2021,Stroud 007E,E01022409,538,437,239,198,5,5,37,21,16,59,50,9,0
2021,Stroud 006C,E01022410,1025,657,396,261,19,19,182,80,102,167,138,29,0
2021,Stroud 006D,E01022411,951,655,379,276,3,3,157,149,8,136,122,14,0
2021,Stroud 012D,E01022413,784,609,334,275,2,2,42,31,11,131,109,22,0
2021,Stroud 006E,E01022414,1163,724,395,329,4,4,212,98,114,222,200,22,1
2021,Stroud 015B,E01022415,616,507,334,173,5,5,20,19,1,83,66,17,1
2021,Stroud 015C,E01022416,608,379,215,164,14,14,167,152,15,43,37,6,5
2021,Stroud 015D,E01022417,790,644,389,255,1,1,45,23,22,100,87,13,0
2021,Stroud 015E,E01022418,790,486,303,183,3,3,112,84,28,186,160,26,3
2021,Tewkesbury 009A,E01022421,732,403,226,177,3,3,216,53,163,106,91,15,4
2021,Tewkesbury 009C,E01022423,951,737,388,349,16,16,76,14,62,122,99,23,0
2021,Tewkesbury 009D,E01022424,659,336,222,114,2,2,236,85,151,85,70,15,0
2021,Tewkesbury 007A,E01022425,492,413,217,196,2,2,33,4,29,44,39,5,0
2021,Tewkesbury 007B,E01022426,635,590,403,187,1,1,8,1,7,36,30,6,0
2021,Tewkesbury 007C,E01022427,661,484,330,154,1,1,39,4,35,136,104,32,1
2021,Tewkesbury 007D,E01022428,837,389,176,213,5,5,312,64,248,131,119,12,0
2021,Tewkesbury 007E,E01022429,680,543,302,241,5,5,23,0,23,109,97,12,0
2021,Tewkesbury 007F,E01022430,628,548,323,225,1,1,29,8,21,50,42,8,0
2021,Tewkesbury 007G,E01022431,884,660,328,332,2,2,15,2,13,207,196,11,0
2021,Tewkesbury 011E,E01022432,925,710,459,251,4,4,71,7,64,140,122,18,0
2021,Tewkesbury 011C,E01022433,868,731,484,247,19,19,47,5,42,71,57,14,0
2021,Tewkesbury 004A,E01022434,863,755,482,273,13,13,19,1,18,76,53,23,0
2021,Tewkesbury 010D,E01022437,601,430,211,219,0,0,86,7,79,85,76,9,0
2021,Tewkesbury 010E,E01022438,601,473,254,219,3,3,8,2,6,117,110,7,0
2021,Tewkesbury 010C,E01022439,1139,751,282,469,80,80,101,9,92,207,184,23,0
2021,Tewkesbury 006A,E01022440,1048,704,344,360,30,30,108,29,79,204,185,19,2
2021,Tewkesbury 004B,E01022441,682,510,306,204,5,5,49,8,41,118,97,21,0
2021,Tewkesbury 006B,E01022442,685,542,332,210,11,11,61,11,50,71,49,22,0
2021,Tewkesbury 006C,E01022443,632,537,323,214,14,14,41,6,35,40,26,14,0
2021,Tewkesbury 006D,E01022444,642,537,319,218,10,10,22,3,19,73,64,9,0
2021,Tewkesbury 004C,E01022445,603,433,266,167,5,5,79,6,73,86,69,17,0
2021,Tewkesbury 007H,E01022447,494,120,35,85,1,1,104,18,86,269,55,214,0
2021,Tewkesbury 008B,E01022448,898,622,282,340,40,40,144,29,115,92,56,36,0
2021,Tewkesbury 003A,E01022449,916,740,496,244,12,12,34,4,30,130,107,23,0
2021,Tewkesbury 001B,E01022450,910,416,189,227,8,8,294,43,251,192,172,20,0
2021,Tewkesbury 001C,E01022451,653,510,284,226,8,8,56,5,51,79,65,14,0
2021,Tewkesbury 001D,E01022452,528,456,221,235,3,3,12,2,10,57,52,5,0
2021,Tewkesbury 004D,E01022453,959,800,461,339,26,26,64,8,56,69,54,15,0
2021,Tewkesbury 008C,E01022454,1093,739,387,352,25,25,235,55,180,92,74,18,2
2021,Tewkesbury 001E,E01022455,810,714,430,284,8,8,28,4,24,60,49,11,0
2021,Tewkesbury 002A,E01022456,547,427,265,162,0,0,36,8,28,84,74,10,0
2021,Tewkesbury 002B,E01022457,600,338,201,137,1,1,205,31,174,54,46,8,2
2021,Tewkesbury 002C,E01022458,664,196,98,98,8,8,391,86,305,69,61,8,0
2021,Tewkesbury 002D,E01022459,874,425,285,140,4,4,75,9,66,370,331,39,0
2021,Tewkesbury 002E,E01022460,931,592,327,265,39,39,170,22,148,130,108,22,0
2021,Tewkesbury 002F,E01022461,613,520,350,170,6,6,33,4,29,54,47,7,0
2021,Tewkesbury 002G,E01022462,857,735,482,253,16,16,53,8,45,53,35,18,0
2021,Tewkesbury 003B,E01022463,710,485,320,165,6,6,74,6,68,145,114,31,0
2021,Tewkesbury 003C,E01022464,754,464,337,127,10,10,236,30,206,42,33,9,2
2021,Tewkesbury 003D,E01022465,762,633,416,217,6,6,62,7,55,61,43,18,0
2021,Tewkesbury 003E,E01022466,990,693,439,254,72,72,85,11,74,140,125,15,0
2021,Basingstoke and Deane 017A,E01022467,681,592,373,219,1,1,21,3,18,67,55,12,0
2021,Basingstoke and Deane 017B,E01022468,791,601,368,233,38,38,56,3,53,96,75,21,0
2021,Basingstoke and Deane 017C,E01022469,668,510,299,211,0,0,114,6,108,44,40,4,0
2021,Basingstoke and Deane 008A,E01022470,803,661,317,344,3,3,11,1,10,128,121,7,0
2021,Basingstoke and Deane 008B,E01022471,615,527,265,262,2,2,8,0,8,78,74,4,0
2021,Basingstoke and Deane 004A,E01022472,509,417,246,171,4,4,17,3,14,71,56,15,0
2021,Basingstoke and Deane 004B,E01022473,508,454,234,220,0,0,14,1,13,40,35,5,0
2021,Basingstoke and Deane 019A,E01022474,731,358,170,188,21,21,233,13,220,119,110,9,0
2021,Basingstoke and Deane 016A,E01022475,736,496,229,267,4,4,50,0,50,186,171,15,0
2021,Basingstoke and Deane 016B,E01022476,692,565,267,298,1,1,13,1,12,113,105,8,0
2021,Basingstoke and Deane 019B,E01022477,640,399,147,252,4,4,126,7,119,111,106,5,0
2021,Basingstoke and Deane 019C,E01022478,630,260,100,160,2,2,299,11,288,69,65,4,0
2021,Basingstoke and Deane 019D,E01022479,600,245,101,144,4,4,283,15,268,68,63,5,0
2021,Basingstoke and Deane 016C,E01022480,499,258,92,166,8,8,175,3,172,58,52,6,0
2021,Basingstoke and Deane 012A,E01022481,766,477,254,223,3,3,112,3,109,173,156,17,1
2021,Basingstoke and Deane 012B,E01022482,705,362,209,153,6,6,191,17,174,146,134,12,0
2021,Basingstoke and Deane 013A,E01022484,524,171,52,119,0,0,305,13,292,48,42,6,0
2021,Basingstoke and Deane 013B,E01022485,458,217,100,117,4,4,181,9,172,55,49,6,1
2021,Basingstoke and Deane 013C,E01022486,814,468,156,312,18,18,217,13,204,111,99,12,0
2021,Basingstoke and Deane 013D,E01022487,482,241,107,134,2,2,191,7,184,48,42,6,0
2021,Basingstoke and Deane 003A,E01022488,541,250,131,119,35,35,147,13,134,109,76,33,0
2021,Basingstoke and Deane 003B,E01022489,598,435,263,172,2,2,67,4,63,94,58,36,0
2021,Basingstoke and Deane 005A,E01022490,748,564,270,294,2,2,120,6,114,62,56,6,0
2021,Basingstoke and Deane 005B,E01022491,798,494,207,287,30,30,214,9,205,60,57,3,0
2021,Basingstoke and Deane 005C,E01022492,631,439,254,185,0,0,26,1,25,166,123,43,0
2021,Basingstoke and Deane 002A,E01022493,543,414,221,193,3,3,55,3,52,71,61,10,0
2021,Basingstoke and Deane 008C,E01022494,1047,691,276,415,22,22,156,5,151,178,168,10,0
2021,Basingstoke and Deane 006A,E01022495,652,442,168,274,3,3,28,0,28,179,171,8,0
2021,Basingstoke and Deane 006C,E01022497,597,442,198,244,2,2,9,0,9,143,131,12,1
2021,Basingstoke and Deane 006D,E01022498,656,477,229,248,0,0,38,4,34,141,132,9,0
2021,Basingstoke and Deane 003C,E01022499,616,547,284,263,8,8,30,3,27,31,21,10,0
2021,Basingstoke and Deane 003D,E01022500,544,376,213,163,3,3,55,5,50,110,77,33,0
2021,Basingstoke and Deane 011B,E01022502,684,457,218,239,27,27,39,0,39,161,149,12,0
2021,Basingstoke and Deane 012D,E01022503,834,482,208,274,4,4,47,2,45,301,289,12,0
2021,Basingstoke and Deane 016D,E01022504,672,527,284,243,17,17,65,2,63,63,53,10,0
2021,Basingstoke and Deane 016E,E01022505,744,571,273,298,1,1,9,0,9,163,150,13,0
2021,Basingstoke and Deane 011C,E01022506,596,411,203,208,4,4,69,4,65,112,100,12,0
2021,Basingstoke and Deane 011D,E01022507,678,361,171,190,3,3,204,11,193,109,97,12,1
2021,Basingstoke and Deane 019E,E01022509,583,474,201,273,7,7,12,0,12,90,83,7,0
2021,Basingstoke and Deane 021B,E01022510,599,497,217,280,4,4,23,1,22,75,66,9,0
2021,Basingstoke and Deane 021C,E01022511,450,397,185,212,1,1,1,0,1,51,40,11,0
2021,Basingstoke and Deane 021D,E01022512,472,444,174,270,0,0,3,0,3,25,21,4,0
2021,Basingstoke and Deane 003E,E01022513,612,463,251,212,0,0,86,6,80,63,44,19,0
2021,Basingstoke and Deane 020A,E01022514,701,495,309,186,12,12,84,6,78,110,86,24,0
2021,Basingstoke and Deane 018A,E01022515,652,610,452,158,1,1,13,0,13,28,22,6,0
2021,Basingstoke and Deane 018B,E01022516,617,549,323,226,1,1,35,4,31,32,26,6,0
2021,Basingstoke and Deane 018C,E01022517,491,465,284,181,0,0,1,0,1,25,21,4,0
2021,Basingstoke and Deane 018D,E01022518,750,653,324,329,0,0,61,2,59,36,31,5,0
2021,Basingstoke and Deane 018E,E01022519,511,485,304,181,0,0,15,0,15,11,10,1,0
2021,Basingstoke and Deane 004C,E01022520,790,381,200,181,4,4,244,19,225,159,107,52,2
2021,Basingstoke and Deane 004D,E01022521,731,615,377,238,1,1,41,1,40,74,63,11,0
2021,Basingstoke and Deane 004E,E01022522,688,514,254,260,13,13,74,4,70,87,58,29,0
2021,Basingstoke and Deane 008D,E01022523,922,314,110,204,52,52,416,28,388,139,123,16,1
2021,Basingstoke and Deane 009A,E01022524,744,239,92,147,32,32,368,30,338,105,97,8,0
2021,Basingstoke and Deane 009B,E01022525,647,489,233,256,5,5,56,5,51,97,81,16,0
2021,Basingstoke and Deane 009D,E01022527,752,288,159,129,12,12,307,20,287,145,132,13,0
2021,Basingstoke and Deane 015A,E01022528,515,468,262,206,1,1,12,1,11,34,29,5,0
2021,Basingstoke and Deane 015B,E01022529,680,431,230,201,3,3,147,4,143,98,81,17,1
2021,Basingstoke and Deane 015C,E01022530,588,542,324,218,18,18,9,1,8,19,13,6,0
2021,Basingstoke and Deane 015D,E01022531,599,510,330,180,3,3,12,1,11,74,68,6,0
2021,Basingstoke and Deane 022A,E01022532,906,640,258,382,59,59,113,11,102,94,80,14,0
2021,Basingstoke and Deane 022B,E01022533,698,460,259,201,18,18,105,7,98,113,77,36,2
2021,Basingstoke and Deane 022C,E01022534,847,604,327,277,19,19,153,9,144,71,60,11,0
2021,Basingstoke and Deane 022D,E01022535,735,482,286,196,8,8,146,12,134,99,87,12,0
2021,Basingstoke and Deane 002B,E01022536,572,489,302,187,0,0,51,3,48,32,18,14,0
2021,Basingstoke and Deane 002C,E01022537,552,513,321,192,0,0,10,0,10,29,26,3,0
2021,Basingstoke and Deane 007B,E01022539,485,270,117,153,2,2,136,9,127,77,70,7,0
2021,Basingstoke and Deane 007C,E01022540,953,465,137,328,41,41,303,16,287,143,129,14,1
2021,Basingstoke and Deane 007E,E01022542,451,219,107,112,3,3,143,13,130,86,79,7,0
2021,Basingstoke and Deane 007F,E01022543,631,285,120,165,22,22,197,8,189,125,120,5,2
2021,Basingstoke and Deane 005E,E01022547,754,588,323,265,6,6,71,3,68,89,77,12,0
2021,Basingstoke and Deane 014A,E01022548,611,390,231,159,4,4,152,6,146,65,50,15,0
2021,Basingstoke and Deane 014B,E01022549,762,299,128,171,8,8,370,26,344,85,77,8,0
2021,Basingstoke and Deane 014C,E01022550,766,322,170,152,6,6,366,21,345,72,63,9,0
2021,Basingstoke and Deane 014D,E01022551,658,383,181,202,2,2,169,5,164,104,97,7,0
2021,Basingstoke and Deane 014E,E01022552,615,267,110,157,6,6,281,20,261,61,48,13,0
2021,Basingstoke and Deane 001A,E01022553,614,523,312,211,0,0,39,2,37,51,45,6,1
2021,Basingstoke and Deane 001B,E01022554,722,564,299,265,30,30,69,2,67,59,48,11,0
2021,Basingstoke and Deane 001C,E01022555,624,487,259,228,9,9,64,5,59,64,51,13,0
2021,Basingstoke and Deane 001D,E01022556,771,407,195,212,11,11,285,15,270,68,60,8,0
2021,Basingstoke and Deane 002D,E01022557,624,473,231,242,4,4,64,4,60,83,75,8,0
2021,Basingstoke and Deane 002E,E01022558,587,400,177,223,5,5,48,2,46,134,124,10,0
2021,Basingstoke and Deane 002F,E01022559,520,440,247,193,0,0,36,3,33,44,35,9,0
2021,Basingstoke and Deane 001E,E01022560,487,395,200,195,0,0,39,0,39,53,40,13,0
2021,Basingstoke and Deane 017D,E01022561,617,333,185,148,6,6,65,2,63,213,158,55,0
2021,Basingstoke and Deane 017E,E01022562,577,432,241,191,3,3,65,5,60,77,55,22,0
2021,Basingstoke and Deane 020B,E01022563,743,602,331,271,1,1,28,3,25,112,90,22,0
2021,Basingstoke and Deane 020C,E01022564,910,597,295,302,22,22,162,8,154,129,98,31,0
2021,Basingstoke and Deane 020D,E01022565,834,484,219,265,19,19,228,19,209,103,93,10,0
2021,Basingstoke and Deane 010B,E01022566,475,385,191,194,2,2,61,3,58,27,23,4,0
2021,Basingstoke and Deane 010C,E01022567,504,239,108,131,4,4,211,5,206,50,45,5,0
2021,Basingstoke and Deane 010D,E01022568,619,343,165,178,7,7,214,10,204,55,45,10,0
2021,Basingstoke and Deane 013E,E01022569,600,458,229,229,8,8,64,7,57,70,61,9,0
2021,Basingstoke and Deane 010E,E01022570,628,535,286,249,8,8,36,2,34,49,42,7,0
2021,East Hampshire 003A,E01022571,466,377,217,160,3,3,11,2,9,75,38,37,0
2021,East Hampshire 003B,E01022572,506,416,248,168,0,0,28,0,28,62,58,4,0
2021,East Hampshire 003C,E01022573,1080,800,460,340,8,8,82,11,71,190,172,18,0
2021,East Hampshire 002A,E01022574,737,443,243,200,10,10,158,21,137,126,117,9,0
2021,East Hampshire 002B,E01022575,586,205,100,105,0,0,327,54,273,54,48,6,0
2021,East Hampshire 002C,E01022576,891,339,219,120,7,7,310,44,266,235,212,23,0
2021,East Hampshire 003D,E01022577,758,567,363,204,9,9,43,4,39,139,126,13,0
2021,East Hampshire 002D,E01022579,759,381,145,236,30,30,283,47,236,65,53,12,0
2021,East Hampshire 003F,E01022580,497,406,222,184,4,4,9,3,6,78,68,10,0
2021,East Hampshire 001A,E01022581,678,466,231,235,6,6,64,5,59,142,119,23,0
2021,East Hampshire 001B,E01022582,594,491,271,220,1,1,22,2,20,80,59,21,0
2021,East Hampshire 009A,E01022583,749,538,270,268,3,3,112,17,95,96,83,13,0
2021,East Hampshire 009B,E01022584,844,475,258,217,6,6,239,29,210,124,110,14,0
2021,East Hampshire 009C,E01022585,784,704,432,272,3,3,16,4,12,61,46,15,0
2021,East Hampshire 009D,E01022586,780,649,305,344,17,17,36,5,31,78,61,17,0
2021,East Hampshire 009E,E01022587,899,634,320,314,44,44,90,13,77,131,113,18,0
2021,East Hampshire 013A,E01022588,1041,825,425,400,42,42,104,11,93,70,58,12,0
2021,East Hampshire 013B,E01022589,861,644,323,321,9,9,101,18,83,107,90,17,0
2021,East Hampshire 013C,E01022590,633,558,356,202,3,3,44,3,41,28,23,5,0
2021,East Hampshire 007A,E01022591,1044,839,480,359,5,5,59,8,51,141,114,27,0
2021,East Hampshire 011A,E01022592,970,651,396,255,6,6,165,14,151,148,105,43,0
2021,East Hampshire 007B,E01022593,527,495,289,206,2,2,0,0,0,30,24,6,0
2021,East Hampshire 007C,E01022594,802,611,320,291,26,26,87,7,80,78,61,17,0
2021,East Hampshire 007D,E01022595,946,763,387,376,34,34,86,11,75,63,50,13,0
2021,East Hampshire 007E,E01022596,768,641,368,273,23,23,44,4,40,60,52,8,0
2021,East Hampshire 011B,E01022597,1028,698,404,294,8,8,103,19,84,219,148,71,0
2021,East Hampshire 017A,E01022599,636,416,249,167,4,4,87,16,71,129,110,19,0
2021,East Hampshire 017B,E01022600,647,599,369,230,1,1,4,1,3,43,33,10,0
2021,East Hampshire 017C,E01022601,605,481,288,193,6,6,74,16,58,43,31,12,1
2021,East Hampshire 017D,E01022602,550,527,315,212,1,1,3,1,2,19,16,3,0
2021,East Hampshire 004A,E01022603,536,296,141,155,2,2,161,32,129,76,61,15,1
2021,East Hampshire 001C,E01022604,569,423,243,180,8,8,53,5,48,85,66,19,0
2021,East Hampshire 001D,E01022605,835,621,331,290,20,20,66,7,59,128,102,26,0
2021,East Hampshire 014A,E01022606,1007,893,471,422,2,2,29,2,27,83,72,11,0
2021,East Hampshire 013D,E01022607,517,405,228,177,0,0,68,12,56,44,36,8,0
2021,East Hampshire 013E,E01022608,529,495,254,241,1,1,3,0,3,30,25,5,0
2021,East Hampshire 016A,E01022610,743,545,274,271,21,21,40,3,37,137,113,24,0
2021,East Hampshire 014B,E01022611,653,489,259,230,0,0,101,9,92,63,54,9,0
2021,East Hampshire 014C,E01022613,559,441,236,205,2,2,69,11,58,47,42,5,0
2021,East Hampshire 014D,E01022614,483,319,188,131,1,1,127,18,109,36,27,9,0
2021,East Hampshire 006A,E01022615,1141,860,422,438,16,16,148,23,125,117,102,15,0
2021,East Hampshire 010A,E01022616,756,370,206,164,5,5,230,34,196,150,133,17,1
2021,East Hampshire 010B,E01022617,696,548,298,250,2,2,41,2,39,105,92,13,0
2021,East Hampshire 010C,E01022618,682,620,375,245,0,0,9,1,8,53,38,15,0
2021,East Hampshire 011C,E01022619,519,406,236,170,3,3,7,0,7,103,80,23,0
2021,East Hampshire 012A,E01022620,502,340,164,176,1,1,81,7,74,80,74,6,0
2021,East Hampshire 012B,E01022621,620,268,169,99,22,22,288,44,244,42,36,6,0
2021,East Hampshire 012C,E01022622,947,684,387,297,45,45,143,27,116,75,65,10,0
2021,East Hampshire 012D,E01022623,939,633,360,273,8,8,148,22,126,150,137,13,0
2021,East Hampshire 011D,E01022624,1005,869,583,286,1,1,11,3,8,124,107,17,0
2021,East Hampshire 011E,E01022625,1127,853,502,351,21,21,133,9,124,120,103,17,0
2021,East Hampshire 007F,E01022627,943,674,400,274,9,9,89,0,89,171,119,52,0
2021,East Hampshire 016B,E01022628,639,441,229,212,28,28,87,12,75,82,75,7,1
2021,East Hampshire 016C,E01022629,709,581,373,208,12,12,60,5,55,56,47,9,0
2021,East Hampshire 008A,E01022630,960,694,434,260,15,15,92,12,80,159,132,27,0
2021,East Hampshire 010D,E01022631,516,409,224,185,3,3,38,9,29,66,44,22,0
2021,East Hampshire 010E,E01022632,460,388,217,171,0,0,26,3,23,46,38,8,0
2021,East Hampshire 006B,E01022633,605,469,212,257,5,5,24,5,19,106,99,7,1
2021,East Hampshire 004B,E01022634,516,307,116,191,4,4,111,14,97,94,81,13,0
2021,East Hampshire 006C,E01022635,522,271,129,142,2,2,222,49,173,27,20,7,0
2021,East Hampshire 006D,E01022636,522,402,169,233,3,3,53,7,46,64,54,10,0
2021,East Hampshire 004C,E01022639,642,343,89,254,13,13,108,10,98,178,136,42,0
2021,East Hampshire 004D,E01022640,1059,625,129,496,82,82,247,33,214,105,93,12,0
2021,East Hampshire 006E,E01022641,534,389,185,204,1,1,42,5,37,102,88,14,0
2021,East Hampshire 008D,E01022642,420,358,201,157,0,0,19,4,15,43,21,22,0
2021,Eastleigh 005A,E01022643,659,512,284,228,6,6,55,7,48,86,74,12,0
2021,Eastleigh 005B,E01022644,498,405,211,194,1,1,56,7,49,36,33,3,0
2021,Eastleigh 008A,E01022645,491,454,301,153,0,0,7,1,6,30,23,7,0
2021,Eastleigh 005C,E01022646,637,501,258,243,6,6,37,3,34,93,75,18,0
2021,Eastleigh 005D,E01022647,699,595,293,302,18,18,27,0,27,59,46,13,0
2021,Eastleigh 004A,E01022648,794,556,328,228,18,18,134,23,111,86,76,10,0
2021,Eastleigh 005E,E01022649,629,229,89,140,12,12,352,26,326,35,27,8,1
2021,Eastleigh 005F,E01022650,479,375,201,174,11,11,33,2,31,60,57,3,0
2021,Eastleigh 012A,E01022651,795,628,314,314,6,6,9,0,9,152,135,17,0
2021,Eastleigh 011A,E01022652,759,497,279,218,2,2,178,23,155,82,72,10,0
2021,Eastleigh 013A,E01022654,568,407,156,251,9,9,25,4,21,127,115,12,0
2021,Eastleigh 013B,E01022655,553,121,51,70,7,7,403,28,375,22,19,3,0
2021,Eastleigh 013C,E01022656,963,683,292,391,36,36,160,8,152,84,74,10,0
2021,Eastleigh 013D,E01022657,1157,789,268,521,52,52,124,14,110,192,170,22,0
2021,Eastleigh 013E,E01022658,733,597,326,271,5,5,54,4,50,77,62,15,0
2021,Eastleigh 002A,E01022659,612,533,253,280,5,5,6,0,6,67,60,7,1
2021,Eastleigh 002B,E01022660,627,453,242,211,3,3,101,5,96,70,58,12,0
2021,Eastleigh 003A,E01022661,794,654,443,211,2,2,12,4,8,126,107,19,0
2021,Eastleigh 003B,E01022662,544,503,289,214,0,0,5,0,5,36,32,4,0
2021,Eastleigh 003C,E01022663,645,527,265,262,3,3,9,0,9,106,96,10,0
2021,Eastleigh 003D,E01022664,645,555,299,256,3,3,7,1,6,80,71,9,0
2021,Eastleigh 003E,E01022665,702,437,261,176,13,13,117,5,112,135,122,13,0
2021,Eastleigh 007A,E01022666,978,533,283,250,18,18,71,5,66,356,315,41,0
2021,Eastleigh 004B,E01022667,822,520,218,302,19,19,144,13,131,139,128,11,0
2021,Eastleigh 007B,E01022669,731,393,163,230,13,13,85,10,75,240,227,13,0
2021,Eastleigh 007C,E01022670,630,236,96,140,2,2,281,16,265,110,103,7,1
2021,Eastleigh 007D,E01022671,697,333,154,179,5,5,186,26,160,173,164,9,0
2021,Eastleigh 004C,E01022672,622,423,227,196,4,4,138,17,121,57,53,4,0
2021,Eastleigh 004D,E01022673,931,543,210,333,25,25,181,9,172,181,167,14,1
2021,Eastleigh 004E,E01022674,702,494,251,243,10,10,83,9,74,115,102,13,0
2021,Eastleigh 002C,E01022675,561,508,302,206,4,4,4,0,4,45,36,9,0
2021,Eastleigh 002D,E01022676,730,577,297,280,10,10,74,4,70,69,60,9,0
2021,Eastleigh 006C,E01022678,739,484,197,287,9,9,170,12,158,76,62,14,0
2021,Eastleigh 007E,E01022679,802,486,189,297,12,12,124,16,108,180,172,8,0
2021,Eastleigh 006D,E01022680,804,329,152,177,14,14,393,47,346,68,57,11,0
2021,Eastleigh 006E,E01022681,696,314,132,182,4,4,313,32,281,65,58,7,0
2021,Eastleigh 008B,E01022682,710,614,280,334,28,28,35,7,28,33,25,8,0
2021,Eastleigh 008C,E01022683,876,654,242,412,39,39,104,8,96,78,70,8,1
2021,Eastleigh 008D,E01022684,583,516,283,233,3,3,8,0,8,56,50,6,0
2021,Eastleigh 008E,E01022685,524,377,218,159,3,3,55,8,47,89,84,5,0
2021,Eastleigh 008F,E01022686,763,631,270,361,33,33,45,5,40,54,46,8,0
2021,Eastleigh 008G,E01022687,667,577,222,355,1,1,9,0,9,80,67,13,0
2021,Eastleigh 015A,E01022688,1049,736,428,308,10,10,55,8,47,248,236,12,0
2021,Eastleigh 015B,E01022689,851,702,360,342,31,31,54,3,51,64,51,13,0
2021,Eastleigh 015C,E01022690,803,441,209,232,4,4,212,19,193,146,134,12,0
2021,Eastleigh 010B,E01022691,612,477,172,305,0,0,15,0,15,120,108,12,0
2021,Eastleigh 010D,E01022693,528,445,180,265,0,0,5,0,5,78,68,10,0
2021,Eastleigh 010E,E01022694,659,485,180,305,15,15,30,1,29,129,122,7,0
2021,Eastleigh 011B,E01022695,578,425,259,166,1,1,64,5,59,87,76,11,1
2021,Eastleigh 012B,E01022696,634,584,359,225,4,4,7,1,6,39,36,3,0
2021,Eastleigh 012C,E01022697,621,541,314,227,2,2,25,2,23,53,47,6,0
2021,Eastleigh 012D,E01022698,792,638,351,287,24,24,52,5,47,78,66,12,0
2021,Eastleigh 012E,E01022699,720,591,298,293,10,10,35,4,31,84,77,7,0
2021,Eastleigh 011C,E01022700,663,404,194,210,3,3,165,14,151,91,76,15,0
2021,Eastleigh 011D,E01022701,415,326,178,148,2,2,61,5,56,26,20,6,0
2021,Eastleigh 012F,E01022702,520,440,190,250,2,2,7,1,6,71,61,10,0
2021,Eastleigh 011E,E01022703,647,490,279,211,8,8,51,9,42,98,92,6,0
2021,Eastleigh 002E,E01022704,733,651,364,287,4,4,10,2,8,68,62,6,0
2021,Eastleigh 001A,E01022705,654,583,386,197,2,2,8,0,8,61,52,9,0
2021,Eastleigh 001B,E01022706,636,597,338,259,0,0,7,1,6,32,28,4,0
2021,Eastleigh 001C,E01022707,735,657,366,291,3,3,20,0,20,55,49,6,0
2021,Eastleigh 001D,E01022708,714,549,277,272,5,5,8,0,8,152,139,13,0
2021,Eastleigh 001E,E01022709,677,579,320,259,6,6,16,1,15,76,69,7,0
2021,Eastleigh 014A,E01022710,964,623,383,240,4,4,156,9,147,181,152,29,0
2021,Eastleigh 014B,E01022711,777,376,167,209,13,13,322,28,294,66,53,13,0
2021,Eastleigh 014C,E01022712,707,519,245,274,13,13,34,4,30,141,128,13,0
2021,Eastleigh 009A,E01022713,836,637,352,285,18,18,91,4,87,90,79,11,0
2021,Eastleigh 009B,E01022714,710,638,417,221,0,0,30,5,25,42,33,9,0
2021,Eastleigh 009C,E01022715,872,572,278,294,42,42,101,8,93,157,145,12,0
2021,Eastleigh 009D,E01022716,733,443,216,227,8,8,93,8,85,189,175,14,0
2021,Eastleigh 009E,E01022717,515,416,205,211,3,3,4,0,4,92,83,9,0
2021,Eastleigh 009F,E01022718,646,510,253,257,0,0,62,8,54,74,63,11,0
2021,Eastleigh 009G,E01022719,725,605,355,250,9,9,37,3,34,74,63,11,0
2021,Fareham 004A,E01022720,610,512,282,230,1,1,2,2,0,95,90,5,0
2021,Fareham 008A,E01022721,697,563,301,262,6,6,20,4,16,108,93,15,0
2021,Fareham 008B,E01022722,724,539,314,225,0,0,75,30,45,110,96,14,0
2021,Fareham 008C,E01022723,774,434,233,201,1,1,103,29,74,236,221,15,0
2021,Fareham 008D,E01022724,575,448,201,247,1,1,45,27,18,81,68,13,0
2021,Fareham 004B,E01022725,486,460,282,178,0,0,5,1,4,21,15,6,0
2021,Fareham 004C,E01022726,597,532,328,204,1,1,40,3,37,24,18,6,0
2021,Fareham 004D,E01022727,655,583,337,246,2,2,27,5,22,43,37,6,0
2021,Fareham 011A,E01022728,826,483,281,202,4,4,76,39,37,262,231,31,1
2021,Fareham 004E,E01022729,456,388,177,211,0,0,11,3,8,57,52,5,0
2021,Fareham 003A,E01022730,645,548,307,241,6,6,27,8,19,63,52,11,1
2021,Fareham 003B,E01022731,502,442,213,229,0,0,18,3,15,42,33,9,0
2021,Fareham 003C,E01022732,644,292,134,158,2,2,278,223,55,68,58,10,4
2021,Fareham 003D,E01022733,734,523,321,202,4,4,129,91,38,75,63,12,3
2021,Fareham 003E,E01022734,540,329,155,174,0,0,141,93,48,70,59,11,0
2021,Fareham 011B,E01022735,758,528,213,315,4,4,104,39,65,121,107,14,1
2021,Fareham 011C,E01022736,662,486,231,255,0,0,90,83,7,85,65,20,1
2021,Fareham 008E,E01022737,646,509,267,242,0,0,42,32,10,95,82,13,0
2021,Fareham 011D,E01022738,462,239,108,131,10,10,164,122,42,48,39,9,1
2021,Fareham 011E,E01022739,669,254,102,152,8,8,329,242,87,73,68,5,5
2021,Fareham 009A,E01022740,717,631,369,262,1,1,10,9,1,75,60,15,0
2021,Fareham 009B,E01022741,560,334,216,118,2,2,16,7,9,208,59,149,0
2021,Fareham 009C,E01022742,853,761,545,216,2,2,7,4,3,83,70,13,0
2021,Fareham 004F,E01022743,797,679,410,269,6,6,38,2,36,74,64,10,0
2021,Fareham 014A,E01022744,555,523,358,165,0,0,6,3,3,26,22,4,0
2021,Fareham 014B,E01022745,637,584,384,200,0,0,1,0,1,52,38,14,0
2021,Fareham 014C,E01022746,728,552,369,183,4,4,23,12,11,149,42,107,0
2021,Fareham 014D,E01022747,590,435,280,155,4,4,63,5,58,88,75,13,0
2021,Fareham 014E,E01022748,625,515,306,209,2,2,9,5,4,99,88,11,0
2021,Fareham 002A,E01022749,539,493,277,216,3,3,19,7,12,24,16,8,0
2021,Fareham 005A,E01022750,647,568,355,213,3,3,16,9,7,60,50,10,0
2021,Fareham 005B,E01022751,667,554,341,213,2,2,63,29,34,46,38,8,2
2021,Fareham 005C,E01022752,549,519,304,215,1,1,9,1,8,20,17,3,0
2021,Fareham 002B,E01022753,492,377,203,174,2,2,64,42,22,47,41,6,2
2021,Fareham 002C,E01022754,1007,601,297,304,34,34,131,32,99,240,221,19,1
2021,Fareham 006A,E01022755,672,551,289,262,7,7,69,52,17,45,37,8,0
2021,Fareham 006B,E01022756,722,591,259,332,6,6,39,8,31,86,77,9,0
2021,Fareham 005D,E01022757,694,460,172,288,2,2,27,10,17,205,195,10,0
2021,Fareham 001A,E01022758,828,608,233,375,22,22,120,38,82,78,71,7,0
2021,Fareham 010A,E01022759,684,604,347,257,2,2,11,8,3,66,49,17,1
2021,Fareham 012A,E01022760,645,512,285,227,0,0,61,55,6,70,54,16,2
2021,Fareham 012B,E01022761,653,490,304,186,3,3,106,97,9,51,35,16,3
2021,Fareham 012C,E01022762,632,543,278,265,1,1,9,7,2,79,66,13,0
2021,Fareham 010B,E01022763,681,631,394,237,2,2,4,3,1,44,32,12,0
2021,Fareham 012D,E01022764,734,545,352,193,0,0,116,83,33,71,58,13,2
2021,Fareham 010C,E01022765,759,692,413,279,1,1,4,3,1,62,49,13,0
2021,Fareham 008F,E01022766,519,483,289,194,2,2,7,1,6,27,21,6,0
2021,Fareham 012E,E01022767,505,441,233,208,0,0,23,19,4,41,27,14,0
2021,Fareham 010D,E01022768,603,471,268,203,3,3,76,58,18,53,48,5,0
2021,Fareham 008G,E01022769,560,409,209,200,5,5,38,10,28,107,91,16,1
2021,Fareham 010E,E01022770,796,709,395,314,13,13,28,1,27,46,37,9,0
2021,Fareham 001B,E01022771,613,471,162,309,3,3,10,2,8,129,121,8,0
2021,Fareham 001C,E01022772,917,716,239,477,19,19,66,3,63,116,102,14,0
2021,Fareham 001D,E01022773,693,596,298,298,3,3,23,3,20,71,57,14,0
2021,Fareham 001E,E01022774,809,705,352,353,4,4,27,8,19,73,59,14,0
2021,Fareham 013B,E01022776,634,539,339,200,4,4,30,27,3,61,54,7,0
2021,Fareham 013C,E01022777,771,574,410,164,4,4,126,95,31,66,56,10,1
2021,Fareham 013D,E01022778,586,504,309,195,2,2,13,8,5,67,57,10,0
2021,Fareham 002D,E01022780,681,439,198,241,19,19,93,3,90,130,98,32,0
2021,Fareham 007A,E01022781,577,334,183,151,2,2,130,112,18,109,54,55,2
2021,Fareham 007B,E01022782,673,552,337,215,3,3,30,11,19,88,72,16,0
2021,Fareham 009D,E01022783,634,567,350,217,0,0,7,3,4,60,53,7,0
2021,Fareham 009E,E01022784,497,461,243,218,1,1,5,4,1,30,28,2,0
2021,Fareham 007C,E01022785,606,522,264,258,1,1,40,35,5,43,37,6,0
2021,Fareham 007D,E01022786,894,654,332,322,60,60,111,17,94,69,62,7,0
2021,Fareham 002E,E01022787,561,415,200,215,11,11,62,46,16,72,63,9,1
2021,Fareham 002F,E01022788,527,365,165,200,2,2,55,39,16,105,100,5,0
2021,Fareham 007E,E01022789,680,519,245,274,6,6,23,3,20,132,119,13,0
2021,Fareham 005E,E01022790,714,596,341,255,1,1,5,3,2,112,94,18,0
2021,Fareham 006C,E01022791,856,691,400,291,2,2,33,23,10,127,112,15,3
2021,Fareham 006D,E01022792,688,551,362,189,4,4,46,33,13,87,61,26,0
2021,Fareham 006E,E01022793,776,684,368,316,1,1,8,0,8,83,76,7,0
2021,Gosport 009A,E01022794,626,528,348,180,1,1,19,7,12,78,47,31,0
2021,Gosport 009B,E01022795,762,614,384,230,1,1,14,8,6,132,106,26,1
2021,Gosport 009C,E01022796,497,438,276,162,0,0,35,10,25,24,21,3,0
2021,Gosport 010A,E01022797,446,362,225,137,0,0,14,13,1,70,65,5,0
2021,Gosport 010B,E01022798,511,366,218,148,0,0,83,26,57,60,42,18,2
2021,Gosport 010C,E01022799,583,480,298,182,3,3,25,20,5,75,52,23,0
2021,Gosport 001A,E01022800,625,431,221,210,2,2,143,119,24,46,40,6,3
2021,Gosport 001B,E01022801,628,331,164,167,16,16,233,130,103,47,41,6,1
2021,Gosport 001C,E01022802,606,493,283,210,4,4,53,12,41,56,47,9,0
2021,Gosport 001D,E01022803,653,342,141,201,4,4,239,175,64,62,55,7,6
2021,Gosport 002A,E01022804,672,483,283,200,1,1,118,82,36,67,57,10,3
2021,Gosport 002B,E01022805,628,340,162,178,1,1,202,105,97,79,44,35,6
2021,Gosport 007A,E01022806,584,401,195,206,2,2,48,12,36,133,116,17,0
2021,Gosport 005A,E01022807,713,320,150,170,3,3,130,29,101,260,242,18,0
2021,Gosport 008A,E01022810,743,429,264,165,2,2,80,63,17,231,209,22,1
2021,Gosport 010D,E01022812,515,397,190,207,2,2,14,6,8,102,95,7,0
2021,Gosport 003A,E01022813,541,458,206,252,0,0,11,9,2,72,60,12,0
2021,Gosport 003B,E01022814,741,472,232,240,4,4,137,115,22,126,97,29,2
2021,Gosport 003C,E01022815,608,498,255,243,1,1,18,5,13,91,74,17,0
2021,Gosport 005B,E01022816,586,418,191,227,1,1,85,73,12,81,71,10,1
2021,Gosport 005C,E01022817,711,396,174,222,7,7,164,120,44,143,130,13,1
2021,Gosport 005D,E01022818,585,260,112,148,16,16,214,167,47,92,83,9,3
2021,Gosport 004A,E01022819,664,351,167,184,5,5,35,7,28,272,258,14,1
2021,Gosport 004B,E01022820,601,204,58,146,5,5,214,19,195,178,97,81,0
2021,Gosport 003D,E01022823,634,514,269,245,5,5,15,7,8,100,88,12,0
2021,Gosport 003E,E01022825,578,445,219,226,6,6,28,7,21,99,82,17,0
2021,Gosport 006A,E01022826,679,576,338,238,3,3,13,7,6,87,79,8,0
2021,Gosport 006C,E01022828,730,563,453,110,3,3,33,6,27,131,124,7,0
2021,Gosport 006D,E01022829,1053,696,465,231,63,63,73,30,43,220,84,136,1
2021,Gosport 006E,E01022830,644,574,378,196,2,2,9,8,1,59,49,10,0
2021,Gosport 010E,E01022831,619,469,243,226,0,0,39,9,30,111,98,13,0
2021,Gosport 007D,E01022832,681,462,208,254,6,6,29,16,13,184,166,18,0
2021,Gosport 008C,E01022833,810,295,114,181,9,9,318,159,159,183,167,16,5
2021,Gosport 002C,E01022834,599,410,232,178,1,1,138,104,34,45,36,9,5
2021,Gosport 002D,E01022835,616,417,217,200,0,0,86,66,20,112,102,10,1
2021,Gosport 001E,E01022836,632,579,371,208,1,1,17,3,14,35,25,10,0
2021,Gosport 009D,E01022837,632,549,342,207,1,1,18,2,16,64,56,8,0
2021,Gosport 009E,E01022838,529,471,291,180,0,0,8,3,5,50,40,10,0
2021,Gosport 007E,E01022839,636,307,138,169,3,3,216,181,35,106,96,10,4
2021,Gosport 002E,E01022840,631,335,166,169,6,6,214,193,21,73,64,9,3
2021,Gosport 004E,E01022841,657,283,136,147,2,2,180,162,18,191,96,95,1
2021,Gosport 004F,E01022842,588,217,133,84,3,3,129,14,115,238,78,160,1
2021,Gosport 008D,E01022843,697,271,139,132,0,0,313,296,17,105,94,11,8
2021,Gosport 010F,E01022845,678,452,255,197,3,3,60,30,30,163,152,11,0
2021,Hart 003A,E01022846,794,540,224,316,71,71,96,9,87,87,75,12,0
2021,Hart 003B,E01022847,774,565,300,265,12,12,23,3,20,174,159,15,0
2021,Hart 003C,E01022848,626,554,310,244,3,3,8,1,7,61,50,11,0
2021,Hart 009A,E01022849,664,526,271,255,1,1,78,4,74,59,52,7,0
2021,Hart 009B,E01022850,614,492,237,255,1,1,12,0,12,109,99,10,0
2021,Hart 009C,E01022851,657,598,295,303,0,0,6,0,6,52,40,12,1
2021,Hart 010A,E01022852,774,548,227,321,9,9,36,1,35,181,157,24,0
2021,Hart 009D,E01022853,757,678,345,333,9,9,11,1,10,59,49,10,0
2021,Hart 010B,E01022854,647,560,258,302,6,6,24,0,24,57,53,4,0
2021,Hart 010C,E01022855,503,354,190,164,6,6,103,12,91,40,35,5,0
2021,Hart 010D,E01022856,650,518,291,227,4,4,71,9,62,57,47,10,0
2021,Hart 004A,E01022858,486,341,164,177,8,8,37,6,31,100,83,17,0
2021,Hart 002A,E01022859,652,509,236,273,4,4,72,8,64,67,51,16,0
2021,Hart 005A,E01022860,933,734,483,251,4,4,57,11,46,138,120,18,0
2021,Hart 007A,E01022861,636,592,331,261,1,1,2,0,2,41,31,10,0
2021,Hart 005B,E01022862,1139,652,316,336,35,35,79,11,68,372,338,34,1
2021,Hart 007B,E01022863,636,584,344,240,2,2,8,2,6,42,39,3,0
2021,Hart 008A,E01022864,639,433,266,167,2,2,174,23,151,30,28,2,0
2021,Hart 007C,E01022865,633,600,353,247,2,2,9,0,9,22,20,2,0
2021,Hart 005D,E01022867,735,487,186,301,3,3,35,2,33,210,195,15,0
2021,Hart 007D,E01022868,681,618,355,263,1,1,26,6,20,36,32,4,0
2021,Hart 009E,E01022869,624,515,255,260,5,5,45,4,41,59,51,8,0
2021,Hart 007E,E01022870,578,474,269,205,4,4,49,3,46,51,46,5,0
2021,Hart 008B,E01022871,556,330,140,190,5,5,145,12,133,76,67,9,0
2021,Hart 008C,E01022872,732,575,301,274,1,1,27,2,25,129,109,20,0
2021,Hart 003D,E01022874,499,432,203,229,3,3,25,3,22,39,35,4,0
2021,Hart 003E,E01022875,484,324,142,182,2,2,114,16,98,44,40,4,0
2021,Hart 003F,E01022876,578,492,273,219,19,19,18,0,18,49,38,11,0
2021,Hart 003G,E01022877,546,474,245,229,2,2,29,4,25,41,31,10,0
2021,Hart 004B,E01022878,716,653,406,247,1,1,4,0,4,58,48,10,0
2021,Hart 004C,E01022879,1010,642,355,287,20,20,162,24,138,185,160,25,1
2021,Hart 004D,E01022880,880,525,227,298,26,26,233,25,208,95,80,15,1
2021,Hart 006A,E01022881,1155,785,301,484,37,37,155,13,142,178,158,20,0
2021,Hart 006B,E01022882,949,714,277,437,49,49,104,15,89,82,68,14,0
2021,Hart 006C,E01022883,543,454,241,213,9,9,26,2,24,54,48,6,0
2021,Hart 006D,E01022884,674,502,264,238,3,3,65,5,60,104,96,8,0
2021,Hart 006E,E01022885,552,437,214,223,9,9,23,2,21,83,76,7,0
2021,Hart 008E,E01022887,605,513,257,256,0,0,18,1,17,74,60,14,0
2021,Hart 011B,E01022888,953,715,430,285,23,23,88,7,81,127,111,16,0
2021,Hart 011C,E01022889,692,443,245,198,1,1,185,21,164,63,54,9,0
2021,Hart 001A,E01022890,623,350,170,180,1,1,212,25,187,60,54,6,0
2021,Hart 001B,E01022891,737,620,345,275,4,4,25,7,18,88,58,30,0
2021,Hart 001C,E01022892,803,702,426,276,7,7,19,0,19,75,66,9,0
2021,Hart 001D,E01022893,751,599,294,305,28,28,55,3,52,69,59,10,0
2021,Hart 001E,E01022894,621,469,231,238,2,2,101,8,93,49,43,6,0
2021,Hart 002B,E01022895,737,644,326,318,4,4,12,1,11,77,67,10,0
2021,Hart 002C,E01022896,596,549,305,244,3,3,7,0,7,37,25,12,0
2021,Hart 002D,E01022897,638,543,264,279,5,5,10,1,9,80,68,12,0
2021,Hart 002E,E01022898,567,534,300,234,2,2,8,1,7,23,18,5,0
2021,Havant 018A,E01022899,492,331,131,200,3,3,111,91,20,46,39,7,1
2021,Havant 010A,E01022900,713,392,174,218,0,0,238,220,18,78,64,14,5
2021,Havant 006A,E01022901,715,389,179,210,14,14,217,132,85,95,81,14,0
2021,Havant 006B,E01022902,568,339,154,185,5,5,152,115,37,72,63,9,0
2021,Havant 008A,E01022903,736,297,122,175,14,14,335,302,33,87,76,11,3
2021,Havant 010B,E01022904,831,469,223,246,5,5,274,182,92,83,64,19,0
2021,Havant 010C,E01022905,814,234,101,133,3,3,435,310,125,139,123,16,3
2021,Havant 008B,E01022906,572,282,131,151,5,5,201,155,46,81,65,16,3
2021,Havant 018B,E01022907,640,521,302,219,1,1,87,9,78,31,22,9,0
2021,Havant 010D,E01022908,628,385,174,211,9,9,148,85,63,85,70,15,1
2021,Havant 018C,E01022909,713,642,329,313,1,1,28,6,22,42,36,6,0
2021,Havant 018D,E01022910,654,416,220,196,4,4,61,8,53,172,148,24,1
2021,Havant 018E,E01022911,643,505,296,209,4,4,64,25,39,69,53,16,1
2021,Havant 009A,E01022913,537,232,101,131,4,4,248,109,139,52,43,9,1
2021,Havant 009B,E01022914,524,274,134,140,4,4,181,141,40,65,57,8,0
2021,Havant 009C,E01022915,612,228,101,127,0,0,312,275,37,67,61,6,5
2021,Havant 009D,E01022916,637,377,167,210,3,3,169,97,72,87,75,12,1
2021,Havant 009E,E01022917,506,222,99,123,2,2,229,175,54,48,43,5,5
2021,Havant 020A,E01022918,684,518,330,188,4,4,107,15,92,55,48,7,0
2021,Havant 019A,E01022919,638,484,242,242,3,3,69,9,60,82,70,12,0
2021,Havant 020B,E01022920,688,593,348,245,2,2,15,7,8,78,72,6,0
2021,Havant 020C,E01022921,647,577,328,249,0,0,9,3,6,61,51,10,0
2021,Havant 004A,E01022922,657,476,219,257,1,1,14,7,7,166,154,12,0
2021,Havant 013A,E01022924,704,540,357,183,2,2,79,12,67,83,66,17,0
2021,Havant 013B,E01022925,883,673,378,295,26,26,104,11,93,80,68,12,0
2021,Havant 013C,E01022926,736,600,371,229,13,13,50,8,42,72,37,35,1
2021,Havant 013D,E01022927,735,476,304,172,4,4,184,29,155,70,58,12,1
2021,Havant 013E,E01022928,803,706,531,175,1,1,16,12,4,80,69,11,0
2021,Havant 013F,E01022929,814,507,390,117,1,1,68,11,57,238,205,33,0
2021,Havant 003A,E01022930,808,725,482,243,4,4,30,5,25,49,37,12,0
2021,Havant 003B,E01022931,666,599,351,248,1,1,5,2,3,61,58,3,0
2021,Havant 019B,E01022933,679,242,115,127,11,11,359,259,100,63,52,11,4
2021,Havant 019C,E01022934,767,309,132,177,15,15,331,261,70,106,96,10,6
2021,Havant 003C,E01022935,655,528,344,184,1,1,70,38,32,53,44,9,3
2021,Havant 017A,E01022936,798,536,404,132,2,2,48,14,34,212,201,11,0
2021,Havant 015A,E01022937,571,391,242,149,2,2,130,16,114,48,36,12,0
2021,Havant 017B,E01022938,758,594,398,196,13,13,30,3,27,121,108,13,0
2021,Havant 017C,E01022939,703,554,372,182,3,3,54,10,44,92,76,16,0
2021,Havant 016A,E01022940,734,553,382,171,3,3,80,5,75,98,86,12,0
2021,Havant 017D,E01022941,694,601,420,181,3,3,9,5,4,81,64,17,0
2021,Havant 016B,E01022942,780,393,293,100,1,1,204,39,165,182,161,21,0
2021,Havant 015B,E01022943,642,599,452,147,2,2,6,5,1,35,28,7,0
2021,Havant 015C,E01022944,542,493,325,168,1,1,11,4,7,37,24,13,0
2021,Havant 016C,E01022945,1082,877,609,268,6,6,31,10,21,167,146,21,1
2021,Havant 015D,E01022946,877,700,455,245,8,8,36,6,30,133,120,13,0
2021,Havant 011A,E01022947,652,601,319,282,0,0,5,3,2,46,41,5,0
2021,Havant 011B,E01022948,712,586,309,277,14,14,32,11,21,80,71,9,0
2021,Havant 011C,E01022949,742,319,136,183,2,2,345,329,16,68,59,9,8
2021,Havant 011D,E01022950,683,616,325,291,14,14,14,1,13,39,28,11,0
2021,Havant 011E,E01022951,575,516,289,227,0,0,23,12,11,36,24,12,0
2021,Havant 011F,E01022952,628,527,286,241,0,0,10,5,5,91,76,15,0
2021,Havant 014B,E01022954,703,620,420,200,1,1,3,1,2,79,65,14,0
2021,Havant 014C,E01022955,697,573,353,220,6,6,41,11,30,77,65,12,0
2021,Havant 014D,E01022956,492,318,146,172,0,0,111,18,93,63,60,3,0
2021,Havant 014E,E01022957,551,387,225,162,7,7,105,23,82,52,47,5,0
2021,Havant 014F,E01022958,931,754,408,346,28,28,89,15,74,59,54,5,1
2021,Havant 005A,E01022959,541,252,107,145,4,4,255,32,223,30,25,5,0
2021,Havant 007A,E01022960,501,309,135,174,3,3,79,9,70,110,102,8,0
2021,Havant 007B,E01022961,489,335,145,190,2,2,80,14,66,72,59,13,0
2021,Havant 005B,E01022962,852,646,286,360,36,36,113,23,90,57,51,6,0
2021,Havant 007C,E01022963,624,443,248,195,2,2,103,15,88,76,67,9,0
2021,Havant 007D,E01022964,638,267,142,125,0,0,258,32,226,112,102,10,1
2021,Havant 005C,E01022965,606,267,121,146,1,1,294,63,231,43,36,7,1
2021,Havant 006C,E01022966,504,229,111,118,0,0,225,182,43,49,44,5,1
2021,Havant 006D,E01022967,477,130,60,70,0,0,288,251,37,50,45,5,9
2021,Havant 008C,E01022968,513,191,78,113,2,2,283,214,69,30,25,5,7
2021,Havant 008D,E01022969,666,235,111,124,7,7,317,255,62,105,97,8,2
2021,Havant 010E,E01022970,680,275,133,142,14,14,306,144,162,84,71,13,1
2021,Havant 004B,E01022971,718,549,328,221,0,0,14,9,5,155,141,14,0
2021,Havant 004C,E01022972,747,641,351,290,9,9,22,0,22,75,65,10,0
2021,Havant 005D,E01022973,980,539,326,213,2,2,226,29,197,211,193,18,2
2021,Havant 004D,E01022974,588,499,299,200,0,0,9,5,4,80,73,7,0
2021,Havant 003D,E01022975,844,667,430,237,32,32,69,12,57,76,68,8,0
2021,Havant 003E,E01022976,682,386,226,160,6,6,244,33,211,46,40,6,0
2021,New Forest 006A,E01022977,597,538,331,207,0,0,3,3,0,56,46,10,0
2021,New Forest 006B,E01022978,639,565,360,205,0,0,20,3,17,54,36,18,0
2021,New Forest 006C,E01022979,477,403,267,136,0,0,48,33,15,26,20,6,0
2021,New Forest 006D,E01022980,567,489,311,178,2,2,18,5,13,58,49,9,0
2021,New Forest 022A,E01022981,906,857,670,187,0,0,3,1,2,46,37,9,0
2021,New Forest 022B,E01022982,947,753,589,164,2,2,40,9,31,152,139,13,0
2021,New Forest 022C,E01022983,796,718,544,174,6,6,8,3,5,64,46,18,0
2021,New Forest 018A,E01022984,653,595,443,152,2,2,5,1,4,51,33,18,0
2021,New Forest 018B,E01022985,529,440,274,166,0,0,11,7,4,78,70,8,0
2021,New Forest 021A,E01022986,645,576,377,199,1,1,17,6,11,51,48,3,0
2021,New Forest 022D,E01022987,896,780,608,172,4,4,7,6,1,105,92,13,0
2021,New Forest 021B,E01022988,640,346,195,151,10,10,165,133,32,119,109,10,0
2021,New Forest 015A,E01022989,726,582,405,177,3,3,83,51,32,56,46,10,2
2021,New Forest 017A,E01022990,620,469,318,151,0,0,65,37,28,86,57,29,0
2021,New Forest 015B,E01022991,902,787,522,265,2,2,9,5,4,104,83,21,0
2021,New Forest 007A,E01022992,485,432,280,152,0,0,3,3,0,50,38,12,0
2021,New Forest 007B,E01022993,551,433,302,131,2,2,32,13,19,84,51,33,0
2021,New Forest 016A,E01022994,679,594,418,176,3,3,37,18,19,45,36,9,0
2021,New Forest 016B,E01022995,582,517,306,211,1,1,15,8,7,49,42,7,0
2021,New Forest 016C,E01022996,513,380,235,145,3,3,62,46,16,68,55,13,0
2021,New Forest 016D,E01022997,561,430,287,143,2,2,58,42,16,71,39,32,0
2021,New Forest 015C,E01022998,677,600,395,205,2,2,11,2,9,64,39,25,0
2021,New Forest 017B,E01022999,906,551,384,167,2,2,83,51,32,270,190,80,0
2021,New Forest 015D,E01023000,795,539,391,148,7,7,118,75,43,129,113,16,2
2021,New Forest 019A,E01023001,955,622,366,256,5,5,62,23,39,266,250,16,0
2021,New Forest 019B,E01023002,780,453,272,181,17,17,182,165,17,126,107,19,2
2021,New Forest 011A,E01023003,766,608,404,204,7,7,90,29,61,60,49,11,1
2021,New Forest 011B,E01023004,706,607,322,285,1,1,50,37,13,48,34,14,0
2021,New Forest 011C,E01023005,630,592,364,228,0,0,8,4,4,30,22,8,0
2021,New Forest 011D,E01023006,492,199,92,107,0,0,254,199,55,37,31,6,2
2021,New Forest 008A,E01023007,495,417,281,136,6,6,33,21,12,39,30,9,0
2021,New Forest 009A,E01023008,884,631,492,139,7,7,85,43,42,159,135,24,2
2021,New Forest 009B,E01023009,639,514,245,269,5,5,24,2,22,96,86,10,0
2021,New Forest 008B,E01023010,629,352,163,189,7,7,147,56,91,123,106,17,0
2021,New Forest 001A,E01023011,631,408,249,159,1,1,88,58,30,134,93,41,0
2021,New Forest 001B,E01023012,596,419,292,127,1,1,44,23,21,132,112,20,0
2021,New Forest 014A,E01023013,630,500,287,213,5,5,66,18,48,58,44,14,1
2021,New Forest 014B,E01023014,752,600,399,201,17,17,49,8,41,86,77,9,0
2021,New Forest 014C,E01023015,594,428,264,164,3,3,52,50,2,111,74,37,0
2021,New Forest 014D,E01023016,622,581,410,171,1,1,2,0,2,38,32,6,0
2021,New Forest 020A,E01023017,808,542,343,199,17,17,191,71,120,58,50,8,0
2021,New Forest 020B,E01023018,691,401,290,111,3,3,211,188,23,75,63,12,1
2021,New Forest 020C,E01023019,668,383,187,196,4,4,138,112,26,141,131,10,2
2021,New Forest 018C,E01023020,629,575,393,182,1,1,5,3,2,48,44,4,0
2021,New Forest 001C,E01023021,623,543,348,195,0,0,17,11,6,63,52,11,0
2021,New Forest 001D,E01023022,953,524,322,202,10,10,162,48,114,257,229,28,0
2021,New Forest 001E,E01023023,754,489,301,188,3,3,172,137,35,87,73,14,3
2021,New Forest 001F,E01023024,720,617,355,262,2,2,17,1,16,84,63,21,0
2021,New Forest 001G,E01023025,585,522,376,146,0,0,5,2,3,58,34,24,0
2021,New Forest 010A,E01023026,474,384,237,147,2,2,12,2,10,76,51,25,0
2021,New Forest 014E,E01023027,606,423,247,176,4,4,103,42,61,76,65,11,0
2021,New Forest 011E,E01023028,853,567,313,254,5,5,135,71,64,145,82,63,1
2021,New Forest 013A,E01023029,634,139,73,66,6,6,456,157,299,30,25,5,3
2021,New Forest 013B,E01023030,510,394,187,207,4,4,21,3,18,91,77,14,0
2021,New Forest 014F,E01023031,541,426,260,166,1,1,10,6,4,104,92,12,0
2021,New Forest 013C,E01023032,560,484,293,191,3,3,31,7,24,42,34,8,0
2021,New Forest 013D,E01023033,527,318,159,159,1,1,142,110,32,66,52,14,0
2021,New Forest 018D,E01023034,810,646,420,226,9,9,80,28,52,75,59,16,0
2021,New Forest 018E,E01023035,755,635,404,231,2,2,33,18,15,84,67,17,1
2021,New Forest 018F,E01023036,932,839,628,211,4,4,29,2,27,60,42,18,0
2021,New Forest 011F,E01023037,924,477,280,197,20,20,315,172,143,112,104,8,0
2021,New Forest 009C,E01023038,631,567,356,211,0,0,5,2,3,59,48,11,0
2021,New Forest 009D,E01023039,644,482,317,165,1,1,72,41,31,88,73,15,1
2021,New Forest 009E,E01023040,654,586,414,172,0,0,6,4,2,62,56,6,0
2021,New Forest 017C,E01023041,768,583,434,149,3,3,66,56,10,115,104,11,1
2021,New Forest 017D,E01023042,952,509,398,111,11,11,126,90,36,304,265,39,2
2021,New Forest 017E,E01023043,827,601,422,179,2,2,23,18,5,201,178,23,0
2021,New Forest 023A,E01023044,540,500,394,106,0,0,7,3,4,33,28,5,0
2021,New Forest 007C,E01023045,707,601,386,215,2,2,18,9,9,86,70,16,0
2021,New Forest 007D,E01023046,665,400,260,140,2,2,120,81,39,143,117,26,0
2021,New Forest 008C,E01023047,534,436,222,214,1,1,8,4,4,89,77,12,0
2021,New Forest 008D,E01023048,513,416,241,175,1,1,65,45,20,31,25,6,0
2021,New Forest 008E,E01023049,669,419,171,248,0,0,65,6,59,185,145,40,0
2021,New Forest 008F,E01023050,680,400,190,210,11,11,77,8,69,192,95,97,0
2021,New Forest 023B,E01023051,663,518,369,149,11,11,56,48,8,77,61,16,1
2021,New Forest 023C,E01023052,923,784,638,146,2,2,21,10,11,116,98,18,0
2021,New Forest 023D,E01023053,836,693,534,159,4,4,18,11,7,121,101,20,0
2021,New Forest 021C,E01023054,862,633,450,183,6,6,49,17,32,174,153,21,0
2021,New Forest 020D,E01023055,511,245,125,120,2,2,223,194,29,41,29,12,0
2021,New Forest 021D,E01023056,796,576,406,170,5,5,72,11,61,143,128,15,0
2021,New Forest 021E,E01023057,894,520,364,156,3,3,63,19,44,308,275,33,0
2021,New Forest 019C,E01023058,620,264,160,104,3,3,303,252,51,48,41,7,2
2021,New Forest 023E,E01023059,788,626,434,192,3,3,43,32,11,116,93,23,0
2021,New Forest 019D,E01023060,651,553,351,202,15,15,19,9,10,64,58,6,0
2021,New Forest 019E,E01023061,665,359,218,141,4,4,204,182,22,90,82,8,8
2021,New Forest 010B,E01023062,567,491,297,194,1,1,29,27,2,46,44,2,0
2021,New Forest 016E,E01023063,550,398,203,195,15,15,29,18,11,108,94,14,0
2021,New Forest 010C,E01023064,538,410,216,194,2,2,29,4,25,97,80,17,0
2021,New Forest 012A,E01023065,659,473,291,182,2,2,121,111,10,63,54,9,0
2021,New Forest 010D,E01023066,715,591,367,224,7,7,60,35,25,56,41,15,1
2021,New Forest 010E,E01023067,605,527,315,212,4,4,5,5,0,69,61,8,0
2021,New Forest 012B,E01023068,522,311,160,151,0,0,155,132,23,53,45,8,3
2021,New Forest 012C,E01023069,835,600,319,281,33,33,86,49,37,116,95,21,0
2021,New Forest 012D,E01023070,993,538,373,165,3,3,112,35,77,340,306,34,0
2021,New Forest 012E,E01023071,686,414,209,205,22,22,41,26,15,208,191,17,1
2021,New Forest 005A,E01023072,546,442,200,242,2,2,10,5,5,92,84,8,0
2021,New Forest 003A,E01023073,506,438,222,216,1,1,2,2,0,65,57,8,0
2021,New Forest 004A,E01023074,633,516,331,185,4,4,28,7,21,85,72,13,0
2021,New Forest 005B,E01023075,571,397,219,178,0,0,101,10,91,73,61,12,0
2021,New Forest 002A,E01023076,627,550,376,174,3,3,18,13,5,55,45,10,1
2021,New Forest 004B,E01023077,830,406,191,215,11,11,174,69,105,239,211,28,0
2021,New Forest 004C,E01023078,651,559,359,200,1,1,48,8,40,43,36,7,0
2021,New Forest 004D,E01023079,715,509,233,276,9,9,105,83,22,92,80,12,0
2021,New Forest 003B,E01023080,556,406,224,182,7,7,52,20,32,91,83,8,0
2021,New Forest 003C,E01023081,759,545,223,322,15,15,129,29,100,70,61,9,0
2021,New Forest 002B,E01023082,604,426,219,207,3,3,66,43,23,109,97,12,0
2021,New Forest 002C,E01023083,665,339,172,167,3,3,228,187,41,92,83,9,3
2021,New Forest 005C,E01023084,617,548,296,252,2,2,19,16,3,48,41,7,0
2021,New Forest 004E,E01023085,626,368,176,192,2,2,172,110,62,84,75,9,0
2021,New Forest 005D,E01023086,641,484,272,212,1,1,114,104,10,42,33,9,0
2021,New Forest 005E,E01023087,615,460,167,293,3,3,16,6,10,136,126,10,0
2021,New Forest 002D,E01023088,610,372,176,196,1,1,179,163,16,52,43,9,6
2021,New Forest 003D,E01023089,703,545,297,248,3,3,22,18,4,133,123,10,0
2021,New Forest 003E,E01023090,812,568,263,305,2,2,64,8,56,178,161,17,0
2021,Rushmoor 006A,E01023091,701,241,85,156,24,24,334,51,283,102,77,25,0
2021,Rushmoor 005A,E01023092,569,492,202,290,8,8,10,1,9,59,47,12,0
2021,Rushmoor 005B,E01023093,523,457,221,236,0,0,10,1,9,56,47,9,0
2021,Rushmoor 006B,E01023094,557,451,220,231,9,9,21,5,16,76,63,13,0
2021,Rushmoor 006C,E01023095,817,484,185,299,9,9,155,17,138,169,152,17,0
2021,Rushmoor 004A,E01023096,1014,655,315,340,36,36,69,5,64,254,236,18,0
2021,Rushmoor 004B,E01023097,620,479,248,231,2,2,13,3,10,126,104,22,0
2021,Rushmoor 006D,E01023098,740,497,251,246,5,5,54,4,50,184,168,16,0
2021,Rushmoor 001A,E01023099,608,368,179,189,9,9,166,28,138,65,47,18,0
2021,Rushmoor 003A,E01023100,485,349,114,235,6,6,56,4,52,74,64,10,0
2021,Rushmoor 003B,E01023101,488,432,236,196,2,2,10,2,8,44,37,7,0
2021,Rushmoor 003C,E01023102,572,493,248,245,6,6,26,1,25,47,41,6,0
2021,Rushmoor 004C,E01023103,623,512,240,272,3,3,29,5,24,79,64,15,0
2021,Rushmoor 001B,E01023104,599,337,135,202,5,5,166,38,128,89,68,21,2
2021,Rushmoor 002A,E01023105,608,255,87,168,18,18,260,30,230,74,59,15,1
2021,Rushmoor 001C,E01023106,572,311,144,167,5,5,177,31,146,79,67,12,0
2021,Rushmoor 012A,E01023107,636,292,136,156,4,4,278,65,213,58,47,11,4
2021,Rushmoor 012B,E01023108,623,220,98,122,2,2,361,56,305,38,28,10,2
2021,Rushmoor 011A,E01023109,595,466,199,267,3,3,4,1,3,122,104,18,0
2021,Rushmoor 012C,E01023110,714,422,157,265,3,3,202,47,155,84,77,7,3
2021,Rushmoor 004D,E01023111,777,531,293,238,39,39,86,4,82,121,109,12,0
2021,Rushmoor 004E,E01023112,470,409,182,227,3,3,15,0,15,43,36,7,0
2021,Rushmoor 007A,E01023113,852,508,243,265,19,19,69,6,63,256,234,22,0
2021,Rushmoor 007B,E01023114,543,417,153,264,7,7,38,2,36,81,76,5,0
2021,Rushmoor 011B,E01023115,529,423,192,231,3,3,40,1,39,63,50,13,0
2021,Rushmoor 011C,E01023116,758,494,179,315,1,1,34,4,30,229,206,23,0
2021,Rushmoor 011D,E01023117,681,583,287,296,2,2,17,0,17,79,68,11,0
2021,Rushmoor 009A,E01023118,736,412,148,264,2,2,92,11,81,230,203,27,0
2021,Rushmoor 002B,E01023119,463,125,58,67,3,3,298,62,236,35,30,5,2
2021,Rushmoor 002C,E01023120,606,316,106,210,0,0,202,26,176,87,68,19,1
2021,Rushmoor 001D,E01023121,766,518,226,292,4,4,183,23,160,61,47,14,0
2021,Rushmoor 002D,E01023122,502,273,102,171,4,4,140,26,114,85,69,16,0
2021,Rushmoor 012D,E01023123,588,442,179,263,5,5,24,4,20,117,94,23,0
2021,Rushmoor 009B,E01023124,501,364,123,241,1,1,30,6,24,106,96,10,0
2021,Rushmoor 009C,E01023125,942,674,268,406,20,20,119,10,109,129,114,15,0
2021,Rushmoor 010A,E01023128,602,391,186,205,1,1,118,18,100,90,78,12,2
2021,Rushmoor 010B,E01023129,574,350,142,208,2,2,50,6,44,172,155,17,0
2021,Rushmoor 010C,E01023130,556,481,244,237,0,0,28,4,24,46,35,11,1
2021,Rushmoor 010D,E01023131,595,397,193,204,0,0,100,8,92,98,90,8,0
2021,Rushmoor 005C,E01023132,615,445,217,228,14,14,92,12,80,64,41,23,0
2021,Rushmoor 005D,E01023133,517,405,159,246,8,8,17,0,17,87,76,11,0
2021,Rushmoor 003D,E01023134,698,539,209,330,9,9,28,3,25,122,107,15,0
2021,Rushmoor 005E,E01023135,950,617,260,357,28,28,159,21,138,146,87,59,0
2021,Rushmoor 007C,E01023136,1075,572,137,435,46,46,102,16,86,355,227,128,0
2021,Rushmoor 007D,E01023137,554,378,136,242,0,0,47,5,42,129,121,8,0
2021,Rushmoor 007E,E01023138,717,377,137,240,5,5,107,15,92,228,204,24,0
2021,Rushmoor 007F,E01023139,530,309,117,192,4,4,138,9,129,78,69,9,1
2021,Rushmoor 007G,E01023140,656,105,37,68,5,5,155,24,131,388,184,204,3
2021,Rushmoor 008A,E01023141,626,98,12,86,14,14,94,13,81,420,100,320,0
2021,Rushmoor 008D,E01023144,772,292,111,181,4,4,64,9,55,412,382,30,0
2021,Rushmoor 010E,E01023145,1097,427,173,254,18,18,180,21,159,471,438,33,1
2021,Rushmoor 002E,E01023146,474,271,91,180,2,2,146,16,130,55,43,12,0
2021,Rushmoor 003E,E01023147,572,479,260,219,1,1,33,5,28,59,50,9,0
2021,Rushmoor 006E,E01023148,585,453,245,208,3,3,32,0,32,97,86,11,0
2021,Rushmoor 006F,E01023149,526,454,228,226,3,3,19,3,16,50,36,14,0
2021,Test Valley 011A,E01023150,849,558,363,195,8,8,119,39,80,164,151,13,0
2021,Test Valley 011B,E01023151,738,347,267,80,2,2,213,71,142,175,150,25,1
2021,Test Valley 011C,E01023152,926,623,476,147,4,4,120,30,90,179,152,27,0
2021,Test Valley 002A,E01023153,779,363,152,211,9,9,238,75,163,168,154,14,1
2021,Test Valley 002B,E01023154,629,253,100,153,7,7,309,85,224,58,45,13,2
2021,Test Valley 002C,E01023156,471,144,57,87,2,2,238,81,157,86,80,6,1
2021,Test Valley 002D,E01023157,520,241,102,139,5,5,217,74,143,56,51,5,1
2021,Test Valley 012A,E01023158,1003,832,526,306,17,17,33,3,30,121,101,20,0
2021,Test Valley 007A,E01023159,975,714,406,308,22,22,112,37,75,125,101,24,2
2021,Test Valley 008A,E01023160,589,490,323,167,2,2,31,8,23,65,51,14,1
2021,Test Valley 013A,E01023162,717,577,360,217,9,9,45,11,34,86,60,26,0
2021,Test Valley 013B,E01023163,673,607,388,219,1,1,3,1,2,62,49,13,0
2021,Test Valley 013C,E01023164,664,509,319,190,5,5,87,22,65,63,39,24,0
2021,Test Valley 001A,E01023165,878,607,335,272,4,4,98,20,78,169,127,42,0
2021,Test Valley 009A,E01023166,692,489,299,190,18,18,87,26,61,98,79,19,0
2021,Test Valley 009B,E01023167,696,475,312,163,3,3,83,22,61,135,81,54,0
2021,Test Valley 008B,E01023168,655,512,342,170,0,0,48,6,42,94,64,30,1
2021,Test Valley 001B,E01023169,927,749,450,299,30,30,55,15,40,92,77,15,1
2021,Test Valley 015A,E01023170,1089,729,330,399,54,54,156,39,117,150,124,26,0
2021,Test Valley 015B,E01023171,646,549,290,259,5,5,28,5,23,64,47,17,0
2021,Test Valley 015C,E01023172,611,552,337,215,5,5,14,4,10,40,31,9,0
2021,Test Valley 015D,E01023173,587,532,319,213,1,1,5,2,3,49,43,6,0
2021,Test Valley 010A,E01023174,724,579,301,278,9,9,22,3,19,114,103,11,0
2021,Test Valley 010B,E01023175,701,624,432,192,5,5,15,3,12,57,47,10,0
2021,Test Valley 010C,E01023176,725,479,308,171,2,2,129,40,89,113,108,5,2
2021,Test Valley 009C,E01023177,910,594,344,250,4,4,149,18,131,163,113,50,0
2021,Test Valley 008C,E01023178,953,619,340,279,6,6,111,29,82,217,137,80,0
2021,Test Valley 004A,E01023179,753,445,205,240,19,19,178,61,117,111,101,10,0
2021,Test Valley 005B,E01023180,715,544,344,200,0,0,47,11,36,124,64,60,0
2021,Test Valley 001C,E01023181,508,403,166,237,0,0,36,3,33,68,61,7,1
2021,Test Valley 001D,E01023182,636,463,188,275,6,6,78,13,65,89,76,13,0
2021,Test Valley 004B,E01023183,578,350,156,194,14,14,155,46,109,59,48,11,0
2021,Test Valley 009D,E01023184,558,403,225,178,2,2,16,4,12,137,106,31,0
2021,Test Valley 009E,E01023185,534,361,213,148,7,7,128,31,97,38,28,10,0
2021,Test Valley 005C,E01023186,725,493,252,241,3,3,123,31,92,106,92,14,0
2021,Test Valley 006A,E01023187,652,471,239,232,7,7,15,3,12,159,141,18,0
2021,Test Valley 006B,E01023188,506,417,191,226,0,0,24,4,20,65,58,7,0
2021,Test Valley 005D,E01023189,628,412,213,199,5,5,30,8,22,181,68,113,0
2021,Test Valley 004C,E01023190,577,381,212,169,1,1,96,7,89,98,83,15,1
2021,Test Valley 012B,E01023191,766,602,291,311,6,6,50,7,43,108,93,15,0
2021,Test Valley 012C,E01023192,824,432,228,204,8,8,305,92,213,76,69,7,3
2021,Test Valley 012D,E01023193,780,664,376,288,9,9,51,5,46,56,47,9,0
2021,Test Valley 012E,E01023194,637,581,378,203,3,3,8,2,6,45,34,11,0
2021,Test Valley 007B,E01023195,755,384,217,167,21,21,83,20,63,267,57,210,0
2021,Test Valley 005E,E01023196,710,518,294,224,3,3,79,22,57,110,84,26,0
2021,Test Valley 007C,E01023197,598,381,211,170,0,0,74,16,58,143,57,86,0
2021,Test Valley 007D,E01023198,619,459,246,213,2,2,68,24,44,90,72,18,0
2021,Test Valley 012F,E01023200,621,522,314,208,7,7,10,1,9,82,69,13,0
2021,Test Valley 018A,E01023202,1103,343,209,134,11,11,403,107,296,343,306,37,3
2021,Test Valley 004D,E01023203,658,505,284,221,8,8,71,26,45,73,64,9,1
2021,Test Valley 004E,E01023204,752,324,130,194,17,17,195,65,130,216,196,20,0
2021,Test Valley 002E,E01023205,464,244,91,153,5,5,160,55,105,55,48,7,0
2021,Test Valley 011D,E01023206,531,388,284,104,0,0,91,26,65,51,44,7,1
2021,Test Valley 010D,E01023207,694,604,363,241,7,7,27,3,24,56,42,14,0
2021,Test Valley 010E,E01023208,466,312,161,151,5,5,96,28,68,53,47,6,0
2021,Test Valley 010F,E01023209,545,479,276,203,3,3,5,2,3,58,49,9,0
2021,Test Valley 014A,E01023210,535,482,228,254,0,0,1,0,1,52,48,4,0
2021,Test Valley 014B,E01023211,679,485,157,328,1,1,70,2,68,123,115,8,0
2021,Test Valley 014C,E01023212,591,529,311,218,1,1,6,3,3,55,53,2,0
2021,Test Valley 014D,E01023213,500,418,211,207,2,2,23,2,21,57,52,5,0
2021,Test Valley 014E,E01023214,521,445,214,231,1,1,7,1,6,68,57,11,0
2021,Test Valley 018C,E01023215,725,494,257,237,5,5,117,35,82,109,77,32,0
2021,Test Valley 006C,E01023216,869,440,249,191,8,8,173,45,128,247,227,20,1
2021,Test Valley 006D,E01023217,714,588,291,297,2,2,14,1,13,110,99,11,0
2021,Test Valley 006E,E01023218,635,566,327,239,1,1,17,5,12,51,44,7,0
2021,Test Valley 018B,E01023219,632,380,218,162,4,4,194,58,136,53,45,8,1
2021,Winchester 012A,E01023220,877,668,325,343,6,6,43,22,21,160,132,28,0
2021,Winchester 012B,E01023221,917,598,379,219,6,6,178,101,77,133,119,14,2
2021,Winchester 012C,E01023222,679,567,366,201,3,3,13,2,11,95,73,22,1
2021,Winchester 012D,E01023223,673,409,246,163,9,9,207,134,73,47,42,5,1
2021,Winchester 004A,E01023225,893,585,344,241,3,3,74,48,26,231,183,48,0
2021,Winchester 010A,E01023226,683,500,255,245,5,5,91,67,24,87,71,16,0
2021,Winchester 010B,E01023227,870,554,298,256,4,4,205,141,64,107,94,13,0
2021,Winchester 010C,E01023228,962,831,497,334,19,19,45,15,30,67,57,10,0
2021,Winchester 009A,E01023229,823,586,347,239,4,4,103,102,1,130,102,28,0
2021,Winchester 010D,E01023230,826,715,381,334,11,11,10,8,2,90,72,18,0
2021,Winchester 014B,E01023231,764,667,380,287,4,4,22,2,20,71,61,10,0
2021,Winchester 014C,E01023232,1097,821,380,441,39,39,102,21,81,135,120,15,0
2021,Winchester 014D,E01023233,772,623,350,273,17,17,50,9,41,82,64,18,0
2021,Winchester 014E,E01023234,693,434,236,198,0,0,191,141,50,68,59,9,0
2021,Winchester 011A,E01023235,895,662,408,254,3,3,88,52,36,142,103,39,0
2021,Winchester 002A,E01023236,819,581,350,231,2,2,67,56,11,169,131,38,0
2021,Winchester 002B,E01023237,648,302,149,153,14,14,276,216,60,53,45,8,3
2021,Winchester 002C,E01023238,639,513,280,233,19,19,39,8,31,68,54,14,0
2021,Winchester 002D,E01023239,688,569,302,267,3,3,39,22,17,77,71,6,0
2021,Winchester 003A,E01023240,869,667,390,277,6,6,54,8,46,142,75,67,0
2021,Winchester 003B,E01023241,544,456,276,180,2,2,29,13,16,57,43,14,0
2021,Winchester 009B,E01023242,490,395,212,183,3,3,1,0,1,91,84,7,0
2021,Winchester 009C,E01023243,595,371,193,178,5,5,11,4,7,208,199,9,0
2021,Winchester 009D,E01023244,664,606,402,204,2,2,15,7,8,41,33,8,0
2021,Winchester 013A,E01023245,1081,845,439,406,20,20,96,51,45,117,82,35,3
2021,Winchester 010E,E01023246,623,467,260,207,2,2,56,45,11,98,61,37,0
2021,Winchester 005A,E01023247,678,520,302,218,5,5,92,54,38,60,54,6,1
2021,Winchester 003C,E01023248,689,630,372,258,0,0,14,2,12,45,35,10,0
2021,Winchester 005B,E01023249,566,362,179,183,2,2,141,68,73,60,54,6,1
2021,Winchester 005C,E01023250,697,328,172,156,5,5,276,252,24,85,73,12,3
2021,Winchester 006A,E01023251,653,196,104,92,4,4,277,233,44,173,158,15,3
2021,Winchester 007A,E01023252,1048,379,225,154,22,22,202,66,136,445,413,32,0
2021,Winchester 003D,E01023253,824,541,309,232,14,14,142,108,34,125,115,10,2
2021,Winchester 007B,E01023254,856,472,237,235,6,6,158,96,62,219,196,23,1
2021,Winchester 006B,E01023255,738,284,135,149,16,16,290,212,78,147,135,12,1
2021,Winchester 006C,E01023256,640,154,81,73,7,7,370,266,104,106,100,6,3
2021,Winchester 006D,E01023257,747,356,188,168,6,6,274,232,42,111,99,12,0
2021,Winchester 006E,E01023258,566,254,155,99,3,3,213,176,37,92,77,15,4
2021,Winchester 009E,E01023259,758,477,241,236,25,25,149,69,80,105,96,9,2
2021,Winchester 008A,E01023260,494,65,28,37,1,1,316,245,71,112,107,5,0
2021,Winchester 008B,E01023261,645,164,83,81,3,3,334,279,55,138,130,8,6
2021,Winchester 008C,E01023262,501,126,75,51,1,1,217,199,18,156,143,13,1
2021,Winchester 007C,E01023263,687,426,302,124,6,6,63,12,51,192,165,27,0
2021,Winchester 007D,E01023264,695,255,173,82,1,1,121,43,78,318,226,92,0
2021,Winchester 007E,E01023265,824,481,266,215,5,5,156,72,84,182,159,23,0
2021,Winchester 008D,E01023266,588,305,186,119,7,7,131,21,110,145,130,15,0
2021,Winchester 007F,E01023267,546,308,137,171,0,0,58,11,47,180,159,21,0
2021,Winchester 005D,E01023268,476,351,162,189,2,2,19,16,3,103,95,8,1
2021,Winchester 005E,E01023269,732,489,288,201,20,20,36,9,27,187,172,15,0
2021,Winchester 005F,E01023270,458,286,134,152,1,1,95,14,81,76,66,10,0
2021,Winchester 013B,E01023271,501,363,213,150,6,6,60,33,27,70,47,23,2
2021,Winchester 012E,E01023272,673,545,268,277,13,13,46,6,40,69,61,8,0
2021,Winchester 012F,E01023273,666,564,301,263,12,12,35,13,22,54,46,8,1
2021,Winchester 003E,E01023274,973,656,323,333,55,55,129,54,75,132,94,38,1
2021,Winchester 011B,E01023275,671,490,252,238,11,11,99,74,25,69,54,15,2
2021,Winchester 011C,E01023276,689,582,324,258,12,12,51,13,38,41,32,9,3
2021,Winchester 011D,E01023277,504,436,254,182,5,5,16,4,12,47,26,21,0
2021,Winchester 004B,E01023278,728,560,374,186,4,4,67,41,26,96,74,22,1
2021,Winchester 004C,E01023279,621,534,321,213,0,0,16,15,1,70,64,6,1
2021,Winchester 004D,E01023280,602,420,240,180,7,7,74,43,31,101,75,26,0
2021,Winchester 004E,E01023281,913,558,392,166,9,9,186,163,23,156,138,18,4
2021,Winchester 011E,E01023282,903,640,385,255,8,8,105,57,48,150,114,36,0
2021,Winchester 013E,E01023285,731,402,242,160,11,11,222,183,39,90,78,12,6
2021,Winchester 001A,E01023286,651,399,212,187,20,20,113,47,66,119,101,18,0
2021,Winchester 001B,E01023287,1128,816,429,387,11,11,36,13,23,265,52,213,0
2021,Winchester 001C,E01023288,621,417,198,219,19,19,70,44,26,115,99,16,0
2021,Broxbourne 004A,E01023289,527,506,256,250,2,2,5,1,4,14,13,1,0
2021,Broxbourne 004B,E01023290,623,518,286,232,2,2,52,5,47,50,44,6,1
2021,Broxbourne 004C,E01023291,661,522,294,228,0,0,21,10,11,118,112,6,0
2021,Broxbourne 004D,E01023292,650,536,300,236,1,1,16,4,12,97,84,13,0
2021,Broxbourne 011A,E01023293,670,531,259,272,3,3,72,16,56,64,48,16,0
2021,Broxbourne 011B,E01023294,827,453,160,293,1,1,291,73,218,80,72,8,2
2021,Broxbourne 011C,E01023295,559,419,190,229,7,7,94,28,66,39,34,5,0
2021,Broxbourne 011D,E01023296,725,473,202,271,7,7,190,43,147,55,48,7,0
2021,Broxbourne 010A,E01023297,502,442,223,219,2,2,5,1,4,53,42,11,0
2021,Broxbourne 010B,E01023298,637,516,306,210,4,4,33,8,25,84,76,8,0
2021,Broxbourne 010C,E01023299,706,514,285,229,1,1,49,32,17,142,126,16,0
2021,Broxbourne 010D,E01023300,677,313,131,182,14,14,173,15,158,177,162,15,0
2021,Broxbourne 010E,E01023301,779,400,179,221,3,3,122,14,108,254,239,15,0
2021,Broxbourne 008A,E01023302,640,374,215,159,3,3,196,48,148,66,57,9,1
2021,Broxbourne 008B,E01023303,642,406,169,237,2,2,130,19,111,103,95,8,1
2021,Broxbourne 008C,E01023304,646,459,239,220,3,3,111,27,84,73,69,4,0
2021,Broxbourne 008D,E01023305,522,420,176,244,1,1,20,12,8,81,72,9,0
2021,Broxbourne 008E,E01023306,603,484,234,250,2,2,51,16,35,66,59,7,0
2021,Broxbourne 006A,E01023307,540,468,244,224,5,5,23,4,19,44,28,16,0
2021,Broxbourne 006B,E01023308,624,570,307,263,1,1,12,1,11,41,35,6,0
2021,Broxbourne 006C,E01023309,613,572,304,268,1,1,7,1,6,33,29,4,0
2021,Broxbourne 006D,E01023310,1154,630,204,426,2,2,316,209,107,202,192,10,4
2021,Broxbourne 007A,E01023311,735,577,307,270,6,6,64,13,51,88,76,12,0
2021,Broxbourne 007B,E01023312,589,476,229,247,41,41,31,8,23,41,39,2,0
2021,Broxbourne 007C,E01023313,631,583,345,238,0,0,14,1,13,34,27,7,0
2021,Broxbourne 009A,E01023314,601,489,223,266,10,10,55,8,47,47,42,5,0
2021,Broxbourne 007D,E01023315,620,532,188,344,7,7,32,1,31,49,43,6,0
2021,Broxbourne 001A,E01023316,517,471,254,217,2,2,3,0,3,41,36,5,0
2021,Broxbourne 001B,E01023317,940,706,327,379,9,9,98,11,87,126,113,13,1
2021,Broxbourne 001C,E01023318,612,525,278,247,2,2,15,3,12,70,62,8,0
2021,Broxbourne 001D,E01023319,628,556,344,212,2,2,38,6,32,32,30,2,0
2021,Broxbourne 003A,E01023320,1095,552,305,247,15,15,84,14,70,444,426,18,0
2021,Broxbourne 003B,E01023321,891,723,414,309,2,2,46,4,42,120,110,10,0
2021,Broxbourne 003C,E01023322,807,522,198,324,1,1,121,25,96,163,151,12,0
2021,Broxbourne 003D,E01023323,837,332,150,182,3,3,310,61,249,192,181,11,0
2021,Broxbourne 009B,E01023324,519,384,172,212,25,25,78,23,55,32,28,4,0
2021,Broxbourne 009C,E01023325,638,467,237,230,9,9,75,17,58,87,78,9,0
2021,Broxbourne 009D,E01023326,671,402,208,194,6,6,194,40,154,69,58,11,0
2021,Broxbourne 002A,E01023327,518,384,187,197,0,0,45,13,32,89,84,5,0
2021,Broxbourne 002B,E01023328,515,382,145,237,6,6,67,7,60,60,55,5,0
2021,Broxbourne 002C,E01023329,513,392,206,186,0,0,74,14,60,45,42,3,2
2021,Broxbourne 002D,E01023330,705,410,161,249,23,23,138,18,120,133,121,12,1
2021,Broxbourne 002E,E01023331,634,432,187,245,0,0,121,19,102,80,70,10,1
2021,Broxbourne 012A,E01023332,1019,631,343,288,15,15,72,12,60,300,275,25,1
2021,Broxbourne 012B,E01023333,868,424,180,244,8,8,183,73,110,252,240,12,1
2021,Broxbourne 012C,E01023334,721,567,335,232,7,7,20,3,17,127,109,18,0
2021,Broxbourne 012D,E01023335,668,555,258,297,2,2,20,2,18,91,82,9,0
2021,Broxbourne 013A,E01023336,830,464,180,284,29,29,121,29,92,216,201,15,0
2021,Broxbourne 013B,E01023337,811,461,213,248,11,11,81,32,49,258,234,24,0
2021,Broxbourne 013D,E01023339,616,253,103,150,18,18,251,96,155,93,78,15,1
2021,Broxbourne 005A,E01023340,748,501,230,271,3,3,72,14,58,172,163,9,0
2021,Broxbourne 005B,E01023341,713,561,279,282,1,1,69,16,53,81,71,10,1
2021,Broxbourne 005D,E01023343,827,368,117,251,4,4,330,72,258,125,114,11,0
2021,Broxbourne 005E,E01023344,747,561,287,274,17,17,59,13,46,110,101,9,0
2021,Dacorum 013A,E01023345,830,461,191,270,2,2,234,109,125,133,126,7,0
2021,Dacorum 013B,E01023346,1027,483,162,321,26,26,427,180,247,90,76,14,1
2021,Dacorum 013C,E01023347,531,364,209,155,2,2,102,98,4,61,57,4,2
2021,Dacorum 013D,E01023348,675,220,79,141,0,0,364,337,27,88,74,14,3
2021,Dacorum 015A,E01023349,785,375,171,204,4,4,319,272,47,85,77,8,2
2021,Dacorum 015B,E01023350,707,365,136,229,8,8,280,252,28,53,50,3,1
2021,Dacorum 015C,E01023351,676,484,222,262,3,3,98,98,0,91,83,8,0
2021,Dacorum 004A,E01023352,1019,804,468,336,6,6,106,92,14,101,89,12,2
2021,Dacorum 018B,E01023354,960,762,272,490,22,22,46,17,29,130,116,14,0
2021,Dacorum 006A,E01023355,632,506,293,213,0,0,78,67,11,47,38,9,1
2021,Dacorum 006B,E01023356,449,361,212,149,2,2,45,41,4,40,23,17,1
2021,Dacorum 020A,E01023357,646,297,131,166,0,0,281,255,26,65,60,5,3
2021,Dacorum 020B,E01023358,526,242,96,146,2,2,209,187,22,70,62,8,3
2021,Dacorum 020C,E01023359,663,352,125,227,11,11,240,200,40,60,49,11,0
2021,Dacorum 020D,E01023360,554,384,170,214,6,6,97,44,53,67,61,6,0
2021,Dacorum 009A,E01023361,912,480,249,231,0,0,118,44,74,314,270,44,0
2021,Dacorum 009B,E01023362,831,703,428,275,3,3,15,11,4,110,96,14,0
2021,Dacorum 009C,E01023363,643,544,288,256,0,0,11,9,2,88,85,3,0
2021,Dacorum 009D,E01023364,508,469,261,208,1,1,8,5,3,30,25,5,0
2021,Dacorum 014A,E01023365,577,357,212,145,2,2,85,74,11,133,120,13,0
2021,Dacorum 014B,E01023366,652,342,147,195,1,1,238,234,4,68,62,6,3
2021,Dacorum 014C,E01023367,422,396,197,199,0,0,4,4,0,21,18,3,1
2021,Dacorum 014D,E01023368,718,572,260,312,0,0,15,6,9,131,120,11,0
2021,Dacorum 012A,E01023369,647,285,117,168,4,4,314,298,16,41,36,5,3
2021,Dacorum 012B,E01023370,757,487,221,266,20,20,127,67,60,122,103,19,1
2021,Dacorum 012C,E01023371,625,515,239,276,0,0,89,65,24,21,19,2,0
2021,Dacorum 012D,E01023372,542,503,274,229,0,0,7,6,1,32,27,5,0
2021,Dacorum 021A,E01023373,528,381,206,175,3,3,79,52,27,64,53,11,1
2021,Dacorum 021B,E01023374,614,468,252,216,1,1,26,25,1,119,104,15,0
2021,Dacorum 021C,E01023375,645,514,295,219,1,1,86,67,19,44,38,6,0
2021,Dacorum 021D,E01023376,518,325,164,161,0,0,113,83,30,80,75,5,0
2021,Dacorum 021E,E01023377,526,469,283,186,6,6,8,7,1,43,36,7,0
2021,Dacorum 021F,E01023378,645,593,313,280,4,4,3,0,3,45,38,7,0
2021,Dacorum 018C,E01023379,704,556,260,296,0,0,45,24,21,103,91,12,0
2021,Dacorum 018D,E01023380,506,419,202,217,0,0,20,20,0,67,62,5,0
2021,Dacorum 018E,E01023381,541,485,295,190,1,1,20,12,8,35,27,8,0
2021,Dacorum 018F,E01023382,686,401,191,210,7,7,174,102,72,102,94,8,2
2021,Dacorum 016A,E01023383,608,414,201,213,0,0,109,100,9,82,76,6,3
2021,Dacorum 016B,E01023384,770,419,177,242,0,0,261,251,10,88,78,10,2
2021,Dacorum 016C,E01023385,664,462,246,216,1,1,146,142,4,54,46,8,1
2021,Dacorum 019A,E01023386,602,302,119,183,2,2,220,189,31,77,72,5,1
2021,Dacorum 019B,E01023387,503,255,124,131,5,5,196,70,126,47,43,4,0
2021,Dacorum 019C,E01023388,633,419,197,222,0,0,105,85,20,108,101,7,1
2021,Dacorum 019D,E01023389,659,517,256,261,2,2,66,56,10,73,60,13,1
2021,Dacorum 010A,E01023390,849,497,207,290,3,3,245,228,17,102,91,11,2
2021,Dacorum 010B,E01023391,684,458,214,244,1,1,133,101,32,91,81,10,1
2021,Dacorum 011A,E01023392,635,354,144,210,0,0,227,184,43,52,48,4,2
2021,Dacorum 007A,E01023393,823,333,135,198,0,0,350,283,67,136,130,6,4
2021,Dacorum 007B,E01023394,518,332,170,162,3,3,106,76,30,75,70,5,2
2021,Dacorum 007C,E01023395,640,332,149,183,2,2,182,153,29,124,114,10,0
2021,Dacorum 007D,E01023396,596,392,202,190,3,3,129,110,19,72,66,6,0
2021,Dacorum 007E,E01023397,524,203,74,129,1,1,295,65,230,25,20,5,0
2021,Dacorum 010C,E01023399,880,475,235,240,0,0,190,155,35,214,194,20,1
2021,Dacorum 015E,E01023400,1023,491,229,262,4,4,286,103,183,241,222,19,1
2021,Dacorum 008A,E01023401,713,265,101,164,31,31,337,189,148,80,75,5,0
2021,Dacorum 008B,E01023402,671,362,163,199,1,1,191,162,29,116,111,5,1
2021,Dacorum 008C,E01023403,645,293,143,150,15,15,231,189,42,106,97,9,0
2021,Dacorum 008D,E01023404,510,136,43,93,0,0,336,251,85,38,33,5,0
2021,Dacorum 008E,E01023405,623,215,76,139,0,0,334,313,21,73,68,5,1
2021,Dacorum 022A,E01023406,872,551,282,269,3,3,177,155,22,141,124,17,0
2021,Dacorum 022B,E01023407,635,493,241,252,1,1,72,64,8,69,63,6,0
2021,Dacorum 022C,E01023408,618,552,320,232,0,0,25,21,4,41,33,8,0
2021,Dacorum 017A,E01023409,775,490,239,251,9,9,177,136,41,99,89,10,0
2021,Dacorum 017B,E01023410,539,487,326,161,0,0,23,21,2,29,22,7,0
2021,Dacorum 017C,E01023411,588,376,161,215,0,0,159,141,18,53,47,6,0
2021,Dacorum 017D,E01023412,497,467,298,169,0,0,14,12,2,16,14,2,0
2021,Dacorum 017E,E01023413,529,318,146,172,0,0,155,125,30,54,52,2,2
2021,Dacorum 020E,E01023414,1032,613,186,427,13,13,193,127,66,213,200,13,0
2021,Dacorum 020F,E01023415,537,421,218,203,1,1,82,74,8,33,22,11,0
2021,Dacorum 006C,E01023416,652,575,374,201,6,6,7,6,1,64,42,22,0
2021,Dacorum 006D,E01023417,662,447,238,209,1,1,137,76,61,77,67,10,0
2021,Dacorum 003A,E01023418,614,298,126,172,2,2,267,252,15,44,40,4,3
2021,Dacorum 003B,E01023419,833,605,297,308,2,2,102,80,22,123,113,10,1
2021,Dacorum 003C,E01023420,629,489,270,219,0,0,45,34,11,95,82,13,0
2021,Dacorum 004B,E01023421,703,519,262,257,8,8,52,35,17,124,110,14,0
2021,Dacorum 004C,E01023422,515,468,285,183,3,3,5,4,1,39,35,4,0
2021,Dacorum 002A,E01023423,581,472,239,233,3,3,47,41,6,59,50,9,0
2021,Dacorum 002B,E01023424,627,482,251,231,6,6,72,54,18,67,56,11,0
2021,Dacorum 002C,E01023425,535,450,234,216,5,5,36,29,7,44,42,2,0
2021,Dacorum 002D,E01023426,777,483,264,219,2,2,76,51,25,216,198,18,0
2021,Dacorum 011B,E01023427,702,377,158,219,2,2,274,262,12,49,43,6,0
2021,Dacorum 011C,E01023428,615,445,224,221,3,3,45,42,3,122,112,10,0
2021,Dacorum 011D,E01023429,787,342,161,181,0,0,380,365,15,65,56,9,0
2021,Dacorum 001A,E01023430,493,403,214,189,1,1,39,31,8,49,44,5,1
2021,Dacorum 001B,E01023431,511,345,185,160,0,0,89,73,16,76,64,12,1
2021,Dacorum 001C,E01023432,668,524,254,270,12,12,77,57,20,54,48,6,1
2021,Dacorum 001D,E01023433,694,427,157,270,4,4,169,160,9,92,85,7,2
2021,Dacorum 005A,E01023434,677,405,160,245,8,8,108,91,17,156,148,8,0
2021,Dacorum 005B,E01023435,648,391,151,240,1,1,21,6,15,235,225,10,0
2021,Dacorum 005C,E01023436,478,404,198,206,1,1,5,5,0,68,63,5,0
2021,Dacorum 005D,E01023437,623,205,75,130,2,2,309,56,253,106,97,9,1
2021,East Hertfordshire 005A,E01023438,603,383,164,219,2,2,98,9,89,120,111,9,0
2021,East Hertfordshire 005B,E01023439,521,331,183,148,9,9,94,13,81,87,81,6,0
2021,East Hertfordshire 005C,E01023440,687,610,347,263,8,8,17,2,15,52,46,6,0
2021,East Hertfordshire 005D,E01023441,502,310,119,191,2,2,23,2,21,167,157,10,0
2021,East Hertfordshire 005E,E01023442,888,507,228,279,28,28,152,24,128,200,189,11,1
2021,East Hertfordshire 007A,E01023443,614,459,231,228,7,7,52,7,45,96,90,6,0
2021,East Hertfordshire 007B,E01023444,807,526,203,323,15,15,52,5,47,214,199,15,0
2021,East Hertfordshire 007C,E01023445,724,390,195,195,14,14,227,41,186,92,82,10,1
2021,East Hertfordshire 007E,E01023447,522,141,70,71,6,6,340,36,304,34,24,10,1
2021,East Hertfordshire 007F,E01023448,577,430,188,242,2,2,63,5,58,82,72,10,0
2021,East Hertfordshire 004A,E01023449,746,558,297,261,2,2,13,3,10,173,163,10,0
2021,East Hertfordshire 004C,E01023451,970,782,436,346,6,6,20,2,18,162,143,19,0
2021,East Hertfordshire 003A,E01023452,477,383,177,206,34,34,23,0,23,37,37,0,0
2021,East Hertfordshire 003B,E01023453,789,587,246,341,35,35,59,12,47,108,87,21,0
2021,East Hertfordshire 003C,E01023454,875,675,245,430,46,46,78,13,65,76,62,14,0
2021,East Hertfordshire 003D,E01023455,533,411,210,201,9,9,35,1,34,78,71,7,0
2021,East Hertfordshire 008A,E01023456,503,445,218,227,0,0,3,2,1,55,48,7,0
2021,East Hertfordshire 008B,E01023457,602,464,211,253,5,5,13,4,9,120,111,9,0
2021,East Hertfordshire 008C,E01023458,562,412,206,206,2,2,32,4,28,116,110,6,0
2021,East Hertfordshire 008D,E01023459,511,446,253,193,2,2,4,1,3,59,55,4,0
2021,East Hertfordshire 008E,E01023460,546,496,221,275,1,1,2,1,1,47,41,6,0
2021,East Hertfordshire 008F,E01023461,517,469,199,270,6,6,8,0,8,34,30,4,0
2021,East Hertfordshire 001A,E01023462,551,406,220,186,0,0,76,15,61,69,52,17,0
2021,East Hertfordshire 003E,E01023463,549,401,226,175,5,5,77,6,71,66,53,13,0
2021,East Hertfordshire 001C,E01023465,674,537,302,235,6,6,55,5,50,76,60,16,0
2021,East Hertfordshire 001D,E01023466,923,596,309,287,17,17,194,21,173,115,103,12,1
2021,East Hertfordshire 019E,E01023467,986,761,466,295,6,6,133,16,117,86,72,14,0
2021,East Hertfordshire 018A,E01023468,538,440,225,215,7,7,14,0,14,77,64,13,0
2021,East Hertfordshire 018B,E01023469,594,374,196,178,1,1,159,16,143,60,53,7,0
2021,East Hertfordshire 014A,E01023470,906,570,270,300,2,2,81,2,79,253,236,17,0
2021,East Hertfordshire 014B,E01023471,553,473,242,231,0,0,11,4,7,69,58,11,0
2021,East Hertfordshire 014C,E01023472,603,300,130,170,0,0,239,29,210,64,60,4,0
2021,East Hertfordshire 014D,E01023473,693,603,356,247,16,16,26,1,25,48,41,7,0
2021,East Hertfordshire 014E,E01023474,630,541,245,296,1,1,13,1,12,75,71,4,0
2021,East Hertfordshire 017A,E01023475,609,323,145,178,2,2,230,36,194,54,47,7,0
2021,East Hertfordshire 017B,E01023476,724,596,334,262,6,6,33,3,30,88,75,13,1
2021,East Hertfordshire 017C,E01023477,968,599,258,341,9,9,72,10,62,288,275,13,0
2021,East Hertfordshire 017E,E01023479,704,513,233,280,8,8,39,3,36,144,132,12,0
2021,East Hertfordshire 018C,E01023480,700,493,289,204,1,1,144,29,115,62,51,11,0
2021,East Hertfordshire 018D,E01023481,510,344,164,180,0,0,21,2,19,145,66,79,0
2021,East Hertfordshire 016A,E01023482,747,596,211,385,0,0,12,1,11,139,133,6,0
2021,East Hertfordshire 016B,E01023483,955,675,271,404,21,21,91,12,79,168,157,11,0
2021,East Hertfordshire 016C,E01023484,670,402,142,260,30,30,158,25,133,79,70,9,1
2021,East Hertfordshire 010A,E01023485,952,699,390,309,3,3,116,20,96,134,121,13,0
2021,East Hertfordshire 010B,E01023486,1050,801,455,346,11,11,113,13,100,125,100,25,0
2021,East Hertfordshire 015A,E01023487,704,276,111,165,17,17,355,47,308,54,49,5,2
2021,East Hertfordshire 015B,E01023488,713,272,129,143,53,53,318,31,287,67,61,6,3
2021,East Hertfordshire 015C,E01023489,633,469,247,222,1,1,34,5,29,129,119,10,0
2021,East Hertfordshire 015D,E01023490,477,376,163,213,0,0,81,10,71,20,17,3,0
2021,East Hertfordshire 009A,E01023491,556,361,195,166,0,0,89,13,76,106,95,11,0
2021,East Hertfordshire 009B,E01023492,844,624,277,347,22,22,131,18,113,67,51,16,0
2021,East Hertfordshire 003F,E01023493,972,739,341,398,11,11,120,15,105,102,84,18,0
2021,East Hertfordshire 019A,E01023494,660,465,251,214,17,17,121,13,108,57,41,16,0
2021,East Hertfordshire 019D,E01023495,503,380,188,192,2,2,60,10,50,61,43,18,0
2021,East Hertfordshire 009C,E01023496,484,321,164,157,2,2,72,14,58,88,74,14,1
2021,East Hertfordshire 009D,E01023497,686,484,257,227,3,3,113,14,99,86,68,18,0
2021,East Hertfordshire 011A,E01023499,894,514,218,296,14,14,262,47,215,102,91,11,2
2021,East Hertfordshire 011B,E01023500,645,612,376,236,0,0,6,0,6,27,22,5,0
2021,East Hertfordshire 011C,E01023501,674,557,287,270,1,1,30,9,21,86,80,6,0
2021,East Hertfordshire 011D,E01023502,801,540,282,258,1,1,9,1,8,251,236,15,0
2021,East Hertfordshire 011E,E01023503,646,565,339,226,3,3,29,1,28,49,48,1,0
2021,East Hertfordshire 018E,E01023504,606,358,190,168,4,4,124,16,108,120,99,21,0
2021,East Hertfordshire 018F,E01023505,734,560,265,295,14,14,32,5,27,127,116,11,1
2021,East Hertfordshire 006B,E01023506,630,466,247,219,8,8,92,14,78,64,56,8,0
2021,East Hertfordshire 006C,E01023507,657,544,287,257,0,0,24,2,22,89,65,24,0
2021,East Hertfordshire 019B,E01023509,562,393,193,200,7,7,99,11,88,63,55,8,0
2021,East Hertfordshire 013A,E01023510,662,507,258,249,18,18,47,3,44,90,80,10,0
2021,East Hertfordshire 013B,E01023511,889,422,164,258,68,68,179,30,149,220,207,13,0
2021,East Hertfordshire 012A,E01023512,931,644,274,370,21,21,77,5,72,189,176,13,0
2021,East Hertfordshire 012B,E01023513,600,410,215,195,0,0,157,18,139,33,30,3,0
2021,East Hertfordshire 012C,E01023514,1078,590,317,273,3,3,131,22,109,354,322,32,0
2021,East Hertfordshire 013C,E01023515,719,548,241,307,26,26,28,1,27,117,103,14,0
2021,East Hertfordshire 013D,E01023516,861,718,401,317,0,0,20,0,20,123,113,10,0
2021,East Hertfordshire 013E,E01023517,680,448,219,229,5,5,140,25,115,87,80,7,0
2021,East Hertfordshire 012D,E01023518,784,487,250,237,10,10,233,38,195,54,52,2,0
2021,East Hertfordshire 012E,E01023519,671,441,175,266,4,4,159,30,129,67,58,9,0
2021,East Hertfordshire 012F,E01023520,660,556,299,257,3,3,26,3,23,75,71,4,0
2021,Hertsmere 005A,E01023523,630,547,286,261,0,0,6,3,3,77,66,11,0
2021,Hertsmere 005B,E01023524,521,483,258,225,0,0,13,1,12,25,17,8,0
2021,Hertsmere 005C,E01023525,769,494,268,226,8,8,45,1,44,222,206,16,0
2021,Hertsmere 005D,E01023526,675,591,309,282,1,1,6,1,5,77,67,10,0
2021,Hertsmere 005E,E01023527,597,335,158,177,7,7,191,10,181,64,60,4,0
2021,Hertsmere 010A,E01023528,590,416,208,208,2,2,24,6,18,148,105,43,0
2021,Hertsmere 007A,E01023529,537,291,120,171,6,6,164,11,153,76,66,10,0
2021,Hertsmere 007B,E01023530,536,117,53,64,2,2,264,32,232,153,148,5,0
2021,Hertsmere 007C,E01023531,748,418,161,257,16,16,159,14,145,155,144,11,0
2021,Hertsmere 007D,E01023532,643,454,221,233,6,6,60,7,53,123,113,10,0
2021,Hertsmere 007E,E01023533,588,328,128,200,5,5,184,15,169,71,61,10,0
2021,Hertsmere 006A,E01023534,635,325,135,190,6,6,234,42,192,70,62,8,0
2021,Hertsmere 006B,E01023535,678,364,170,194,5,5,223,33,190,86,76,10,0
2021,Hertsmere 006C,E01023536,736,143,48,95,4,4,508,80,428,75,70,5,6
2021,Hertsmere 006D,E01023537,1047,634,180,454,13,13,249,37,212,151,134,17,0
2021,Hertsmere 006E,E01023538,970,319,114,205,21,21,396,54,342,231,213,18,3
2021,Hertsmere 011B,E01023540,663,464,210,254,6,6,124,8,116,69,65,4,0
2021,Hertsmere 011C,E01023541,975,628,220,408,17,17,128,19,109,200,186,14,2
2021,Hertsmere 011D,E01023542,664,418,178,240,10,10,156,19,137,80,68,12,0
2021,Hertsmere 011E,E01023543,585,271,135,136,5,5,221,31,190,87,78,9,1
2021,Hertsmere 009A,E01023544,486,329,170,159,31,31,50,5,45,76,70,6,0
2021,Hertsmere 009B,E01023545,830,379,153,226,35,35,183,7,176,233,213,20,0
2021,Hertsmere 009C,E01023546,825,441,187,254,4,4,220,22,198,159,142,17,1
2021,Hertsmere 009D,E01023547,726,325,125,200,17,17,322,34,288,62,52,10,0
2021,Hertsmere 013A,E01023548,930,687,437,250,12,12,91,6,85,140,124,16,0
2021,Hertsmere 013B,E01023549,814,614,343,271,2,2,32,5,27,165,147,18,1
2021,Hertsmere 013C,E01023550,690,440,244,196,0,0,36,1,35,214,89,125,0
2021,Hertsmere 013D,E01023551,548,512,235,277,1,1,3,1,2,32,31,1,0
2021,Hertsmere 008A,E01023552,638,450,215,235,13,13,135,4,131,40,38,2,0
2021,Hertsmere 008B,E01023553,744,535,210,325,18,18,47,2,45,144,121,23,0
2021,Hertsmere 008C,E01023554,717,419,188,231,2,2,115,7,108,181,175,6,0
2021,Hertsmere 008D,E01023555,777,382,173,209,24,24,189,27,162,181,167,14,1
2021,Hertsmere 013E,E01023556,718,524,205,319,9,9,121,12,109,64,57,7,0
2021,Hertsmere 013F,E01023557,611,483,234,249,2,2,42,4,38,84,79,5,0
2021,Hertsmere 012A,E01023558,813,628,326,302,3,3,25,4,21,156,143,13,1
2021,Hertsmere 012B,E01023559,685,525,228,297,6,6,16,4,12,138,131,7,0
2021,Hertsmere 012C,E01023560,752,274,92,182,26,26,343,24,319,109,89,20,0
2021,Hertsmere 012D,E01023561,657,439,214,225,1,1,128,9,119,89,74,15,0
2021,Hertsmere 012E,E01023562,749,585,325,260,1,1,72,7,65,90,79,11,1
2021,Hertsmere 012F,E01023563,756,550,285,265,6,6,36,3,33,164,145,19,0
2021,Hertsmere 010B,E01023564,642,394,166,228,8,8,97,17,80,143,134,9,0
2021,Hertsmere 010C,E01023565,678,470,199,271,1,1,37,4,33,170,156,14,0
2021,Hertsmere 010D,E01023566,510,478,238,240,1,1,1,0,1,30,24,6,0
2021,Hertsmere 002A,E01023567,744,681,332,349,1,1,12,1,11,50,44,6,0
2021,Hertsmere 002B,E01023568,635,565,367,198,2,2,15,1,14,53,45,8,0
2021,Hertsmere 002C,E01023569,609,422,217,205,4,4,98,7,91,85,78,7,0
2021,Hertsmere 002D,E01023570,620,300,135,165,5,5,200,10,190,114,106,8,1
2021,Hertsmere 003A,E01023571,610,509,316,193,1,1,25,2,23,74,70,4,1
2021,Hertsmere 003B,E01023572,717,448,234,214,3,3,86,6,80,180,175,5,0
2021,Hertsmere 003C,E01023573,540,251,107,144,2,2,204,104,100,81,80,1,2
2021,Hertsmere 003D,E01023574,665,311,143,168,5,5,284,20,264,63,57,6,2
2021,Hertsmere 003E,E01023575,656,427,218,209,4,4,118,28,90,107,101,6,0
2021,Hertsmere 001A,E01023576,595,501,328,173,2,2,9,3,6,83,69,14,0
2021,Hertsmere 001B,E01023577,718,608,393,215,3,3,21,0,21,86,71,15,0
2021,Hertsmere 001C,E01023578,725,613,376,237,0,0,12,3,9,100,88,12,0
2021,Hertsmere 001D,E01023579,638,372,194,178,3,3,54,5,49,209,194,15,0
2021,Hertsmere 001E,E01023580,702,461,257,204,0,0,55,3,52,186,174,12,0
2021,Hertsmere 004A,E01023581,484,414,176,238,0,0,18,0,18,52,50,2,0
2021,Hertsmere 004B,E01023582,616,373,173,200,25,25,155,9,146,63,48,15,0
2021,Hertsmere 004C,E01023583,554,358,165,193,2,2,117,19,98,77,59,18,0
2021,Hertsmere 004D,E01023584,447,271,126,145,2,2,92,12,80,81,59,22,1
2021,North Hertfordshire 016A,E01023585,445,321,186,135,3,3,36,17,19,85,67,18,0
2021,North Hertfordshire 016B,E01023586,730,534,308,226,8,8,92,18,74,95,87,8,1
2021,North Hertfordshire 004A,E01023587,493,372,184,188,0,0,7,4,3,114,101,13,0
2021,North Hertfordshire 004B,E01023588,629,523,284,239,10,10,14,4,10,82,74,8,0
2021,North Hertfordshire 004C,E01023589,878,519,285,234,3,3,124,37,87,232,198,34,0
2021,North Hertfordshire 004D,E01023590,807,525,271,254,2,2,99,29,70,181,162,19,0
2021,North Hertfordshire 004E,E01023591,666,546,322,224,7,7,33,15,18,80,59,21,0
2021,North Hertfordshire 004F,E01023592,571,278,127,151,0,0,247,101,146,46,40,6,0
2021,North Hertfordshire 004G,E01023593,634,312,148,164,34,34,216,84,132,72,61,11,0
2021,North Hertfordshire 014A,E01023594,1040,662,383,279,5,5,256,112,144,117,109,8,0
2021,North Hertfordshire 015A,E01023595,695,521,278,243,8,8,52,20,32,114,96,18,0
2021,North Hertfordshire 015B,E01023596,510,338,173,165,3,3,149,39,110,20,16,4,0
2021,North Hertfordshire 016C,E01023597,514,396,237,159,3,3,55,18,37,60,46,14,0
2021,North Hertfordshire 016D,E01023598,621,414,235,179,12,12,103,30,73,92,63,29,0
2021,North Hertfordshire 017B,E01023600,585,385,195,190,2,2,147,39,108,51,43,8,0
2021,North Hertfordshire 010A,E01023601,1153,464,180,284,16,16,196,54,142,476,454,22,1
2021,North Hertfordshire 010B,E01023602,653,444,184,260,2,2,54,8,46,153,143,10,0
2021,North Hertfordshire 010C,E01023603,609,497,233,264,1,1,19,5,14,92,83,9,0
2021,North Hertfordshire 010D,E01023604,537,436,211,225,2,2,21,1,20,78,72,6,0
2021,North Hertfordshire 010E,E01023605,725,294,116,178,43,43,116,20,96,272,267,5,0
2021,North Hertfordshire 013A,E01023606,782,457,222,235,3,3,182,76,106,140,121,19,0
2021,North Hertfordshire 013B,E01023607,608,515,290,225,3,3,9,2,7,81,76,5,0
2021,North Hertfordshire 013C,E01023608,642,584,336,248,1,1,6,2,4,51,42,9,0
2021,North Hertfordshire 013D,E01023609,765,494,240,254,0,0,38,8,30,233,209,24,0
2021,North Hertfordshire 013E,E01023610,513,407,185,222,2,2,12,6,6,92,88,4,0
2021,North Hertfordshire 012A,E01023611,675,311,176,135,7,7,292,106,186,63,58,5,2
2021,North Hertfordshire 012B,E01023612,778,548,289,259,3,3,115,48,67,112,102,10,0
2021,North Hertfordshire 012C,E01023613,751,227,99,128,3,3,468,236,232,52,44,8,1
2021,North Hertfordshire 012D,E01023614,811,703,388,315,9,9,5,2,3,94,77,17,0
2021,North Hertfordshire 012E,E01023615,723,662,408,254,0,0,13,3,10,48,42,6,0
2021,North Hertfordshire 012F,E01023616,1306,743,416,327,19,19,142,27,115,402,377,25,0
2021,North Hertfordshire 011A,E01023617,624,545,300,245,0,0,34,16,18,45,41,4,0
2021,North Hertfordshire 011B,E01023618,702,419,163,256,28,28,158,76,82,97,86,11,0
2021,North Hertfordshire 011C,E01023619,779,485,210,275,11,11,70,20,50,213,198,15,0
2021,North Hertfordshire 011D,E01023620,524,235,95,140,4,4,231,91,140,54,45,9,0
2021,North Hertfordshire 011E,E01023621,580,356,189,167,2,2,135,53,82,87,78,9,0
2021,North Hertfordshire 014B,E01023622,463,289,147,142,0,0,128,49,79,46,31,15,0
2021,North Hertfordshire 014C,E01023623,637,393,209,184,4,4,135,56,79,104,85,19,1
2021,North Hertfordshire 014D,E01023624,546,332,161,171,9,9,121,44,77,84,66,18,0
2021,North Hertfordshire 014E,E01023625,434,292,155,137,6,6,26,9,17,110,99,11,0
2021,North Hertfordshire 015C,E01023626,902,692,382,310,9,9,131,47,84,70,55,15,0
2021,North Hertfordshire 015D,E01023627,733,593,341,252,3,3,34,15,19,103,83,20,0
2021,North Hertfordshire 015E,E01023628,827,571,305,266,4,4,46,5,41,206,185,21,0
2021,North Hertfordshire 015F,E01023629,768,445,233,212,0,0,228,72,156,95,86,9,0
2021,North Hertfordshire 006A,E01023630,725,393,166,227,2,2,259,80,179,71,65,6,0
2021,North Hertfordshire 006B,E01023631,720,307,129,178,0,0,334,45,289,78,72,6,1
2021,North Hertfordshire 006C,E01023632,806,453,183,270,56,56,216,40,176,81,74,7,0
2021,North Hertfordshire 006D,E01023633,606,277,125,152,0,0,176,24,152,152,143,9,1
2021,North Hertfordshire 006E,E01023634,610,462,309,153,3,3,47,13,34,98,94,4,0
2021,North Hertfordshire 003A,E01023635,630,381,196,185,2,2,198,74,124,49,41,8,0
2021,North Hertfordshire 003B,E01023636,792,497,267,230,6,6,214,72,142,74,65,9,1
2021,North Hertfordshire 003C,E01023637,928,316,162,154,17,17,519,200,319,76,68,8,0
2021,North Hertfordshire 003D,E01023638,689,360,168,192,6,6,240,65,175,83,66,17,0
2021,North Hertfordshire 009A,E01023639,554,423,248,175,2,2,48,5,43,81,71,10,0
2021,North Hertfordshire 009B,E01023640,564,212,109,103,0,0,308,133,175,44,38,6,0
2021,North Hertfordshire 009C,E01023641,586,251,116,135,2,2,294,133,161,39,33,6,0
2021,North Hertfordshire 009D,E01023642,496,465,301,164,1,1,3,1,2,27,20,7,0
2021,North Hertfordshire 009E,E01023643,494,307,168,139,2,2,143,49,94,42,34,8,0
2021,North Hertfordshire 008A,E01023644,832,572,381,191,7,7,112,11,101,141,126,15,0
2021,North Hertfordshire 008B,E01023645,683,403,242,161,4,4,198,71,127,78,65,13,0
2021,North Hertfordshire 008C,E01023646,507,198,81,117,0,0,286,101,185,23,22,1,0
2021,North Hertfordshire 008D,E01023647,592,542,330,212,2,2,7,3,4,41,35,6,0
2021,North Hertfordshire 008E,E01023648,469,395,256,139,2,2,14,0,14,58,52,6,0
2021,North Hertfordshire 007A,E01023649,674,395,190,205,4,4,83,19,64,192,175,17,0
2021,North Hertfordshire 007B,E01023650,682,233,98,135,17,17,352,96,256,80,72,8,0
2021,North Hertfordshire 007C,E01023651,506,381,208,173,2,2,56,28,28,67,62,5,0
2021,North Hertfordshire 007D,E01023652,607,252,124,128,29,29,291,49,242,35,28,7,0
2021,North Hertfordshire 014F,E01023653,1042,721,372,349,19,19,191,60,131,111,90,21,0
2021,North Hertfordshire 002A,E01023654,669,572,294,278,4,4,16,7,9,77,67,10,0
2021,North Hertfordshire 002B,E01023655,856,657,374,283,18,18,108,22,86,73,62,11,0
2021,North Hertfordshire 002C,E01023656,1135,690,343,347,2,2,137,56,81,306,280,26,0
2021,North Hertfordshire 002D,E01023657,1076,927,531,396,7,7,24,9,15,118,105,13,0
2021,North Hertfordshire 002E,E01023658,690,465,232,233,25,25,152,65,87,48,33,15,0
2021,North Hertfordshire 002F,E01023659,533,456,242,214,5,5,13,5,8,59,49,10,0
2021,North Hertfordshire 001A,E01023660,1177,666,348,318,19,19,147,51,96,344,312,32,1
2021,North Hertfordshire 001B,E01023661,548,284,149,135,1,1,233,107,126,30,25,5,0
2021,North Hertfordshire 001C,E01023662,806,585,228,357,17,17,68,5,63,136,125,11,0
2021,North Hertfordshire 016E,E01023663,854,584,330,254,2,2,131,34,97,134,105,29,3
2021,St Albans 013A,E01023664,702,555,216,339,0,0,35,4,31,112,100,12,0
2021,St Albans 013B,E01023665,669,494,193,301,3,3,30,4,26,142,129,13,0
2021,St Albans 011A,E01023666,861,386,122,264,13,13,155,113,42,303,293,10,4
2021,St Albans 013C,E01023667,584,440,201,239,3,3,9,6,3,132,121,11,0
2021,St Albans 013D,E01023668,471,405,172,233,0,0,38,37,1,28,25,3,0
2021,St Albans 009A,E01023669,672,297,110,187,2,2,325,131,194,48,45,3,0
2021,St Albans 009B,E01023670,854,618,271,347,7,7,93,37,56,135,119,16,1
2021,St Albans 009C,E01023671,747,448,210,238,4,4,240,208,32,53,43,10,2
2021,St Albans 009D,E01023672,686,466,203,263,1,1,156,110,46,62,55,7,1
2021,St Albans 010A,E01023673,523,461,245,216,1,1,29,23,6,32,29,3,0
2021,St Albans 011B,E01023674,726,513,187,326,0,0,31,15,16,182,172,10,0
2021,St Albans 011C,E01023675,506,452,259,193,1,1,9,5,4,44,38,6,0
2021,St Albans 011D,E01023676,1198,513,238,275,18,18,175,62,113,492,454,38,0
2021,St Albans 021B,E01023677,493,228,79,149,5,5,220,9,211,40,32,8,0
2021,St Albans 021D,E01023678,734,599,295,304,4,4,39,19,20,92,84,8,0
2021,St Albans 021A,E01023680,511,370,195,175,5,5,63,49,14,73,44,29,0
2021,St Albans 016A,E01023681,637,279,116,163,5,5,279,235,44,73,67,6,1
2021,St Albans 016B,E01023682,735,510,255,255,3,3,111,78,33,111,97,14,0
2021,St Albans 016C,E01023683,660,381,201,180,1,1,222,190,32,56,47,9,0
2021,St Albans 016D,E01023684,664,558,320,238,2,2,10,4,6,94,85,9,0
2021,St Albans 002A,E01023685,637,491,190,301,5,5,71,8,63,70,64,6,0
2021,St Albans 002B,E01023686,525,493,233,260,0,0,5,4,1,27,20,7,0
2021,St Albans 002C,E01023687,622,307,136,171,8,8,248,227,21,55,49,6,4
2021,St Albans 002D,E01023688,640,415,178,237,0,0,93,49,44,132,125,7,0
2021,St Albans 002E,E01023689,512,397,212,185,1,1,38,24,14,76,68,8,0
2021,St Albans 001A,E01023690,647,510,241,269,1,1,14,3,11,122,102,20,0
2021,St Albans 001B,E01023691,508,475,242,233,0,0,10,6,4,23,22,1,0
2021,St Albans 001C,E01023692,495,293,138,155,0,0,130,105,25,71,68,3,1
2021,St Albans 001D,E01023693,622,494,211,283,7,7,54,37,17,66,62,4,1
2021,St Albans 001E,E01023694,598,547,240,307,3,3,5,3,2,43,39,4,0
2021,St Albans 005A,E01023695,625,563,282,281,0,0,28,25,3,34,32,2,0
2021,St Albans 005B,E01023696,648,613,351,262,0,0,1,1,0,34,29,5,0
2021,St Albans 005C,E01023697,781,547,274,273,2,2,68,64,4,160,147,13,4
2021,St Albans 005D,E01023698,600,562,322,240,0,0,5,4,1,33,30,3,0
2021,St Albans 003A,E01023699,616,522,281,241,6,6,10,3,7,78,75,3,0
2021,St Albans 003B,E01023700,470,444,261,183,0,0,2,1,1,24,23,1,0
2021,St Albans 003C,E01023701,992,547,364,183,6,6,125,65,60,314,273,41,0
2021,St Albans 003D,E01023702,681,469,224,245,1,1,10,6,4,201,188,13,0
2021,St Albans 003E,E01023703,533,469,212,257,0,0,15,13,2,49,43,6,0
2021,St Albans 018A,E01023704,736,474,213,261,1,1,69,13,56,192,179,13,0
2021,St Albans 018B,E01023705,642,333,159,174,6,6,210,184,26,91,81,10,2
2021,St Albans 018C,E01023706,690,513,264,249,0,0,48,42,6,128,120,8,1
2021,St Albans 018E,E01023708,664,438,198,240,1,1,129,116,13,95,82,13,1
2021,St Albans 008A,E01023709,712,482,223,259,3,3,147,96,51,79,75,4,1
2021,St Albans 008B,E01023710,540,520,268,252,1,1,2,2,0,17,15,2,0
2021,St Albans 008C,E01023711,626,492,295,197,1,1,76,54,22,57,52,5,0
2021,St Albans 008D,E01023712,844,510,213,297,20,20,108,56,52,203,192,11,3
2021,St Albans 007A,E01023713,731,491,190,301,1,1,115,70,45,124,119,5,0
2021,St Albans 010B,E01023714,631,575,302,273,0,0,3,1,2,53,44,9,0
2021,St Albans 010C,E01023715,525,446,195,251,0,0,48,46,2,31,29,2,0
2021,St Albans 010D,E01023716,854,654,274,380,2,2,21,7,14,177,163,14,0
2021,St Albans 020A,E01023717,557,403,179,224,0,0,47,12,35,107,90,17,0
2021,St Albans 019A,E01023718,710,639,371,268,2,2,10,10,0,59,45,14,0
2021,St Albans 019B,E01023719,506,313,178,135,0,0,141,102,39,50,40,10,2
2021,St Albans 019C,E01023720,857,516,240,276,8,8,172,62,110,157,141,16,4
2021,St Albans 019D,E01023721,547,494,275,219,4,4,15,15,0,34,27,7,0
2021,St Albans 006A,E01023722,592,440,252,188,1,1,43,25,18,108,83,25,0
2021,St Albans 006B,E01023723,672,376,173,203,2,2,258,210,48,35,32,3,1
2021,St Albans 006C,E01023724,723,587,353,234,0,0,45,28,17,91,80,11,0
2021,St Albans 006D,E01023725,589,540,270,270,4,4,3,0,3,42,33,9,0
2021,St Albans 012A,E01023726,986,600,198,402,0,0,43,25,18,343,319,24,0
2021,St Albans 012B,E01023727,1132,433,212,221,1,1,194,72,122,502,473,29,2
2021,St Albans 012C,E01023728,961,621,253,368,0,0,69,28,41,271,256,15,0
2021,St Albans 020B,E01023730,683,623,370,253,1,1,15,12,3,44,35,9,0
2021,St Albans 020C,E01023731,643,503,270,233,2,2,33,31,2,102,92,10,3
2021,St Albans 020D,E01023732,667,563,341,222,3,3,7,2,5,94,83,11,0
2021,St Albans 020E,E01023733,757,668,385,283,14,14,23,6,17,52,48,4,0
2021,St Albans 007B,E01023734,647,547,280,267,0,0,7,2,5,93,83,10,0
2021,St Albans 007C,E01023735,769,608,349,259,5,5,13,3,10,143,133,10,0
2021,St Albans 007D,E01023736,681,436,209,227,0,0,155,141,14,89,83,6,1
2021,St Albans 017A,E01023737,506,220,85,135,1,1,198,140,58,86,78,8,1
2021,St Albans 017B,E01023738,618,281,110,171,6,6,267,237,30,60,55,5,4
2021,St Albans 017C,E01023739,530,339,154,185,1,1,118,109,9,71,56,15,1
2021,St Albans 017D,E01023740,715,358,172,186,0,0,85,53,32,269,248,21,3
2021,St Albans 017E,E01023741,628,507,227,280,1,1,42,35,7,78,68,10,0
2021,St Albans 014A,E01023742,690,620,363,257,7,7,33,4,29,30,28,2,0
2021,St Albans 014B,E01023743,889,631,354,277,12,12,37,6,31,209,171,38,0
2021,St Albans 014C,E01023744,621,579,352,227,0,0,5,3,2,37,30,7,0
2021,St Albans 014D,E01023745,802,588,309,279,1,1,22,12,10,191,175,16,0
2021,St Albans 004A,E01023746,633,326,161,165,4,4,245,214,31,58,51,7,0
2021,St Albans 004B,E01023747,744,575,317,258,1,1,93,73,20,75,67,8,0
2021,St Albans 004C,E01023748,559,480,307,173,1,1,30,28,2,48,41,7,0
2021,St Albans 004D,E01023749,716,628,324,304,2,2,30,11,19,56,48,8,0
2021,Stevenage 009A,E01023750,589,201,86,115,1,1,309,300,9,74,70,4,4
2021,Stevenage 009B,E01023751,473,323,159,164,1,1,97,90,7,52,49,3,0
2021,Stevenage 009C,E01023752,525,321,127,194,2,2,142,141,1,60,50,10,0
2021,Stevenage 009D,E01023753,716,555,271,284,8,8,21,7,14,132,122,10,0
2021,Stevenage 009E,E01023754,461,320,122,198,3,3,92,88,4,46,41,5,0
2021,Stevenage 008A,E01023755,660,361,175,186,2,2,193,187,6,104,90,14,0
2021,Stevenage 008B,E01023756,599,271,126,145,2,2,244,230,14,81,75,6,1
2021,Stevenage 008C,E01023757,738,374,163,211,13,13,252,231,21,97,88,9,2
2021,Stevenage 007A,E01023759,574,378,159,219,1,1,150,142,8,44,37,7,1
2021,Stevenage 007B,E01023760,605,433,216,217,6,6,108,91,17,56,48,8,2
2021,Stevenage 007C,E01023761,851,453,165,288,37,37,233,182,51,127,121,6,1
2021,Stevenage 007D,E01023762,629,427,187,240,3,3,136,115,21,63,47,16,0
2021,Stevenage 012A,E01023763,608,463,230,233,2,2,86,74,12,57,50,7,0
2021,Stevenage 012B,E01023764,573,362,220,142,4,4,133,96,37,74,66,8,0
2021,Stevenage 012C,E01023765,609,415,197,218,3,3,146,124,22,44,39,5,1
2021,Stevenage 012D,E01023766,622,374,165,209,2,2,188,178,10,57,51,6,1
2021,Stevenage 013D,E01023767,650,527,233,294,1,1,25,21,4,97,92,5,0
2021,Stevenage 013B,E01023769,725,453,204,249,5,5,197,155,42,69,61,8,1
2021,Stevenage 013C,E01023770,629,518,279,239,2,2,16,6,10,93,87,6,0
2021,Stevenage 003A,E01023771,685,461,220,241,4,4,94,82,12,126,114,12,0
2021,Stevenage 003B,E01023772,772,409,195,214,8,8,231,145,86,124,117,7,0
2021,Stevenage 003C,E01023773,507,227,106,121,17,17,227,28,199,36,35,1,0
2021,Stevenage 003D,E01023774,664,336,151,185,10,10,193,146,47,124,114,10,1
2021,Stevenage 006A,E01023775,1109,460,255,205,9,9,346,256,90,292,277,15,2
2021,Stevenage 002A,E01023776,1157,633,318,315,77,77,180,44,136,267,244,23,0
2021,Stevenage 002B,E01023777,770,561,271,290,1,1,98,76,22,110,102,8,0
2021,Stevenage 002C,E01023778,672,266,117,149,7,7,331,289,42,67,57,10,1
2021,Stevenage 006B,E01023779,724,324,148,176,24,24,232,133,99,144,133,11,0
2021,Stevenage 006C,E01023780,627,354,159,195,2,2,175,169,6,96,89,7,0
2021,Stevenage 006D,E01023781,807,347,158,189,15,15,338,214,124,107,91,16,0
2021,Stevenage 006E,E01023782,631,413,223,190,1,1,125,119,6,92,88,4,0
2021,Stevenage 011A,E01023783,717,361,140,221,1,1,248,179,69,107,100,7,0
2021,Stevenage 011B,E01023784,652,458,253,205,2,2,141,134,7,51,43,8,0
2021,Stevenage 011C,E01023785,783,358,146,212,19,19,318,220,98,88,76,12,0
2021,Stevenage 011D,E01023786,762,380,151,229,107,107,166,131,35,107,95,12,2
2021,Stevenage 001A,E01023787,541,356,162,194,2,2,98,91,7,85,76,9,0
2021,Stevenage 001B,E01023788,616,341,137,204,2,2,176,169,7,97,91,6,0
2021,Stevenage 001D,E01023790,629,321,131,190,3,3,195,184,11,110,106,4,0
2021,Stevenage 010A,E01023791,646,422,182,240,1,1,165,148,17,58,53,5,0
2021,Stevenage 010B,E01023792,606,336,129,207,3,3,203,194,9,64,53,11,0
2021,Stevenage 010C,E01023793,614,283,108,175,1,1,265,225,40,65,54,11,0
2021,Stevenage 010D,E01023794,625,313,130,183,6,6,226,219,7,80,73,7,0
2021,Stevenage 005A,E01023795,731,436,221,215,0,0,150,140,10,145,132,13,0
2021,Stevenage 005B,E01023796,717,254,120,134,1,1,290,225,65,170,151,19,2
2021,Stevenage 005C,E01023797,563,278,128,150,4,4,227,145,82,54,47,7,0
2021,Stevenage 005D,E01023798,660,409,203,206,3,3,88,76,12,160,150,10,0
2021,Stevenage 002D,E01023799,513,368,217,151,1,1,105,37,68,39,37,2,0
2021,Stevenage 002E,E01023800,822,470,272,198,1,1,175,99,76,176,166,10,0
2021,Stevenage 002F,E01023801,923,600,185,415,4,4,163,43,120,155,144,11,1
2021,Three Rivers 001A,E01023802,744,588,305,283,2,2,49,15,34,104,94,10,1
2021,Three Rivers 001B,E01023803,611,542,294,248,0,0,37,1,36,32,25,7,0
2021,Three Rivers 001C,E01023804,625,365,187,178,15,15,189,52,137,56,49,7,0
2021,Three Rivers 010A,E01023805,631,367,151,216,6,6,195,69,126,63,55,8,0
2021,Three Rivers 012A,E01023806,879,507,183,324,15,15,274,114,160,83,76,7,0
2021,Three Rivers 001D,E01023807,611,438,245,193,5,5,122,20,102,46,39,7,0
2021,Three Rivers 010B,E01023809,775,583,305,278,3,3,75,22,53,114,99,15,0
2021,Three Rivers 010C,E01023810,736,662,411,251,2,2,6,2,4,66,60,6,0
2021,Three Rivers 010D,E01023811,610,509,293,216,0,0,8,3,5,93,78,15,0
2021,Three Rivers 004A,E01023812,505,475,263,212,1,1,1,0,1,28,21,7,0
2021,Three Rivers 004B,E01023813,516,473,200,273,0,0,2,2,0,41,36,5,0
2021,Three Rivers 004C,E01023814,481,412,254,158,4,4,23,4,19,42,34,8,0
2021,Three Rivers 005A,E01023815,584,461,222,239,2,2,61,17,44,60,50,10,0
2021,Three Rivers 005B,E01023816,495,386,196,190,2,2,60,14,46,47,42,5,0
2021,Three Rivers 005C,E01023817,580,420,243,177,0,0,8,2,6,152,136,16,0
2021,Three Rivers 005D,E01023818,529,470,261,209,0,0,28,4,24,31,25,6,0
2021,Three Rivers 006A,E01023819,689,497,237,260,2,2,44,10,34,146,136,10,0
2021,Three Rivers 006B,E01023820,546,471,270,201,2,2,28,5,23,45,36,9,0
2021,Three Rivers 006C,E01023821,489,418,211,207,1,1,24,0,24,46,40,6,0
2021,Three Rivers 006D,E01023822,534,468,245,223,1,1,20,5,15,45,39,6,0
2021,Three Rivers 003A,E01023823,684,479,241,238,13,13,128,29,99,64,52,12,0
2021,Three Rivers 003B,E01023824,798,717,373,344,2,2,22,5,17,57,47,10,0
2021,Three Rivers 006E,E01023825,926,748,344,404,3,3,14,3,11,161,149,12,0
2021,Three Rivers 006F,E01023826,595,472,229,243,1,1,75,6,69,47,44,3,0
2021,Three Rivers 008A,E01023827,887,518,188,330,4,4,271,95,176,94,79,15,0
2021,Three Rivers 008B,E01023828,625,303,111,192,2,2,239,79,160,79,71,8,2
2021,Three Rivers 002A,E01023829,626,362,157,205,6,6,208,77,131,50,47,3,0
2021,Three Rivers 002B,E01023830,734,462,244,218,5,5,162,47,115,104,90,14,1
2021,Three Rivers 003C,E01023831,787,591,247,344,18,18,103,19,84,75,59,16,0
2021,Three Rivers 002C,E01023832,802,482,179,303,19,19,171,63,108,129,116,13,1
2021,Three Rivers 002E,E01023834,674,514,229,285,11,11,65,19,46,84,79,5,0
2021,Three Rivers 009A,E01023835,533,412,210,202,0,0,105,39,66,15,10,5,1
2021,Three Rivers 009B,E01023836,634,315,139,176,4,4,199,54,145,115,104,11,1
2021,Three Rivers 009C,E01023837,645,455,182,273,7,7,74,19,55,109,98,11,0
2021,Three Rivers 009D,E01023838,508,249,116,133,0,0,220,47,173,39,34,5,0
2021,Three Rivers 011A,E01023839,783,692,371,321,0,0,4,3,1,87,73,14,0
2021,Three Rivers 011B,E01023840,584,369,220,149,0,0,6,1,5,209,118,91,0
2021,Three Rivers 011C,E01023841,626,453,242,211,2,2,7,2,5,164,115,49,0
2021,Three Rivers 012B,E01023842,670,274,103,171,4,4,327,116,211,64,57,7,1
2021,Three Rivers 012C,E01023843,857,473,176,297,11,11,245,74,171,128,121,7,0
2021,Three Rivers 012D,E01023844,812,275,59,216,22,22,410,125,285,105,95,10,0
2021,Three Rivers 008C,E01023845,696,460,217,243,9,9,173,26,147,54,48,6,0
2021,Three Rivers 008D,E01023846,576,515,253,262,0,0,34,9,25,27,25,2,0
2021,Three Rivers 007A,E01023847,777,562,224,338,1,1,79,26,53,135,120,15,0
2021,Three Rivers 007B,E01023848,661,398,153,245,2,2,197,55,142,63,58,5,1
2021,Three Rivers 011D,E01023849,601,516,312,204,4,4,29,8,21,51,42,9,1
2021,Three Rivers 007C,E01023850,856,395,210,185,4,4,128,23,105,327,306,21,2
2021,Three Rivers 004D,E01023851,920,548,317,231,3,3,57,11,46,312,279,33,0
2021,Three Rivers 007D,E01023852,615,432,200,232,2,2,84,22,62,96,82,14,1
2021,Three Rivers 007E,E01023853,755,701,370,331,0,0,10,1,9,44,42,2,0
2021,Three Rivers 003D,E01023854,805,653,414,239,4,4,62,16,46,84,57,27,2
2021,Watford 006A,E01023855,901,420,135,285,3,3,33,7,26,444,419,25,1
2021,Watford 006B,E01023856,1030,568,194,374,6,6,49,7,42,406,385,21,1
2021,Watford 006C,E01023857,609,281,112,169,0,0,161,59,102,165,156,9,2
2021,Watford 006D,E01023858,881,448,166,282,6,6,29,11,18,398,382,16,0
2021,Watford 009B,E01023860,953,240,81,159,15,15,358,56,302,340,321,19,0
2021,Watford 009D,E01023862,1183,522,268,254,16,16,112,22,90,533,501,32,0
2021,Watford 011A,E01023863,701,377,177,200,1,1,21,3,18,302,292,10,0
2021,Watford 011B,E01023864,645,222,74,148,36,36,181,57,124,206,196,10,0
2021,Watford 011C,E01023865,710,230,57,173,24,24,350,72,278,106,101,5,0
2021,Watford 011D,E01023866,650,188,70,118,21,21,391,111,280,49,44,5,1
2021,Watford 004A,E01023868,712,376,163,213,5,5,246,60,186,85,71,14,0
2021,Watford 004B,E01023869,505,299,108,191,2,2,105,40,65,99,95,4,0
2021,Watford 004C,E01023870,517,233,74,159,1,1,211,82,129,71,64,7,1
2021,Watford 004D,E01023871,731,455,127,328,21,21,70,9,61,185,176,9,0
2021,Watford 004E,E01023872,630,463,217,246,4,4,25,14,11,138,132,6,0
2021,Watford 003A,E01023873,523,252,100,152,1,1,198,57,141,70,61,9,2
2021,Watford 003B,E01023874,477,326,152,174,3,3,102,35,67,46,38,8,0
2021,Watford 003C,E01023875,945,690,353,337,15,15,48,9,39,192,172,20,0
2021,Watford 003D,E01023876,673,191,65,126,16,16,401,127,274,64,60,4,1
2021,Watford 003E,E01023877,655,358,147,211,2,2,228,64,164,67,61,6,0
2021,Watford 007A,E01023878,825,673,362,311,3,3,18,3,15,131,119,12,0
2021,Watford 007C,E01023880,1022,464,216,248,7,7,130,23,107,421,394,27,0
2021,Watford 007D,E01023881,583,473,226,247,0,0,41,15,26,69,59,10,0
2021,Watford 012A,E01023882,656,548,250,298,1,1,26,2,24,81,76,5,0
2021,Watford 012B,E01023883,705,316,135,181,3,3,287,92,195,99,94,5,0
2021,Watford 012C,E01023884,877,532,241,291,7,7,83,8,75,254,239,15,1
2021,Watford 012D,E01023885,687,546,261,285,1,1,6,3,3,134,121,13,0
2021,Watford 008A,E01023886,1086,602,240,362,29,29,117,13,104,338,325,13,0
2021,Watford 008B,E01023887,624,572,299,273,1,1,9,3,6,42,37,5,0
2021,Watford 008C,E01023888,603,425,232,193,2,2,35,7,28,141,128,13,0
2021,Watford 008D,E01023889,626,589,322,267,1,1,5,2,3,31,30,1,0
2021,Watford 002A,E01023890,535,376,163,213,1,1,48,9,39,110,94,16,0
2021,Watford 002B,E01023891,536,210,85,125,2,2,268,72,196,55,51,4,1
2021,Watford 002C,E01023892,506,361,148,213,0,0,88,24,64,57,48,9,0
2021,Watford 002D,E01023893,719,571,308,263,5,5,18,4,14,125,115,10,0
2021,Watford 002E,E01023894,524,447,222,225,0,0,4,1,3,73,64,9,0
2021,Watford 005A,E01023895,720,408,172,236,1,1,8,1,7,302,289,13,1
2021,Watford 005B,E01023896,475,383,190,193,3,3,9,2,7,80,77,3,0
2021,Watford 005C,E01023897,646,488,270,218,1,1,92,24,68,64,56,8,1
2021,Watford 005D,E01023898,557,499,246,253,0,0,6,3,3,52,46,6,0
2021,Watford 010A,E01023899,594,249,112,137,3,3,28,5,23,314,295,19,0
2021,Watford 010B,E01023900,604,321,142,179,3,3,5,3,2,275,261,14,0
2021,Watford 010C,E01023901,750,388,149,239,3,3,7,1,6,352,334,18,0
2021,Watford 010D,E01023902,656,307,132,175,2,2,115,5,110,232,219,13,0
2021,Watford 010E,E01023903,562,283,114,169,4,4,61,11,50,214,199,15,0
2021,Watford 001A,E01023904,779,438,189,249,8,8,244,82,162,89,81,8,0
2021,Watford 001B,E01023905,850,528,202,326,6,6,161,46,115,153,138,15,2
2021,Watford 001C,E01023906,628,276,113,163,1,1,301,95,206,50,45,5,0
2021,Watford 001D,E01023907,766,516,248,268,17,17,69,9,60,164,150,14,0
2021,Welwyn Hatfield 015A,E01023908,641,536,279,257,1,1,10,6,4,94,82,12,0
2021,Welwyn Hatfield 015B,E01023909,421,385,199,186,0,0,2,2,0,34,17,17,0
2021,Welwyn Hatfield 015C,E01023910,556,459,248,211,1,1,20,19,1,76,63,13,0
2021,Welwyn Hatfield 015D,E01023911,718,583,324,259,1,1,43,37,6,91,77,14,0
2021,Welwyn Hatfield 004A,E01023912,662,458,233,225,6,6,87,69,18,110,101,9,1
2021,Welwyn Hatfield 004B,E01023913,552,317,158,159,6,6,161,93,68,66,59,7,2
2021,Welwyn Hatfield 004C,E01023914,746,337,171,166,3,3,346,328,18,53,48,5,7
2021,Welwyn Hatfield 004D,E01023915,646,338,137,201,1,1,196,170,26,111,102,9,0
2021,Welwyn Hatfield 006A,E01023916,692,412,186,226,7,7,212,194,18,57,52,5,4
2021,Welwyn Hatfield 006B,E01023917,774,544,317,227,2,2,137,78,59,91,88,3,0
2021,Welwyn Hatfield 006C,E01023918,1046,510,350,160,9,9,327,183,144,196,179,17,4
2021,Welwyn Hatfield 006D,E01023919,587,527,312,215,0,0,35,34,1,25,22,3,0
2021,Welwyn Hatfield 012A,E01023920,710,138,52,86,0,0,398,244,154,171,159,12,3
2021,Welwyn Hatfield 012B,E01023921,943,294,119,175,24,24,291,202,89,330,313,17,4
2021,Welwyn Hatfield 012C,E01023922,650,226,82,144,3,3,256,231,25,165,156,9,0
2021,Welwyn Hatfield 012D,E01023923,794,395,173,222,14,14,174,138,36,210,194,16,1
2021,Welwyn Hatfield 011A,E01023924,680,172,78,94,1,1,322,184,138,185,173,12,0
2021,Welwyn Hatfield 011B,E01023925,706,435,219,216,11,11,100,68,32,160,142,18,0
2021,Welwyn Hatfield 011C,E01023926,808,563,287,276,1,1,38,31,7,205,192,13,1
2021,Welwyn Hatfield 011D,E01023927,718,295,124,171,21,21,251,192,59,150,140,10,1
2021,Welwyn Hatfield 010A,E01023929,653,391,187,204,4,4,178,171,7,76,71,5,4
2021,Welwyn Hatfield 010B,E01023930,680,266,112,154,5,5,260,232,28,145,135,10,4
2021,Welwyn Hatfield 013A,E01023932,650,260,97,163,3,3,200,170,30,184,174,10,3
2021,Welwyn Hatfield 017A,E01023933,633,225,116,109,4,4,283,253,30,116,112,4,5
2021,Welwyn Hatfield 013B,E01023934,494,167,65,102,19,19,120,91,29,188,183,5,0
2021,Welwyn Hatfield 013C,E01023935,485,229,119,110,4,4,107,73,34,145,119,26,0
2021,Welwyn Hatfield 013D,E01023936,758,354,164,190,3,3,221,147,74,177,164,13,3
2021,Welwyn Hatfield 013E,E01023937,450,135,58,77,4,4,169,148,21,139,129,10,3
2021,Welwyn Hatfield 010D,E01023938,613,462,224,238,2,2,58,50,8,91,82,9,0
2021,Welwyn Hatfield 009A,E01023939,519,255,123,132,1,1,225,180,45,37,34,3,1
2021,Welwyn Hatfield 009B,E01023940,711,366,154,212,3,3,277,223,54,64,55,9,1
2021,Welwyn Hatfield 009D,E01023942,622,306,130,176,13,13,257,212,45,46,44,2,0
2021,Welwyn Hatfield 008A,E01023943,602,355,151,204,4,4,197,140,57,46,42,4,0
2021,Welwyn Hatfield 008B,E01023944,887,490,209,281,25,25,299,215,84,72,64,8,1
2021,Welwyn Hatfield 008C,E01023945,651,359,150,209,1,1,257,181,76,34,30,4,0
2021,Welwyn Hatfield 008D,E01023946,897,528,204,324,16,16,292,81,211,61,55,6,0
2021,Welwyn Hatfield 016A,E01023947,754,492,281,211,5,5,84,47,37,173,151,22,0
2021,Welwyn Hatfield 016B,E01023948,669,615,329,286,2,2,9,4,5,43,39,4,0
2021,Welwyn Hatfield 016C,E01023949,775,724,426,298,1,1,12,6,6,38,31,7,0
2021,Welwyn Hatfield 005A,E01023950,631,468,221,247,3,3,74,59,15,86,80,6,0
2021,Welwyn Hatfield 005B,E01023951,823,340,180,160,3,3,416,156,260,62,55,7,2
2021,Welwyn Hatfield 005C,E01023952,830,408,200,208,4,4,241,206,35,170,161,9,7
2021,Welwyn Hatfield 005D,E01023953,613,459,242,217,3,3,48,42,6,103,98,5,0
2021,Welwyn Hatfield 007B,E01023955,545,238,83,155,1,1,268,249,19,38,35,3,0
2021,Welwyn Hatfield 007C,E01023956,506,218,73,145,7,7,224,204,20,52,50,2,5
2021,Welwyn Hatfield 007D,E01023957,625,249,81,168,8,8,261,206,55,106,97,9,1
2021,Welwyn Hatfield 007E,E01023958,615,147,52,95,3,3,397,254,143,64,60,4,4
2021,Welwyn Hatfield 003A,E01023959,572,501,307,194,2,2,16,13,3,52,46,6,1
2021,Welwyn Hatfield 003B,E01023960,644,399,187,212,6,6,175,152,23,62,56,6,2
2021,Welwyn Hatfield 003C,E01023961,610,315,149,166,4,4,229,220,9,62,54,8,0
2021,Welwyn Hatfield 003D,E01023962,574,426,228,198,1,1,119,111,8,28,24,4,0
2021,Welwyn Hatfield 017B,E01023963,1045,617,328,289,2,2,243,206,37,182,165,17,1
2021,Welwyn Hatfield 001A,E01023965,548,513,286,227,1,1,8,6,2,26,18,8,0
2021,Welwyn Hatfield 001B,E01023966,662,601,344,257,1,1,16,8,8,44,37,7,0
2021,Welwyn Hatfield 001C,E01023967,591,411,181,230,1,1,94,85,9,84,72,12,1
2021,Welwyn Hatfield 002B,E01023968,572,493,299,194,5,5,18,12,6,56,47,9,0
2021,Welwyn Hatfield 002C,E01023969,662,477,292,185,2,2,85,81,4,97,83,14,1
2021,Welwyn Hatfield 002D,E01023970,804,438,171,267,17,17,269,206,63,77,66,11,3
2021,Welwyn Hatfield 001D,E01023971,631,561,317,244,2,2,23,20,3,45,40,5,0
2021,Ashford 006A,E01023972,524,285,105,180,0,0,186,180,6,53,42,11,0
2021,Ashford 005A,E01023973,1103,380,127,253,32,32,454,291,163,231,220,11,6
2021,Ashford 007A,E01023974,551,246,127,119,2,2,167,146,21,133,123,10,3
2021,Ashford 007B,E01023975,770,371,126,245,38,38,268,239,29,89,72,17,4
2021,Ashford 008A,E01023976,717,304,113,191,5,5,333,235,98,72,55,17,3
2021,Ashford 007C,E01023977,596,437,200,237,7,7,31,16,15,120,113,7,1
2021,Ashford 011A,E01023978,552,473,318,155,1,1,7,5,2,71,57,14,0
2021,Ashford 011B,E01023979,555,376,205,171,15,15,117,83,34,47,39,8,0
2021,Ashford 015A,E01023980,501,367,223,144,1,1,84,35,49,49,37,12,0
2021,Ashford 015B,E01023981,638,342,159,183,21,21,200,167,33,71,60,11,4
2021,Ashford 003A,E01023983,619,533,338,195,2,2,7,7,0,77,61,16,0
2021,Ashford 015C,E01023984,475,228,95,133,1,1,181,145,36,65,57,8,0
2021,Ashford 002A,E01023985,547,451,330,121,2,2,30,23,7,63,41,22,1
2021,Ashford 002B,E01023986,654,405,223,182,13,13,147,109,38,88,70,18,1
2021,Ashford 001B,E01023987,444,302,184,118,0,0,83,64,19,58,40,18,1
2021,Ashford 001C,E01023988,626,484,265,219,8,8,26,13,13,108,85,23,0
2021,Ashford 002C,E01023989,503,451,239,212,3,3,15,13,2,34,24,10,0
2021,Ashford 002D,E01023990,546,350,202,148,3,3,108,105,3,85,66,19,0
2021,Ashford 016C,E01023992,714,395,144,251,23,23,123,85,38,173,149,24,0
2021,Ashford 016D,E01023993,552,427,183,244,1,1,8,1,7,116,104,12,0
2021,Ashford 006B,E01023995,473,403,216,187,3,3,6,5,1,61,57,4,0
2021,Ashford 006C,E01023996,474,384,169,215,2,2,6,5,1,82,78,4,0
2021,Ashford 014A,E01023997,657,446,269,177,7,7,125,93,32,77,62,15,2
2021,Ashford 014B,E01023998,519,395,265,130,0,0,73,61,12,51,40,11,0
2021,Ashford 003B,E01023999,930,816,503,313,1,1,14,3,11,99,79,20,0
2021,Ashford 009A,E01024001,666,346,170,176,2,2,214,191,23,102,85,17,2
2021,Ashford 005B,E01024002,597,299,119,180,2,2,56,25,31,237,218,19,3
2021,Ashford 006D,E01024003,778,612,383,229,6,6,64,3,61,96,73,23,0
2021,Ashford 006E,E01024004,890,688,324,364,22,22,34,8,26,146,106,40,0
2021,Ashford 006F,E01024005,642,446,209,237,11,11,77,48,29,108,94,14,0
2021,Ashford 009B,E01024006,440,371,159,212,0,0,2,0,2,67,60,7,0
2021,Ashford 009D,E01024008,711,565,205,360,2,2,6,4,2,138,125,13,0
2021,Ashford 013A,E01024009,631,493,338,155,21,21,35,17,18,82,63,19,0
2021,Ashford 013B,E01024010,632,405,264,141,10,10,117,99,18,99,76,23,1
2021,Ashford 013C,E01024011,512,419,276,143,3,3,22,18,4,68,51,17,0
2021,Ashford 013D,E01024012,491,355,223,132,1,1,67,43,24,67,62,5,1
2021,Ashford 010A,E01024013,814,565,311,254,35,35,133,90,43,81,66,15,0
2021,Ashford 010B,E01024014,748,640,388,252,9,9,31,7,24,68,45,23,0
2021,Ashford 010C,E01024015,662,557,338,219,4,4,10,9,1,91,73,18,0
2021,Ashford 007D,E01024016,642,394,175,219,7,7,10,7,3,231,216,15,0
2021,Ashford 007E,E01024017,808,527,220,307,10,10,83,37,46,188,170,18,0
2021,Ashford 008B,E01024019,553,225,84,141,14,14,202,69,133,112,101,11,0
2021,Ashford 008C,E01024020,645,200,72,128,26,26,294,96,198,123,109,14,2
2021,Ashford 015E,E01024021,665,341,192,149,1,1,69,7,62,254,235,19,0
2021,Ashford 015D,E01024022,648,464,292,172,3,3,103,21,82,78,68,10,0
2021,Ashford 005C,E01024023,982,596,238,358,5,5,125,22,103,256,227,29,0
2021,Ashford 013E,E01024024,1125,792,570,222,13,13,130,62,68,189,158,31,1
2021,Ashford 013F,E01024025,714,412,318,94,24,24,168,105,63,109,101,8,1
2021,Ashford 014C,E01024026,518,429,284,145,3,3,44,42,2,41,27,14,1
2021,Ashford 007F,E01024028,705,238,108,130,1,1,344,292,52,118,102,16,4
2021,Ashford 005E,E01024029,987,625,296,329,7,7,189,170,19,161,145,16,5
2021,Ashford 012B,E01024031,707,529,336,193,4,4,85,62,23,89,60,29,0
2021,Ashford 011C,E01024032,823,667,437,230,5,5,60,46,14,91,71,20,0
2021,Ashford 002E,E01024033,732,556,299,257,6,6,80,55,25,88,64,24,2
2021,Ashford 002F,E01024035,454,358,204,154,5,5,50,27,23,41,30,11,0
2021,Ashford 011D,E01024036,571,433,256,177,8,8,70,48,22,60,36,24,0
2021,Ashford 014D,E01024037,815,611,313,298,9,9,86,55,31,107,93,14,2
2021,Ashford 012C,E01024038,908,735,513,222,20,20,80,54,26,71,52,19,2
2021,Ashford 012D,E01024039,656,546,310,236,14,14,34,25,9,62,46,16,0
2021,Ashford 001D,E01024040,600,311,167,144,8,8,183,149,34,94,84,10,4
2021,Ashford 001E,E01024041,525,399,267,132,4,4,7,3,4,115,96,19,0
2021,Canterbury 018A,E01024042,574,422,242,180,0,0,76,62,14,73,52,21,3
2021,Canterbury 018B,E01024043,564,503,332,171,1,1,6,4,2,54,42,12,0
2021,Canterbury 016A,E01024044,878,375,228,147,37,37,82,13,69,384,355,29,0
2021,Canterbury 016B,E01024045,667,469,299,170,0,0,59,55,4,138,121,17,1
2021,Canterbury 016C,E01024046,852,582,387,195,0,0,66,4,62,204,169,35,0
2021,Canterbury 014A,E01024047,676,219,54,165,22,22,315,266,49,117,93,24,3
2021,Canterbury 016D,E01024048,554,151,93,58,1,1,163,142,21,239,217,22,0
2021,Canterbury 014B,E01024049,555,156,74,82,2,2,309,220,89,88,80,8,0
2021,Canterbury 017A,E01024052,966,561,206,355,4,4,226,124,102,174,156,18,1
2021,Canterbury 017B,E01024053,814,650,336,314,0,0,16,2,14,148,129,19,0
2021,Canterbury 017C,E01024054,746,595,365,230,3,3,45,40,5,102,87,15,1
2021,Canterbury 007A,E01024055,718,620,412,208,3,3,11,3,8,84,69,15,0
2021,Canterbury 005A,E01024056,791,754,521,233,1,1,6,4,2,30,24,6,0
2021,Canterbury 005B,E01024057,821,723,507,216,3,3,4,3,1,90,76,14,1
2021,Canterbury 005C,E01024058,675,557,310,247,4,4,12,5,7,102,95,7,0
2021,Canterbury 004A,E01024059,747,426,288,138,3,3,215,203,12,101,84,17,2
2021,Canterbury 008A,E01024060,684,507,283,224,2,2,16,13,3,159,138,21,0
2021,Canterbury 007B,E01024061,641,231,125,106,8,8,321,257,64,77,69,8,4
2021,Canterbury 009A,E01024062,886,613,330,283,16,16,68,22,46,189,169,20,0
2021,Canterbury 007C,E01024063,661,583,334,249,1,1,3,1,2,74,62,12,0
2021,Canterbury 003A,E01024064,998,840,446,394,9,9,51,19,32,98,86,12,0
2021,Canterbury 004B,E01024065,822,656,389,267,6,6,13,7,6,147,129,18,0
2021,Canterbury 003B,E01024066,666,378,193,185,1,1,195,153,42,92,82,10,0
2021,Canterbury 012C,E01024067,483,398,227,171,2,2,15,5,10,68,62,6,0
2021,Canterbury 012D,E01024068,588,468,292,176,1,1,39,19,20,80,65,15,0
2021,Canterbury 008B,E01024069,549,406,199,207,1,1,23,21,2,119,110,9,0
2021,Canterbury 008C,E01024070,654,350,231,119,1,1,56,50,6,247,226,21,0
2021,Canterbury 007D,E01024071,741,476,251,225,1,1,137,39,98,127,114,13,0
2021,Canterbury 008D,E01024072,565,318,177,141,2,2,5,2,3,240,222,18,0
2021,Canterbury 006A,E01024073,1006,749,369,380,41,41,73,5,68,143,125,18,0
2021,Canterbury 006B,E01024074,550,503,279,224,1,1,6,3,3,40,33,7,0
2021,Canterbury 006C,E01024075,686,532,314,218,3,3,48,22,26,103,81,22,0
2021,Canterbury 006D,E01024076,751,612,300,312,8,8,11,7,4,120,104,16,0
2021,Canterbury 006E,E01024077,837,651,298,353,37,37,34,8,26,115,101,14,0
2021,Canterbury 001A,E01024078,969,399,244,155,6,6,47,16,31,517,485,32,0
2021,Canterbury 003C,E01024079,699,575,366,209,5,5,19,2,17,100,84,16,0
2021,Canterbury 001B,E01024080,610,257,134,123,0,0,62,50,12,290,269,21,1
2021,Canterbury 001C,E01024081,828,343,190,153,12,12,155,59,96,318,294,24,0
2021,Canterbury 001D,E01024082,625,394,231,163,3,3,55,26,29,173,152,21,0
2021,Canterbury 003D,E01024083,664,338,213,125,0,0,234,155,79,88,77,11,4
2021,Canterbury 010A,E01024084,519,347,188,159,1,1,110,55,55,60,45,15,1
2021,Canterbury 010B,E01024085,651,517,295,222,3,3,16,16,0,114,89,25,1
2021,Canterbury 010C,E01024086,854,541,251,290,10,10,146,102,44,157,135,22,0
2021,Canterbury 010D,E01024087,517,421,238,183,12,12,22,16,6,62,41,21,0
2021,Canterbury 018C,E01024088,652,469,274,195,10,10,56,28,28,117,93,24,0
2021,Canterbury 018D,E01024089,485,393,256,137,1,1,15,7,8,76,62,14,0
2021,Canterbury 014C,E01024090,839,240,127,113,0,0,266,226,40,329,312,17,4
2021,Canterbury 011A,E01024091,504,201,99,102,3,3,186,168,18,112,97,15,2
2021,Canterbury 014D,E01024092,641,113,55,58,15,15,286,197,89,224,218,6,3
2021,Canterbury 014E,E01024093,848,213,133,80,30,30,299,182,117,304,266,38,2
2021,Canterbury 002A,E01024094,1148,964,627,337,23,23,41,11,30,120,95,25,0
2021,Canterbury 001E,E01024095,637,443,246,197,8,8,19,8,11,167,150,17,0
2021,Canterbury 002B,E01024096,767,655,450,205,11,11,20,17,3,81,72,9,0
2021,Canterbury 002C,E01024097,765,571,389,182,32,32,114,58,56,48,41,7,0
2021,Canterbury 002D,E01024098,658,598,410,188,2,2,4,4,0,54,40,14,0
2021,Canterbury 013A,E01024099,530,120,70,50,1,1,206,172,34,200,186,14,3
2021,Canterbury 013B,E01024100,492,259,151,108,1,1,53,41,12,176,174,2,3
2021,Canterbury 013C,E01024101,633,249,151,98,9,9,129,55,74,246,231,15,0
2021,Canterbury 013D,E01024102,678,335,221,114,2,2,58,8,50,283,261,22,0
2021,Canterbury 013E,E01024103,621,152,98,54,4,4,314,26,288,151,137,14,0
2021,Canterbury 020A,E01024104,988,396,255,141,13,13,65,22,43,514,494,20,0
2021,Canterbury 009B,E01024105,696,623,419,204,5,5,33,4,29,35,28,7,0
2021,Canterbury 008E,E01024106,713,590,376,214,11,11,12,9,3,99,85,14,1
2021,Canterbury 009C,E01024107,599,521,303,218,3,3,3,2,1,72,63,9,0
2021,Canterbury 009D,E01024108,539,345,241,104,2,2,136,130,6,55,45,10,1
2021,Canterbury 009E,E01024109,991,877,570,307,2,2,12,3,9,100,81,19,0
2021,Canterbury 011B,E01024110,675,554,345,209,10,10,42,18,24,68,57,11,1
2021,Canterbury 011C,E01024111,621,374,174,200,1,1,181,145,36,61,53,8,4
2021,Canterbury 011D,E01024112,660,584,340,244,6,6,4,1,3,66,50,16,0
2021,Canterbury 011E,E01024113,623,441,270,171,1,1,57,40,17,123,100,23,1
2021,Canterbury 005D,E01024114,801,675,454,221,3,3,11,8,3,112,92,20,0
2021,Canterbury 005E,E01024115,647,597,415,182,0,0,3,1,2,47,39,8,0
2021,Canterbury 007E,E01024116,667,516,349,167,1,1,23,7,16,127,111,16,0
2021,Canterbury 004C,E01024117,665,580,394,186,3,3,9,8,1,72,58,14,1
2021,Canterbury 003E,E01024118,774,610,368,242,1,1,32,25,7,131,115,16,0
2021,Canterbury 004D,E01024119,620,384,186,198,2,2,140,136,4,93,78,15,1
2021,Canterbury 004E,E01024120,814,690,482,208,5,5,5,1,4,114,98,16,0
2021,Canterbury 020B,E01024121,669,370,243,127,1,1,17,8,9,281,272,9,0
2021,Canterbury 020C,E01024122,649,276,142,134,21,21,152,143,9,197,176,21,3
2021,Canterbury 012E,E01024123,621,448,261,187,2,2,34,11,23,137,122,15,0
2021,Canterbury 020D,E01024124,547,235,165,70,4,4,22,3,19,286,247,39,0
2021,Canterbury 020E,E01024126,547,201,94,107,3,3,228,157,71,114,107,7,1
2021,Canterbury 017D,E01024127,680,572,330,242,4,4,44,35,9,60,48,12,0
2021,Canterbury 019A,E01024128,680,229,98,131,3,3,270,227,43,173,160,13,5
2021,Canterbury 019B,E01024129,640,245,119,126,5,5,58,48,10,331,317,14,1
2021,Canterbury 016E,E01024131,682,418,250,168,2,2,3,2,1,259,235,24,0
2021,Dartford 012A,E01024132,488,329,145,184,6,6,119,89,30,33,26,7,1
2021,Dartford 008A,E01024133,469,405,172,233,0,0,12,4,8,52,46,6,0
2021,Dartford 012B,E01024134,642,485,252,233,4,4,89,80,9,62,56,6,2
2021,Dartford 012C,E01024135,550,311,130,181,2,2,149,148,1,88,79,9,0
2021,Dartford 008B,E01024136,634,433,213,220,5,5,35,8,27,161,153,8,0
2021,Dartford 008C,E01024137,658,542,241,301,18,18,17,4,13,81,71,10,0
2021,Dartford 008D,E01024138,683,446,219,227,8,8,133,90,43,96,88,8,0
2021,Dartford 008E,E01024139,689,611,355,256,4,4,8,7,1,66,58,8,0
2021,Dartford 002C,E01024143,1088,686,240,446,32,32,31,10,21,339,321,18,0
2021,Dartford 007A,E01024144,540,497,260,237,0,0,5,3,2,38,32,6,0
2021,Dartford 007B,E01024145,585,505,256,249,3,3,7,4,3,70,59,11,0
2021,Dartford 007C,E01024146,528,492,276,216,0,0,8,7,1,28,22,6,0
2021,Dartford 007D,E01024147,659,561,267,294,1,1,5,2,3,92,81,11,0
2021,Dartford 010A,E01024150,636,582,377,205,1,1,7,5,2,46,35,11,0
2021,Dartford 010B,E01024151,642,598,417,181,5,5,10,4,6,29,25,4,0
2021,Dartford 010C,E01024152,956,697,263,434,10,10,118,46,72,130,121,9,1
2021,Dartford 010D,E01024153,543,514,289,225,3,3,4,3,1,22,20,2,0
2021,Dartford 001C,E01024154,502,242,107,135,1,1,209,192,17,47,41,6,3
2021,Dartford 001D,E01024155,903,516,99,417,10,10,321,240,81,56,47,9,0
2021,Dartford 005A,E01024156,737,381,165,216,4,4,79,61,18,272,260,12,1
2021,Dartford 013A,E01024157,728,568,322,246,8,8,64,63,1,86,75,11,2
2021,Dartford 013B,E01024158,809,599,319,280,33,33,57,36,21,119,105,14,1
2021,Dartford 013C,E01024159,644,606,387,219,0,0,11,9,2,25,23,2,2
2021,Dartford 013D,E01024160,548,519,319,200,2,2,7,7,0,20,15,5,0
2021,Dartford 005B,E01024161,772,517,185,332,2,2,48,41,7,204,192,12,1
2021,Dartford 005C,E01024162,903,538,157,381,17,17,68,34,34,280,267,13,0
2021,Dartford 005D,E01024163,730,557,260,297,5,5,30,18,12,138,127,11,0
2021,Dartford 005E,E01024164,826,448,190,258,8,8,81,22,59,287,264,23,2
2021,Dartford 009A,E01024165,672,179,65,114,1,1,395,208,187,95,89,6,2
2021,Dartford 009B,E01024166,605,327,119,208,1,1,204,199,5,70,65,5,3
2021,Dartford 009C,E01024167,850,491,204,287,3,3,199,97,102,155,142,13,2
2021,Dartford 009D,E01024168,474,331,151,180,3,3,98,94,4,40,31,9,2
2021,Dartford 006A,E01024169,902,543,195,348,24,24,203,159,44,130,112,18,2
2021,Dartford 006B,E01024170,639,292,120,172,2,2,274,210,64,69,64,5,2
2021,Dartford 006C,E01024171,594,390,141,249,2,2,91,88,3,108,98,10,3
2021,Dartford 006D,E01024172,1018,526,179,347,46,46,90,46,44,356,336,20,0
2021,Dartford 011A,E01024173,692,617,308,309,1,1,11,10,1,63,57,6,0
2021,Dartford 012D,E01024174,488,314,143,171,0,0,122,83,39,52,46,6,0
2021,Dartford 012E,E01024175,501,405,194,211,4,4,38,24,14,54,47,7,0
2021,Dartford 004B,E01024176,793,401,180,221,1,1,194,173,21,192,178,14,5
2021,Dartford 004C,E01024177,570,226,104,122,2,2,288,269,19,50,46,4,4
2021,Dartford 004D,E01024178,603,361,155,206,1,1,132,122,10,105,93,12,4
2021,Dartford 002D,E01024179,1133,455,153,302,23,23,196,112,84,457,435,22,2
2021,Dartford 003A,E01024180,1013,500,126,374,67,67,89,40,49,354,333,21,3
2021,Dartford 003B,E01024181,833,509,129,380,9,9,17,9,8,298,281,17,0
2021,Dartford 003C,E01024182,814,295,110,185,23,23,159,74,85,337,313,24,0
2021,Dartford 003D,E01024183,521,430,217,213,2,2,18,3,15,71,62,9,0
2021,Dartford 003E,E01024184,825,572,261,311,27,27,48,12,36,178,158,20,0
2021,Dartford 003F,E01024185,910,570,271,299,47,47,92,44,48,201,191,10,0
2021,Dartford 007E,E01024186,512,439,198,241,1,1,5,4,1,67,59,8,0
2021,Dartford 011B,E01024187,438,365,189,176,0,0,23,22,1,48,38,10,2
2021,Dartford 011C,E01024188,527,458,242,216,0,0,29,28,1,40,32,8,0
2021,Dartford 011D,E01024189,692,507,276,231,1,1,140,104,36,44,35,9,0
2021,Dover 006A,E01024190,557,373,214,159,2,2,64,54,10,118,104,14,0
2021,Dover 006C,E01024192,785,391,176,215,0,0,328,202,126,62,50,12,4
2021,Dover 011A,E01024193,687,234,119,115,0,0,328,168,160,123,117,6,2
2021,Dover 011B,E01024194,626,388,181,207,0,0,53,23,30,185,172,13,0
2021,Dover 011C,E01024195,549,350,150,200,2,2,123,81,42,73,60,13,1
2021,Dover 011D,E01024196,613,259,127,132,0,0,293,246,47,61,50,11,0
2021,Dover 011E,E01024197,671,434,199,235,1,1,116,105,11,120,106,14,0
2021,Dover 014A,E01024198,1157,994,696,298,5,5,62,54,8,96,73,23,0
2021,Dover 008A,E01024200,711,578,377,201,5,5,24,16,8,104,85,19,0
2021,Dover 005A,E01024201,598,452,266,186,0,0,33,29,4,113,94,19,0
2021,Dover 002A,E01024202,793,512,323,189,1,1,193,119,74,84,64,20,3
2021,Dover 008B,E01024203,651,536,348,188,7,7,29,23,6,79,65,14,0
2021,Dover 006D,E01024204,665,485,254,231,0,0,127,87,40,53,43,10,0
2021,Dover 008C,E01024205,640,505,296,209,0,0,87,77,10,48,39,9,0
2021,Dover 001A,E01024206,809,608,360,248,4,4,108,46,62,86,59,27,3
2021,Dover 001B,E01024207,756,578,353,225,3,3,54,24,30,121,101,20,0
2021,Dover 001C,E01024208,712,470,276,194,6,6,112,79,33,124,100,24,0
2021,Dover 001D,E01024209,734,537,333,204,14,14,76,50,26,107,87,20,0
2021,Dover 014B,E01024212,646,487,259,228,3,3,42,8,34,113,104,9,1
2021,Dover 014C,E01024213,558,487,257,230,2,2,2,2,0,67,60,7,0
2021,Dover 013A,E01024214,730,305,137,168,3,3,102,53,49,319,302,17,1
2021,Dover 013B,E01024215,719,236,115,121,1,1,84,29,55,397,377,20,1
2021,Dover 013C,E01024216,623,460,234,226,2,2,9,5,4,152,136,16,0
2021,Dover 007A,E01024218,569,296,148,148,3,3,177,126,51,91,83,8,2
2021,Dover 003A,E01024219,557,382,257,125,2,2,104,96,8,67,57,10,2
2021,Dover 003B,E01024220,750,594,431,163,3,3,29,3,26,122,109,13,2
2021,Dover 003C,E01024221,643,545,358,187,4,4,12,7,5,81,65,16,1
2021,Dover 007B,E01024222,702,368,195,173,3,3,206,164,42,125,112,13,0
2021,Dover 005C,E01024223,623,425,229,196,1,1,112,100,12,85,64,21,0
2021,Dover 007C,E01024224,668,506,300,206,5,5,71,22,49,86,72,14,0
2021,Dover 005D,E01024225,679,501,253,248,1,1,46,14,32,131,114,17,0
2021,Dover 005E,E01024226,692,412,234,178,19,19,183,102,81,78,65,13,0
2021,Dover 003D,E01024227,673,408,270,138,41,41,43,34,9,181,167,14,0
2021,Dover 004A,E01024228,671,444,323,121,2,2,21,17,4,204,178,26,0
2021,Dover 003E,E01024229,710,453,271,182,3,3,129,77,52,122,102,20,3
2021,Dover 004B,E01024230,725,527,388,139,3,3,30,12,18,165,145,20,0
2021,Dover 004C,E01024231,687,421,310,111,2,2,26,10,16,238,213,25,0
2021,Dover 009A,E01024232,906,741,542,199,6,6,67,60,7,92,72,20,0
2021,Dover 010C,E01024233,641,595,355,240,0,0,7,3,4,39,28,11,0
2021,Dover 014D,E01024234,576,503,321,182,4,4,20,12,8,49,33,16,0
2021,Dover 010D,E01024235,686,579,364,215,5,5,17,5,12,85,72,13,0
2021,Dover 009B,E01024236,769,590,367,223,7,7,67,45,22,104,83,21,1
2021,Dover 009C,E01024237,723,626,455,171,2,2,17,14,3,78,65,13,0
2021,Dover 012B,E01024238,536,307,135,172,1,1,62,32,30,166,73,93,0
2021,Dover 012C,E01024239,882,383,218,165,2,2,174,66,108,320,302,18,3
2021,Dover 011F,E01024240,670,166,74,92,3,3,329,221,108,170,165,5,2
2021,Dover 011G,E01024241,897,416,191,225,4,4,166,32,134,311,291,20,0
2021,Dover 002B,E01024242,726,607,411,196,10,10,19,16,3,90,66,24,0
2021,Dover 002C,E01024243,749,447,272,175,10,10,204,172,32,83,69,14,5
2021,Dover 002D,E01024244,935,636,466,170,3,3,52,45,7,244,221,23,0
2021,Dover 002E,E01024245,809,653,400,253,3,3,66,42,24,87,70,17,0
2021,Dover 013D,E01024246,941,383,185,198,8,8,90,35,55,459,432,27,1
2021,Dover 012D,E01024247,959,354,175,179,5,5,228,98,130,367,340,27,5
2021,Dover 011H,E01024248,874,349,142,207,7,7,276,133,143,241,225,16,1
2021,Dover 013E,E01024249,937,366,187,179,2,2,387,269,118,181,164,17,1
2021,Dover 007D,E01024250,754,524,358,166,1,1,114,73,41,115,98,17,0
2021,Dover 007E,E01024251,753,522,347,175,2,2,136,26,110,93,75,18,0
2021,Dover 004D,E01024252,1137,821,553,268,11,11,37,6,31,268,244,24,0
2021,Dover 009D,E01024253,793,677,510,167,6,6,10,2,8,100,80,20,0
2021,Dover 010E,E01024254,917,623,310,313,30,30,168,19,149,96,84,12,0
2021,Dover 008D,E01024255,746,665,424,241,0,0,21,18,3,58,40,18,2
2021,Dover 010F,E01024256,782,685,397,288,1,1,38,6,32,58,48,10,0
2021,Gravesham 002A,E01024257,896,232,95,137,8,8,243,182,61,404,386,18,9
2021,Gravesham 003A,E01024258,659,342,166,176,10,10,67,27,40,240,226,14,0
2021,Gravesham 005A,E01024259,570,488,258,230,1,1,11,9,2,70,64,6,0
2021,Gravesham 005B,E01024260,777,567,306,261,6,6,31,9,22,172,152,20,1
2021,Gravesham 003B,E01024261,949,763,455,308,3,3,23,9,14,160,144,16,0
2021,Gravesham 004A,E01024262,697,358,156,202,2,2,162,103,59,174,160,14,1
2021,Gravesham 004B,E01024263,592,243,109,134,0,0,269,256,13,77,70,7,3
2021,Gravesham 009A,E01024264,623,315,139,176,2,2,259,241,18,46,41,5,1
2021,Gravesham 010A,E01024265,495,454,262,192,0,0,5,2,3,35,25,10,1
2021,Gravesham 010B,E01024266,472,313,187,126,1,1,115,101,14,40,34,6,3
2021,Gravesham 010C,E01024267,629,526,289,237,5,5,47,36,11,51,43,8,0
2021,Gravesham 012A,E01024268,622,569,341,228,0,0,6,5,1,46,35,11,1
2021,Gravesham 012B,E01024269,760,700,417,283,0,0,9,6,3,51,44,7,0
2021,Gravesham 012C,E01024270,603,519,315,204,3,3,10,5,5,71,63,8,0
2021,Gravesham 012D,E01024271,590,423,230,193,2,2,93,78,15,67,53,14,5
2021,Gravesham 012E,E01024272,610,544,344,200,3,3,29,25,4,34,28,6,0
2021,Gravesham 013A,E01024273,588,533,273,260,1,1,2,2,0,50,34,16,2
2021,Gravesham 013B,E01024274,606,550,344,206,8,8,10,7,3,38,30,8,0
2021,Gravesham 013C,E01024275,527,474,210,264,0,0,6,4,2,47,41,6,0
2021,Gravesham 001A,E01024276,977,546,242,304,31,31,113,17,96,286,274,12,1
2021,Gravesham 001B,E01024277,789,290,125,165,6,6,269,215,54,221,204,17,3
2021,Gravesham 001C,E01024278,822,191,69,122,11,11,422,364,58,193,184,9,5
2021,Gravesham 001D,E01024279,622,287,113,174,5,5,94,71,23,231,219,12,5
2021,Gravesham 006B,E01024281,530,384,205,179,1,1,80,53,27,65,56,9,0
2021,Gravesham 004C,E01024282,585,302,129,173,19,19,20,8,12,243,229,14,1
2021,Gravesham 004D,E01024283,483,341,156,185,2,2,25,9,16,115,106,9,0
2021,Gravesham 004E,E01024284,604,310,138,172,3,3,75,30,45,215,192,23,1
2021,Gravesham 006C,E01024285,526,389,217,172,4,4,69,64,5,63,53,10,1
2021,Gravesham 009B,E01024286,612,528,312,216,0,0,38,35,3,45,43,2,1
2021,Gravesham 006D,E01024287,629,364,188,176,0,0,216,205,11,46,39,7,3
2021,Gravesham 006E,E01024288,495,440,256,184,0,0,16,16,0,39,28,11,0
2021,Gravesham 002C,E01024290,634,339,195,144,3,3,72,18,54,218,207,11,2
2021,Gravesham 002D,E01024291,795,302,188,114,1,1,154,74,80,333,325,8,5
2021,Gravesham 005C,E01024292,571,390,208,182,1,1,31,12,19,148,137,11,1
2021,Gravesham 003C,E01024293,595,380,182,198,0,0,57,34,23,158,144,14,0
2021,Gravesham 003D,E01024294,995,478,115,363,30,30,344,258,86,140,131,9,3
2021,Gravesham 002E,E01024295,995,255,117,138,8,8,279,241,38,448,418,30,5
2021,Gravesham 003E,E01024296,1164,509,209,300,26,26,182,80,102,447,422,25,0
2021,Gravesham 008A,E01024297,566,506,264,242,1,1,8,7,1,51,42,9,0
2021,Gravesham 008B,E01024298,530,494,300,194,0,0,3,1,2,33,27,6,0
2021,Gravesham 008C,E01024299,552,473,266,207,1,1,8,4,4,70,64,6,0
2021,Gravesham 010D,E01024300,557,507,296,211,1,1,17,13,4,32,23,9,0
2021,Gravesham 010E,E01024301,508,397,238,159,0,0,64,50,14,46,38,8,1
2021,Gravesham 013D,E01024302,600,469,278,191,0,0,77,35,42,54,44,10,0
2021,Gravesham 011A,E01024303,662,444,199,245,2,2,74,60,14,140,127,13,2
2021,Gravesham 011B,E01024304,662,397,169,228,6,6,171,123,48,85,76,9,3
2021,Gravesham 011C,E01024305,593,205,80,125,4,4,313,243,70,64,57,7,7
2021,Gravesham 011D,E01024306,634,230,45,185,18,18,326,226,100,55,47,8,5
2021,Gravesham 011E,E01024307,616,394,202,192,1,1,174,155,19,42,33,9,5
2021,Gravesham 007A,E01024308,615,192,77,115,4,4,370,342,28,42,39,3,7
2021,Gravesham 008D,E01024309,469,255,112,143,3,3,168,150,18,42,35,7,1
2021,Gravesham 007B,E01024310,622,375,188,187,1,1,200,196,4,44,37,7,2
2021,Gravesham 007C,E01024311,470,248,81,167,5,5,154,141,13,63,55,8,0
2021,Gravesham 008E,E01024312,473,351,154,197,0,0,61,56,5,61,58,3,0
2021,Gravesham 005D,E01024313,617,468,232,236,8,8,63,43,20,76,67,9,2
2021,Gravesham 007D,E01024314,472,376,176,200,2,2,29,25,4,65,57,8,0
2021,Gravesham 007E,E01024315,644,348,158,190,10,10,214,169,45,68,58,10,4
2021,Gravesham 009C,E01024316,884,698,292,406,31,31,83,5,78,72,64,8,0
2021,Gravesham 005E,E01024317,630,446,215,231,3,3,79,10,69,102,96,6,0
2021,Gravesham 005F,E01024318,622,439,225,214,1,1,9,6,3,173,158,15,0
2021,Gravesham 009D,E01024319,556,389,196,193,1,1,121,95,26,45,38,7,0
2021,Maidstone 003A,E01024320,716,603,279,324,27,27,45,14,31,41,26,15,0
2021,Maidstone 003B,E01024321,739,684,426,258,1,1,4,0,4,50,37,13,0
2021,Maidstone 003C,E01024322,489,447,279,168,0,0,4,0,4,38,31,7,0
2021,Maidstone 003D,E01024323,735,602,317,285,15,15,27,3,24,91,84,7,0
2021,Maidstone 003E,E01024324,628,529,306,223,5,5,3,0,3,91,79,12,0
2021,Maidstone 014A,E01024325,1034,932,613,319,8,8,30,4,26,64,49,15,0
2021,Maidstone 007A,E01024326,787,717,445,272,3,3,18,4,14,49,39,10,0
2021,Maidstone 007B,E01024327,672,523,295,228,9,9,19,4,15,121,110,11,0
2021,Maidstone 007C,E01024328,688,555,319,236,3,3,47,6,41,82,68,14,1
2021,Maidstone 007D,E01024329,637,559,332,227,14,14,10,1,9,54,45,9,0
2021,Maidstone 005A,E01024330,640,588,313,275,2,2,1,1,0,49,41,8,0
2021,Maidstone 012A,E01024331,652,527,289,238,16,16,54,9,45,55,52,3,0
2021,Maidstone 015A,E01024332,509,378,214,164,6,6,39,6,33,86,62,24,0
2021,Maidstone 001A,E01024333,526,408,151,257,4,4,8,1,7,106,95,11,0
2021,Maidstone 001C,E01024335,651,551,266,285,1,1,18,4,14,81,61,20,0
2021,Maidstone 005B,E01024336,732,628,304,324,6,6,14,3,11,84,76,8,0
2021,Maidstone 005C,E01024337,612,519,316,203,2,2,6,1,5,85,80,5,0
2021,Maidstone 006A,E01024339,1002,421,176,245,12,12,153,18,135,416,390,26,0
2021,Maidstone 006B,E01024340,1123,522,241,281,50,50,136,12,124,415,396,19,0
2021,Maidstone 003F,E01024341,739,611,364,247,8,8,9,1,8,111,93,18,0
2021,Maidstone 016A,E01024342,947,584,267,317,36,36,224,46,178,102,85,17,1
2021,Maidstone 016B,E01024343,532,462,245,217,8,8,26,4,22,36,28,8,0
2021,Maidstone 016C,E01024344,734,639,360,279,22,22,21,5,16,52,45,7,0
2021,Maidstone 018A,E01024345,635,485,273,212,4,4,42,9,33,104,82,22,0
2021,Maidstone 014B,E01024346,577,438,251,187,2,2,40,10,30,97,81,16,0
2021,Maidstone 001E,E01024347,729,594,308,286,3,3,41,10,31,91,67,24,0
2021,Maidstone 005D,E01024348,530,472,231,241,3,3,2,1,1,53,48,5,0
2021,Maidstone 007E,E01024349,593,415,164,251,4,4,8,2,6,166,153,13,0
2021,Maidstone 015B,E01024350,799,580,230,350,32,32,103,7,96,84,73,11,0
2021,Maidstone 005E,E01024351,662,456,271,185,1,1,62,5,57,143,123,20,0
2021,Maidstone 004A,E01024352,871,342,171,171,4,4,225,46,179,299,266,33,1
2021,Maidstone 002A,E01024353,758,639,319,320,11,11,12,2,10,96,85,11,0
2021,Maidstone 002B,E01024354,592,416,221,195,0,0,8,3,5,168,156,12,0
2021,Maidstone 002C,E01024355,846,560,264,296,4,4,30,4,26,252,235,17,0
2021,Maidstone 006C,E01024356,720,390,157,233,7,7,10,1,9,313,290,23,0
2021,Maidstone 008A,E01024357,685,390,161,229,21,21,71,12,59,203,183,20,0
2021,Maidstone 008B,E01024358,788,395,190,205,1,1,285,50,235,104,91,13,3
2021,Maidstone 009A,E01024360,650,459,204,255,1,1,52,17,35,138,122,16,0
2021,Maidstone 011A,E01024361,768,537,344,193,21,21,105,18,87,105,71,34,0
2021,Maidstone 011B,E01024362,791,617,344,273,10,10,53,5,48,111,91,20,0
2021,Maidstone 017A,E01024364,760,537,320,217,4,4,113,29,84,106,77,29,0
2021,Maidstone 017B,E01024365,1088,807,446,361,47,47,98,20,78,136,111,25,0
2021,Maidstone 017C,E01024366,691,546,309,237,5,5,41,13,28,99,71,28,0
2021,Maidstone 008C,E01024367,620,389,193,196,22,22,94,13,81,115,104,11,0
2021,Maidstone 008E,E01024369,621,528,278,250,5,5,13,0,13,75,68,7,0
2021,Maidstone 010A,E01024371,667,511,259,252,2,2,70,21,49,84,66,18,0
2021,Maidstone 009B,E01024372,918,390,152,238,29,29,108,18,90,390,370,20,1
2021,Maidstone 006E,E01024373,928,428,176,252,22,22,202,32,170,274,257,17,2
2021,Maidstone 009C,E01024374,606,216,73,143,4,4,294,81,213,92,85,7,0
2021,Maidstone 015C,E01024375,1013,812,474,338,12,12,94,13,81,95,64,31,0
2021,Maidstone 016D,E01024376,1021,851,476,375,11,11,77,13,64,82,72,10,0
2021,Maidstone 014C,E01024377,734,529,312,217,7,7,72,13,59,126,103,23,0
2021,Maidstone 014D,E01024378,653,447,220,227,17,17,116,13,103,73,59,14,0
2021,Maidstone 018B,E01024379,698,552,293,259,5,5,34,13,21,107,80,27,0
2021,Maidstone 018C,E01024380,928,662,335,327,32,32,73,20,53,161,133,28,0
2021,Maidstone 018D,E01024381,877,563,251,312,43,43,199,39,160,72,64,8,0
2021,Maidstone 004C,E01024382,620,270,92,178,3,3,45,8,37,302,286,16,0
2021,Maidstone 004D,E01024383,1188,471,138,333,24,24,187,20,167,505,304,201,1
2021,Maidstone 004E,E01024384,811,502,221,281,10,10,188,42,146,111,100,11,0
2021,Maidstone 002D,E01024385,630,499,256,243,2,2,82,6,76,47,41,6,0
2021,Maidstone 002E,E01024386,765,575,305,270,7,7,54,4,50,129,106,23,0
2021,Maidstone 011D,E01024387,1042,797,466,331,3,3,72,13,59,170,139,31,0
2021,Maidstone 013B,E01024390,703,297,103,194,26,26,323,85,238,55,53,2,2
2021,Maidstone 013C,E01024391,480,216,96,120,0,0,216,65,151,48,45,3,0
2021,Maidstone 010B,E01024392,621,375,162,213,3,3,169,47,122,73,59,14,1
2021,Maidstone 010C,E01024393,689,463,290,173,24,24,148,42,106,54,41,13,0
2021,Maidstone 012B,E01024394,538,486,282,204,0,0,13,3,10,39,36,3,0
2021,Maidstone 010D,E01024395,512,349,151,198,3,3,122,35,87,38,30,8,0
2021,Maidstone 010E,E01024396,622,345,150,195,5,5,222,40,182,50,44,6,0
2021,Maidstone 013D,E01024397,613,263,135,128,3,3,294,70,224,53,43,10,0
2021,Maidstone 013E,E01024398,676,292,135,157,13,13,336,85,251,35,32,3,0
2021,Maidstone 013F,E01024399,623,290,136,154,3,3,274,43,231,55,44,11,1
2021,Maidstone 013G,E01024400,551,437,244,193,1,1,73,13,60,38,29,9,2
2021,Maidstone 009D,E01024401,819,449,190,259,40,40,153,16,137,177,169,8,0
2021,Maidstone 012C,E01024402,618,554,313,241,7,7,23,3,20,34,29,5,0
2021,Maidstone 009E,E01024403,919,619,214,405,24,24,105,18,87,171,149,22,0
2021,Maidstone 012D,E01024404,640,563,295,268,0,0,9,2,7,68,63,5,0
2021,Maidstone 012E,E01024405,1115,738,393,345,41,41,197,31,166,139,122,17,0
2021,Maidstone 019A,E01024406,702,471,226,245,30,30,94,16,78,107,91,16,0
2021,Maidstone 019B,E01024407,701,576,279,297,25,25,19,3,16,81,65,16,0
2021,Maidstone 019C,E01024408,636,510,267,243,9,9,19,3,16,98,92,6,0
2021,Maidstone 019D,E01024409,622,476,291,185,2,2,51,8,43,93,85,8,0
2021,Maidstone 015E,E01024410,682,538,314,224,0,0,70,16,54,74,57,17,0
2021,Maidstone 017D,E01024411,522,344,156,188,15,15,75,21,54,88,61,27,0
2021,Sevenoaks 016A,E01024413,715,417,218,199,15,15,129,11,118,154,136,18,0
2021,Sevenoaks 016B,E01024414,605,448,201,247,9,9,26,4,22,122,106,16,0
2021,Sevenoaks 016C,E01024415,502,468,282,186,3,3,7,2,5,24,20,4,0
2021,Sevenoaks 011A,E01024416,638,497,244,253,4,4,43,5,38,94,73,21,0
2021,Sevenoaks 013A,E01024417,662,447,221,226,3,3,117,6,111,94,76,18,1
2021,Sevenoaks 011B,E01024418,515,426,249,177,5,5,39,4,35,45,44,1,0
2021,Sevenoaks 013B,E01024419,751,591,353,238,1,1,22,5,17,137,110,27,0
2021,Sevenoaks 015A,E01024420,874,621,343,278,10,10,93,11,82,150,108,42,0
2021,Sevenoaks 003A,E01024421,829,606,330,276,7,7,126,18,108,90,74,16,0
2021,Sevenoaks 008B,E01024423,759,468,202,266,2,2,67,5,62,222,208,14,0
2021,Sevenoaks 011C,E01024424,485,426,202,224,2,2,12,2,10,45,42,3,0
2021,Sevenoaks 014A,E01024425,931,606,307,299,57,57,152,31,121,116,104,12,0
2021,Sevenoaks 014B,E01024426,885,691,365,326,34,34,53,10,43,107,97,10,0
2021,Sevenoaks 014C,E01024427,543,290,138,152,44,44,172,39,133,35,28,7,2
2021,Sevenoaks 014D,E01024428,526,358,166,192,15,15,127,19,108,25,19,6,1
2021,Sevenoaks 014E,E01024429,702,332,160,172,34,34,245,45,200,90,79,11,1
2021,Sevenoaks 014F,E01024430,578,445,241,204,13,13,13,0,13,107,96,11,0
2021,Sevenoaks 005A,E01024431,804,640,394,246,6,6,72,6,66,86,68,18,0
2021,Sevenoaks 005B,E01024432,606,464,249,215,9,9,88,19,69,45,30,15,0
2021,Sevenoaks 005C,E01024433,591,442,231,211,17,17,42,4,38,90,66,24,0
2021,Sevenoaks 005D,E01024434,905,634,326,308,44,44,103,22,81,124,110,14,0
2021,Sevenoaks 007A,E01024435,633,516,306,210,6,6,47,5,42,64,51,13,0
2021,Sevenoaks 007B,E01024436,716,643,470,173,11,11,20,3,17,42,35,7,0
2021,Sevenoaks 007C,E01024437,619,456,259,197,7,7,102,16,86,54,41,13,0
2021,Sevenoaks 007D,E01024438,611,544,320,224,8,8,5,2,3,54,39,15,0
2021,Sevenoaks 008C,E01024439,653,542,301,241,5,5,68,13,55,38,29,9,0
2021,Sevenoaks 008D,E01024440,773,663,351,312,2,2,23,5,18,85,69,16,0
2021,Sevenoaks 004A,E01024441,656,623,412,211,1,1,5,2,3,27,21,6,0
2021,Sevenoaks 004B,E01024442,595,524,324,200,1,1,11,3,8,59,46,13,0
2021,Sevenoaks 004C,E01024443,662,579,418,161,14,14,14,2,12,55,43,12,0
2021,Sevenoaks 004D,E01024444,515,259,106,153,8,8,194,29,165,54,50,4,0
2021,Sevenoaks 001A,E01024445,543,491,298,193,4,4,12,1,11,35,32,3,1
2021,Sevenoaks 001B,E01024446,590,509,297,212,3,3,12,2,10,66,54,12,0
2021,Sevenoaks 001C,E01024447,556,426,235,191,0,0,81,15,66,47,41,6,2
2021,Sevenoaks 009A,E01024448,517,392,193,199,12,12,62,4,58,51,46,5,0
2021,Sevenoaks 009B,E01024449,564,520,318,202,5,5,18,3,15,21,18,3,0
2021,Sevenoaks 009C,E01024450,641,464,259,205,12,12,95,9,86,70,57,13,0
2021,Sevenoaks 015B,E01024451,960,645,332,313,19,19,133,19,114,163,137,26,0
2021,Sevenoaks 008E,E01024452,614,428,261,167,5,5,91,6,85,90,71,19,0
2021,Sevenoaks 009D,E01024453,646,583,335,248,2,2,15,3,12,46,32,14,0
2021,Sevenoaks 009E,E01024454,613,479,267,212,8,8,94,13,81,32,29,3,0
2021,Sevenoaks 015C,E01024455,483,346,188,158,1,1,47,2,45,89,69,20,0
2021,Sevenoaks 015D,E01024456,512,407,261,146,4,4,54,3,51,46,32,14,1
2021,Sevenoaks 010A,E01024457,536,305,145,160,34,34,147,18,129,50,43,7,0
2021,Sevenoaks 012A,E01024458,537,441,234,207,3,3,7,0,7,86,74,12,0
2021,Sevenoaks 012B,E01024459,632,481,270,211,1,1,68,7,61,82,60,22,0
2021,Sevenoaks 010B,E01024460,665,385,184,201,19,19,185,24,161,75,63,12,1
2021,Sevenoaks 010C,E01024461,1016,666,326,340,9,9,96,8,88,245,219,26,0
2021,Sevenoaks 012C,E01024462,646,461,249,212,1,1,132,18,114,52,42,10,0
2021,Sevenoaks 011D,E01024463,569,465,228,237,5,5,14,2,12,85,72,13,0
2021,Sevenoaks 011E,E01024464,601,514,311,203,5,5,22,3,19,60,42,18,0
2021,Sevenoaks 010D,E01024465,612,320,142,178,49,49,102,20,82,139,127,12,2
2021,Sevenoaks 010E,E01024466,542,307,143,164,22,22,150,13,137,63,58,5,0
2021,Sevenoaks 011F,E01024467,639,531,241,290,1,1,24,3,21,83,75,8,0
2021,Sevenoaks 010F,E01024468,664,457,233,224,10,10,43,5,38,154,138,16,0
2021,Sevenoaks 012D,E01024469,811,433,223,210,4,4,23,2,21,351,320,31,0
2021,Sevenoaks 012E,E01024470,668,470,243,227,2,2,56,8,48,140,136,4,0
2021,Sevenoaks 012F,E01024471,778,402,254,148,4,4,146,6,140,226,171,55,0
2021,Sevenoaks 001D,E01024472,537,399,189,210,4,4,96,18,78,38,31,7,0
2021,Sevenoaks 003B,E01024473,638,534,258,276,6,6,46,14,32,52,44,8,0
2021,Sevenoaks 003C,E01024474,653,587,270,317,13,13,13,5,8,40,34,6,0
2021,Sevenoaks 003D,E01024475,694,493,260,233,6,6,56,10,46,139,125,14,0
2021,Sevenoaks 002A,E01024476,659,230,81,149,26,26,360,57,303,43,37,6,0
2021,Sevenoaks 002B,E01024477,624,266,111,155,9,9,274,55,219,71,62,9,4
2021,Sevenoaks 002C,E01024478,593,442,227,215,6,6,78,18,60,67,58,9,0
2021,Sevenoaks 001E,E01024479,641,529,279,250,11,11,28,2,26,73,60,13,0
2021,Sevenoaks 002D,E01024480,818,367,180,187,17,17,369,82,287,63,58,5,2
2021,Sevenoaks 002E,E01024481,670,344,154,190,5,5,259,54,205,61,55,6,1
2021,Sevenoaks 002F,E01024482,669,324,162,162,15,15,260,50,210,68,60,8,2
2021,Sevenoaks 013C,E01024483,694,474,246,228,7,7,31,5,26,182,168,14,0
2021,Sevenoaks 013D,E01024484,504,412,244,168,2,2,27,3,24,63,46,17,0
2021,Sevenoaks 013E,E01024485,740,420,195,225,23,23,227,27,200,68,61,7,2
2021,Folkestone and Hythe 011A,E01024486,871,639,430,209,2,2,133,105,28,96,76,20,1
2021,Folkestone and Hythe 011B,E01024487,577,497,336,161,0,0,2,2,0,78,64,14,0
2021,Folkestone and Hythe 011C,E01024488,646,525,404,121,2,2,55,49,6,61,45,16,3
2021,Folkestone and Hythe 009A,E01024489,750,688,527,161,4,4,8,6,2,50,36,14,0
2021,Folkestone and Hythe 001A,E01024490,879,722,490,232,4,4,31,20,11,122,93,29,0
2021,Folkestone and Hythe 005A,E01024491,556,386,165,221,2,2,30,24,6,138,116,22,0
2021,Folkestone and Hythe 002A,E01024492,635,414,199,215,3,3,93,76,17,123,101,22,2
2021,Folkestone and Hythe 005B,E01024493,617,361,194,167,17,17,146,120,26,91,74,17,2
2021,Folkestone and Hythe 005C,E01024494,766,468,229,239,18,18,169,121,48,109,78,31,2
2021,Folkestone and Hythe 005D,E01024495,861,429,173,256,22,22,162,65,97,248,123,125,0
2021,Folkestone and Hythe 003A,E01024496,640,343,165,178,3,3,185,115,70,109,89,20,0
2021,Folkestone and Hythe 003B,E01024497,650,437,242,195,2,2,122,107,15,89,74,15,0
2021,Folkestone and Hythe 003C,E01024498,640,242,112,130,1,1,324,289,35,69,53,16,4
2021,Folkestone and Hythe 004A,E01024499,661,343,165,178,1,1,68,11,57,248,223,25,1
2021,Folkestone and Hythe 004B,E01024500,539,242,103,139,3,3,149,101,48,144,133,11,1
2021,Folkestone and Hythe 004C,E01024501,603,343,156,187,0,0,17,6,11,243,229,14,0
2021,Folkestone and Hythe 004D,E01024502,589,279,133,146,0,0,93,36,57,216,205,11,1
2021,Folkestone and Hythe 003D,E01024503,752,453,243,210,1,1,185,117,68,111,97,14,2
2021,Folkestone and Hythe 014A,E01024504,942,258,126,132,1,1,131,81,50,550,530,20,2
2021,Folkestone and Hythe 004E,E01024505,814,388,196,192,4,4,161,99,62,261,241,20,0
2021,Folkestone and Hythe 014B,E01024507,982,237,102,135,9,9,240,150,90,492,476,16,4
2021,Folkestone and Hythe 015A,E01024508,1086,402,250,152,1,1,74,7,67,609,583,26,0
2021,Folkestone and Hythe 015B,E01024509,857,415,284,131,1,1,50,14,36,391,366,25,0
2021,Folkestone and Hythe 015C,E01024510,812,452,257,195,1,1,23,11,12,336,315,21,0
2021,Folkestone and Hythe 006A,E01024511,694,539,296,243,11,11,5,4,1,139,129,10,0
2021,Folkestone and Hythe 006B,E01024512,709,450,231,219,0,0,26,12,14,233,205,28,0
2021,Folkestone and Hythe 006C,E01024513,662,437,218,219,6,6,51,19,32,167,158,9,1
2021,Folkestone and Hythe 006D,E01024514,504,392,206,186,1,1,2,1,1,108,93,15,1
2021,Folkestone and Hythe 006E,E01024515,785,632,368,264,10,10,8,7,1,135,110,25,0
2021,Folkestone and Hythe 006F,E01024516,548,436,276,160,0,0,79,6,73,33,24,9,0
2021,Folkestone and Hythe 015D,E01024517,752,337,167,170,0,0,11,6,5,404,386,18,0
2021,Folkestone and Hythe 003E,E01024518,673,533,302,231,0,0,83,11,72,57,44,13,0
2021,Folkestone and Hythe 006G,E01024519,678,471,304,167,7,7,54,37,17,146,135,11,0
2021,Folkestone and Hythe 005E,E01024520,665,369,181,188,6,6,156,20,136,134,116,18,0
2021,Folkestone and Hythe 006H,E01024521,821,581,369,212,6,6,20,13,7,214,197,17,0
2021,Folkestone and Hythe 010A,E01024522,717,473,329,144,24,24,69,28,41,150,132,18,1
2021,Folkestone and Hythe 008A,E01024523,679,623,433,190,1,1,6,5,1,49,43,6,0
2021,Folkestone and Hythe 010B,E01024524,785,380,256,124,13,13,263,194,69,125,109,16,4
2021,Folkestone and Hythe 010C,E01024525,832,490,370,120,5,5,46,15,31,291,266,25,0
2021,Folkestone and Hythe 008B,E01024526,664,594,388,206,0,0,3,0,3,67,51,16,0
2021,Folkestone and Hythe 008C,E01024527,775,655,481,174,9,9,17,11,6,94,85,9,0
2021,Folkestone and Hythe 005F,E01024528,558,371,213,158,0,0,73,60,13,114,84,30,0
2021,Folkestone and Hythe 010D,E01024529,708,482,365,117,1,1,149,137,12,75,65,10,1
2021,Folkestone and Hythe 009B,E01024530,772,681,346,335,0,0,17,8,9,74,50,24,0
2021,Folkestone and Hythe 010E,E01024531,646,461,289,172,4,4,95,83,12,85,70,15,1
2021,Folkestone and Hythe 013A,E01024532,532,458,305,153,2,2,2,0,2,69,56,13,1
2021,Folkestone and Hythe 013B,E01024533,541,438,325,113,1,1,3,2,1,99,90,9,0
2021,Folkestone and Hythe 013C,E01024534,620,332,175,157,5,5,205,158,47,75,63,12,3
2021,Folkestone and Hythe 013D,E01024535,1048,784,483,301,6,6,37,24,13,219,189,30,2
2021,Folkestone and Hythe 009C,E01024536,791,671,403,268,7,7,23,19,4,90,69,21,0
2021,Folkestone and Hythe 012A,E01024537,739,600,421,179,7,7,4,3,1,127,107,20,1
2021,Folkestone and Hythe 012B,E01024538,721,651,472,179,4,4,2,2,0,64,52,12,0
2021,Folkestone and Hythe 012C,E01024539,931,488,296,192,16,16,249,131,118,178,159,19,0
2021,Folkestone and Hythe 012D,E01024540,787,664,436,228,22,22,30,9,21,71,60,11,0
2021,Folkestone and Hythe 002B,E01024541,951,579,264,315,10,10,233,98,135,128,106,22,1
2021,Folkestone and Hythe 002C,E01024542,801,640,356,284,4,4,28,2,26,129,102,27,0
2021,Folkestone and Hythe 001B,E01024544,584,498,325,173,6,6,23,17,6,56,40,16,1
2021,Folkestone and Hythe 001C,E01024545,615,530,334,196,4,4,4,2,2,77,52,25,0
2021,Folkestone and Hythe 009D,E01024546,716,579,301,278,6,6,60,42,18,71,54,17,0
2021,Folkestone and Hythe 001D,E01024547,623,474,326,148,0,0,74,58,16,73,56,17,2
2021,Folkestone and Hythe 011D,E01024548,515,358,207,151,0,0,91,68,23,66,46,20,0
2021,Folkestone and Hythe 011E,E01024549,501,375,215,160,6,6,51,38,13,68,49,19,1
2021,Folkestone and Hythe 008D,E01024550,860,703,438,265,8,8,39,28,11,110,83,27,0
2021,Swale 015A,E01024551,999,616,314,302,16,16,89,12,77,278,245,33,0
2021,Swale 015B,E01024552,906,502,201,301,41,41,269,48,221,93,76,17,1
2021,Swale 015C,E01024553,1043,649,452,197,7,7,49,2,47,338,304,34,0
2021,Swale 009A,E01024554,996,787,433,354,9,9,78,9,69,122,103,19,0
2021,Swale 017A,E01024555,554,430,254,176,0,0,62,7,55,62,40,22,0
2021,Swale 017B,E01024556,509,370,235,135,0,0,55,8,47,84,67,17,0
2021,Swale 017C,E01024557,639,437,215,222,6,6,140,26,114,56,43,13,0
2021,Swale 017D,E01024558,705,580,347,233,1,1,30,9,21,94,77,17,0
2021,Swale 010A,E01024559,669,320,181,139,12,12,82,18,64,255,235,20,0
2021,Swale 012A,E01024560,521,302,139,163,2,2,97,15,82,120,113,7,0
2021,Swale 009B,E01024561,739,530,156,374,8,8,39,10,29,162,153,9,0
2021,Swale 012B,E01024562,664,485,201,284,3,3,25,1,24,151,136,15,0
2021,Swale 015D,E01024563,644,278,155,123,1,1,319,70,249,46,39,7,0
2021,Swale 014A,E01024564,540,456,269,187,7,7,31,3,28,46,31,15,0
2021,Swale 016A,E01024565,536,379,235,144,5,5,64,8,56,88,69,19,0
2021,Swale 016B,E01024566,627,446,271,175,1,1,89,10,79,91,72,19,0
2021,Swale 012C,E01024569,723,571,322,249,4,4,42,8,34,106,92,14,0
2021,Swale 008A,E01024570,702,511,282,229,3,3,137,13,124,51,41,10,0
2021,Swale 008B,E01024571,827,612,296,316,11,11,79,9,70,125,106,19,0
2021,Swale 008C,E01024572,533,487,242,245,1,1,2,0,2,43,28,15,0
2021,Swale 008D,E01024573,536,423,235,188,9,9,54,12,42,50,41,9,0
2021,Swale 008E,E01024575,503,433,242,191,3,3,28,6,22,39,29,10,0
2021,Swale 007B,E01024576,682,516,197,319,15,15,10,1,9,140,131,9,1
2021,Swale 007C,E01024577,524,380,191,189,1,1,88,9,79,55,49,6,0
2021,Swale 007D,E01024578,658,491,200,291,3,3,54,10,44,110,94,16,0
2021,Swale 006A,E01024580,962,628,467,161,5,5,80,7,73,249,209,40,0
2021,Swale 006B,E01024581,573,436,239,197,1,1,16,0,16,120,105,15,0
2021,Swale 009E,E01024582,632,465,231,234,1,1,44,7,37,120,112,8,2
2021,Swale 007F,E01024583,672,457,192,265,3,3,128,25,103,84,78,6,0
2021,Swale 010B,E01024584,741,324,168,156,9,9,292,63,229,116,98,18,0
2021,Swale 003A,E01024585,609,345,203,142,2,2,194,31,163,67,54,13,1
2021,Swale 006C,E01024586,693,571,347,224,2,2,15,5,10,105,84,21,0
2021,Swale 003B,E01024587,824,686,392,294,3,3,17,2,15,118,95,23,0
2021,Swale 003C,E01024588,657,566,358,208,3,3,20,2,18,68,61,7,0
2021,Swale 003D,E01024589,694,615,397,218,3,3,22,3,19,54,36,18,0
2021,Swale 010C,E01024590,610,172,75,97,6,6,316,71,245,114,105,9,2
2021,Swale 011A,E01024591,1007,625,205,420,24,24,139,26,113,219,201,18,0
2021,Swale 011B,E01024592,525,419,208,211,0,0,25,6,19,81,70,11,0
2021,Swale 011C,E01024593,511,340,155,185,6,6,46,6,40,119,113,6,0
2021,Swale 005A,E01024594,606,510,313,197,0,0,12,1,11,84,71,13,0
2021,Swale 004A,E01024595,657,519,284,235,1,1,17,2,15,120,106,14,0
2021,Swale 005B,E01024596,693,420,218,202,3,3,76,14,62,194,178,16,0
2021,Swale 005C,E01024597,718,319,153,166,35,35,205,37,168,159,140,19,0
2021,Swale 004B,E01024598,666,524,242,282,1,1,7,0,7,134,122,12,0
2021,Swale 010D,E01024599,879,479,220,259,2,2,96,16,80,302,290,12,0
2021,Swale 011D,E01024600,601,334,181,153,2,2,202,35,167,63,50,13,0
2021,Swale 011E,E01024601,736,468,250,218,18,18,147,18,129,103,90,13,0
2021,Swale 015E,E01024602,678,476,280,196,2,2,73,3,70,127,112,15,0
2021,Swale 014B,E01024603,517,408,219,189,9,9,16,0,16,84,78,6,0
2021,Swale 014C,E01024604,485,205,95,110,8,8,186,23,163,86,76,10,0
2021,Swale 014D,E01024605,580,487,311,176,3,3,25,0,25,65,49,16,0
2021,Swale 013A,E01024606,542,408,212,196,7,7,30,4,26,97,91,6,0
2021,Swale 010E,E01024608,900,430,252,178,4,4,114,23,91,352,331,21,0
2021,Swale 001A,E01024609,630,166,88,78,3,3,76,17,59,385,373,12,0
2021,Swale 001B,E01024610,714,314,170,144,8,8,55,7,48,337,320,17,0
2021,Swale 001C,E01024611,623,260,126,134,3,3,31,4,27,329,312,17,0
2021,Swale 001D,E01024612,654,345,194,151,4,4,38,13,25,267,249,18,0
2021,Swale 002A,E01024613,699,235,114,121,3,3,138,26,112,323,309,14,0
2021,Swale 002B,E01024614,627,213,104,109,5,5,300,60,240,106,95,11,3
2021,Swale 002C,E01024615,600,204,98,106,0,0,328,64,264,68,59,9,0
2021,Swale 002D,E01024616,701,393,196,197,7,7,207,44,163,94,80,14,0
2021,Swale 004D,E01024619,600,495,292,203,2,2,10,1,9,93,86,7,0
2021,Swale 005D,E01024620,650,522,307,215,1,1,22,5,17,105,94,11,0
2021,Swale 004E,E01024621,522,228,87,141,0,0,253,40,213,40,37,3,1
2021,Swale 016C,E01024622,733,514,288,226,5,5,99,14,85,115,95,20,0
2021,Swale 016D,E01024623,847,559,288,271,18,18,162,17,145,107,93,14,1
2021,Swale 016E,E01024624,1118,666,252,414,86,86,152,16,136,212,185,27,2
2021,Swale 015F,E01024625,819,653,393,260,11,11,49,5,44,106,91,15,0
2021,Swale 014E,E01024626,792,634,294,340,14,14,73,10,63,71,62,9,0
2021,Swale 014F,E01024627,816,436,239,197,1,1,278,40,238,100,81,19,1
2021,Swale 013C,E01024628,611,456,268,188,4,4,46,6,40,105,90,15,0
2021,Swale 013D,E01024629,457,401,223,178,1,1,22,4,18,33,28,5,0
2021,Swale 012D,E01024630,749,571,379,192,3,3,90,19,71,85,70,15,0
2021,Swale 013E,E01024631,647,589,370,219,1,1,15,3,12,42,31,11,0
2021,Swale 012E,E01024632,641,589,390,199,0,0,13,1,12,39,31,8,0
2021,Thanet 006A,E01024633,652,366,171,195,2,2,176,65,111,107,91,16,1
2021,Thanet 006B,E01024634,534,320,160,160,3,3,125,42,83,86,75,11,0
2021,Thanet 009A,E01024635,699,544,329,215,3,3,31,20,11,121,101,20,0
2021,Thanet 008A,E01024636,1094,896,673,223,5,5,26,12,14,167,141,26,0
2021,Thanet 008B,E01024637,773,705,513,192,2,2,8,2,6,58,49,9,0
2021,Thanet 008C,E01024638,807,653,459,194,3,3,35,8,27,116,102,14,0
2021,Thanet 008D,E01024639,832,595,420,175,1,1,32,2,30,204,187,17,0
2021,Thanet 008E,E01024640,781,673,485,188,4,4,33,19,14,71,55,16,0
2021,Thanet 007A,E01024641,733,463,281,182,2,2,172,82,90,96,85,11,0
2021,Thanet 009B,E01024642,692,578,441,137,1,1,9,3,6,104,80,24,0
2021,Thanet 010A,E01024643,586,327,221,106,1,1,44,11,33,214,193,21,0
2021,Thanet 009C,E01024644,601,549,397,152,0,0,7,2,5,45,33,12,0
2021,Thanet 015A,E01024645,648,425,215,210,1,1,65,15,50,157,140,17,0
2021,Thanet 016A,E01024646,1016,449,293,156,1,1,98,15,83,467,438,29,1
2021,Thanet 015B,E01024647,652,403,192,211,6,6,19,10,9,224,207,17,0
2021,Thanet 016B,E01024648,766,352,187,165,8,8,92,25,67,314,294,20,0
2021,Thanet 016C,E01024649,968,387,227,160,5,5,94,72,22,482,454,28,0
2021,Thanet 017A,E01024650,658,589,365,224,2,2,3,1,2,63,51,12,1
2021,Thanet 017B,E01024651,726,422,297,125,1,1,110,26,84,193,168,25,0
2021,Thanet 017C,E01024652,811,727,439,288,6,6,6,1,5,72,56,16,0
2021,Thanet 002A,E01024653,728,597,380,217,0,0,20,3,17,111,97,14,0
2021,Thanet 002B,E01024654,757,553,357,196,3,3,67,4,63,134,111,23,0
2021,Thanet 002C,E01024655,663,583,401,182,20,20,7,3,4,53,40,13,0
2021,Thanet 002D,E01024656,805,600,392,208,7,7,23,6,17,175,164,11,0
2021,Thanet 001A,E01024657,1133,262,131,131,6,6,57,22,35,808,781,27,0
2021,Thanet 001B,E01024658,1130,317,200,117,5,5,255,68,187,550,531,19,3
2021,Thanet 001C,E01024659,713,357,216,141,0,0,48,23,25,308,296,12,0
2021,Thanet 001D,E01024660,779,266,135,131,6,6,48,27,21,456,436,20,3
2021,Thanet 004A,E01024661,668,274,133,141,2,2,16,3,13,376,357,19,0
2021,Thanet 006C,E01024662,641,393,255,138,3,3,159,91,68,86,71,15,0
2021,Thanet 006D,E01024663,588,169,85,84,1,1,325,244,81,90,78,12,3
2021,Thanet 004B,E01024664,630,336,168,168,2,2,140,48,92,152,139,13,0
2021,Thanet 004C,E01024665,609,425,190,235,3,3,46,18,28,135,116,19,0
2021,Thanet 006E,E01024666,692,318,182,136,3,3,279,197,82,90,82,8,2
2021,Thanet 016D,E01024667,986,214,123,91,1,1,385,229,156,383,352,31,3
2021,Thanet 015C,E01024668,497,304,133,171,1,1,24,16,8,168,146,22,0
2021,Thanet 012A,E01024669,745,422,192,230,1,1,59,5,54,263,233,30,0
2021,Thanet 015D,E01024670,752,342,155,187,2,2,60,18,42,348,319,29,0
2021,Thanet 016E,E01024671,907,394,242,152,0,0,73,27,46,440,417,23,0
2021,Thanet 005A,E01024672,629,324,150,174,1,1,237,71,166,67,54,13,0
2021,Thanet 005B,E01024673,817,560,316,244,2,2,50,26,24,204,179,25,1
2021,Thanet 005C,E01024674,607,525,250,275,3,3,20,11,9,59,48,11,0
2021,Thanet 002E,E01024675,897,766,496,270,1,1,5,0,5,125,103,22,0
2021,Thanet 003A,E01024676,1022,226,118,108,1,1,206,68,138,586,562,24,3
2021,Thanet 003B,E01024677,720,331,155,176,1,1,55,30,25,333,307,26,0
2021,Thanet 017D,E01024679,610,505,343,162,1,1,65,4,61,39,30,9,0
2021,Thanet 017E,E01024680,708,566,323,243,5,5,15,2,13,122,101,21,0
2021,Thanet 015E,E01024681,769,465,211,254,1,1,38,0,38,265,242,23,0
2021,Thanet 013A,E01024682,841,296,129,167,19,19,397,202,195,128,115,13,1
2021,Thanet 013B,E01024683,661,212,109,103,1,1,362,195,167,86,76,10,0
2021,Thanet 013C,E01024684,694,417,203,214,2,2,85,33,52,190,162,28,0
2021,Thanet 013D,E01024685,728,471,265,206,1,1,135,74,61,121,95,26,0
2021,Thanet 011A,E01024686,729,476,301,175,1,1,141,70,71,110,100,10,1
2021,Thanet 013E,E01024687,614,243,119,124,1,1,276,139,137,91,81,10,3
2021,Thanet 011B,E01024688,771,568,352,216,7,7,66,46,20,130,92,38,0
2021,Thanet 011C,E01024689,540,460,308,152,0,0,9,3,6,71,61,10,0
2021,Thanet 011D,E01024690,658,475,333,142,1,1,122,16,106,60,52,8,0
2021,Thanet 011E,E01024691,488,389,213,176,2,2,8,4,4,89,75,14,0
2021,Thanet 009D,E01024692,829,526,340,186,3,3,101,9,92,199,170,29,0
2021,Thanet 009E,E01024693,611,479,293,186,1,1,7,0,7,124,108,16,0
2021,Thanet 004D,E01024694,655,368,171,197,2,2,153,48,105,131,95,36,1
2021,Thanet 003C,E01024695,504,325,132,193,3,3,7,4,3,169,151,18,0
2021,Thanet 004E,E01024696,628,441,230,211,0,0,46,10,36,141,120,21,0
2021,Thanet 003D,E01024697,498,189,87,102,3,3,161,33,128,145,137,8,0
2021,Thanet 012B,E01024698,634,430,235,195,2,2,20,3,17,182,168,14,0
2021,Thanet 012C,E01024699,761,412,224,188,1,1,248,85,163,100,90,10,0
2021,Thanet 012D,E01024700,730,535,306,229,1,1,20,3,17,174,152,22,0
2021,Thanet 014B,E01024702,620,356,232,124,2,2,154,34,120,108,93,15,0
2021,Thanet 014C,E01024703,803,611,353,258,5,5,52,14,38,135,111,24,0
2021,Thanet 014D,E01024704,781,626,358,268,8,8,55,22,33,92,74,18,0
2021,Thanet 010B,E01024705,556,293,203,90,2,2,30,4,26,231,220,11,0
2021,Thanet 010C,E01024706,648,439,278,161,16,16,11,4,7,182,168,14,0
2021,Thanet 010D,E01024707,598,435,271,164,0,0,9,3,6,154,138,16,0
2021,Thanet 010E,E01024708,845,719,492,227,17,17,33,4,29,76,60,16,0
2021,Thanet 012E,E01024709,626,523,362,161,3,3,47,4,43,53,51,2,0
2021,Thanet 003E,E01024710,793,275,161,114,2,2,26,7,19,489,458,31,1
2021,Thanet 005D,E01024711,568,454,253,201,1,1,40,3,37,73,65,8,0
2021,Thanet 005E,E01024712,640,579,341,238,0,0,3,1,2,58,45,13,0
2021,Thanet 007B,E01024713,744,461,209,252,5,5,147,86,61,131,113,18,0
2021,Thanet 007C,E01024714,823,501,367,134,3,3,66,5,61,253,234,19,0
2021,Thanet 007D,E01024715,1010,478,305,173,3,3,32,9,23,497,460,37,0
2021,Thanet 007E,E01024716,873,674,342,332,7,7,42,12,30,150,128,22,0
2021,Tonbridge and Malling 005A,E01024717,979,412,158,254,19,19,452,32,420,96,74,22,0
2021,Tonbridge and Malling 005B,E01024718,524,495,285,210,3,3,5,1,4,21,16,5,0
2021,Tonbridge and Malling 001A,E01024719,929,649,247,402,38,38,123,6,117,119,99,20,0
2021,Tonbridge and Malling 001B,E01024720,546,497,277,220,2,2,18,1,17,29,23,6,0
2021,Tonbridge and Malling 001C,E01024721,530,477,242,235,1,1,7,1,6,45,38,7,0
2021,Tonbridge and Malling 001D,E01024722,555,485,217,268,0,0,6,3,3,63,55,8,1
2021,Tonbridge and Malling 006A,E01024723,659,498,271,227,5,5,63,2,61,93,68,25,0
2021,Tonbridge and Malling 006B,E01024724,809,692,364,328,4,4,28,2,26,85,67,18,0
2021,Tonbridge and Malling 006C,E01024725,850,638,307,331,24,24,35,5,30,153,135,18,0
2021,Tonbridge and Malling 006D,E01024726,777,510,278,232,6,6,180,28,152,81,69,12,0
2021,Tonbridge and Malling 001F,E01024728,733,514,250,264,6,6,161,22,139,51,41,10,1
2021,Tonbridge and Malling 011A,E01024729,708,414,236,178,18,18,245,29,216,31,30,1,0
2021,Tonbridge and Malling 009A,E01024730,580,475,334,141,16,16,53,6,47,36,28,8,0
2021,Tonbridge and Malling 009B,E01024731,486,451,302,149,4,4,10,1,9,21,14,7,0
2021,Tonbridge and Malling 012A,E01024732,794,387,195,192,41,41,62,6,56,304,251,53,0
2021,Tonbridge and Malling 012B,E01024733,741,540,288,252,8,8,17,4,13,176,148,28,0
2021,Tonbridge and Malling 010A,E01024734,681,519,296,223,5,5,81,13,68,76,63,13,0
2021,Tonbridge and Malling 005C,E01024735,602,524,304,220,8,8,27,7,20,42,36,6,1
2021,Tonbridge and Malling 005D,E01024736,741,485,225,260,12,12,183,24,159,61,49,12,0
2021,Tonbridge and Malling 005E,E01024737,965,658,294,364,30,30,169,24,145,108,86,22,0
2021,Tonbridge and Malling 014A,E01024740,846,607,336,271,14,14,101,6,95,124,108,16,0
2021,Tonbridge and Malling 003A,E01024741,572,230,108,122,16,16,309,52,257,17,11,6,0
2021,Tonbridge and Malling 014B,E01024742,725,360,162,198,18,18,294,46,248,53,43,10,0
2021,Tonbridge and Malling 008A,E01024743,768,505,283,222,14,14,156,13,143,93,74,19,0
2021,Tonbridge and Malling 008B,E01024744,810,664,388,276,11,11,30,5,25,105,74,31,0
2021,Tonbridge and Malling 008C,E01024745,709,583,360,223,12,12,42,3,39,72,54,18,0
2021,Tonbridge and Malling 007A,E01024746,441,313,173,140,3,3,28,0,28,97,67,30,0
2021,Tonbridge and Malling 008D,E01024747,651,312,183,129,8,8,295,25,270,36,30,6,0
2021,Tonbridge and Malling 011B,E01024748,534,494,297,197,2,2,8,1,7,30,23,7,0
2021,Tonbridge and Malling 011C,E01024749,617,291,140,151,11,11,271,41,230,43,38,5,1
2021,Tonbridge and Malling 011D,E01024750,635,470,281,189,4,4,124,11,113,37,33,4,0
2021,Tonbridge and Malling 011E,E01024751,644,592,375,217,0,0,5,0,5,47,38,9,0
2021,Tonbridge and Malling 010B,E01024752,642,586,315,271,0,0,8,1,7,48,37,11,0
2021,Tonbridge and Malling 010C,E01024753,602,493,273,220,4,4,55,9,46,50,37,13,0
2021,Tonbridge and Malling 010D,E01024754,664,550,296,254,3,3,40,4,36,71,63,8,0
2021,Tonbridge and Malling 006E,E01024755,768,675,366,309,5,5,27,3,24,61,51,10,0
2021,Tonbridge and Malling 012C,E01024756,641,337,140,197,17,17,147,21,126,140,133,7,0
2021,Tonbridge and Malling 013A,E01024757,694,476,208,268,10,10,53,5,48,155,142,13,0
2021,Tonbridge and Malling 013B,E01024758,673,451,225,226,20,20,111,15,96,91,83,8,0
2021,Tonbridge and Malling 007C,E01024760,540,426,209,217,3,3,88,11,77,23,18,5,0
2021,Tonbridge and Malling 003B,E01024761,895,696,364,332,19,19,87,10,77,93,89,4,0
2021,Tonbridge and Malling 003C,E01024762,901,713,315,398,20,20,41,5,36,127,111,16,0
2021,Tonbridge and Malling 003D,E01024763,523,409,219,190,11,11,67,6,61,36,27,9,0
2021,Tonbridge and Malling 003E,E01024764,604,349,190,159,7,7,175,25,150,73,56,17,0
2021,Tonbridge and Malling 003F,E01024765,538,463,239,224,4,4,29,8,21,42,34,8,0
2021,Tonbridge and Malling 012E,E01024767,778,374,162,212,38,38,316,43,273,50,43,7,0
2021,Tonbridge and Malling 012F,E01024768,871,597,320,277,11,11,26,3,23,237,209,28,0
2021,Tonbridge and Malling 002C,E01024771,791,422,152,270,32,32,176,24,152,160,144,16,1
2021,Tonbridge and Malling 002D,E01024772,674,532,263,269,19,19,48,2,46,75,67,8,0
2021,Tonbridge and Malling 002E,E01024773,737,654,389,265,12,12,18,2,16,53,44,9,0
2021,Tonbridge and Malling 009C,E01024775,662,218,111,107,29,29,381,50,331,34,33,1,0
2021,Tonbridge and Malling 009D,E01024776,522,265,141,124,4,4,220,18,202,33,24,9,0
2021,Tonbridge and Malling 009E,E01024777,494,247,145,102,3,3,213,19,194,31,26,5,0
2021,Tonbridge and Malling 013C,E01024778,758,549,208,341,25,25,33,0,33,151,137,14,0
2021,Tonbridge and Malling 013D,E01024779,780,426,189,237,7,7,143,11,132,203,190,13,1
2021,Tonbridge and Malling 013E,E01024780,599,342,163,179,6,6,172,22,150,79,77,2,0
2021,Tonbridge and Malling 007D,E01024781,829,635,359,276,8,8,73,10,63,113,102,11,0
2021,Tonbridge and Malling 003G,E01024782,479,429,214,215,5,5,5,1,4,40,34,6,0
2021,Tonbridge and Malling 014C,E01024783,710,406,251,155,3,3,165,30,135,136,117,19,0
2021,Tonbridge and Malling 003H,E01024785,640,484,218,266,10,10,84,11,73,62,56,6,0
2021,Tonbridge and Malling 006F,E01024786,776,535,282,253,7,7,133,14,119,101,83,18,0
2021,Tunbridge Wells 013A,E01024787,483,369,213,156,0,0,40,11,29,74,56,18,0
2021,Tunbridge Wells 013B,E01024788,605,281,157,124,34,34,208,28,180,82,72,10,0
2021,Tunbridge Wells 014A,E01024789,763,524,319,205,7,7,99,13,86,133,113,20,0
2021,Tunbridge Wells 013C,E01024790,500,220,134,86,1,1,161,18,143,118,100,18,0
2021,Tunbridge Wells 013D,E01024791,564,471,298,173,0,0,17,2,15,76,61,15,0
2021,Tunbridge Wells 011A,E01024792,723,610,358,252,2,2,16,0,16,95,72,23,0
2021,Tunbridge Wells 004A,E01024793,720,547,313,234,0,0,91,15,76,82,65,17,0
2021,Tunbridge Wells 011B,E01024794,701,496,274,222,3,3,105,11,94,96,79,17,1
2021,Tunbridge Wells 010A,E01024795,616,218,101,117,11,11,293,62,231,93,90,3,1
2021,Tunbridge Wells 010B,E01024796,606,327,168,159,1,1,116,19,97,160,147,13,2
2021,Tunbridge Wells 012A,E01024797,743,536,323,213,3,3,66,7,59,137,130,7,1
2021,Tunbridge Wells 001A,E01024798,914,646,353,293,4,4,112,20,92,152,128,24,0
2021,Tunbridge Wells 007A,E01024799,1036,660,379,281,25,25,99,14,85,251,228,23,1
2021,Tunbridge Wells 007B,E01024800,644,561,326,235,4,4,8,1,7,71,65,6,0
2021,Tunbridge Wells 008B,E01024802,949,432,210,222,3,3,29,6,23,485,463,22,0
2021,Tunbridge Wells 013E,E01024803,927,696,399,297,11,11,103,7,96,117,88,29,0
2021,Tunbridge Wells 011C,E01024804,571,422,243,179,0,0,33,1,32,116,100,16,0
2021,Tunbridge Wells 011D,E01024805,653,465,227,238,1,1,69,8,61,118,87,31,0
2021,Tunbridge Wells 011E,E01024806,627,408,204,204,4,4,151,18,133,64,42,22,0
2021,Tunbridge Wells 014B,E01024807,750,412,239,173,5,5,243,37,206,89,79,10,1
2021,Tunbridge Wells 014C,E01024808,779,566,308,258,13,13,29,2,27,171,159,12,0
2021,Tunbridge Wells 014D,E01024809,586,447,274,173,5,5,82,14,68,52,37,15,0
2021,Tunbridge Wells 014E,E01024810,619,479,261,218,4,4,61,3,58,75,54,21,0
2021,Tunbridge Wells 001B,E01024811,482,423,265,158,1,1,23,2,21,35,30,5,0
2021,Tunbridge Wells 001C,E01024812,564,427,248,179,15,15,62,5,57,60,48,12,0
2021,Tunbridge Wells 001D,E01024813,798,398,175,223,5,5,158,31,127,237,223,14,0
2021,Tunbridge Wells 001E,E01024814,514,432,243,189,6,6,36,2,34,40,32,8,0
2021,Tunbridge Wells 001F,E01024815,487,330,182,148,2,2,113,10,103,42,38,4,0
2021,Tunbridge Wells 001G,E01024816,574,411,185,226,10,10,119,15,104,34,30,4,0
2021,Tunbridge Wells 012B,E01024817,731,609,357,252,0,0,18,0,18,104,95,9,0
2021,Tunbridge Wells 012C,E01024818,764,564,324,240,8,8,90,9,81,102,90,12,0
2021,Tunbridge Wells 012D,E01024819,792,412,192,220,2,2,36,4,32,342,324,18,0
2021,Tunbridge Wells 012E,E01024820,666,553,260,293,2,2,9,0,9,102,93,9,0
2021,Tunbridge Wells 009A,E01024821,975,615,338,277,5,5,167,9,158,188,174,14,0
2021,Tunbridge Wells 009B,E01024822,954,671,389,282,12,12,105,21,84,166,141,25,0
2021,Tunbridge Wells 008C,E01024823,914,457,227,230,3,3,28,5,23,426,395,31,0
2021,Tunbridge Wells 009C,E01024824,652,542,270,272,4,4,20,2,18,86,77,9,0
2021,Tunbridge Wells 004B,E01024825,491,429,257,172,2,2,8,2,6,52,39,13,0
2021,Tunbridge Wells 004C,E01024826,621,444,277,167,0,0,106,5,101,71,65,6,0
2021,Tunbridge Wells 004D,E01024827,601,456,257,199,8,8,96,11,85,41,29,12,0
2021,Tunbridge Wells 004E,E01024828,665,383,196,187,10,10,158,16,142,107,71,36,7
2021,Tunbridge Wells 006A,E01024829,663,511,274,237,10,10,43,4,39,99,92,7,0
2021,Tunbridge Wells 010C,E01024830,867,471,259,212,11,11,266,36,230,119,107,12,0
2021,Tunbridge Wells 010D,E01024831,596,329,162,167,0,0,190,32,158,77,64,13,0
2021,Tunbridge Wells 009D,E01024832,653,416,163,253,1,1,28,6,22,208,199,9,0
2021,Tunbridge Wells 008D,E01024833,1244,411,161,250,19,19,350,55,295,464,440,24,0
2021,Tunbridge Wells 009E,E01024834,900,529,191,338,13,13,94,16,78,264,252,12,0
2021,Tunbridge Wells 007C,E01024835,809,565,196,369,5,5,23,0,23,216,202,14,0
2021,Tunbridge Wells 003A,E01024836,689,340,126,214,7,7,172,14,158,170,157,13,0
2021,Tunbridge Wells 002A,E01024837,647,525,250,275,0,0,66,3,63,56,47,9,0
2021,Tunbridge Wells 007D,E01024838,702,479,203,276,14,14,18,3,15,191,185,6,0
2021,Tunbridge Wells 003B,E01024839,1197,843,327,516,75,75,113,23,90,166,154,12,0
2021,Tunbridge Wells 005A,E01024840,652,242,96,146,12,12,301,54,247,97,89,8,0
2021,Tunbridge Wells 005B,E01024841,853,372,172,200,28,28,354,60,294,99,89,10,0
2021,Tunbridge Wells 005C,E01024842,716,399,210,189,5,5,249,29,220,63,49,14,0
2021,Tunbridge Wells 005D,E01024843,583,284,125,159,13,13,194,17,177,92,84,8,0
2021,Tunbridge Wells 002B,E01024844,653,401,150,251,12,12,80,11,69,160,144,16,0
2021,Tunbridge Wells 003C,E01024845,528,387,187,200,1,1,97,13,84,43,39,4,0
2021,Tunbridge Wells 002C,E01024846,656,400,167,233,3,3,151,26,125,101,86,15,1
2021,Tunbridge Wells 003D,E01024847,678,396,167,229,8,8,150,25,125,124,112,12,0
2021,Tunbridge Wells 003E,E01024848,647,377,198,179,7,7,157,17,140,106,84,22,0
2021,Tunbridge Wells 002D,E01024849,678,485,239,246,0,0,59,5,54,134,121,13,0
2021,Tunbridge Wells 002E,E01024850,486,442,253,189,0,0,8,0,8,36,30,6,0
2021,Tunbridge Wells 006B,E01024851,655,490,263,227,3,3,65,9,56,97,83,14,0
2021,Tunbridge Wells 006C,E01024852,499,478,287,191,0,0,3,1,2,18,17,1,0
2021,Tunbridge Wells 006D,E01024853,535,430,231,199,3,3,60,3,57,42,35,7,0
2021,Tunbridge Wells 006E,E01024854,590,482,263,219,3,3,36,5,31,69,57,12,0
2021,Burnley 007A,E01024855,784,235,145,90,0,0,291,60,231,255,226,29,3
2021,Burnley 003A,E01024856,669,346,204,142,8,8,13,4,9,302,268,34,0
2021,Burnley 007B,E01024857,637,318,151,167,0,0,194,33,161,125,112,13,0
2021,Burnley 007C,E01024858,691,171,110,61,2,2,79,8,71,439,422,17,0
2021,Burnley 001A,E01024859,677,472,197,275,1,1,6,2,4,198,171,27,0
2021,Burnley 009A,E01024860,592,472,262,210,1,1,69,13,56,50,36,14,0
2021,Burnley 001B,E01024861,539,468,278,190,0,0,24,1,23,47,34,13,0
2021,Burnley 001C,E01024862,660,545,293,252,0,0,18,5,13,97,86,11,0
2021,Burnley 008A,E01024863,624,345,182,163,1,1,187,50,137,91,75,16,0
2021,Burnley 007D,E01024864,726,435,229,206,0,0,39,6,33,252,224,28,0
2021,Burnley 008B,E01024865,769,319,174,145,2,2,345,110,235,97,88,9,6
2021,Burnley 008C,E01024866,851,465,247,218,1,1,293,79,214,89,77,12,3
2021,Burnley 008D,E01024867,608,555,363,192,1,1,6,2,4,46,27,19,0
2021,Burnley 009B,E01024868,521,409,227,182,0,0,29,11,18,83,61,22,0
2021,Burnley 009C,E01024869,646,594,398,196,2,2,4,1,3,46,36,10,0
2021,Burnley 009D,E01024870,526,423,270,153,0,0,19,4,15,84,70,14,0
2021,Burnley 014D,E01024871,516,436,238,198,0,0,17,2,15,63,50,13,0
2021,Burnley 010A,E01024872,721,250,118,132,2,2,360,136,224,108,86,22,1
2021,Burnley 014E,E01024873,595,466,268,198,0,0,88,22,66,41,33,8,0
2021,Burnley 011A,E01024874,452,397,249,148,0,0,11,2,9,43,34,9,1
2021,Burnley 003B,E01024875,527,249,179,70,1,1,78,13,65,198,176,22,1
2021,Burnley 003C,E01024876,537,269,180,89,0,0,63,15,48,202,173,29,3
2021,Burnley 003D,E01024877,753,202,116,86,3,3,166,22,144,380,341,39,2
2021,Burnley 003E,E01024878,540,319,195,124,0,0,71,17,54,150,115,35,0
2021,Burnley 005A,E01024879,658,434,152,282,1,1,98,43,55,124,105,19,1
2021,Burnley 005B,E01024880,629,439,263,176,2,2,126,27,99,60,52,8,2
2021,Burnley 006A,E01024881,625,397,191,206,4,4,21,3,18,203,180,23,0
2021,Burnley 006B,E01024882,710,325,159,166,2,2,98,22,76,285,267,18,0
2021,Burnley 004A,E01024883,657,325,174,151,1,1,240,84,156,91,76,15,0
2021,Burnley 004B,E01024884,710,473,281,192,2,2,152,23,129,82,67,15,1
2021,Burnley 004C,E01024885,866,373,218,155,0,0,62,19,43,431,402,29,0
2021,Burnley 004D,E01024886,699,335,182,153,0,0,66,27,39,298,267,31,0
2021,Burnley 011B,E01024887,626,428,209,219,0,0,106,45,61,92,84,8,0
2021,Burnley 011C,E01024888,822,654,301,353,2,2,28,7,21,137,115,22,1
2021,Burnley 004E,E01024889,631,395,213,182,9,9,68,12,56,159,137,22,0
2021,Burnley 004F,E01024890,732,338,162,176,4,4,241,90,151,149,136,13,0
2021,Burnley 001D,E01024891,737,509,284,225,0,0,163,62,101,65,53,12,0
2021,Burnley 001E,E01024892,640,446,271,175,1,1,107,30,77,86,75,11,0
2021,Burnley 002A,E01024893,712,325,180,145,0,0,126,46,80,261,246,15,0
2021,Burnley 001F,E01024894,528,368,185,183,1,1,90,36,54,67,59,8,2
2021,Burnley 003F,E01024895,669,311,178,133,1,1,36,11,25,321,292,29,0
2021,Burnley 002B,E01024896,604,409,231,178,1,1,87,26,61,107,97,10,0
2021,Burnley 002C,E01024897,529,394,245,149,1,1,24,8,16,110,94,16,0
2021,Burnley 002D,E01024898,729,325,196,129,3,3,47,9,38,352,319,33,2
2021,Burnley 010B,E01024899,671,351,195,156,0,0,192,85,107,127,113,14,1
2021,Burnley 010C,E01024900,706,233,114,119,4,4,341,127,214,126,114,12,2
2021,Burnley 011D,E01024901,762,598,284,314,0,0,17,4,13,147,128,19,0
2021,Burnley 006C,E01024902,925,520,219,301,2,2,81,21,60,322,297,25,0
2021,Burnley 014F,E01024903,478,279,128,151,0,0,145,47,98,54,41,13,0
2021,Burnley 014A,E01024904,782,528,292,236,3,3,65,22,43,186,164,22,0
2021,Burnley 014G,E01024905,501,445,220,225,0,0,13,3,10,43,36,7,0
2021,Burnley 014B,E01024906,1059,413,215,198,5,5,251,64,187,389,368,21,1
2021,Burnley 010D,E01024907,637,285,176,109,1,1,51,14,37,300,281,19,0
2021,Burnley 010E,E01024908,738,269,109,160,7,7,189,41,148,271,254,17,2
2021,Burnley 010F,E01024909,755,301,139,162,2,2,164,25,139,287,269,18,1
2021,Burnley 014C,E01024910,636,383,232,151,5,5,24,7,17,224,202,22,0
2021,Burnley 006D,E01024911,827,488,268,220,2,2,192,28,164,145,128,17,0
2021,Burnley 005C,E01024912,603,565,381,184,1,1,9,4,5,28,22,6,0
2021,Burnley 005D,E01024913,505,449,184,265,0,0,9,3,6,47,42,5,0
2021,Burnley 005E,E01024914,611,562,349,213,3,3,11,2,9,35,27,8,0
2021,Chorley 014A,E01024915,1165,796,366,430,5,5,184,46,138,180,158,22,0
2021,Chorley 014B,E01024916,753,663,388,275,0,0,8,2,6,82,67,15,0
2021,Chorley 014C,E01024917,816,509,271,238,2,2,125,34,91,180,163,17,0
2021,Chorley 014D,E01024918,769,648,410,238,2,2,19,4,15,100,88,12,0
2021,Chorley 008B,E01024920,938,732,507,225,1,1,98,8,90,107,95,12,0
2021,Chorley 002A,E01024921,900,754,467,287,3,3,15,0,15,128,98,30,0
2021,Chorley 013A,E01024922,599,491,255,236,1,1,33,12,21,74,63,11,0
2021,Chorley 011A,E01024923,547,478,295,183,0,0,21,4,17,48,38,10,0
2021,Chorley 011B,E01024924,644,535,317,218,6,6,73,18,55,30,21,9,0
2021,Chorley 009A,E01024925,788,298,158,140,2,2,271,67,204,215,199,16,2
2021,Chorley 009B,E01024926,1034,577,209,368,9,9,277,61,216,169,154,15,2
2021,Chorley 009C,E01024927,736,513,287,226,0,0,64,9,55,159,133,26,0
2021,Chorley 009D,E01024928,639,448,233,215,0,0,71,10,61,120,102,18,0
2021,Chorley 006B,E01024930,653,413,210,203,1,1,97,14,83,142,124,18,0
2021,Chorley 006C,E01024931,667,398,181,217,7,7,99,15,84,162,149,13,1
2021,Chorley 006E,E01024933,603,355,222,133,4,4,141,15,126,103,89,14,0
2021,Chorley 008C,E01024934,690,581,333,248,1,1,39,8,31,69,60,9,0
2021,Chorley 008D,E01024935,618,538,365,173,21,21,7,1,6,52,41,11,0
2021,Chorley 010A,E01024936,855,436,236,200,3,3,89,60,29,327,299,28,0
2021,Chorley 006F,E01024937,666,574,364,210,2,2,30,4,26,60,46,14,0
2021,Chorley 010B,E01024938,877,754,354,400,2,2,33,10,23,88,75,13,0
2021,Chorley 010C,E01024939,897,784,386,398,5,5,44,5,39,64,54,10,0
2021,Chorley 010D,E01024940,888,352,164,188,1,1,215,40,175,318,298,20,2
2021,Chorley 010E,E01024941,899,422,178,244,4,4,284,63,221,189,166,23,0
2021,Chorley 012A,E01024942,779,323,159,164,1,1,364,126,238,90,78,12,1
2021,Chorley 012B,E01024943,1012,542,212,330,9,9,249,56,193,212,190,22,0
2021,Chorley 012C,E01024944,830,724,250,474,2,2,46,7,39,58,54,4,0
2021,Chorley 003A,E01024946,523,440,247,193,2,2,37,0,37,44,32,12,0
2021,Chorley 003B,E01024947,506,457,226,231,0,0,9,1,8,40,34,6,0
2021,Chorley 004A,E01024948,722,602,305,297,3,3,25,2,23,92,73,19,0
2021,Chorley 004C,E01024950,543,511,275,236,1,1,3,0,3,28,22,6,0
2021,Chorley 001A,E01024951,479,149,71,78,0,0,292,28,264,38,26,12,0
2021,Chorley 001B,E01024952,556,239,101,138,3,3,238,13,225,76,62,14,0
2021,Chorley 001C,E01024953,637,184,85,99,1,1,405,46,359,45,41,4,2
2021,Chorley 001D,E01024954,727,520,293,227,5,5,95,12,83,106,93,13,1
2021,Chorley 003C,E01024955,656,541,308,233,7,7,14,3,11,94,85,9,0
2021,Chorley 003D,E01024956,824,706,369,337,30,30,26,3,23,62,47,15,0
2021,Chorley 003E,E01024957,1011,888,425,463,28,28,70,7,63,25,20,5,0
2021,Chorley 003F,E01024958,559,361,176,185,0,0,134,9,125,64,50,14,0
2021,Chorley 013B,E01024959,890,446,171,275,9,9,264,57,207,171,150,21,0
2021,Chorley 013C,E01024960,723,494,196,298,10,10,145,33,112,73,65,8,1
2021,Chorley 013D,E01024961,676,556,301,255,1,1,25,6,19,94,86,8,0
2021,Chorley 013E,E01024962,652,585,373,212,2,2,16,5,11,49,40,9,0
2021,Chorley 011C,E01024963,682,534,317,217,9,9,56,9,47,82,71,11,1
2021,Chorley 007A,E01024964,651,552,346,206,1,1,36,8,28,62,51,11,0
2021,Chorley 011D,E01024965,584,540,334,206,0,0,6,0,6,38,28,10,0
2021,Chorley 011E,E01024966,801,651,343,308,22,22,36,2,34,92,86,6,0
2021,Chorley 005A,E01024967,543,500,327,173,0,0,5,2,3,38,33,5,0
2021,Chorley 005B,E01024968,880,763,332,431,12,12,27,9,18,78,67,11,0
2021,Chorley 005C,E01024969,610,391,225,166,12,12,166,38,128,41,35,6,0
2021,Chorley 005D,E01024970,574,517,279,238,3,3,5,1,4,49,38,11,0
2021,Chorley 005E,E01024971,549,472,283,189,0,0,16,3,13,61,56,5,0
2021,Chorley 005F,E01024972,529,479,282,197,1,1,6,1,5,43,33,10,0
2021,Chorley 014E,E01024973,900,749,442,307,12,12,36,9,27,103,79,24,0
2021,Chorley 007B,E01024974,661,558,356,202,1,1,30,5,25,72,59,13,0
2021,Chorley 007C,E01024975,517,403,194,209,8,8,24,3,21,82,64,18,0
2021,Chorley 007D,E01024976,723,512,272,240,8,8,97,12,85,103,88,15,3
2021,Chorley 004D,E01024977,1108,923,439,484,13,13,91,17,74,81,59,22,0
2021,Chorley 002B,E01024978,573,433,227,206,9,9,66,2,64,65,52,13,0
2021,Chorley 002C,E01024979,607,524,297,227,4,4,8,1,7,71,53,18,0
2021,Chorley 002D,E01024980,576,477,284,193,2,2,43,10,33,54,42,12,0
2021,Fylde 008A,E01024981,691,553,394,159,1,1,9,1,8,128,113,15,0
2021,Fylde 008B,E01024982,637,431,284,147,2,2,61,3,58,143,117,26,0
2021,Fylde 008C,E01024983,603,503,264,239,1,1,13,3,10,86,69,17,0
2021,Fylde 006A,E01024984,671,512,345,167,3,3,40,5,35,116,102,14,0
2021,Fylde 006B,E01024985,618,501,321,180,2,2,34,5,29,80,68,12,1
2021,Fylde 006C,E01024986,1000,479,365,114,2,2,38,2,36,480,448,32,1
2021,Fylde 006D,E01024987,754,213,101,112,2,2,85,9,76,454,435,19,0
2021,Fylde 006E,E01024988,861,498,372,126,3,3,38,2,36,322,290,32,0
2021,Fylde 006F,E01024989,652,466,261,205,1,1,10,0,10,175,162,13,0
2021,Fylde 009A,E01024990,799,507,338,169,1,1,39,4,35,252,229,23,0
2021,Fylde 009B,E01024991,532,355,269,86,0,0,10,2,8,167,145,22,0
2021,Fylde 009C,E01024992,762,682,544,138,2,2,5,2,3,73,55,18,0
2021,Fylde 001A,E01024993,708,610,384,226,5,5,23,4,19,70,57,13,0
2021,Fylde 008D,E01024994,742,590,422,168,3,3,10,2,8,139,123,16,0
2021,Fylde 008E,E01024995,664,519,363,156,1,1,4,1,3,140,121,19,0
2021,Fylde 006G,E01024996,661,312,206,106,2,2,52,1,51,295,289,6,0
2021,Fylde 007A,E01024997,683,561,365,196,0,0,12,2,10,110,88,22,0
2021,Fylde 003A,E01024998,708,476,323,153,1,1,156,28,128,74,61,13,1
2021,Fylde 007B,E01024999,664,520,307,213,0,0,49,8,41,94,75,19,1
2021,Fylde 007C,E01025000,611,525,361,164,3,3,10,1,9,73,66,7,0
2021,Fylde 005A,E01025001,986,672,383,289,1,1,153,21,132,160,140,20,0
2021,Fylde 005B,E01025002,646,450,242,208,2,2,18,1,17,176,158,18,0
2021,Fylde 008F,E01025003,805,659,453,206,4,4,20,1,19,122,100,22,0
2021,Fylde 004A,E01025004,596,502,294,208,1,1,14,3,11,79,67,12,0
2021,Fylde 005C,E01025005,727,594,458,136,0,0,20,5,15,113,93,20,0
2021,Fylde 004B,E01025006,616,256,124,132,5,5,211,29,182,143,127,16,1
2021,Fylde 002A,E01025007,808,651,288,363,31,31,58,8,50,68,64,4,0
2021,Fylde 002B,E01025008,494,452,270,182,2,2,2,1,1,38,30,8,0
2021,Fylde 002C,E01025009,782,435,273,162,5,5,150,20,130,192,170,22,0
2021,Fylde 003B,E01025010,522,455,286,169,2,2,22,6,16,43,30,13,0
2021,Fylde 002D,E01025011,731,336,166,170,4,4,160,26,134,230,205,25,1
2021,Fylde 002E,E01025012,1122,854,359,495,47,47,106,13,93,115,99,16,0
2021,Fylde 002F,E01025013,801,389,174,215,13,13,187,32,155,211,192,19,1
2021,Fylde 003C,E01025014,739,561,307,254,14,14,73,15,58,91,73,18,0
2021,Fylde 003D,E01025015,658,575,326,249,4,4,22,3,19,57,41,16,0
2021,Fylde 005D,E01025016,1036,907,607,300,5,5,7,2,5,117,104,13,0
2021,Fylde 008G,E01025017,800,436,280,156,4,4,283,19,264,77,66,11,0
2021,Fylde 005E,E01025018,546,477,326,151,1,1,10,2,8,58,43,15,0
2021,Fylde 002G,E01025019,822,696,411,285,6,6,46,7,39,74,57,17,0
2021,Fylde 009D,E01025020,624,403,223,180,2,2,113,15,98,106,93,13,0
2021,Fylde 009E,E01025021,641,493,284,209,2,2,46,3,43,99,87,12,1
2021,Fylde 009F,E01025022,861,632,325,307,8,8,19,0,19,202,180,22,0
2021,Fylde 004C,E01025023,587,518,342,176,4,4,6,0,6,59,52,7,0
2021,Fylde 004D,E01025024,1043,632,386,246,40,40,166,15,151,205,181,24,0
2021,Fylde 004E,E01025025,683,467,216,251,3,3,62,11,51,151,128,23,0
2021,Fylde 001B,E01025026,584,459,302,157,0,0,28,4,24,97,74,23,0
2021,Fylde 001C,E01025027,730,416,226,190,4,4,74,14,60,236,116,120,0
2021,Fylde 001D,E01025028,662,501,241,260,6,6,85,9,76,70,59,11,0
2021,Fylde 007D,E01025029,1175,940,578,362,12,12,75,8,67,147,122,25,1
2021,Fylde 007E,E01025030,875,539,214,325,20,20,163,16,147,153,123,30,0
2021,Fylde 001E,E01025031,866,775,415,360,3,3,26,2,24,62,41,21,0
2021,Hyndburn 002A,E01025032,603,343,187,156,0,0,138,56,82,120,109,11,2
2021,Hyndburn 002B,E01025033,808,672,240,432,3,3,13,2,11,120,104,16,0
2021,Hyndburn 002C,E01025034,722,484,247,237,1,1,26,3,23,211,195,16,0
2021,Hyndburn 008A,E01025035,635,449,247,202,0,0,127,31,96,59,50,9,0
2021,Hyndburn 008B,E01025036,897,291,185,106,0,0,143,22,121,463,439,24,0
2021,Hyndburn 008C,E01025037,648,390,227,163,2,2,117,45,72,139,124,15,0
2021,Hyndburn 008D,E01025038,593,492,296,196,0,0,32,6,26,69,56,13,0
2021,Hyndburn 008E,E01025039,491,450,249,201,1,1,6,3,3,34,30,4,0
2021,Hyndburn 008F,E01025040,607,527,238,289,1,1,5,2,3,74,61,13,0
2021,Hyndburn 006A,E01025041,656,227,161,66,1,1,267,21,246,159,134,25,2
2021,Hyndburn 006B,E01025042,624,377,283,94,2,2,59,9,50,186,149,37,0
2021,Hyndburn 005A,E01025044,467,297,171,126,0,0,23,7,16,147,138,9,0
2021,Hyndburn 005B,E01025045,503,167,80,87,0,0,260,89,171,76,68,8,0
2021,Hyndburn 005C,E01025046,657,269,146,123,0,0,205,49,156,182,163,19,1
2021,Hyndburn 002D,E01025048,675,547,335,212,0,0,50,1,49,78,64,14,0
2021,Hyndburn 002E,E01025049,756,343,186,157,6,6,153,43,110,254,231,23,0
2021,Hyndburn 002F,E01025050,638,459,227,232,0,0,48,3,45,131,114,17,0
2021,Hyndburn 004A,E01025051,692,353,180,173,2,2,264,94,170,73,62,11,0
2021,Hyndburn 004B,E01025052,651,556,292,264,0,0,6,2,4,89,67,22,0
2021,Hyndburn 002G,E01025053,626,477,222,255,2,2,38,13,25,108,96,12,1
2021,Hyndburn 009A,E01025054,740,437,250,187,0,0,170,62,108,132,115,17,1
2021,Hyndburn 007A,E01025055,675,320,161,159,1,1,137,28,109,217,200,17,0
2021,Hyndburn 009B,E01025056,587,529,344,185,2,2,8,2,6,48,37,11,0
2021,Hyndburn 004C,E01025057,700,487,290,197,0,0,12,1,11,201,172,29,0
2021,Hyndburn 004D,E01025058,652,362,219,143,0,0,186,75,111,102,90,12,2
2021,Hyndburn 004E,E01025059,781,465,207,258,0,0,182,81,101,134,105,29,0
2021,Hyndburn 001A,E01025060,568,336,181,155,1,1,22,5,17,209,197,12,0
2021,Hyndburn 001B,E01025061,761,573,401,172,33,33,97,14,83,58,48,10,0
2021,Hyndburn 001C,E01025062,751,343,193,150,1,1,63,11,52,343,322,21,1
2021,Hyndburn 001D,E01025063,694,404,226,178,1,1,208,56,152,81,71,10,0
2021,Hyndburn 001E,E01025064,690,612,384,228,1,1,18,2,16,59,44,15,0
2021,Hyndburn 001F,E01025065,789,466,201,265,1,1,73,18,55,249,219,30,0
2021,Hyndburn 001G,E01025066,665,523,246,277,1,1,24,2,22,116,102,14,1
2021,Hyndburn 004F,E01025067,704,304,152,152,1,1,45,5,40,354,323,31,0
2021,Hyndburn 004G,E01025068,762,288,151,137,1,1,119,17,102,353,318,35,1
2021,Hyndburn 004H,E01025069,621,379,189,190,1,1,26,4,22,215,186,29,0
2021,Hyndburn 003A,E01025070,517,242,126,116,1,1,126,30,96,148,132,16,0
2021,Hyndburn 003B,E01025071,614,372,202,170,1,1,63,16,47,178,164,14,0
2021,Hyndburn 003C,E01025072,700,371,171,200,0,0,45,6,39,284,254,30,0
2021,Hyndburn 003D,E01025073,598,425,260,165,0,0,18,3,15,155,137,18,0
2021,Hyndburn 003E,E01025074,568,512,324,188,2,2,8,2,6,46,34,12,0
2021,Hyndburn 007B,E01025075,782,426,178,248,2,2,103,18,85,251,228,23,0
2021,Hyndburn 007C,E01025076,623,349,166,183,2,2,141,6,135,131,120,11,0
2021,Hyndburn 007D,E01025077,628,371,195,176,1,1,171,43,128,84,76,8,1
2021,Hyndburn 007E,E01025078,606,535,270,265,0,0,15,4,11,56,47,9,0
2021,Hyndburn 009C,E01025079,705,633,372,261,0,0,9,2,7,63,50,13,0
2021,Hyndburn 009D,E01025080,636,520,278,242,0,0,13,6,7,103,85,18,0
2021,Hyndburn 005D,E01025081,674,582,283,299,0,0,9,3,6,82,72,10,1
2021,Hyndburn 006E,E01025082,640,261,142,119,0,0,295,126,169,81,72,9,3
2021,Hyndburn 006F,E01025083,771,379,187,192,3,3,75,21,54,313,282,31,1
2021,Hyndburn 006G,E01025084,550,351,225,126,0,0,57,29,28,142,123,19,0
2021,Lancaster 004A,E01025085,602,497,280,217,5,5,8,2,6,92,77,15,0
2021,Lancaster 004B,E01025086,667,573,416,157,1,1,9,2,7,84,67,17,0
2021,Lancaster 004C,E01025087,675,419,310,109,5,5,15,7,8,236,211,25,0
2021,Lancaster 001A,E01025088,461,378,209,169,6,6,7,3,4,70,47,23,0
2021,Lancaster 003A,E01025089,652,546,343,203,5,5,41,32,9,60,53,7,0
2021,Lancaster 003B,E01025090,737,670,425,245,1,1,5,2,3,61,46,15,0
2021,Lancaster 013A,E01025091,716,361,171,190,4,4,260,188,72,84,73,11,7
2021,Lancaster 013B,E01025092,529,288,128,160,1,1,179,171,8,58,41,17,3
2021,Lancaster 014A,E01025093,712,180,115,65,12,12,130,41,89,389,369,20,1
2021,Lancaster 014B,E01025094,584,269,149,120,2,2,151,66,85,160,146,14,2
2021,Lancaster 013C,E01025095,1078,844,341,503,18,18,26,9,17,190,170,20,0
2021,Lancaster 001B,E01025096,715,590,320,270,3,3,3,1,2,119,105,14,0
2021,Lancaster 001C,E01025097,646,391,201,190,3,3,169,157,12,82,56,26,1
2021,Lancaster 001D,E01025098,625,482,312,170,2,2,8,2,6,133,108,25,0
2021,Lancaster 014C,E01025099,884,352,162,190,20,20,132,34,98,380,356,24,0
2021,Lancaster 017A,E01025100,1061,745,287,458,39,39,77,38,39,200,188,12,0
2021,Lancaster 017B,E01025101,620,217,98,119,3,3,257,159,98,142,133,9,1
2021,Lancaster 017C,E01025102,568,362,226,136,5,5,55,5,50,146,129,17,0
2021,Lancaster 017D,E01025103,519,467,292,175,1,1,2,1,1,49,40,9,0
2021,Lancaster 019A,E01025105,505,363,232,131,2,2,6,3,3,134,101,33,0
2021,Lancaster 019B,E01025106,885,653,304,349,33,33,49,32,17,150,134,16,0
2021,Lancaster 019C,E01025107,684,526,318,208,17,17,15,8,7,126,101,25,0
2021,Lancaster 005A,E01025108,644,514,278,236,2,2,56,30,26,71,60,11,1
2021,Lancaster 005B,E01025109,600,517,312,205,4,4,23,15,8,56,48,8,0
2021,Lancaster 009A,E01025110,741,192,110,82,14,14,88,8,80,447,435,12,0
2021,Lancaster 008A,E01025111,732,533,245,288,6,6,41,23,18,152,128,24,0
2021,Lancaster 006A,E01025112,717,285,155,130,19,19,195,11,184,218,201,17,0
2021,Lancaster 008B,E01025113,639,514,275,239,0,0,6,1,5,118,106,12,1
2021,Lancaster 016A,E01025114,680,584,359,225,1,1,8,5,3,87,78,9,0
2021,Lancaster 016B,E01025115,642,430,215,215,2,2,107,104,3,103,88,15,0
2021,Lancaster 009B,E01025116,618,383,225,158,10,10,41,4,37,183,161,22,1
2021,Lancaster 009C,E01025117,624,198,103,95,13,13,53,6,47,360,348,12,0
2021,Lancaster 008C,E01025118,455,323,158,165,4,4,12,3,9,116,100,16,0
2021,Lancaster 008D,E01025119,571,429,216,213,3,3,9,5,4,130,113,17,0
2021,Lancaster 009D,E01025120,647,341,161,180,6,6,12,4,8,288,264,24,0
2021,Lancaster 016C,E01025121,890,714,337,377,0,0,22,13,9,154,129,25,0
2021,Lancaster 016D,E01025122,749,616,358,258,0,0,5,3,2,128,106,22,0
2021,Lancaster 016E,E01025123,1035,794,334,460,6,6,61,6,55,174,157,17,0
2021,Lancaster 016F,E01025124,653,339,193,146,0,0,183,129,54,130,110,20,1
2021,Lancaster 013D,E01025126,838,662,302,360,10,10,25,5,20,141,125,16,0
2021,Lancaster 018A,E01025127,594,541,315,226,0,0,9,3,6,44,38,6,0
2021,Lancaster 015B,E01025128,643,260,135,125,2,2,72,10,62,309,296,13,0
2021,Lancaster 002A,E01025130,995,848,566,282,2,2,35,18,17,110,75,35,0
2021,Lancaster 005C,E01025131,665,519,330,189,4,4,43,36,7,99,78,21,0
2021,Lancaster 002B,E01025132,568,453,329,124,3,3,9,5,4,103,74,29,0
2021,Lancaster 005D,E01025133,741,604,385,219,11,11,51,37,14,75,59,16,0
2021,Lancaster 006B,E01025136,669,260,136,124,7,7,180,13,167,222,207,15,0
2021,Lancaster 020A,E01025137,611,484,251,233,2,2,37,31,6,88,66,22,0
2021,Lancaster 006C,E01025138,584,358,166,192,0,0,25,6,19,201,172,29,0
2021,Lancaster 006D,E01025139,794,258,161,97,13,13,34,4,30,489,440,49,0
2021,Lancaster 006E,E01025140,606,344,199,145,3,3,47,3,44,212,193,19,0
2021,Lancaster 018B,E01025141,582,446,262,184,2,2,65,32,33,68,63,5,1
2021,Lancaster 019D,E01025142,628,567,374,193,0,0,12,8,4,49,37,12,0
2021,Lancaster 018C,E01025143,632,332,174,158,2,2,220,138,82,78,68,10,0
2021,Lancaster 017E,E01025144,747,369,204,165,14,14,131,94,37,233,209,24,0
2021,Lancaster 018D,E01025145,590,371,172,199,1,1,28,15,13,190,176,14,0
2021,Lancaster 017F,E01025146,774,642,377,265,25,25,7,0,7,100,82,18,0
2021,Lancaster 015D,E01025147,625,393,240,153,5,5,30,11,19,197,184,13,0
2021,Lancaster 001E,E01025148,954,806,595,211,2,2,36,23,13,110,81,29,0
2021,Lancaster 011A,E01025149,1001,640,306,334,4,4,73,16,57,284,253,31,0
2021,Lancaster 011B,E01025150,627,480,242,238,2,2,46,37,9,99,73,26,0
2021,Lancaster 011C,E01025151,847,287,141,146,3,3,307,202,105,248,232,16,2
2021,Lancaster 011D,E01025152,638,407,215,192,14,14,126,118,8,91,81,10,0
2021,Lancaster 020F,E01025153,511,414,219,195,2,2,21,19,2,74,59,15,0
2021,Lancaster 011E,E01025154,619,218,91,127,3,3,333,294,39,59,40,19,6
2021,Lancaster 020G,E01025155,524,453,230,223,2,2,17,4,13,52,43,9,0
2021,Lancaster 020H,E01025156,481,110,42,68,2,2,315,298,17,50,43,7,4
2021,Lancaster 020I,E01025157,617,276,145,131,1,1,264,30,234,75,69,6,1
2021,Lancaster 003C,E01025158,617,574,404,170,0,0,4,0,4,39,32,7,0
2021,Lancaster 003D,E01025159,611,512,326,186,1,1,20,17,3,78,63,15,0
2021,Lancaster 003E,E01025160,614,559,354,205,7,7,14,4,10,34,25,9,0
2021,Lancaster 004D,E01025161,613,525,423,102,3,3,11,3,8,74,58,16,0
2021,Lancaster 020B,E01025162,690,596,420,176,7,7,7,4,3,80,64,16,0
2021,Lancaster 020C,E01025163,626,564,383,181,1,1,7,4,3,54,41,13,0
2021,Lancaster 020D,E01025164,628,509,312,197,3,3,5,3,2,111,86,25,0
2021,Lancaster 020E,E01025165,589,494,209,285,2,2,6,4,2,87,81,6,0
2021,Lancaster 002C,E01025166,555,421,296,125,9,9,28,14,14,97,73,24,0
2021,Lancaster 002D,E01025167,500,376,241,135,7,7,13,7,6,104,81,23,0
2021,Lancaster 001F,E01025168,535,414,260,154,6,6,34,11,23,81,73,8,0
2021,Lancaster 001G,E01025169,564,475,317,158,1,1,41,37,4,47,26,21,0
2021,Lancaster 010A,E01025170,806,579,383,196,6,6,47,3,44,174,157,17,0
2021,Lancaster 010B,E01025171,916,414,314,100,3,3,378,212,166,119,106,13,2
2021,Lancaster 010C,E01025172,643,450,258,192,1,1,20,2,18,172,156,16,0
2021,Lancaster 010D,E01025173,769,454,267,187,3,3,187,178,9,124,98,26,1
2021,Pendle 008A,E01025174,595,494,308,186,0,0,13,3,10,88,72,16,0
2021,Pendle 008B,E01025175,671,557,335,222,1,1,21,6,15,92,82,10,0
2021,Pendle 008C,E01025176,1023,576,292,284,0,0,142,32,110,303,272,31,2
2021,Pendle 008D,E01025177,739,645,403,242,2,2,14,2,12,78,67,11,0
2021,Pendle 006A,E01025178,798,622,349,273,0,0,63,14,49,113,92,21,0
2021,Pendle 006B,E01025179,688,551,286,265,0,0,22,5,17,115,98,17,0
2021,Pendle 006C,E01025180,810,679,355,324,0,0,38,16,22,93,81,12,0
2021,Pendle 009A,E01025181,659,281,142,139,3,3,281,121,160,90,80,10,4
2021,Pendle 009B,E01025182,646,280,196,84,1,1,144,26,118,221,192,29,0
2021,Pendle 009C,E01025183,725,358,210,148,2,2,91,32,59,271,245,26,3
2021,Pendle 009D,E01025184,600,311,233,78,1,1,25,13,12,259,220,39,4
2021,Pendle 013A,E01025185,727,467,311,156,0,0,43,11,32,217,175,42,0
2021,Pendle 013B,E01025186,701,437,256,181,0,0,45,11,34,219,181,38,0
2021,Pendle 012A,E01025187,558,419,244,175,1,1,72,32,40,65,48,17,1
2021,Pendle 010A,E01025188,859,353,229,124,2,2,204,37,167,300,264,36,0
2021,Pendle 010B,E01025189,642,369,225,144,3,3,45,7,38,225,204,21,0
2021,Pendle 012B,E01025190,621,497,285,212,1,1,30,16,14,93,79,14,0
2021,Pendle 001A,E01025191,528,438,245,193,1,1,13,8,5,76,66,10,0
2021,Pendle 001B,E01025192,663,386,174,212,5,5,105,37,68,167,151,16,0
2021,Pendle 001C,E01025193,608,452,264,188,3,3,97,36,61,54,40,14,2
2021,Pendle 001D,E01025194,605,380,193,187,1,1,38,3,35,186,168,18,0
2021,Pendle 002A,E01025195,523,446,252,194,0,0,5,0,5,72,63,9,0
2021,Pendle 002B,E01025196,792,418,218,200,0,0,50,13,37,324,302,22,0
2021,Pendle 002C,E01025197,563,486,320,166,0,0,6,1,5,71,58,13,0
2021,Pendle 002D,E01025198,629,429,211,218,0,0,77,34,43,123,103,20,0
2021,Pendle 003A,E01025199,817,652,374,278,3,3,16,3,13,146,126,20,0
2021,Pendle 003B,E01025200,686,441,253,188,2,2,103,23,80,140,128,12,0
2021,Pendle 003C,E01025201,671,472,284,188,0,0,86,30,56,113,99,14,0
2021,Pendle 003D,E01025202,606,489,290,199,1,1,40,19,21,76,66,10,0
2021,Pendle 006D,E01025203,768,620,361,259,8,8,27,8,19,113,96,17,0
2021,Pendle 008E,E01025204,754,623,370,253,3,3,23,8,15,104,86,18,1
2021,Pendle 014E,E01025205,556,346,161,185,1,1,33,9,24,175,158,17,1
2021,Pendle 014A,E01025206,524,438,281,157,2,2,31,11,20,53,44,9,0
2021,Pendle 014G,E01025207,651,275,148,127,0,0,139,46,93,237,214,23,0
2021,Pendle 014F,E01025208,617,259,144,115,1,1,246,102,144,110,98,12,1
2021,Pendle 012C,E01025209,689,465,259,206,0,0,155,51,104,68,58,10,1
2021,Pendle 010C,E01025210,785,438,206,232,1,1,123,59,64,221,196,25,2
2021,Pendle 008F,E01025211,706,575,340,235,1,1,58,18,40,72,57,15,0
2021,Pendle 013C,E01025212,559,497,313,184,0,0,4,0,4,58,41,17,0
2021,Pendle 013D,E01025213,496,391,203,188,3,3,30,10,20,70,52,18,2
2021,Pendle 013E,E01025214,551,500,269,231,0,0,6,1,5,45,30,15,0
2021,Pendle 013F,E01025215,521,304,181,123,1,1,105,16,89,111,86,25,0
2021,Pendle 012D,E01025216,758,510,238,272,2,2,122,46,76,123,103,20,1
2021,Pendle 010D,E01025217,618,293,174,119,0,0,45,12,33,279,248,31,1
2021,Pendle 010E,E01025218,468,155,108,47,4,4,177,55,122,130,108,22,2
2021,Pendle 010F,E01025219,571,212,141,71,2,2,31,3,28,326,305,21,0
2021,Pendle 014C,E01025220,628,261,120,141,1,1,235,114,121,128,119,9,3
2021,Pendle 014B,E01025221,551,357,146,211,3,3,112,52,60,77,69,8,2
2021,Pendle 014D,E01025222,646,538,309,229,0,0,24,11,13,84,72,12,0
2021,Pendle 014H,E01025223,633,346,199,147,3,3,131,19,112,152,140,12,1
2021,Pendle 011A,E01025224,792,447,286,161,1,1,84,31,53,259,215,44,1
2021,Pendle 011B,E01025225,633,455,253,202,2,2,11,4,7,165,148,17,0
2021,Pendle 007A,E01025226,772,330,181,149,0,0,202,57,145,239,219,20,1
2021,Pendle 007B,E01025227,943,387,230,157,2,2,230,47,183,323,303,20,1
2021,Pendle 007C,E01025228,760,617,288,329,0,0,18,5,13,125,106,19,0
2021,Pendle 011C,E01025229,757,434,298,136,2,2,55,20,35,266,232,34,0
2021,Pendle 011D,E01025230,621,273,185,88,4,4,111,20,91,233,196,37,0
2021,Preston 013A,E01025231,580,472,288,184,0,0,10,1,9,98,85,13,0
2021,Preston 013B,E01025232,746,334,131,203,1,1,59,11,48,351,316,35,1
2021,Preston 008A,E01025233,515,436,241,195,3,3,4,0,4,72,60,12,0
2021,Preston 007A,E01025234,552,353,159,194,1,1,123,26,97,75,66,9,0
2021,Preston 007B,E01025235,688,577,313,264,1,1,26,4,22,84,70,14,0
2021,Preston 009A,E01025236,576,255,112,143,1,1,265,61,204,55,46,9,0
2021,Preston 007C,E01025237,691,376,189,187,1,1,215,52,163,99,79,20,0
2021,Preston 007D,E01025238,627,264,107,157,3,3,279,67,212,80,70,10,1
2021,Preston 006A,E01025239,657,461,290,171,22,22,93,8,85,81,69,12,0
2021,Preston 008B,E01025240,654,600,336,264,2,2,6,1,5,46,39,7,0
2021,Preston 006B,E01025241,655,548,329,219,1,1,7,2,5,99,81,18,0
2021,Preston 006C,E01025242,612,558,339,219,0,0,12,1,11,42,33,9,0
2021,Preston 006D,E01025243,773,501,290,211,5,5,98,6,92,169,155,14,0
2021,Preston 015A,E01025244,504,328,215,113,1,1,22,3,19,153,127,26,0
2021,Preston 007E,E01025245,920,464,265,199,3,3,340,87,253,111,93,18,2
2021,Preston 011A,E01025246,516,377,264,113,0,0,20,5,15,117,96,21,2
2021,Preston 016A,E01025247,627,282,171,111,6,6,101,24,77,237,212,25,1
2021,Preston 016B,E01025248,496,134,71,63,0,0,280,56,224,82,77,5,0
2021,Preston 016C,E01025249,433,308,159,149,1,1,61,4,57,63,57,6,0
2021,Preston 016D,E01025250,608,263,144,119,1,1,172,49,123,172,153,19,0
2021,Preston 006E,E01025251,553,348,222,126,10,10,106,16,90,89,53,36,0
2021,Preston 007F,E01025252,618,387,195,192,1,1,134,13,121,96,82,14,0
2021,Preston 004A,E01025253,702,559,228,331,2,2,11,2,9,130,121,9,0
2021,Preston 004B,E01025254,470,416,254,162,1,1,7,1,6,46,41,5,0
2021,Preston 004C,E01025255,580,483,215,268,13,13,3,0,3,81,71,10,0
2021,Preston 003A,E01025256,623,498,287,211,5,5,56,1,55,64,46,18,0
2021,Preston 002A,E01025257,553,521,301,220,1,1,7,1,6,24,21,3,0
2021,Preston 003B,E01025258,618,550,340,210,3,3,9,2,7,56,40,16,0
2021,Preston 003C,E01025259,1119,966,461,505,11,11,38,1,37,104,89,15,0
2021,Preston 005A,E01025260,764,296,126,170,11,11,360,72,288,96,82,14,1
2021,Preston 008C,E01025261,660,518,306,212,10,10,21,5,16,111,91,20,0
2021,Preston 005B,E01025262,698,389,224,165,2,2,243,21,222,64,54,10,0
2021,Preston 005C,E01025263,642,260,155,105,4,4,281,30,251,96,87,9,1
2021,Preston 005D,E01025264,675,273,136,137,3,3,304,28,276,95,85,10,0
2021,Preston 013C,E01025265,642,451,226,225,9,9,95,13,82,87,70,17,0
2021,Preston 008D,E01025266,504,456,270,186,0,0,4,1,3,44,33,11,0
2021,Preston 013D,E01025267,616,381,193,188,0,0,152,30,122,83,64,19,0
2021,Preston 013E,E01025268,864,405,143,262,4,4,328,49,279,125,109,16,2
2021,Preston 013F,E01025269,724,421,162,259,2,2,202,50,152,97,82,15,2
2021,Preston 010A,E01025270,675,535,255,280,1,1,59,15,44,80,63,17,0
2021,Preston 013G,E01025271,617,381,201,180,2,2,191,38,153,43,36,7,0
2021,Preston 010B,E01025272,1105,867,304,563,36,36,110,18,92,92,84,8,0
2021,Preston 010C,E01025273,515,467,231,236,3,3,3,0,3,42,33,9,0
2021,Preston 011B,E01025274,820,229,110,119,1,1,121,12,109,466,439,27,3
2021,Preston 011C,E01025275,771,263,136,127,5,5,196,24,172,307,284,23,0
2021,Preston 012A,E01025276,650,379,186,193,1,1,33,3,30,237,213,24,0
2021,Preston 002B,E01025277,956,825,447,378,7,7,48,1,47,76,59,17,0
2021,Preston 001A,E01025278,1107,943,490,453,11,11,27,7,20,126,109,17,0
2021,Preston 001B,E01025279,954,819,438,381,3,3,61,3,58,71,49,22,0
2021,Preston 002D,E01025281,841,757,352,405,30,30,8,1,7,46,35,11,0
2021,Preston 001C,E01025282,715,580,330,250,34,34,11,0,11,90,78,12,0
2021,Preston 009B,E01025283,623,237,82,155,0,0,313,113,200,72,62,10,1
2021,Preston 009C,E01025284,645,452,221,231,35,35,92,17,75,66,55,11,0
2021,Preston 009D,E01025285,508,322,146,176,0,0,131,33,98,55,50,5,0
2021,Preston 009E,E01025286,714,242,102,140,0,0,399,118,281,73,68,5,0
2021,Preston 009F,E01025287,937,315,162,153,6,6,508,124,384,107,92,15,1
2021,Preston 010D,E01025288,959,354,188,166,6,6,180,12,168,418,396,22,1
2021,Preston 017A,E01025289,630,245,150,95,8,8,124,6,118,252,234,18,1
2021,Preston 017B,E01025290,769,215,134,81,12,12,130,6,124,411,394,17,1
2021,Preston 017C,E01025291,643,337,201,136,1,1,94,7,87,210,189,21,1
2021,Preston 015B,E01025292,620,78,42,36,2,2,259,38,221,278,273,5,3
2021,Preston 015C,E01025293,907,253,153,100,6,6,396,55,341,251,217,34,1
2021,Preston 011D,E01025294,636,328,164,164,3,3,50,9,41,255,216,39,0
2021,Preston 014A,E01025295,1100,259,150,109,12,12,445,73,372,384,356,28,0
2021,Preston 014B,E01025296,731,325,177,148,0,0,251,70,181,153,138,15,2
2021,Preston 014C,E01025297,902,340,180,160,10,10,215,38,177,336,302,34,1
2021,Preston 014D,E01025298,666,272,151,121,3,3,138,34,104,253,229,24,0
2021,Preston 003D,E01025299,611,510,318,192,4,4,16,2,14,81,67,14,0
2021,Preston 004D,E01025300,512,281,200,81,3,3,169,9,160,59,48,11,0
2021,Preston 003E,E01025301,460,305,155,150,5,5,50,0,50,100,94,6,0
2021,Preston 003F,E01025302,498,417,261,156,1,1,5,1,4,75,64,11,0
2021,Preston 004E,E01025303,602,460,259,201,8,8,9,0,9,125,109,16,0
2021,Preston 016E,E01025304,632,471,277,194,2,2,37,3,34,122,98,24,0
2021,Preston 016F,E01025305,642,356,228,128,6,6,93,10,83,187,168,19,0
2021,Preston 017D,E01025306,960,197,111,86,0,0,129,17,112,634,595,39,0
2021,Preston 012B,E01025308,729,316,146,170,3,3,34,2,32,376,363,13,0
2021,Preston 008E,E01025309,526,390,208,182,1,1,65,6,59,70,61,9,0
2021,Preston 012C,E01025310,737,340,161,179,2,2,76,10,66,319,296,23,0
2021,Preston 012D,E01025311,647,358,159,199,2,2,58,8,50,229,215,14,0
2021,Preston 012E,E01025312,769,393,155,238,4,4,27,5,22,345,317,28,0
2021,Preston 012F,E01025313,644,129,70,59,3,3,270,25,245,242,221,21,0
2021,Preston 012G,E01025314,740,299,170,129,4,4,82,10,72,355,329,26,0
2021,Ribble Valley 001A,E01025315,570,379,229,150,10,10,21,3,18,160,105,55,0
2021,Ribble Valley 006A,E01025316,667,579,335,244,5,5,22,1,21,61,45,16,0
2021,Ribble Valley 006B,E01025317,480,339,198,141,1,1,20,5,15,120,106,14,0
2021,Ribble Valley 007A,E01025318,495,395,194,201,9,9,47,10,37,44,34,10,0
2021,Ribble Valley 007B,E01025319,825,696,349,347,6,6,34,1,33,89,74,15,0
2021,Ribble Valley 001B,E01025320,537,346,223,123,4,4,6,0,6,181,146,35,0
2021,Ribble Valley 005A,E01025321,584,383,217,166,0,0,52,1,51,149,133,16,0
2021,Ribble Valley 004A,E01025322,611,430,273,157,2,2,62,9,53,117,84,33,0
2021,Ribble Valley 008A,E01025323,491,395,250,145,2,2,36,3,33,58,41,17,0
2021,Ribble Valley 008B,E01025324,575,505,295,210,7,7,3,0,3,60,44,16,0
2021,Ribble Valley 006C,E01025325,741,386,211,175,4,4,166,27,139,185,161,24,0
2021,Ribble Valley 004B,E01025326,785,611,370,241,11,11,21,1,20,142,126,16,0
2021,Ribble Valley 004C,E01025327,549,432,254,178,2,2,21,1,20,94,84,10,0
2021,Ribble Valley 006D,E01025328,657,527,285,242,21,21,23,6,17,86,75,11,0
2021,Ribble Valley 003A,E01025329,898,645,303,342,8,8,180,30,150,65,52,13,0
2021,Ribble Valley 003B,E01025330,694,465,238,227,15,15,112,20,92,102,89,13,0
2021,Ribble Valley 001C,E01025331,592,448,265,183,7,7,26,1,25,111,92,19,0
2021,Ribble Valley 007C,E01025333,555,436,277,159,28,28,36,1,35,55,42,13,0
2021,Ribble Valley 002A,E01025334,920,693,390,303,37,37,64,13,51,126,116,10,0
2021,Ribble Valley 003C,E01025335,684,340,216,124,6,6,212,44,168,126,103,23,0
2021,Ribble Valley 008D,E01025336,485,403,263,140,16,16,12,0,12,54,47,7,0
2021,Ribble Valley 008E,E01025337,685,568,379,189,4,4,54,9,45,59,45,14,0
2021,Ribble Valley 003D,E01025338,742,459,243,216,7,7,75,5,70,201,177,24,0
2021,Ribble Valley 003E,E01025339,1001,729,317,412,44,44,136,34,102,92,76,16,0
2021,Ribble Valley 005B,E01025340,624,483,283,200,3,3,24,2,22,114,102,12,0
2021,Ribble Valley 005C,E01025341,505,466,292,174,3,3,4,2,2,32,20,12,0
2021,Ribble Valley 004D,E01025342,675,534,344,190,3,3,55,1,54,82,54,28,1
2021,Ribble Valley 005D,E01025343,714,521,274,247,11,11,84,9,75,98,80,18,0
2021,Ribble Valley 002B,E01025344,652,433,267,166,4,4,101,7,94,114,99,15,0
2021,Ribble Valley 002C,E01025345,659,543,357,186,2,2,20,7,13,94,78,16,0
2021,Ribble Valley 002D,E01025346,653,444,243,201,0,0,33,5,28,176,153,23,0
2021,Ribble Valley 002E,E01025347,773,517,260,257,13,13,92,6,86,150,120,30,1
2021,Ribble Valley 001D,E01025348,774,645,482,163,3,3,43,0,43,83,67,16,0
2021,Ribble Valley 001E,E01025349,592,479,310,169,1,1,28,2,26,84,59,25,0
2021,Ribble Valley 007D,E01025350,726,537,304,233,26,26,87,14,73,76,64,12,0
2021,Ribble Valley 007E,E01025351,1150,916,495,421,23,23,50,3,47,161,120,41,0
2021,Ribble Valley 008F,E01025352,556,521,327,194,1,1,1,0,1,33,24,9,0
2021,Ribble Valley 005E,E01025354,975,739,383,356,57,57,73,6,67,106,92,14,0
2021,Rossendale 001A,E01025355,888,809,418,391,0,0,10,2,8,69,53,16,0
2021,Rossendale 004A,E01025356,668,390,190,200,1,1,109,26,83,168,145,23,0
2021,Rossendale 008A,E01025357,623,428,216,212,5,5,86,15,71,104,93,11,0
2021,Rossendale 008B,E01025358,945,817,418,399,1,1,12,2,10,115,102,13,0
2021,Rossendale 009A,E01025359,739,567,335,232,0,0,90,28,62,82,65,17,0
2021,Rossendale 009B,E01025360,957,587,289,298,2,2,183,47,136,185,163,22,0
2021,Rossendale 001B,E01025361,906,683,321,362,8,8,34,6,28,180,153,27,1
2021,Rossendale 001C,E01025362,841,646,306,340,2,2,122,22,100,71,59,12,0
2021,Rossendale 002A,E01025363,561,392,200,192,1,1,93,11,82,75,61,14,0
2021,Rossendale 002B,E01025364,544,492,290,202,1,1,4,3,1,47,42,5,0
2021,Rossendale 008C,E01025365,676,523,298,225,1,1,22,6,16,130,99,31,0
2021,Rossendale 002C,E01025366,589,321,155,166,0,0,82,28,54,186,167,19,0
2021,Rossendale 003A,E01025367,733,606,275,331,1,1,4,1,3,122,91,31,0
2021,Rossendale 003B,E01025368,754,492,271,221,5,5,75,19,56,182,159,23,0
2021,Rossendale 003C,E01025369,599,258,134,124,0,0,149,25,124,190,169,21,2
2021,Rossendale 010F,E01025370,546,431,247,184,1,1,25,6,19,89,73,16,0
2021,Rossendale 010A,E01025371,663,340,165,175,1,1,181,30,151,141,125,16,0
2021,Rossendale 004C,E01025373,723,541,291,250,4,4,56,5,51,122,100,22,0
2021,Rossendale 010B,E01025374,625,399,204,195,0,0,162,54,108,64,54,10,0
2021,Rossendale 009C,E01025375,683,573,290,283,0,0,15,5,10,95,83,12,0
2021,Rossendale 009D,E01025376,1109,603,257,346,3,3,276,85,191,227,195,32,0
2021,Rossendale 007A,E01025377,645,578,309,269,4,4,8,2,6,55,44,11,0
2021,Rossendale 007B,E01025378,704,601,298,303,7,7,7,1,6,89,66,23,0
2021,Rossendale 007C,E01025379,630,342,163,179,1,1,214,51,163,72,59,13,1
2021,Rossendale 007D,E01025380,623,547,337,210,1,1,14,3,11,61,48,13,0
2021,Rossendale 003D,E01025381,632,355,182,173,0,0,182,69,113,94,86,8,1
2021,Rossendale 003E,E01025382,814,333,191,142,1,1,324,95,229,155,143,12,1
2021,Rossendale 003F,E01025383,1149,942,362,580,1,1,57,14,43,148,125,23,1
2021,Rossendale 008D,E01025384,544,431,259,172,2,2,54,14,40,55,44,11,2
2021,Rossendale 004D,E01025385,583,227,108,119,0,0,265,102,163,90,79,11,1
2021,Rossendale 004F,E01025387,716,566,252,314,14,14,77,14,63,59,50,9,0
2021,Rossendale 010G,E01025388,686,438,235,203,1,1,55,16,39,192,184,8,0
2021,Rossendale 010H,E01025389,606,313,161,152,1,1,165,42,123,126,111,15,1
2021,Rossendale 010I,E01025390,537,281,162,119,0,0,184,51,133,71,58,13,1
2021,Rossendale 010C,E01025391,662,392,173,219,1,1,187,65,122,82,64,18,0
2021,Rossendale 010D,E01025392,609,404,219,185,0,0,67,12,55,136,117,19,2
2021,Rossendale 001D,E01025393,620,486,245,241,0,0,55,12,43,79,59,20,0
2021,Rossendale 010E,E01025394,676,408,202,206,1,1,123,30,93,143,128,15,1
2021,Rossendale 002D,E01025395,715,524,287,237,0,0,43,11,32,148,126,22,0
2021,Rossendale 002E,E01025396,653,230,128,102,0,0,308,75,233,113,104,9,2
2021,Rossendale 002F,E01025397,660,383,179,204,1,1,44,5,39,232,206,26,0
2021,Rossendale 002G,E01025398,555,311,149,162,1,1,138,43,95,105,88,17,0
2021,South Ribble 008A,E01025399,611,343,201,142,0,0,164,13,151,104,95,9,0
2021,South Ribble 008B,E01025400,809,672,313,359,7,7,61,10,51,69,63,6,0
2021,South Ribble 008C,E01025401,753,585,301,284,22,22,12,0,12,134,118,16,0
2021,South Ribble 008D,E01025402,792,515,156,359,14,14,99,13,86,164,152,12,0
2021,South Ribble 004A,E01025403,871,759,303,456,1,1,12,0,12,99,92,7,0
2021,South Ribble 007A,E01025404,553,502,332,170,2,2,4,0,4,45,32,13,0
2021,South Ribble 007B,E01025405,566,352,215,137,1,1,82,7,75,131,124,7,0
2021,South Ribble 007C,E01025406,547,426,253,173,0,0,69,6,63,51,43,8,1
2021,South Ribble 007D,E01025407,896,412,186,226,3,3,171,16,155,309,278,31,1
2021,South Ribble 003A,E01025408,646,554,383,171,0,0,14,0,14,78,66,12,0
2021,South Ribble 003B,E01025409,575,457,267,190,4,4,23,3,20,91,72,19,0
2021,South Ribble 003C,E01025410,521,492,279,213,2,2,2,1,1,25,20,5,0
2021,South Ribble 005A,E01025411,953,753,350,403,16,16,22,3,19,162,149,13,0
2021,South Ribble 006A,E01025412,675,447,257,190,13,13,139,7,132,75,64,11,1
2021,South Ribble 002A,E01025413,763,639,385,254,1,1,48,7,41,75,65,10,0
2021,South Ribble 002B,E01025414,696,649,457,192,3,3,2,0,2,42,32,10,0
2021,South Ribble 015A,E01025415,860,616,313,303,3,3,137,15,122,104,84,20,0
2021,South Ribble 014A,E01025416,627,545,293,252,1,1,35,1,34,46,37,9,0
2021,South Ribble 012A,E01025417,663,544,280,264,2,2,39,4,35,78,65,13,0
2021,South Ribble 012B,E01025418,628,494,245,249,0,0,14,3,11,120,95,25,0
2021,South Ribble 012C,E01025419,679,490,251,239,4,4,96,18,78,89,77,12,0
2021,South Ribble 013A,E01025421,996,713,229,484,5,5,86,7,79,192,169,23,0
2021,South Ribble 013B,E01025422,699,461,234,227,8,8,131,11,120,99,90,9,0
2021,South Ribble 015B,E01025423,592,206,93,113,1,1,320,34,286,64,57,7,1
2021,South Ribble 001A,E01025424,506,453,231,222,0,0,8,0,8,45,42,3,0
2021,South Ribble 001B,E01025425,541,483,264,219,2,2,12,1,11,44,39,5,0
2021,South Ribble 001C,E01025426,499,459,273,186,0,0,3,0,3,37,33,4,0
2021,South Ribble 006B,E01025427,681,425,239,186,11,11,137,6,131,108,100,8,0
2021,South Ribble 006C,E01025428,616,401,183,218,2,2,118,18,100,95,82,13,0
2021,South Ribble 006D,E01025429,613,245,98,147,7,7,270,25,245,90,78,12,1
2021,South Ribble 013C,E01025431,938,572,201,371,16,16,98,11,87,252,222,30,0
2021,South Ribble 013D,E01025433,728,597,316,281,4,4,22,5,17,105,89,16,0
2021,South Ribble 016C,E01025434,810,773,535,238,3,3,6,0,6,28,17,11,0
2021,South Ribble 015C,E01025435,685,455,283,172,3,3,117,11,106,110,88,22,0
2021,South Ribble 011A,E01025436,948,821,455,366,0,0,31,2,29,96,76,20,0
2021,South Ribble 011B,E01025437,868,667,348,319,10,10,63,5,58,128,114,14,0
2021,South Ribble 011C,E01025438,547,493,307,186,0,0,6,0,6,48,40,8,0
2021,South Ribble 010A,E01025439,605,548,329,219,1,1,2,0,2,54,40,14,0
2021,South Ribble 011D,E01025440,618,555,386,169,0,0,4,0,4,59,44,15,0
2021,South Ribble 011E,E01025441,660,536,363,173,4,4,47,3,44,73,55,18,0
2021,South Ribble 009A,E01025442,518,273,113,160,0,0,103,10,93,142,125,17,0
2021,South Ribble 009B,E01025443,600,530,311,219,1,1,9,0,9,60,53,7,0
2021,South Ribble 009C,E01025444,556,439,225,214,0,0,18,1,17,99,87,12,0
2021,South Ribble 017A,E01025445,596,264,118,146,6,6,281,32,249,45,36,9,0
2021,South Ribble 015D,E01025446,654,509,279,230,15,15,75,8,67,55,47,8,0
2021,South Ribble 017B,E01025447,523,143,56,87,2,2,341,47,294,36,34,2,1
2021,South Ribble 005B,E01025448,727,599,318,281,4,4,13,2,11,111,89,22,0
2021,South Ribble 014B,E01025451,748,686,357,329,3,3,7,1,6,52,48,4,0
2021,South Ribble 014C,E01025452,737,347,171,176,3,3,299,28,271,88,78,10,0
2021,South Ribble 010B,E01025453,717,628,356,272,11,11,13,2,11,65,53,12,0
2021,South Ribble 010C,E01025454,524,439,260,179,1,1,48,2,46,36,29,7,0
2021,South Ribble 010D,E01025455,699,599,367,232,11,11,18,0,18,71,51,20,0
2021,South Ribble 002C,E01025456,468,390,241,149,2,2,13,0,13,63,41,22,0
2021,South Ribble 004B,E01025457,613,492,270,222,1,1,6,2,4,114,105,9,0
2021,South Ribble 002D,E01025458,716,509,226,283,5,5,80,3,77,122,112,10,0
2021,South Ribble 017C,E01025459,733,543,306,237,2,2,62,8,54,126,107,19,0
2021,South Ribble 017D,E01025460,917,454,219,235,11,11,369,36,333,83,72,11,0
2021,South Ribble 009D,E01025461,797,719,364,355,1,1,22,3,19,55,46,9,0
2021,South Ribble 009E,E01025462,853,739,318,421,8,8,15,4,11,91,75,16,0
2021,South Ribble 004C,E01025463,587,526,233,293,0,0,7,0,7,54,47,7,0
2021,South Ribble 004D,E01025464,516,484,311,173,2,2,0,0,0,30,26,4,0
2021,South Ribble 004E,E01025465,484,384,193,191,2,2,37,1,36,61,51,10,0
2021,South Ribble 001D,E01025466,660,562,312,250,2,2,38,0,38,58,39,19,0
2021,South Ribble 003D,E01025467,871,800,493,307,2,2,5,0,5,64,46,18,0
2021,West Lancashire 009A,E01025468,631,569,252,317,0,0,11,11,0,51,43,8,0
2021,West Lancashire 009B,E01025469,811,439,180,259,4,4,247,229,18,117,103,14,4
2021,West Lancashire 009C,E01025470,738,637,275,362,42,42,13,5,8,46,38,8,0
2021,West Lancashire 010A,E01025471,597,285,130,155,6,6,176,171,5,128,115,13,2
2021,West Lancashire 012A,E01025472,562,533,325,208,2,2,1,0,1,26,18,8,0
2021,West Lancashire 012B,E01025473,598,440,245,195,0,0,89,81,8,67,51,16,2
2021,West Lancashire 003A,E01025474,530,381,184,197,0,0,68,47,21,81,74,7,0
2021,West Lancashire 012C,E01025475,613,584,375,209,1,1,3,2,1,25,22,3,0
2021,West Lancashire 012D,E01025476,624,523,325,198,31,31,13,9,4,55,48,7,2
2021,West Lancashire 012E,E01025477,484,411,243,168,0,0,22,22,0,51,40,11,0
2021,West Lancashire 012F,E01025478,504,485,298,187,0,0,3,1,2,16,11,5,0
2021,West Lancashire 008A,E01025479,927,736,422,314,8,8,45,44,1,137,112,25,1
2021,West Lancashire 010B,E01025480,511,264,100,164,3,3,137,122,15,105,95,10,2
2021,West Lancashire 010C,E01025481,691,350,112,238,3,3,224,214,10,109,97,12,5
2021,West Lancashire 010D,E01025482,629,210,89,121,2,2,319,310,9,97,87,10,1
2021,West Lancashire 004A,E01025483,1071,654,321,333,2,2,241,114,127,173,145,28,1
2021,West Lancashire 004B,E01025484,892,771,408,363,7,7,18,5,13,95,73,22,1
2021,West Lancashire 004C,E01025485,729,529,276,253,0,0,46,35,11,154,137,17,0
2021,West Lancashire 004D,E01025486,653,522,281,241,0,0,38,33,5,91,79,12,2
2021,West Lancashire 004E,E01025487,710,551,270,281,1,1,91,76,15,65,51,14,2
2021,West Lancashire 007A,E01025488,918,466,232,234,59,59,152,93,59,237,220,17,4
2021,West Lancashire 007B,E01025489,552,413,210,203,1,1,36,33,3,102,89,13,0
2021,West Lancashire 007C,E01025490,502,276,150,126,8,8,75,10,65,143,129,14,0
2021,West Lancashire 008B,E01025491,570,494,318,176,6,6,26,24,2,43,35,8,1
2021,West Lancashire 013A,E01025492,513,373,197,176,2,2,53,47,6,84,74,10,1
2021,West Lancashire 014A,E01025493,660,153,77,76,2,2,385,380,5,115,106,9,5
2021,West Lancashire 014B,E01025494,786,241,119,122,14,14,335,255,80,196,186,10,0
2021,West Lancashire 003B,E01025495,910,763,456,307,2,2,45,33,12,98,63,35,2
2021,West Lancashire 001A,E01025496,509,383,204,179,7,7,56,48,8,63,47,16,0
2021,West Lancashire 001B,E01025497,577,512,268,244,1,1,10,2,8,54,44,10,0
2021,West Lancashire 001C,E01025498,591,484,280,204,15,15,16,4,12,76,62,14,0
2021,West Lancashire 006A,E01025499,583,426,241,185,1,1,48,45,3,107,99,8,1
2021,West Lancashire 007D,E01025500,834,453,270,183,23,23,172,85,87,183,161,22,3
2021,West Lancashire 006B,E01025501,490,448,322,126,1,1,9,9,0,31,23,8,1
2021,West Lancashire 006C,E01025502,635,577,352,225,12,12,6,5,1,40,31,9,0
2021,West Lancashire 014C,E01025503,540,231,110,121,1,1,148,112,36,160,144,16,0
2021,West Lancashire 014D,E01025504,474,163,71,92,1,1,207,175,32,103,96,7,0
2021,West Lancashire 014E,E01025505,643,438,220,218,1,1,111,102,9,92,76,16,1
2021,West Lancashire 008C,E01025506,887,770,482,288,1,1,28,15,13,88,57,31,0
2021,West Lancashire 002A,E01025507,860,710,415,295,12,12,34,7,27,104,93,11,0
2021,West Lancashire 002B,E01025508,632,469,301,168,3,3,70,8,62,90,79,11,0
2021,West Lancashire 002C,E01025509,593,403,237,166,15,15,106,58,48,67,55,12,2
2021,West Lancashire 005A,E01025510,512,484,327,157,2,2,8,8,0,18,13,5,0
2021,West Lancashire 005B,E01025511,474,430,255,175,0,0,10,10,0,34,24,10,0
2021,West Lancashire 005C,E01025512,557,439,249,190,18,18,21,18,3,78,62,16,1
2021,West Lancashire 002D,E01025513,926,794,474,320,20,20,55,34,21,57,31,26,0
2021,West Lancashire 003C,E01025514,1043,849,524,325,10,10,56,15,41,127,103,24,1
2021,West Lancashire 003D,E01025515,735,609,417,192,12,12,39,31,8,70,51,19,5
2021,West Lancashire 006D,E01025516,634,529,326,203,1,1,45,37,8,58,50,8,1
2021,West Lancashire 006E,E01025517,863,546,224,322,12,12,186,143,43,118,104,14,1
2021,West Lancashire 007E,E01025518,673,280,165,115,7,7,151,97,54,234,215,19,1
2021,West Lancashire 006F,E01025519,508,462,280,182,0,0,3,3,0,43,35,8,0
2021,West Lancashire 010E,E01025520,519,250,127,123,1,1,180,177,3,86,80,6,2
2021,West Lancashire 010F,E01025521,641,358,156,202,0,0,156,146,10,125,110,15,2
2021,West Lancashire 009D,E01025522,503,362,230,132,0,0,83,30,53,58,48,10,0
2021,West Lancashire 011A,E01025523,696,452,221,231,1,1,92,52,40,149,138,11,2
2021,West Lancashire 011B,E01025524,762,275,143,132,2,2,357,346,11,124,103,21,4
2021,West Lancashire 011C,E01025525,644,470,234,236,0,0,90,84,6,83,70,13,1
2021,West Lancashire 011D,E01025526,797,462,240,222,5,5,129,118,11,196,179,17,5
2021,West Lancashire 013B,E01025527,674,267,122,145,0,0,302,248,54,99,88,11,6
2021,West Lancashire 013C,E01025528,769,340,110,230,2,2,307,250,57,117,111,6,3
2021,West Lancashire 013D,E01025529,745,448,193,255,2,2,162,140,22,132,121,11,1
2021,West Lancashire 001D,E01025530,694,611,351,260,8,8,13,9,4,62,49,13,0
2021,West Lancashire 002E,E01025531,494,415,291,124,2,2,20,12,8,57,40,17,0
2021,West Lancashire 001E,E01025532,722,647,375,272,7,7,11,7,4,57,44,13,0
2021,West Lancashire 001F,E01025533,715,503,319,184,8,8,80,64,16,120,102,18,4
2021,West Lancashire 015A,E01025534,686,600,314,286,2,2,21,20,1,63,55,8,0
2021,West Lancashire 015B,E01025535,677,528,266,262,14,14,64,46,18,70,58,12,1
2021,West Lancashire 015C,E01025536,654,341,186,155,0,0,253,188,65,58,45,13,2
2021,West Lancashire 015D,E01025537,722,580,343,237,1,1,40,39,1,101,86,15,0
2021,West Lancashire 005D,E01025538,659,562,363,199,2,2,29,21,8,66,43,23,0
2021,West Lancashire 005E,E01025539,582,488,260,228,0,0,33,33,0,61,49,12,0
2021,West Lancashire 015E,E01025540,500,424,256,168,0,0,31,9,22,45,38,7,0
2021,Wyre 011A,E01025541,975,718,247,471,17,17,33,4,29,207,185,22,0
2021,Wyre 010A,E01025542,792,687,389,298,12,12,5,0,5,88,77,11,0
2021,Wyre 011B,E01025543,749,491,222,269,9,9,36,4,32,213,188,25,0
2021,Wyre 011C,E01025544,720,494,314,180,1,1,91,10,81,134,115,19,0
2021,Wyre 013A,E01025545,1058,845,484,361,34,34,49,7,42,130,115,15,0
2021,Wyre 013B,E01025546,761,472,238,234,1,1,60,2,58,228,192,36,0
2021,Wyre 006A,E01025547,921,596,340,256,45,45,110,5,105,170,136,34,0
2021,Wyre 007A,E01025548,845,756,616,140,12,12,6,1,5,71,58,13,0
2021,Wyre 006B,E01025549,996,807,468,339,7,7,59,5,54,123,98,25,0
2021,Wyre 012A,E01025550,696,616,369,247,0,0,5,1,4,75,60,15,0
2021,Wyre 013C,E01025551,549,445,249,196,0,0,24,3,21,80,71,9,0
2021,Wyre 012B,E01025552,512,463,268,195,0,0,16,6,10,33,27,6,0
2021,Wyre 007B,E01025553,1150,953,521,432,26,26,36,5,31,135,123,12,0
2021,Wyre 008A,E01025554,747,539,379,160,1,1,81,14,67,125,98,27,1
2021,Wyre 010B,E01025555,688,550,378,172,4,4,16,1,15,118,97,21,0
2021,Wyre 008B,E01025556,636,480,258,222,3,3,49,5,44,104,92,12,0
2021,Wyre 005A,E01025557,670,569,330,239,3,3,17,2,15,81,73,8,0
2021,Wyre 007C,E01025558,808,618,477,141,2,2,93,7,86,95,82,13,0
2021,Wyre 007D,E01025559,939,604,339,265,19,19,105,11,94,210,175,35,1
2021,Wyre 007E,E01025560,642,585,455,130,3,3,2,0,2,52,44,8,0
2021,Wyre 009A,E01025561,651,568,342,226,7,7,14,1,13,62,51,11,0
2021,Wyre 009B,E01025562,1088,836,490,346,16,16,88,5,83,147,111,36,1
2021,Wyre 004A,E01025563,512,446,327,119,2,2,1,0,1,63,51,12,0
2021,Wyre 004B,E01025564,817,638,378,260,23,23,53,6,47,101,88,13,2
2021,Wyre 004C,E01025565,765,649,413,236,9,9,29,2,27,78,61,17,0
2021,Wyre 014A,E01025566,896,815,539,276,1,1,28,4,24,52,42,10,0
2021,Wyre 013D,E01025567,808,551,324,227,1,1,117,14,103,138,119,19,1
2021,Wyre 014B,E01025568,884,716,393,323,0,0,22,1,21,146,126,20,0
2021,Wyre 014C,E01025569,922,794,514,280,1,1,13,1,12,114,97,17,0
2021,Wyre 008C,E01025570,736,316,241,75,0,0,15,2,13,405,387,18,0
2021,Wyre 008D,E01025571,609,391,224,167,3,3,21,3,18,194,171,23,0
2021,Wyre 008E,E01025572,646,522,390,132,1,1,28,3,25,95,74,21,0
2021,Wyre 001A,E01025573,584,483,286,197,4,4,15,1,14,82,74,8,0
2021,Wyre 001B,E01025574,745,293,171,122,2,2,194,30,164,255,230,25,1
2021,Wyre 005B,E01025575,869,376,155,221,5,5,344,57,287,143,124,19,1
2021,Wyre 011D,E01025576,1109,854,494,360,13,13,27,4,23,215,186,29,0
2021,Wyre 011E,E01025577,657,390,199,191,3,3,110,12,98,154,145,9,0
2021,Wyre 005C,E01025578,642,388,196,192,1,1,135,20,115,118,113,5,0
2021,Wyre 005D,E01025579,522,252,148,104,1,1,139,37,102,130,116,14,0
2021,Wyre 005E,E01025580,530,436,270,166,1,1,22,7,15,71,58,13,0
2021,Wyre 001C,E01025581,610,388,203,185,2,2,19,1,18,201,185,16,0
2021,Wyre 001D,E01025582,614,262,153,109,2,2,65,3,62,285,269,16,0
2021,Wyre 001E,E01025583,622,305,162,143,2,2,40,2,38,275,264,11,0
2021,Wyre 001F,E01025584,886,227,147,80,1,1,169,21,148,489,457,32,0
2021,Wyre 009C,E01025585,1076,862,588,274,16,16,86,7,79,112,78,34,0
2021,Wyre 004D,E01025586,723,620,426,194,0,0,10,0,10,93,76,17,0
2021,Wyre 004E,E01025587,780,615,433,182,7,7,54,3,51,104,90,14,0
2021,Wyre 004F,E01025588,724,519,382,137,3,3,27,3,24,175,158,17,0
2021,Wyre 004G,E01025589,498,361,190,171,0,0,42,3,39,95,84,11,0
2021,Wyre 003A,E01025590,671,228,132,96,0,0,312,60,252,131,112,19,0
2021,Wyre 003B,E01025591,749,668,471,197,3,3,9,0,9,69,57,12,0
2021,Wyre 003C,E01025592,526,180,98,82,7,7,275,63,212,64,54,10,0
2021,Wyre 003D,E01025593,644,577,425,152,5,5,11,3,8,51,42,9,0
2021,Wyre 012C,E01025594,723,592,420,172,1,1,4,0,4,126,105,21,0
2021,Wyre 012D,E01025595,627,560,361,199,1,1,2,0,2,64,50,14,0
2021,Wyre 012E,E01025596,896,751,393,358,10,10,28,2,26,107,92,15,0
2021,Wyre 012F,E01025597,489,411,232,179,2,2,8,3,5,68,59,9,0
2021,Wyre 013E,E01025598,769,469,296,173,5,5,55,5,50,237,219,18,3
2021,Wyre 014D,E01025599,456,395,242,153,0,0,8,4,4,53,41,12,0
2021,Wyre 014E,E01025600,679,573,337,236,3,3,5,0,5,98,80,18,0
2021,Wyre 010C,E01025601,654,589,409,180,1,1,4,0,4,60,50,10,0
2021,Wyre 010D,E01025602,760,550,284,266,6,6,14,0,14,190,172,18,0
2021,Wyre 010E,E01025603,704,585,394,191,2,2,10,3,7,107,89,18,0
2021,Wyre 008F,E01025604,665,475,260,215,0,0,3,0,3,187,161,26,0
2021,Wyre 002A,E01025605,562,497,286,211,1,1,8,1,7,56,50,6,0
2021,Wyre 002B,E01025606,543,221,112,109,1,1,206,42,164,114,103,11,1
2021,Wyre 002C,E01025607,640,512,283,229,9,9,38,2,36,81,68,13,0
2021,Wyre 002D,E01025608,668,522,292,230,6,6,5,0,5,135,121,14,0
2021,Wyre 006C,E01025609,961,726,453,273,16,16,48,10,38,171,143,28,0
2021,Blaby 008A,E01025610,664,471,247,224,4,4,109,13,96,80,67,13,0
2021,Blaby 008B,E01025611,666,552,298,254,4,4,55,6,49,55,44,11,0
2021,Blaby 008C,E01025612,920,643,358,285,24,24,186,22,164,66,52,14,1
2021,Blaby 010A,E01025613,684,471,278,193,8,8,119,10,109,86,71,15,0
2021,Blaby 010B,E01025614,690,568,320,248,3,3,60,7,53,59,54,5,0
2021,Blaby 009A,E01025615,848,726,282,444,17,17,50,6,44,55,40,15,0
2021,Blaby 011A,E01025616,770,700,350,350,2,2,15,1,14,53,43,10,0
2021,Blaby 011B,E01025617,886,723,426,297,10,10,60,11,49,93,74,19,0
2021,Blaby 011C,E01025618,757,528,272,256,15,15,112,28,84,102,89,13,0
2021,Blaby 011D,E01025619,923,758,396,362,13,13,71,4,67,81,71,10,0
2021,Blaby 010C,E01025620,500,375,208,167,5,5,74,7,67,46,38,8,0
2021,Blaby 010D,E01025621,550,462,258,204,14,14,11,2,9,63,57,6,0
2021,Blaby 013A,E01025622,759,557,299,258,3,3,61,15,46,137,110,27,1
2021,Blaby 013B,E01025623,761,629,363,266,3,3,71,12,59,58,48,10,0
2021,Blaby 013C,E01025624,952,805,390,415,17,17,42,2,40,88,73,15,0
2021,Blaby 006A,E01025625,572,291,149,142,0,0,191,25,166,89,78,11,1
2021,Blaby 006B,E01025626,1090,826,235,591,12,12,58,5,53,193,171,22,1
2021,Blaby 006C,E01025627,975,698,326,372,16,16,126,16,110,135,122,13,0
2021,Blaby 013D,E01025629,653,496,296,200,5,5,81,10,71,71,59,12,0
2021,Blaby 013E,E01025630,706,628,364,264,1,1,4,0,4,73,61,12,0
2021,Blaby 002A,E01025631,621,498,226,272,7,7,35,1,34,81,69,12,0
2021,Blaby 002B,E01025632,497,450,202,248,3,3,7,0,7,37,32,5,0
2021,Blaby 002C,E01025633,744,627,313,314,3,3,6,2,4,108,96,12,0
2021,Blaby 003A,E01025634,711,600,256,344,10,10,28,3,25,73,63,10,0
2021,Blaby 002D,E01025635,484,432,229,203,2,2,0,0,0,50,42,8,0
2021,Blaby 005A,E01025636,603,448,286,162,3,3,47,2,45,105,94,11,0
2021,Blaby 005B,E01025637,540,394,213,181,4,4,49,3,46,93,84,9,0
2021,Blaby 003B,E01025638,650,590,389,201,2,2,16,2,14,42,35,7,0
2021,Blaby 003C,E01025639,557,463,272,191,0,0,32,4,28,62,51,11,0
2021,Blaby 003D,E01025640,670,501,269,232,1,1,64,9,55,104,93,11,0
2021,Blaby 007A,E01025641,866,648,350,298,25,25,84,15,69,109,97,12,0
2021,Blaby 007B,E01025642,834,602,280,322,1,1,78,16,62,153,144,9,0
2021,Blaby 007C,E01025643,663,526,255,271,4,4,38,3,35,95,85,10,0
2021,Blaby 010E,E01025644,706,515,250,265,46,46,92,17,75,53,42,11,0
2021,Blaby 003E,E01025645,490,369,213,156,10,10,51,11,40,60,53,7,0
2021,Blaby 009B,E01025646,722,461,225,236,4,4,174,24,150,83,72,11,0
2021,Blaby 009C,E01025647,718,486,273,213,19,19,117,13,104,96,85,11,0
2021,Blaby 009D,E01025648,800,715,287,428,5,5,11,0,11,69,63,6,0
2021,Blaby 007D,E01025649,759,640,358,282,5,5,17,2,15,97,85,12,0
2021,Blaby 007E,E01025650,564,495,254,241,1,1,10,0,10,58,54,4,0
2021,Blaby 006D,E01025651,630,559,315,244,10,10,10,4,6,51,45,6,0
2021,Blaby 005C,E01025652,504,415,238,177,2,2,4,1,3,83,78,5,0
2021,Blaby 005D,E01025653,661,454,219,235,2,2,94,12,82,111,96,15,0
2021,Blaby 005E,E01025654,510,429,234,195,3,3,1,0,1,77,68,9,0
2021,Blaby 005F,E01025655,630,487,261,226,3,3,3,1,2,137,121,16,0
2021,Blaby 005G,E01025656,495,388,209,179,1,1,6,0,6,100,88,12,0
2021,Blaby 006E,E01025657,848,644,336,308,6,6,111,11,100,87,73,14,0
2021,Blaby 008D,E01025658,730,604,267,337,16,16,7,0,7,103,91,12,0
2021,Blaby 008E,E01025659,932,647,401,246,8,8,94,11,83,183,163,20,0
2021,Blaby 006F,E01025660,675,610,337,273,0,0,6,0,6,58,47,11,1
2021,Blaby 012A,E01025661,969,764,304,460,30,30,78,5,73,97,89,8,0
2021,Blaby 012B,E01025662,835,575,250,325,17,17,149,24,125,94,82,12,0
2021,Blaby 012C,E01025663,676,527,285,242,10,10,71,5,66,66,50,16,2
2021,Blaby 012D,E01025664,599,496,299,197,3,3,61,8,53,39,33,6,0
2021,Blaby 012E,E01025665,820,686,370,316,7,7,57,8,49,70,64,6,0
2021,Blaby 004A,E01025666,654,417,199,218,2,2,155,38,117,80,69,11,0
2021,Blaby 004B,E01025667,491,379,198,181,0,0,56,21,35,56,48,8,0
2021,Blaby 004C,E01025668,909,599,224,375,3,3,13,0,13,294,280,14,0
2021,Blaby 004D,E01025669,814,546,162,384,1,1,2,1,1,265,252,13,0
2021,Charnwood 022A,E01025670,520,381,219,162,1,1,88,83,5,50,32,18,0
2021,Charnwood 022B,E01025671,1023,783,370,413,19,19,91,11,80,130,122,8,0
2021,Charnwood 022C,E01025672,951,757,384,373,14,14,103,38,65,76,56,20,1
2021,Charnwood 022D,E01025673,842,559,285,274,5,5,120,112,8,156,140,16,2
2021,Charnwood 011A,E01025674,859,662,381,281,14,14,62,41,21,121,102,19,0
2021,Charnwood 011B,E01025675,689,542,312,230,1,1,32,18,14,114,99,15,0
2021,Charnwood 011C,E01025676,996,820,386,434,24,24,46,10,36,106,95,11,0
2021,Charnwood 011D,E01025677,675,441,244,197,10,10,135,109,26,88,78,10,1
2021,Charnwood 020A,E01025678,672,585,324,261,3,3,19,2,17,65,53,12,0
2021,Charnwood 019B,E01025680,647,582,343,239,2,2,7,4,3,56,49,7,0
2021,Charnwood 019C,E01025681,705,593,380,213,4,4,31,26,5,76,64,12,1
2021,Charnwood 019D,E01025682,621,534,343,191,1,1,35,32,3,51,40,11,0
2021,Charnwood 020B,E01025683,664,506,251,255,1,1,81,75,6,74,67,7,2
2021,Charnwood 020C,E01025684,758,595,311,284,1,1,15,7,8,147,129,18,0
2021,Charnwood 015A,E01025685,535,445,261,184,3,3,32,26,6,55,47,8,0
2021,Charnwood 015B,E01025686,602,531,266,265,6,6,16,3,13,49,41,8,0
2021,Charnwood 016A,E01025687,671,595,392,203,1,1,13,11,2,62,55,7,0
2021,Charnwood 016B,E01025688,681,489,272,217,2,2,75,66,9,112,77,35,3
2021,Charnwood 007A,E01025689,798,321,174,147,7,7,213,173,40,251,233,18,6
2021,Charnwood 007B,E01025690,537,167,90,77,1,1,227,203,24,140,130,10,2
2021,Charnwood 001B,E01025692,841,602,323,279,7,7,78,3,75,154,143,11,0
2021,Charnwood 001C,E01025693,1062,812,449,363,18,18,68,26,42,164,151,13,0
2021,Charnwood 004A,E01025695,637,488,319,169,2,2,8,1,7,138,133,5,1
2021,Charnwood 004B,E01025696,541,475,290,185,3,3,2,0,2,61,54,7,0
2021,Charnwood 004C,E01025697,681,286,172,114,0,0,254,161,93,138,126,12,3
2021,Charnwood 004D,E01025698,642,525,328,197,4,4,22,5,17,91,82,9,0
2021,Charnwood 002A,E01025699,859,159,78,81,2,2,461,376,85,234,220,14,3
2021,Charnwood 002B,E01025700,957,342,141,201,10,10,286,21,265,319,292,27,0
2021,Charnwood 002C,E01025701,751,305,140,165,2,2,230,124,106,213,199,14,1
2021,Charnwood 009A,E01025702,529,425,242,183,2,2,30,23,7,72,67,5,0
2021,Charnwood 002D,E01025703,861,373,211,162,6,6,100,36,64,380,360,20,2
2021,Charnwood 002E,E01025704,685,314,186,128,26,26,150,13,137,195,179,16,0
2021,Charnwood 002F,E01025705,636,254,106,148,14,14,116,6,110,252,242,10,0
2021,Charnwood 002G,E01025706,783,338,165,173,11,11,251,130,121,180,172,8,3
2021,Charnwood 007C,E01025707,554,410,261,149,3,3,37,3,34,104,94,10,0
2021,Charnwood 010A,E01025708,537,476,319,157,2,2,5,3,2,54,49,5,0
2021,Charnwood 007D,E01025709,478,386,239,147,0,0,5,5,0,87,74,13,0
2021,Charnwood 010B,E01025710,503,432,281,151,1,1,3,2,1,67,57,10,0
2021,Charnwood 010C,E01025711,632,581,393,188,3,3,3,1,2,45,37,8,0
2021,Charnwood 010D,E01025712,651,576,382,194,4,4,14,3,11,57,49,8,0
2021,Charnwood 010E,E01025713,508,424,249,175,8,8,8,2,6,68,60,8,0
2021,Charnwood 009B,E01025715,650,305,143,162,11,11,227,177,50,106,97,9,1
2021,Charnwood 009C,E01025716,610,393,197,196,1,1,113,102,11,102,91,11,1
2021,Charnwood 009E,E01025718,558,175,91,84,0,0,213,123,90,169,158,11,1
2021,Charnwood 009F,E01025719,614,451,252,199,0,0,22,14,8,141,127,14,0
2021,Charnwood 003A,E01025720,718,161,93,68,4,4,115,17,98,438,419,19,0
2021,Charnwood 003B,E01025721,622,211,139,72,3,3,106,74,32,301,288,13,1
2021,Charnwood 003C,E01025722,422,318,203,115,2,2,32,27,5,70,64,6,0
2021,Charnwood 003D,E01025723,675,205,112,93,6,6,115,60,55,349,326,23,0
2021,Charnwood 003E,E01025724,631,113,57,56,5,5,37,23,14,475,452,23,1
2021,Charnwood 003F,E01025725,583,206,125,81,4,4,281,231,50,87,74,13,5
2021,Charnwood 014A,E01025726,846,637,267,370,14,14,36,5,31,159,148,11,0
2021,Charnwood 014B,E01025727,683,362,192,170,0,0,215,209,6,106,90,16,0
2021,Charnwood 014C,E01025728,874,700,334,366,3,3,82,34,48,89,73,16,0
2021,Charnwood 014D,E01025729,660,576,313,263,0,0,15,2,13,69,55,14,0
2021,Charnwood 015C,E01025730,1152,856,367,489,38,38,106,45,61,152,137,15,0
2021,Charnwood 015D,E01025731,754,655,409,246,16,16,39,24,15,44,39,5,0
2021,Charnwood 012A,E01025732,815,650,370,280,4,4,53,16,37,108,99,9,0
2021,Charnwood 012B,E01025733,809,581,330,251,8,8,84,57,27,135,122,13,1
2021,Charnwood 012C,E01025734,708,657,395,262,2,2,19,5,14,30,26,4,0
2021,Charnwood 012D,E01025735,889,582,300,282,15,15,98,45,53,194,176,18,0
2021,Charnwood 016C,E01025736,625,568,353,215,0,0,13,11,2,44,33,11,0
2021,Charnwood 014E,E01025737,1182,880,344,536,32,32,136,46,90,130,111,19,4
2021,Charnwood 016D,E01025738,621,571,333,238,0,0,10,1,9,40,29,11,0
2021,Charnwood 014F,E01025739,988,761,354,407,12,12,105,68,37,110,96,14,0
2021,Charnwood 006A,E01025740,714,491,275,216,6,6,43,4,39,174,162,12,0
2021,Charnwood 006B,E01025741,645,550,321,229,3,3,9,6,3,83,71,12,0
2021,Charnwood 006C,E01025742,674,399,224,175,4,4,193,145,48,78,57,21,0
2021,Charnwood 006D,E01025743,1028,728,322,406,26,26,95,47,48,179,164,15,0
2021,Charnwood 005A,E01025744,1102,920,452,468,14,14,56,9,47,112,96,16,0
2021,Charnwood 005B,E01025745,646,541,337,204,1,1,39,28,11,65,56,9,0
2021,Charnwood 005C,E01025746,894,551,273,278,10,10,146,92,54,186,171,15,1
2021,Charnwood 005D,E01025747,789,524,255,269,3,3,120,95,25,139,124,15,3
2021,Charnwood 013A,E01025748,979,696,324,372,2,2,64,44,20,217,191,26,0
2021,Charnwood 013B,E01025749,832,590,242,348,15,15,162,123,39,65,56,9,0
2021,Charnwood 013C,E01025750,796,642,332,310,16,16,54,5,49,83,74,9,1
2021,Charnwood 013D,E01025751,938,637,271,366,9,9,87,64,23,202,180,22,3
2021,Charnwood 018A,E01025752,1153,892,394,498,32,32,122,37,85,107,95,12,0
2021,Charnwood 018B,E01025753,694,419,229,190,0,0,173,125,48,100,90,10,2
2021,Charnwood 018C,E01025754,519,456,277,179,3,3,16,4,12,44,37,7,0
2021,Charnwood 018D,E01025755,629,512,283,229,4,4,27,13,14,86,76,10,0
2021,Charnwood 017A,E01025756,874,531,254,277,5,5,47,13,34,291,269,22,0
2021,Charnwood 017B,E01025757,550,414,214,200,7,7,19,4,15,110,98,12,0
2021,Charnwood 017C,E01025758,653,535,277,258,9,9,28,9,19,81,74,7,0
2021,Charnwood 017D,E01025759,710,425,282,143,4,4,159,128,31,122,110,12,0
2021,Charnwood 008A,E01025760,562,486,287,199,0,0,19,6,13,56,45,11,1
2021,Charnwood 008B,E01025761,750,633,338,295,8,8,30,15,15,78,56,22,1
2021,Charnwood 021A,E01025762,700,493,281,212,6,6,88,38,50,113,103,10,0
2021,Charnwood 021B,E01025763,735,524,325,199,17,17,45,11,34,149,129,20,0
2021,Charnwood 021C,E01025764,510,438,249,189,2,2,13,4,9,57,48,9,0
2021,Charnwood 021D,E01025765,591,519,339,180,0,0,2,2,0,70,63,7,0
2021,Charnwood 021E,E01025766,860,454,219,235,22,22,241,100,141,139,116,23,4
2021,Charnwood 021F,E01025767,627,506,301,205,1,1,42,37,5,78,69,9,0
2021,Charnwood 008C,E01025768,601,503,312,191,0,0,21,19,2,77,67,10,0
2021,Charnwood 008D,E01025769,614,516,296,220,3,3,35,17,18,60,50,10,0
2021,Harborough 002A,E01025770,806,592,361,231,6,6,62,9,53,146,118,28,0
2021,Harborough 004A,E01025772,939,704,302,402,21,21,36,5,31,178,163,15,0
2021,Harborough 004B,E01025773,561,502,218,284,3,3,10,1,9,46,38,8,0
2021,Harborough 004C,E01025774,656,554,259,295,16,16,31,3,28,55,45,10,0
2021,Harborough 004D,E01025775,953,690,363,327,30,30,136,11,125,97,84,13,0
2021,Harborough 004E,E01025776,784,676,377,299,8,8,28,5,23,72,61,11,0
2021,Harborough 006A,E01025777,950,785,459,326,4,4,63,9,54,97,78,19,1
2021,Harborough 005B,E01025778,832,611,290,321,12,12,83,10,73,126,110,16,0
2021,Harborough 005C,E01025779,627,539,290,249,2,2,14,0,14,72,66,6,0
2021,Harborough 005D,E01025780,606,522,303,219,4,4,33,2,31,47,35,12,0
2021,Harborough 003A,E01025781,671,504,251,253,14,14,34,4,30,119,106,13,0
2021,Harborough 003B,E01025782,622,490,314,176,2,2,58,3,55,71,66,5,1
2021,Harborough 003C,E01025783,904,734,384,350,22,22,58,3,55,90,79,11,0
2021,Harborough 005E,E01025784,566,463,265,198,8,8,20,1,19,75,60,15,0
2021,Harborough 003E,E01025786,935,579,280,299,28,28,218,14,204,110,92,18,0
2021,Harborough 003F,E01025787,729,613,417,196,0,0,13,0,13,103,93,10,0
2021,Harborough 005F,E01025788,546,429,227,202,4,4,41,7,34,72,58,14,0
2021,Harborough 007A,E01025789,613,469,240,229,13,13,50,5,45,81,69,12,0
2021,Harborough 010A,E01025790,1041,902,476,426,15,15,12,0,12,112,94,18,0
2021,Harborough 010B,E01025791,1137,790,449,341,21,21,144,23,121,182,168,14,0
2021,Harborough 010C,E01025792,1094,630,396,234,18,18,217,21,196,229,197,32,0
2021,Harborough 007B,E01025794,738,616,343,273,4,4,6,0,6,112,100,12,0
2021,Harborough 008A,E01025795,839,561,363,198,32,32,52,10,42,194,176,18,0
2021,Harborough 008B,E01025796,890,439,239,200,8,8,289,53,236,153,137,16,1
2021,Harborough 007C,E01025797,906,738,399,339,19,19,65,9,56,84,75,9,0
2021,Harborough 009A,E01025798,1065,769,426,343,19,19,48,0,48,229,203,26,0
2021,Harborough 009B,E01025799,785,633,255,378,24,24,15,2,13,113,103,10,0
2021,Harborough 009C,E01025800,703,485,297,188,29,29,43,2,41,146,136,10,0
2021,Harborough 008C,E01025801,598,332,190,142,4,4,108,14,94,154,140,14,0
2021,Harborough 007D,E01025802,635,526,379,147,3,3,18,2,16,88,71,17,0
2021,Harborough 007E,E01025803,699,652,334,318,9,9,7,0,7,31,23,8,0
2021,Harborough 009D,E01025804,880,657,415,242,21,21,82,4,78,120,105,15,0
2021,Harborough 008D,E01025806,724,324,167,157,25,25,304,38,266,69,55,14,2
2021,Harborough 009E,E01025807,604,378,162,216,11,11,22,4,18,193,172,21,0
2021,Harborough 006B,E01025808,1196,940,487,453,20,20,78,19,59,158,130,28,0
2021,Harborough 002B,E01025809,962,765,466,299,3,3,66,2,64,128,113,15,0
2021,Harborough 006C,E01025810,960,806,492,314,2,2,59,15,44,93,70,23,0
2021,Harborough 011A,E01025812,730,567,344,223,26,26,41,4,37,96,83,13,0
2021,Harborough 011B,E01025813,783,684,376,308,29,29,27,2,25,43,37,6,0
2021,Harborough 011C,E01025814,698,597,339,258,14,14,32,2,30,55,38,17,0
2021,Harborough 002C,E01025815,898,720,429,291,9,9,36,2,34,133,100,33,0
2021,Harborough 006D,E01025816,1044,821,420,401,13,13,107,10,97,103,85,18,0
2021,Hinckley and Bosworth 008A,E01025817,988,820,496,324,11,11,62,26,36,94,74,20,1
2021,Hinckley and Bosworth 008B,E01025818,586,429,247,182,3,3,44,29,15,110,96,14,0
2021,Hinckley and Bosworth 004A,E01025819,732,500,301,199,2,2,126,83,43,102,88,14,2
2021,Hinckley and Bosworth 004B,E01025820,676,570,316,254,2,2,13,4,9,91,77,14,0
2021,Hinckley and Bosworth 007A,E01025821,872,523,248,275,9,9,19,4,15,321,302,19,0
2021,Hinckley and Bosworth 007B,E01025822,667,383,204,179,0,0,213,171,42,69,58,11,2
2021,Hinckley and Bosworth 007C,E01025823,690,451,225,226,10,10,146,73,73,83,73,10,0
2021,Hinckley and Bosworth 007D,E01025824,626,437,230,207,6,6,87,20,67,96,80,16,0
2021,Hinckley and Bosworth 007E,E01025825,617,505,284,221,1,1,47,31,16,61,57,4,3
2021,Hinckley and Bosworth 007F,E01025826,601,508,246,262,3,3,31,24,7,59,55,4,0
2021,Hinckley and Bosworth 013A,E01025827,695,467,323,144,1,1,167,133,34,54,41,13,6
2021,Hinckley and Bosworth 013B,E01025828,644,543,322,221,0,0,39,29,10,61,47,14,1
2021,Hinckley and Bosworth 013C,E01025829,662,367,166,201,2,2,224,212,12,66,57,9,3
2021,Hinckley and Bosworth 013D,E01025830,695,467,255,212,1,1,107,88,19,119,106,13,1
2021,Hinckley and Bosworth 014A,E01025831,605,446,263,183,1,1,49,11,38,109,101,8,0
2021,Hinckley and Bosworth 014B,E01025832,772,663,314,349,24,24,35,3,32,50,43,7,0
2021,Hinckley and Bosworth 014C,E01025833,866,664,320,344,11,11,64,37,27,127,106,21,0
2021,Hinckley and Bosworth 014D,E01025834,649,568,294,274,2,2,9,5,4,70,68,2,0
2021,Hinckley and Bosworth 014E,E01025835,1102,972,472,500,15,15,20,4,16,95,79,16,0
2021,Hinckley and Bosworth 014F,E01025836,557,498,348,150,4,4,6,3,3,48,40,8,1
2021,Hinckley and Bosworth 004C,E01025837,911,699,404,295,7,7,67,28,39,138,112,26,0
2021,Hinckley and Bosworth 004D,E01025838,659,529,363,166,0,0,37,37,0,91,68,23,2
2021,Hinckley and Bosworth 006A,E01025839,732,550,285,265,12,12,21,9,12,149,133,16,0
2021,Hinckley and Bosworth 006B,E01025840,759,545,300,245,9,9,85,48,37,120,109,11,0
2021,Hinckley and Bosworth 006C,E01025841,817,695,431,264,12,12,44,0,44,66,51,15,0
2021,Hinckley and Bosworth 006D,E01025842,814,481,193,288,7,7,214,137,77,109,100,9,3
2021,Hinckley and Bosworth 006E,E01025843,801,528,275,253,13,13,82,49,33,178,161,17,0
2021,Hinckley and Bosworth 006F,E01025844,729,336,153,183,4,4,253,180,73,136,122,14,0
2021,Hinckley and Bosworth 003A,E01025845,655,597,408,189,1,1,21,13,8,36,26,10,0
2021,Hinckley and Bosworth 002A,E01025846,854,749,421,328,23,23,20,4,16,62,47,15,0
2021,Hinckley and Bosworth 002B,E01025847,667,582,278,304,0,0,4,3,1,81,72,9,0
2021,Hinckley and Bosworth 002C,E01025848,721,522,319,203,2,2,94,68,26,103,94,9,0
2021,Hinckley and Bosworth 012A,E01025849,1017,549,244,305,26,26,162,89,73,279,251,28,1
2021,Hinckley and Bosworth 010A,E01025850,659,444,218,226,3,3,52,37,15,160,145,15,0
2021,Hinckley and Bosworth 012B,E01025851,553,475,263,212,1,1,19,3,16,58,44,14,0
2021,Hinckley and Bosworth 010B,E01025852,1018,467,230,237,3,3,63,25,38,483,450,33,2
2021,Hinckley and Bosworth 011B,E01025854,926,698,290,408,4,4,60,9,51,164,144,20,0
2021,Hinckley and Bosworth 011C,E01025855,628,472,247,225,7,7,28,5,23,121,99,22,0
2021,Hinckley and Bosworth 012C,E01025856,639,288,163,125,3,3,260,162,98,86,74,12,2
2021,Hinckley and Bosworth 012D,E01025857,601,509,226,283,6,6,2,1,1,84,76,8,0
2021,Hinckley and Bosworth 010C,E01025858,1080,593,272,321,12,12,50,5,45,425,390,35,0
2021,Hinckley and Bosworth 009A,E01025859,668,590,328,262,8,8,24,1,23,46,40,6,0
2021,Hinckley and Bosworth 009B,E01025860,554,524,287,237,3,3,2,1,1,25,22,3,0
2021,Hinckley and Bosworth 009C,E01025861,781,617,328,289,8,8,48,16,32,108,98,10,0
2021,Hinckley and Bosworth 009D,E01025862,845,720,415,305,12,12,31,3,28,82,67,15,0
2021,Hinckley and Bosworth 010D,E01025863,764,533,306,227,14,14,135,100,35,81,71,10,1
2021,Hinckley and Bosworth 008C,E01025864,844,670,260,410,10,10,59,16,43,105,92,13,0
2021,Hinckley and Bosworth 010E,E01025865,780,527,227,300,2,2,126,89,37,123,111,12,2
2021,Hinckley and Bosworth 011D,E01025866,825,510,268,242,3,3,217,163,54,94,76,18,1
2021,Hinckley and Bosworth 011E,E01025867,660,526,295,231,0,0,25,11,14,109,95,14,0
2021,Hinckley and Bosworth 001A,E01025868,686,526,332,194,2,2,54,40,14,103,93,10,1
2021,Hinckley and Bosworth 001B,E01025869,749,603,394,209,10,10,40,33,7,96,85,11,0
2021,Hinckley and Bosworth 001C,E01025870,703,590,359,231,10,10,47,14,33,56,47,9,0
2021,Hinckley and Bosworth 001D,E01025871,614,481,242,239,9,9,71,44,27,53,44,9,0
2021,Hinckley and Bosworth 005A,E01025872,663,604,412,192,0,0,13,12,1,46,37,9,0
2021,Hinckley and Bosworth 005B,E01025873,660,575,340,235,0,0,16,12,4,69,61,8,0
2021,Hinckley and Bosworth 005C,E01025874,850,628,321,307,17,17,156,89,67,49,40,9,0
2021,Hinckley and Bosworth 005D,E01025875,733,452,221,231,10,10,197,147,50,71,56,15,3
2021,Hinckley and Bosworth 005E,E01025876,770,683,383,300,4,4,8,3,5,75,65,10,0
2021,Hinckley and Bosworth 003B,E01025877,758,558,286,272,9,9,72,29,43,119,103,16,0
2021,Hinckley and Bosworth 003C,E01025879,525,321,159,162,6,6,129,98,31,68,58,10,1
2021,Hinckley and Bosworth 003D,E01025880,704,612,336,276,16,16,24,5,19,52,37,15,0
2021,Hinckley and Bosworth 008D,E01025881,610,525,352,173,1,1,31,22,9,53,46,7,0
2021,Hinckley and Bosworth 004E,E01025882,713,556,313,243,4,4,69,49,20,84,55,29,0
2021,Melton 003A,E01025883,856,650,383,267,17,17,80,33,47,109,92,17,0
2021,Melton 003B,E01025884,777,507,210,297,16,16,162,124,38,91,74,17,1
2021,Melton 001A,E01025885,826,702,426,276,17,17,32,18,14,75,65,10,0
2021,Melton 001B,E01025886,816,576,337,239,16,16,94,57,37,128,111,17,2
2021,Melton 001C,E01025887,771,500,289,211,1,1,47,45,2,223,198,25,0
2021,Melton 003C,E01025888,796,651,388,263,3,3,31,20,11,111,92,19,0
2021,Melton 006A,E01025889,741,586,364,222,3,3,50,32,18,102,82,20,0
2021,Melton 001D,E01025890,566,402,233,169,11,11,92,75,17,58,45,13,3
2021,Melton 001E,E01025891,550,446,277,169,1,1,25,24,1,77,67,10,1
2021,Melton 001F,E01025892,682,542,306,236,3,3,34,28,6,103,89,14,0
2021,Melton 005A,E01025893,851,715,422,293,1,1,13,6,7,122,106,16,0
2021,Melton 005B,E01025894,862,346,199,147,2,2,249,226,23,261,240,21,4
2021,Melton 005C,E01025895,750,537,284,253,3,3,33,30,3,177,159,18,0
2021,Melton 004A,E01025896,718,609,379,230,14,14,17,3,14,78,66,12,0
2021,Melton 004B,E01025897,1022,509,240,269,14,14,230,70,160,269,249,20,0
2021,Melton 004C,E01025898,566,392,220,172,3,3,75,59,16,94,67,27,2
2021,Melton 004D,E01025899,545,314,140,174,8,8,40,11,29,183,174,9,0
2021,Melton 004E,E01025900,612,309,150,159,17,17,214,191,23,69,64,5,3
2021,Melton 002A,E01025901,941,746,457,289,2,2,85,15,70,108,93,15,0
2021,Melton 002B,E01025902,696,597,409,188,6,6,25,15,10,68,61,7,0
2021,Melton 002C,E01025903,847,462,221,241,8,8,68,53,15,308,286,22,1
2021,Melton 002D,E01025904,916,790,412,378,11,11,35,7,28,80,62,18,0
2021,Melton 004F,E01025905,698,332,196,136,37,37,283,197,86,42,35,7,4
2021,Melton 002E,E01025906,652,577,309,268,1,1,6,1,5,68,57,11,0
2021,Melton 005D,E01025907,726,472,255,217,5,5,171,156,15,78,69,9,0
2021,Melton 005E,E01025908,778,598,379,219,2,2,20,15,5,158,135,23,0
2021,Melton 003D,E01025909,833,651,374,277,2,2,65,56,9,114,84,30,1
2021,Melton 006B,E01025910,779,602,351,251,9,9,58,37,21,110,89,21,0
2021,Melton 006C,E01025911,727,540,323,217,14,14,53,25,28,120,106,14,0
2021,Melton 006D,E01025912,699,368,226,142,4,4,29,15,14,297,269,28,1
2021,North West Leicestershire 012A,E01025913,1021,829,463,366,2,2,101,79,22,89,69,20,0
2021,North West Leicestershire 006A,E01025914,533,509,306,203,0,0,3,1,2,21,19,2,0
2021,North West Leicestershire 003A,E01025915,550,419,265,154,1,1,36,6,30,94,78,16,0
2021,North West Leicestershire 003B,E01025916,773,584,280,304,5,5,31,28,3,153,142,11,0
2021,North West Leicestershire 003D,E01025918,755,390,223,167,15,15,266,92,174,83,73,10,1
2021,North West Leicestershire 006B,E01025919,612,397,215,182,23,23,138,134,4,53,47,6,1
2021,North West Leicestershire 006C,E01025920,810,529,261,268,16,16,209,163,46,53,50,3,3
2021,North West Leicestershire 006D,E01025921,939,683,397,286,7,7,88,68,20,160,145,15,1
2021,North West Leicestershire 002A,E01025923,624,496,299,197,2,2,61,47,14,63,52,11,2
2021,North West Leicestershire 001A,E01025924,490,369,184,185,3,3,25,14,11,93,83,10,0
2021,North West Leicestershire 001C,E01025926,1093,849,366,483,31,31,112,57,55,100,87,13,1
2021,North West Leicestershire 001D,E01025927,678,483,269,214,1,1,126,125,1,68,59,9,0
2021,North West Leicestershire 001E,E01025928,621,535,298,237,2,2,9,6,3,75,66,9,0
2021,North West Leicestershire 010A,E01025929,795,575,274,301,15,15,82,30,52,123,113,10,0
2021,North West Leicestershire 010B,E01025930,822,382,191,191,8,8,146,71,75,285,261,24,1
2021,North West Leicestershire 010C,E01025931,863,465,226,239,8,8,179,125,54,208,195,13,3
2021,North West Leicestershire 009A,E01025932,553,200,81,119,1,1,329,311,18,21,19,2,2
2021,North West Leicestershire 009B,E01025933,557,382,225,157,1,1,135,120,15,39,36,3,0
2021,North West Leicestershire 009C,E01025934,776,360,190,170,1,1,338,68,270,76,63,13,1
2021,North West Leicestershire 009D,E01025935,544,494,364,130,1,1,25,14,11,24,17,7,0
2021,North West Leicestershire 009E,E01025936,577,348,191,157,2,2,196,187,9,28,26,2,3
2021,North West Leicestershire 011B,E01025937,995,797,321,476,26,26,69,16,53,102,88,14,1
2021,North West Leicestershire 013A,E01025938,552,403,201,202,0,0,85,68,17,64,58,6,0
2021,North West Leicestershire 013B,E01025939,883,668,325,343,7,7,92,53,39,115,105,10,1
2021,North West Leicestershire 013C,E01025940,868,629,316,313,0,0,125,75,50,112,96,16,2
2021,North West Leicestershire 013D,E01025941,847,692,320,372,11,11,62,28,34,82,67,15,0
2021,North West Leicestershire 013E,E01025942,1132,942,409,533,28,28,85,21,64,77,62,15,0
2021,North West Leicestershire 013F,E01025943,831,440,232,208,9,9,244,223,21,132,117,15,6
2021,North West Leicestershire 002B,E01025944,728,555,306,249,10,10,49,25,24,114,102,12,0
2021,North West Leicestershire 002C,E01025945,719,474,281,193,0,0,56,49,7,187,177,10,2
2021,North West Leicestershire 002D,E01025946,887,467,234,233,11,11,123,82,41,285,264,21,1
2021,North West Leicestershire 012B,E01025947,909,783,439,344,4,4,27,20,7,95,75,20,0
2021,North West Leicestershire 012C,E01025948,738,466,212,254,2,2,86,47,39,184,166,18,0
2021,North West Leicestershire 012D,E01025949,705,323,161,162,5,5,236,225,11,140,130,10,1
2021,North West Leicestershire 008A,E01025950,914,560,203,357,1,1,239,200,39,109,94,15,5
2021,North West Leicestershire 008B,E01025951,854,703,377,326,15,15,48,6,42,88,70,18,0
2021,North West Leicestershire 008C,E01025952,753,607,365,242,3,3,105,88,17,38,28,10,0
2021,North West Leicestershire 008D,E01025953,539,406,198,208,0,0,85,71,14,48,34,14,0
2021,North West Leicestershire 008E,E01025954,632,490,234,256,0,0,73,67,6,69,58,11,0
2021,North West Leicestershire 005A,E01025955,790,672,375,297,16,16,47,16,31,55,42,13,0
2021,North West Leicestershire 005B,E01025956,553,395,226,169,4,4,76,51,25,78,69,9,0
2021,North West Leicestershire 010D,E01025957,899,475,193,282,22,22,170,23,147,232,214,18,0
2021,North West Leicestershire 011C,E01025958,902,664,294,370,26,26,80,40,40,132,115,17,0
2021,North West Leicestershire 011D,E01025959,1111,931,426,505,7,7,44,33,11,129,103,26,0
2021,North West Leicestershire 004A,E01025960,637,532,347,185,4,4,54,17,37,47,36,11,0
2021,North West Leicestershire 004B,E01025961,663,534,318,216,6,6,49,43,6,73,60,13,1
2021,North West Leicestershire 004C,E01025962,720,457,240,217,15,15,196,168,28,52,46,6,0
2021,North West Leicestershire 005C,E01025963,679,537,286,251,2,2,92,85,7,46,41,5,2
2021,North West Leicestershire 005D,E01025964,684,593,343,250,4,4,33,31,2,54,43,11,0
2021,North West Leicestershire 004D,E01025965,566,453,279,174,7,7,41,27,14,65,51,14,0
2021,North West Leicestershire 007A,E01025966,647,434,228,206,0,0,160,156,4,52,45,7,1
2021,North West Leicestershire 007B,E01025967,726,670,445,225,2,2,25,20,5,29,25,4,0
2021,North West Leicestershire 007C,E01025968,805,678,379,299,2,2,13,8,5,112,104,8,0
2021,North West Leicestershire 007D,E01025969,816,542,259,283,8,8,107,73,34,159,146,13,0
2021,Oadby and Wigston 003A,E01025970,627,528,291,237,6,6,30,2,28,63,52,11,0
2021,Oadby and Wigston 003B,E01025971,478,414,278,136,0,0,3,0,3,61,53,8,0
2021,Oadby and Wigston 003C,E01025972,456,402,231,171,0,0,2,0,2,52,40,12,0
2021,Oadby and Wigston 010C,E01025973,480,445,262,183,0,0,3,3,0,32,26,6,0
2021,Oadby and Wigston 010A,E01025974,601,387,198,189,0,0,30,8,22,184,173,11,0
2021,Oadby and Wigston 010D,E01025975,492,428,257,171,0,0,16,1,15,48,41,7,0
2021,Oadby and Wigston 003D,E01025976,581,308,173,135,2,2,185,165,20,83,78,5,3
2021,Oadby and Wigston 003E,E01025977,677,513,351,162,0,0,19,5,14,144,125,19,1
2021,Oadby and Wigston 003F,E01025978,744,440,278,162,3,3,85,37,48,216,197,19,0
2021,Oadby and Wigston 011C,E01025979,495,409,209,200,0,0,13,12,1,73,65,8,0
2021,Oadby and Wigston 010B,E01025980,462,406,230,176,0,0,1,1,0,55,43,12,0
2021,Oadby and Wigston 011E,E01025981,615,479,275,204,9,9,3,1,2,124,110,14,0
2021,Oadby and Wigston 011B,E01025982,655,528,263,265,1,1,23,2,21,103,96,7,0
2021,Oadby and Wigston 011D,E01025983,502,366,209,157,2,2,23,22,1,111,105,6,0
2021,Oadby and Wigston 011A,E01025984,486,436,263,173,0,0,3,2,1,47,45,2,0
2021,Oadby and Wigston 006A,E01025985,584,516,372,144,3,3,6,4,2,59,45,14,0
2021,Oadby and Wigston 006B,E01025986,625,562,355,207,2,2,1,0,1,60,48,12,0
2021,Oadby and Wigston 006C,E01025987,742,326,164,162,21,21,156,74,82,238,224,14,1
2021,Oadby and Wigston 006D,E01025988,819,439,144,295,15,15,144,17,127,221,206,15,0
2021,Oadby and Wigston 006E,E01025989,803,409,180,229,17,17,127,78,49,248,238,10,2
2021,Oadby and Wigston 007A,E01025990,601,514,351,163,0,0,21,8,13,66,57,9,0
2021,Oadby and Wigston 007B,E01025991,594,533,353,180,0,0,19,4,15,42,40,2,0
2021,Oadby and Wigston 005A,E01025992,839,447,259,188,11,11,208,159,49,167,149,18,6
2021,Oadby and Wigston 007C,E01025993,587,517,305,212,5,5,17,8,9,47,39,8,1
2021,Oadby and Wigston 005B,E01025994,690,412,156,256,16,16,153,121,32,103,91,12,6
2021,Oadby and Wigston 008A,E01025995,593,471,267,204,2,2,5,2,3,115,105,10,0
2021,Oadby and Wigston 005C,E01025997,585,360,153,207,4,4,169,133,36,51,36,15,1
2021,Oadby and Wigston 007D,E01025998,955,772,328,444,6,6,24,6,18,153,138,15,0
2021,Oadby and Wigston 005D,E01025999,655,402,233,169,7,7,141,122,19,103,95,8,2
2021,Oadby and Wigston 007E,E01026000,536,477,338,139,2,2,7,4,3,50,47,3,0
2021,Oadby and Wigston 007F,E01026001,633,500,317,183,10,10,11,7,4,112,97,15,0
2021,Oadby and Wigston 008B,E01026003,653,518,315,203,7,7,54,46,8,74,65,9,0
2021,Oadby and Wigston 008C,E01026004,683,631,358,273,0,0,7,6,1,45,35,10,0
2021,Oadby and Wigston 005E,E01026005,697,519,292,227,5,5,75,52,23,98,90,8,0
2021,Boston 001A,E01026007,487,415,256,159,5,5,27,11,16,40,31,9,0
2021,Boston 001B,E01026008,561,403,262,141,6,6,110,29,81,42,28,14,0
2021,Boston 001C,E01026009,514,375,246,129,1,1,87,17,70,51,34,17,0
2021,Boston 002A,E01026010,748,123,46,77,13,13,473,213,260,133,126,7,6
2021,Boston 004A,E01026012,539,271,192,79,2,2,216,60,156,50,43,7,0
2021,Boston 008A,E01026013,619,533,358,175,3,3,22,10,12,61,54,7,0
2021,Boston 008B,E01026014,788,594,355,239,11,11,73,24,49,110,98,12,0
2021,Boston 004B,E01026015,699,404,201,203,18,18,63,17,46,214,206,8,0
2021,Boston 006A,E01026016,1032,763,453,310,11,11,176,54,122,82,66,16,0
2021,Boston 007A,E01026017,698,448,260,188,4,4,191,61,130,55,44,11,0
2021,Boston 007B,E01026018,738,632,428,204,3,3,38,14,24,65,56,9,0
2021,Boston 007C,E01026019,1155,547,276,271,19,19,395,146,249,193,172,21,1
2021,Boston 007D,E01026020,1183,805,425,380,27,27,139,31,108,212,195,17,0
2021,Boston 003B,E01026021,799,496,324,172,5,5,57,6,51,241,217,24,0
2021,Boston 008C,E01026022,915,745,497,248,18,18,19,2,17,133,122,11,0
2021,Boston 001D,E01026023,600,432,301,131,1,1,96,24,72,70,57,13,1
2021,Boston 001E,E01026024,924,636,391,245,26,26,160,44,116,101,83,18,1
2021,Boston 003C,E01026025,1088,332,174,158,18,18,245,66,179,492,463,29,1
2021,Boston 004C,E01026026,895,386,146,240,16,16,399,137,262,90,85,5,4
2021,Boston 004D,E01026027,751,449,235,214,9,9,97,26,71,196,188,8,0
2021,Boston 004E,E01026028,855,440,252,188,2,2,210,64,146,202,187,15,1
2021,Boston 002C,E01026030,1126,302,142,160,24,24,527,199,328,266,249,17,7
2021,Boston 009B,E01026031,699,508,361,147,26,26,85,22,63,78,68,10,2
2021,Boston 002D,E01026032,772,339,197,142,7,7,126,52,74,299,285,14,1
2021,Boston 006B,E01026033,1000,778,430,348,10,10,87,31,56,125,108,17,0
2021,Boston 006C,E01026034,842,533,311,222,12,12,193,51,142,104,82,22,0
2021,Boston 009C,E01026035,1073,933,532,401,6,6,25,15,10,109,96,13,0
2021,Boston 003D,E01026036,650,286,162,124,3,3,31,16,15,330,315,15,0
2021,Boston 002E,E01026037,692,249,150,99,1,1,240,83,157,201,193,8,1
2021,Boston 008D,E01026038,655,451,278,173,2,2,39,10,29,163,145,18,0
2021,Boston 009D,E01026039,512,410,275,135,4,4,50,19,31,48,33,15,0
2021,Boston 008E,E01026040,677,467,206,261,27,27,98,37,61,85,69,16,0
2021,Boston 007E,E01026041,613,259,123,136,4,4,287,99,188,62,57,5,1
2021,East Lindsey 008A,E01026042,771,368,219,149,9,9,159,39,120,235,221,14,0
2021,East Lindsey 008B,E01026043,813,526,339,187,10,10,132,33,99,145,124,21,0
2021,East Lindsey 008C,E01026044,614,498,381,117,6,6,25,6,19,85,65,20,0
2021,East Lindsey 001A,E01026045,881,634,447,187,6,6,89,14,75,152,128,24,0
2021,East Lindsey 013A,E01026046,597,382,246,136,5,5,73,18,55,137,113,24,0
2021,East Lindsey 013B,E01026047,624,514,387,127,6,6,17,2,15,87,77,10,0
2021,East Lindsey 010A,E01026048,783,455,373,82,16,16,74,13,61,237,205,32,1
2021,East Lindsey 010B,E01026049,750,570,443,127,6,6,32,6,26,142,104,38,0
2021,East Lindsey 010C,E01026050,818,646,525,121,2,2,19,3,16,151,125,26,0
2021,East Lindsey 016A,E01026051,611,505,288,217,8,8,26,0,26,72,66,6,0
2021,East Lindsey 016B,E01026052,845,487,303,184,24,24,103,21,82,231,116,115,0
2021,East Lindsey 016C,E01026053,780,496,264,232,7,7,22,5,17,255,143,112,0
2021,East Lindsey 016D,E01026054,715,397,225,172,4,4,137,37,100,175,150,25,2
2021,East Lindsey 013C,E01026055,491,429,308,121,0,0,16,3,13,46,32,14,0
2021,East Lindsey 017A,E01026056,521,413,284,129,3,3,32,14,18,73,46,27,0
2021,East Lindsey 018A,E01026057,865,663,446,217,2,2,36,9,27,164,96,68,0
2021,East Lindsey 002A,E01026058,1019,835,525,310,5,5,63,10,53,116,92,24,0
2021,East Lindsey 013D,E01026059,492,407,304,103,2,2,44,11,33,39,23,16,0
2021,East Lindsey 009A,E01026060,577,465,322,143,2,2,29,6,23,81,60,21,0
2021,East Lindsey 001B,E01026061,501,454,265,189,1,1,4,1,3,42,32,10,0
2021,East Lindsey 001C,E01026062,519,388,234,154,0,0,50,8,42,81,68,13,0
2021,East Lindsey 001D,E01026063,687,594,349,245,13,13,16,2,14,64,56,8,0
2021,East Lindsey 011A,E01026064,711,353,194,159,30,30,246,61,185,81,72,9,1
2021,East Lindsey 011B,E01026065,890,698,494,204,9,9,44,11,33,139,105,34,0
2021,East Lindsey 011C,E01026066,964,779,506,273,2,2,24,1,23,159,132,27,0
2021,East Lindsey 011D,E01026067,975,472,268,204,7,7,168,24,144,328,301,27,0
2021,East Lindsey 009B,E01026068,945,674,464,210,3,3,63,17,46,205,171,34,0
2021,East Lindsey 010D,E01026069,1060,666,576,90,11,11,170,43,127,213,162,51,0
2021,East Lindsey 009C,E01026070,951,641,418,223,20,20,50,10,40,239,179,60,1
2021,East Lindsey 007A,E01026071,952,734,520,214,6,6,45,6,39,167,132,35,0
2021,East Lindsey 005A,E01026072,1014,597,458,139,27,27,209,54,155,180,155,25,1
2021,East Lindsey 005B,E01026073,959,491,371,120,5,5,212,22,190,251,218,33,0
2021,East Lindsey 005C,E01026074,1059,762,625,137,11,11,118,24,94,166,142,24,2
2021,East Lindsey 018B,E01026075,953,688,469,219,0,0,73,13,60,192,154,38,0
2021,East Lindsey 002B,E01026076,974,791,522,269,5,5,66,12,54,112,86,26,0
2021,East Lindsey 003A,E01026077,647,370,218,152,18,18,196,49,147,61,52,9,2
2021,East Lindsey 003B,E01026078,478,268,158,110,1,1,126,24,102,80,74,6,3
2021,East Lindsey 002C,E01026079,865,687,494,193,2,2,60,12,48,116,85,31,0
2021,East Lindsey 001E,E01026080,904,724,478,246,9,9,49,7,42,122,92,30,0
2021,East Lindsey 004A,E01026081,1189,633,410,223,2,2,93,21,72,461,415,46,0
2021,East Lindsey 007B,E01026082,1034,865,628,237,3,3,25,6,19,141,105,36,0
2021,East Lindsey 015A,E01026083,786,240,143,97,7,7,453,124,329,86,78,8,0
2021,East Lindsey 012A,E01026084,711,405,268,137,6,6,86,21,65,214,195,19,0
2021,East Lindsey 003C,E01026087,629,324,138,186,22,22,187,51,136,96,88,8,0
2021,East Lindsey 003D,E01026088,623,513,335,178,10,10,25,8,17,75,66,9,0
2021,East Lindsey 004C,E01026089,995,753,535,218,1,1,53,11,42,188,156,32,0
2021,East Lindsey 003E,E01026090,623,408,279,129,1,1,115,24,91,99,84,15,0
2021,East Lindsey 003F,E01026091,499,360,197,163,2,2,59,8,51,78,68,10,0
2021,East Lindsey 014A,E01026092,644,278,153,125,3,3,69,6,63,294,276,18,0
2021,East Lindsey 014B,E01026093,919,253,178,75,6,6,51,2,49,609,569,40,0
2021,East Lindsey 015B,E01026094,1067,402,291,111,60,60,439,107,332,165,148,17,1
2021,East Lindsey 014C,E01026095,595,322,214,108,0,0,36,3,33,237,225,12,0
2021,East Lindsey 015C,E01026096,620,481,274,207,5,5,9,3,6,125,110,15,0
2021,East Lindsey 015D,E01026097,752,416,310,106,2,2,183,33,150,151,133,18,0
2021,East Lindsey 018C,E01026098,900,736,488,248,7,7,59,10,49,98,77,21,0
2021,East Lindsey 005D,E01026099,904,759,554,205,0,0,41,3,38,104,68,36,0
2021,East Lindsey 013E,E01026100,846,514,323,191,5,5,81,11,70,246,214,32,0
2021,East Lindsey 013F,E01026101,614,272,170,102,17,17,194,40,154,131,109,22,0
2021,East Lindsey 018D,E01026102,992,783,516,267,8,8,88,20,68,113,81,32,0
2021,East Lindsey 006A,E01026103,1004,717,583,134,6,6,71,7,64,210,178,32,0
2021,East Lindsey 006B,E01026104,1077,889,752,137,10,10,83,20,63,94,75,19,1
2021,East Lindsey 009D,E01026105,993,782,547,235,0,0,34,6,28,177,126,51,0
2021,East Lindsey 001F,E01026106,528,427,248,179,3,3,32,3,29,66,54,12,0
2021,East Lindsey 001G,E01026107,501,412,241,171,2,2,11,1,10,76,61,15,0
2021,East Lindsey 003G,E01026108,1102,509,252,257,36,36,371,86,285,183,159,24,3
2021,East Lindsey 006C,E01026109,1114,855,727,128,1,1,38,8,30,220,191,29,0
2021,East Lindsey 017B,E01026110,691,489,374,115,4,4,80,5,75,118,93,25,0
2021,East Lindsey 017C,E01026111,667,470,338,132,6,6,106,19,87,85,66,19,0
2021,East Lindsey 017D,E01026112,503,191,128,63,0,0,160,48,112,152,125,27,0
2021,East Lindsey 008D,E01026113,920,715,552,163,3,3,62,8,54,140,104,36,0
2021,East Lindsey 014D,E01026114,782,309,193,116,2,2,65,2,63,406,378,28,0
2021,East Lindsey 012C,E01026115,819,376,273,103,16,16,132,23,109,294,276,18,1
2021,East Lindsey 012D,E01026116,728,469,293,176,27,27,76,14,62,156,144,12,0
2021,East Lindsey 008E,E01026117,870,705,532,173,4,4,40,4,36,121,88,33,0
2021,East Lindsey 016E,E01026118,852,715,515,200,26,26,31,1,30,80,62,18,0
2021,East Lindsey 016F,E01026119,513,450,343,107,0,0,12,1,11,51,40,11,0
2021,East Lindsey 016G,E01026120,739,447,293,154,22,22,106,11,95,164,134,30,0
2021,East Lindsey 007C,E01026121,1159,829,524,305,6,6,114,27,87,209,174,35,1
2021,Lincoln 004A,E01026122,801,250,134,116,11,11,125,61,64,415,386,29,0
2021,Lincoln 004B,E01026123,1054,458,163,295,31,31,313,240,73,246,230,16,6
2021,Lincoln 004C,E01026124,749,286,142,144,2,2,42,11,31,419,397,22,0
2021,Lincoln 003A,E01026125,516,293,144,149,3,3,19,11,8,201,186,15,0
2021,Lincoln 004D,E01026126,921,174,91,83,11,11,430,388,42,296,278,18,10
2021,Lincoln 007A,E01026127,632,206,77,129,2,2,313,306,7,104,96,8,7
2021,Lincoln 007C,E01026129,720,136,57,79,0,0,499,357,142,82,75,7,3
2021,Lincoln 009A,E01026130,625,503,323,180,7,7,35,22,13,79,67,12,1
2021,Lincoln 007D,E01026131,604,387,197,190,2,2,137,133,4,76,64,12,2
2021,Lincoln 005A,E01026132,780,133,71,62,6,6,205,162,43,428,404,24,8
2021,Lincoln 006A,E01026134,933,323,136,187,4,4,127,109,18,474,452,22,5
2021,Lincoln 008B,E01026135,760,623,326,297,0,0,60,49,11,75,57,18,2
2021,Lincoln 008C,E01026136,780,598,303,295,35,35,56,13,43,91,73,18,0
2021,Lincoln 011A,E01026137,479,406,195,211,0,0,9,7,2,64,57,7,0
2021,Lincoln 011B,E01026138,621,549,301,248,1,1,6,3,3,65,53,12,0
2021,Lincoln 011C,E01026139,566,489,265,224,5,5,20,4,16,52,49,3,0
2021,Lincoln 011D,E01026140,629,315,131,184,2,2,182,18,164,130,123,7,0
2021,Lincoln 011E,E01026141,597,494,218,276,2,2,42,33,9,57,47,10,2
2021,Lincoln 011F,E01026142,501,294,147,147,0,0,145,144,1,59,54,5,3
2021,Lincoln 003B,E01026144,890,303,151,152,29,29,108,26,82,450,383,67,0
2021,Lincoln 005C,E01026145,657,344,186,158,8,8,38,27,11,267,262,5,0
2021,Lincoln 005D,E01026146,736,134,76,58,6,6,227,168,59,365,343,22,4
2021,Lincoln 003C,E01026147,1067,742,377,365,7,7,13,10,3,305,277,28,0
2021,Lincoln 003D,E01026148,976,372,208,164,9,9,157,136,21,429,400,29,9
2021,Lincoln 001A,E01026149,780,353,204,149,0,0,319,303,16,101,86,15,7
2021,Lincoln 001B,E01026150,857,290,119,171,21,21,426,407,19,113,102,11,7
2021,Lincoln 003E,E01026151,967,550,317,233,14,14,140,122,18,261,240,21,2
2021,Lincoln 004E,E01026152,568,95,31,64,1,1,433,426,7,34,30,4,5
2021,Lincoln 002A,E01026153,1098,713,342,371,9,9,92,48,44,284,257,27,0
2021,Lincoln 004F,E01026154,531,311,131,180,2,2,158,148,10,60,46,14,0
2021,Lincoln 002B,E01026155,811,598,287,311,2,2,9,9,0,202,190,12,0
2021,Lincoln 004G,E01026156,484,239,114,125,1,1,189,186,3,54,48,6,1
2021,Lincoln 002C,E01026157,642,299,213,86,1,1,251,211,40,89,83,6,2
2021,Lincoln 009B,E01026158,658,546,355,191,0,0,21,8,13,91,80,11,0
2021,Lincoln 009C,E01026159,662,451,209,242,5,5,49,16,33,157,144,13,0
2021,Lincoln 009D,E01026160,614,468,254,214,0,0,20,15,5,126,111,15,0
2021,Lincoln 010A,E01026161,662,293,135,158,3,3,268,250,18,91,81,10,7
2021,Lincoln 009E,E01026162,642,468,284,184,0,0,94,76,18,80,69,11,0
2021,Lincoln 009F,E01026163,605,467,248,219,1,1,10,8,2,127,114,13,0
2021,Lincoln 003F,E01026164,566,454,273,181,1,1,54,52,2,57,53,4,0
2021,Lincoln 002D,E01026165,831,399,214,185,10,10,314,290,24,102,87,15,6
2021,Lincoln 001C,E01026166,607,277,138,139,25,25,230,205,25,72,56,16,3
2021,Lincoln 003G,E01026167,810,454,297,157,2,2,59,41,18,292,259,33,3
2021,Lincoln 001D,E01026168,695,236,113,123,15,15,377,352,25,63,52,11,4
2021,Lincoln 011G,E01026169,724,509,324,185,2,2,148,141,7,62,48,14,3
2021,Lincoln 010B,E01026170,646,354,170,184,6,6,184,157,27,101,87,14,1
2021,Lincoln 011H,E01026171,697,592,376,216,1,1,20,9,11,84,74,10,0
2021,Lincoln 010C,E01026172,645,298,132,166,13,13,267,256,11,62,56,6,5
2021,Lincoln 010D,E01026173,695,158,73,85,1,1,476,464,12,49,44,5,11
2021,Lincoln 008D,E01026174,658,303,125,178,5,5,63,44,19,286,271,15,1
2021,Lincoln 010E,E01026175,933,333,120,213,6,6,202,136,66,391,368,23,1
2021,Lincoln 006B,E01026176,1011,133,81,52,5,5,299,159,140,567,531,36,7
2021,Lincoln 006C,E01026177,813,207,99,108,4,4,43,17,26,559,536,23,0
2021,Lincoln 006D,E01026178,800,312,160,152,3,3,73,39,34,410,394,16,2
2021,North Kesteven 008A,E01026179,417,183,99,84,4,4,46,39,7,183,38,145,1
2021,North Kesteven 007A,E01026180,618,466,293,173,3,3,71,69,2,77,64,13,1
2021,North Kesteven 003B,E01026182,635,504,281,223,9,9,59,43,16,63,45,18,0
2021,North Kesteven 007B,E01026183,1186,770,460,310,6,6,239,218,21,166,131,35,5
2021,North Kesteven 004A,E01026184,587,271,112,159,2,2,25,7,18,289,37,252,0
2021,North Kesteven 004B,E01026185,996,707,381,326,7,7,116,101,15,165,147,18,1
2021,North Kesteven 001A,E01026186,741,631,381,250,1,1,15,11,4,94,69,25,0
2021,North Kesteven 001B,E01026187,781,627,241,386,1,1,7,2,5,146,129,17,0
2021,North Kesteven 004C,E01026188,1032,586,281,305,11,11,208,169,39,224,206,18,3
2021,North Kesteven 001C,E01026189,817,706,482,224,4,4,7,3,4,100,88,12,0
2021,North Kesteven 004D,E01026190,813,471,250,221,28,28,206,103,103,105,77,28,3
2021,North Kesteven 005A,E01026191,791,593,297,296,21,21,82,51,31,94,76,18,1
2021,North Kesteven 006A,E01026192,530,417,243,174,10,10,52,40,12,51,33,18,0
2021,North Kesteven 003C,E01026193,648,522,301,221,0,0,54,53,1,72,51,21,0
2021,North Kesteven 006B,E01026194,927,689,409,280,21,21,140,107,33,76,64,12,1
2021,North Kesteven 006C,E01026195,833,689,446,243,1,1,33,29,4,109,84,25,1
2021,North Kesteven 006D,E01026196,658,491,310,181,2,2,51,49,2,111,84,27,3
2021,North Kesteven 008B,E01026197,644,490,258,232,0,0,38,29,9,113,98,15,3
2021,North Kesteven 008C,E01026198,468,157,54,103,3,3,26,14,12,282,79,203,0
2021,North Kesteven 003D,E01026199,1083,872,499,373,7,7,51,44,7,152,107,45,1
2021,North Kesteven 012A,E01026200,816,647,372,275,0,0,25,16,9,144,118,26,0
2021,North Kesteven 012B,E01026201,894,643,440,203,2,2,139,130,9,109,77,32,1
2021,North Kesteven 012C,E01026202,923,672,430,242,7,7,159,127,32,83,66,17,2
2021,North Kesteven 001D,E01026203,891,699,456,243,12,12,63,24,39,117,96,21,0
2021,North Kesteven 001E,E01026204,749,660,454,206,0,0,8,7,1,81,64,17,0
2021,North Kesteven 005B,E01026205,737,495,265,230,12,12,151,142,9,78,60,18,1
2021,North Kesteven 001F,E01026206,780,676,380,296,2,2,6,6,0,96,80,16,0
2021,North Kesteven 012D,E01026207,549,413,266,147,1,1,65,63,2,70,62,8,0
2021,North Kesteven 012E,E01026208,691,528,306,222,4,4,70,43,27,87,66,21,2
2021,North Kesteven 009A,E01026209,971,788,542,246,1,1,73,58,15,109,74,35,0
2021,North Kesteven 007C,E01026210,1032,727,417,310,2,2,137,125,12,166,128,38,0
2021,North Kesteven 005C,E01026211,811,661,317,344,0,0,40,31,9,110,91,19,0
2021,North Kesteven 005D,E01026212,656,533,304,229,5,5,33,17,16,85,66,19,0
2021,North Kesteven 005E,E01026213,809,510,311,199,3,3,165,141,24,124,97,27,7
2021,North Kesteven 014A,E01026214,514,410,229,181,0,0,52,46,6,51,39,12,1
2021,North Kesteven 014B,E01026215,461,413,281,132,1,1,6,5,1,41,36,5,0
2021,North Kesteven 014C,E01026218,581,463,335,128,7,7,30,3,27,81,69,12,0
2021,North Kesteven 014D,E01026219,514,460,292,168,1,1,8,6,2,45,33,12,0
2021,North Kesteven 013A,E01026220,1038,798,566,232,23,23,123,83,40,93,75,18,1
2021,North Kesteven 009B,E01026221,1094,757,467,290,0,0,154,132,22,183,148,35,0
2021,North Kesteven 009C,E01026222,876,710,458,252,1,1,31,19,12,133,117,16,1
2021,North Kesteven 008D,E01026223,914,764,467,297,2,2,22,20,2,126,102,24,0
2021,North Kesteven 007D,E01026224,792,425,228,197,6,6,262,239,23,92,76,16,7
2021,North Kesteven 003E,E01026225,741,493,226,267,5,5,90,89,1,151,130,21,2
2021,North Kesteven 003F,E01026226,834,736,516,220,5,5,3,2,1,90,73,17,0
2021,North Kesteven 010A,E01026227,810,352,188,164,1,1,190,102,88,266,244,22,1
2021,North Kesteven 011A,E01026228,729,468,196,272,5,5,72,48,24,184,170,14,0
2021,North Kesteven 011B,E01026229,763,527,256,271,26,26,105,12,93,105,90,15,0
2021,North Kesteven 010B,E01026230,764,382,135,247,42,42,208,169,39,128,115,13,4
2021,North Kesteven 010C,E01026231,1170,862,439,423,5,5,75,56,19,227,199,28,1
2021,North Kesteven 010D,E01026232,1025,619,363,256,2,2,182,102,80,220,192,28,2
2021,North Kesteven 011C,E01026233,720,584,313,271,0,0,15,9,6,121,107,14,0
2021,North Kesteven 010E,E01026235,767,351,206,145,12,12,234,166,68,168,148,20,2
2021,North Kesteven 011E,E01026236,538,414,274,140,6,6,39,14,25,79,70,9,0
2021,North Kesteven 004E,E01026237,507,439,276,163,3,3,9,3,6,56,45,11,0
2021,North Kesteven 004F,E01026238,631,494,236,258,38,38,39,4,35,60,55,5,0
2021,South Holland 011A,E01026239,917,631,310,321,11,11,88,50,38,186,144,42,1
2021,South Holland 011B,E01026240,1140,883,450,433,8,8,160,139,21,88,74,14,1
2021,South Holland 005A,E01026241,752,531,204,327,1,1,120,119,1,99,84,15,1
2021,South Holland 001A,E01026242,780,612,359,253,22,22,81,36,45,64,50,14,1
2021,South Holland 001B,E01026243,593,365,224,141,3,3,155,130,25,66,54,12,4
2021,South Holland 001C,E01026244,555,459,284,175,1,1,53,53,0,42,29,13,0
2021,South Holland 010A,E01026245,1078,857,560,297,14,14,47,45,2,157,129,28,3
2021,South Holland 002A,E01026246,981,745,477,268,1,1,127,116,11,108,79,29,0
2021,South Holland 001D,E01026247,842,648,426,222,3,3,83,71,12,107,84,23,1
2021,South Holland 002B,E01026248,944,695,406,289,3,3,109,86,23,137,109,28,0
2021,South Holland 010B,E01026249,856,719,440,279,7,7,44,39,5,86,65,21,0
2021,South Holland 003A,E01026250,1003,434,233,201,22,22,179,108,71,365,338,27,3
2021,South Holland 003B,E01026251,812,694,456,238,8,8,34,16,18,76,61,15,0
2021,South Holland 003C,E01026252,826,593,375,218,1,1,89,81,8,142,122,20,1
2021,South Holland 003D,E01026253,894,577,342,235,4,4,185,134,51,128,114,14,0
2021,South Holland 008A,E01026254,859,557,373,184,6,6,194,144,50,99,76,23,3
2021,South Holland 008B,E01026255,904,641,434,207,8,8,37,12,25,218,194,24,0
2021,South Holland 008C,E01026256,726,510,317,193,4,4,136,107,29,73,61,12,3
2021,South Holland 002C,E01026257,971,782,550,232,11,11,85,29,56,91,73,18,2
2021,South Holland 005B,E01026258,977,814,493,321,41,41,39,11,28,83,67,16,0
2021,South Holland 005C,E01026259,712,541,294,247,0,0,102,92,10,69,58,11,0
2021,South Holland 005D,E01026260,862,557,328,229,8,8,170,119,51,120,103,17,7
2021,South Holland 009A,E01026262,645,535,330,205,1,1,15,12,3,94,78,16,0
2021,South Holland 009B,E01026263,972,675,301,374,28,28,61,37,24,207,189,18,1
2021,South Holland 009C,E01026264,656,390,225,165,4,4,77,67,10,184,168,16,1
2021,South Holland 009D,E01026265,535,401,242,159,1,1,54,52,2,79,68,11,0
2021,South Holland 006B,E01026266,1067,389,233,156,22,22,80,13,67,574,543,31,2
2021,South Holland 007A,E01026268,877,429,254,175,4,4,241,226,15,200,184,16,3
2021,South Holland 007B,E01026269,943,757,496,261,1,1,29,21,8,155,133,22,1
2021,South Holland 007C,E01026270,727,326,174,152,4,4,223,160,63,174,159,15,0
2021,South Holland 007D,E01026271,755,270,136,134,4,4,311,285,26,161,149,12,9
2021,South Holland 007E,E01026272,600,379,228,151,1,1,55,42,13,163,153,10,2
2021,South Holland 006C,E01026273,742,647,396,251,2,2,16,6,10,77,68,9,0
2021,South Holland 006E,E01026275,1115,674,262,412,15,15,167,129,38,255,239,16,4
2021,South Holland 001E,E01026276,982,790,514,276,4,4,82,76,6,106,79,27,0
2021,South Holland 008D,E01026277,720,330,159,171,5,5,210,189,21,172,160,12,3
2021,South Holland 008E,E01026278,630,476,294,182,1,1,20,7,13,132,109,23,1
2021,South Holland 008F,E01026279,620,458,286,172,3,3,59,26,33,100,88,12,0
2021,South Holland 010C,E01026280,1118,882,547,335,1,1,121,102,19,113,84,29,1
2021,South Holland 004A,E01026281,585,497,311,186,8,8,27,25,2,53,38,15,0
2021,South Holland 004B,E01026282,765,519,310,209,10,10,162,145,17,71,59,12,3
2021,South Holland 004C,E01026283,750,618,403,215,7,7,42,36,6,83,62,21,0
2021,South Holland 011C,E01026284,972,758,400,358,18,18,104,74,30,91,74,17,1
2021,South Holland 004D,E01026285,620,504,326,178,4,4,45,37,8,65,48,17,2
2021,South Holland 004E,E01026286,529,384,223,161,5,5,75,45,30,65,51,14,0
2021,South Kesteven 015A,E01026287,612,398,253,145,3,3,104,92,12,106,89,17,1
2021,South Kesteven 015B,E01026288,745,305,148,157,22,22,320,296,24,97,84,13,1
2021,South Kesteven 015C,E01026289,996,665,337,328,30,30,131,71,60,169,152,17,1
2021,South Kesteven 008A,E01026290,939,718,427,291,3,3,108,99,9,110,82,28,0
2021,South Kesteven 002A,E01026291,891,725,441,284,2,2,94,64,30,70,60,10,0
2021,South Kesteven 007A,E01026292,637,521,315,206,0,0,4,1,3,112,99,13,0
2021,South Kesteven 007B,E01026293,866,628,318,310,1,1,7,4,3,230,186,44,0
2021,South Kesteven 007C,E01026294,657,506,234,272,4,4,17,4,13,130,122,8,0
2021,South Kesteven 011B,E01026296,659,569,387,182,1,1,24,23,1,65,50,15,0
2021,South Kesteven 011C,E01026297,665,429,288,141,15,15,145,117,28,74,66,8,2
2021,South Kesteven 011D,E01026298,1048,481,235,246,4,4,241,170,71,319,293,26,3
2021,South Kesteven 010A,E01026299,744,469,287,182,6,6,125,104,21,142,128,14,2
2021,South Kesteven 010B,E01026300,636,584,387,197,0,0,5,4,1,47,40,7,0
2021,South Kesteven 010D,E01026302,493,412,223,189,4,4,7,6,1,70,60,10,0
2021,South Kesteven 014A,E01026303,525,448,235,213,2,2,6,6,0,69,61,8,0
2021,South Kesteven 014B,E01026304,625,533,290,243,4,4,10,4,6,78,65,13,0
2021,South Kesteven 014C,E01026305,608,460,229,231,1,1,6,3,3,141,131,10,0
2021,South Kesteven 014D,E01026306,816,487,252,235,35,35,199,113,86,91,76,15,4
2021,South Kesteven 014E,E01026307,556,451,261,190,0,0,6,5,1,99,87,12,0
2021,South Kesteven 005A,E01026308,625,176,64,112,1,1,389,344,45,57,52,5,2
2021,South Kesteven 005B,E01026309,726,496,270,226,1,1,73,61,12,154,137,17,2
2021,South Kesteven 005C,E01026310,452,283,161,122,2,2,113,106,7,54,41,13,0
2021,South Kesteven 005D,E01026311,679,320,134,186,4,4,192,150,42,159,153,6,4
2021,South Kesteven 005E,E01026312,448,128,41,87,4,4,280,243,37,33,32,1,3
2021,South Kesteven 001A,E01026313,629,500,295,205,5,5,54,44,10,70,54,16,0
2021,South Kesteven 001B,E01026314,586,439,248,191,3,3,67,49,18,77,63,14,0
2021,South Kesteven 009A,E01026315,964,547,332,215,2,2,144,92,52,271,243,28,0
2021,South Kesteven 007D,E01026316,1062,705,416,289,4,4,117,69,48,236,189,47,0
2021,South Kesteven 006A,E01026317,1117,428,184,244,7,7,125,47,78,557,528,29,0
2021,South Kesteven 006B,E01026318,1023,406,143,263,29,29,189,62,127,397,372,25,2
2021,South Kesteven 006C,E01026319,1111,778,390,388,24,24,65,16,49,243,224,19,1
2021,South Kesteven 004B,E01026321,597,509,299,210,7,7,8,0,8,73,62,11,0
2021,South Kesteven 004C,E01026322,590,447,254,193,3,3,3,2,1,137,118,19,0
2021,South Kesteven 004D,E01026323,1061,405,234,171,2,2,249,166,83,402,380,22,3
2021,South Kesteven 004E,E01026324,879,738,402,336,1,1,18,15,3,121,106,15,1
2021,South Kesteven 003A,E01026325,622,338,144,194,3,3,222,208,14,55,43,12,4
2021,South Kesteven 003B,E01026326,625,468,285,183,2,2,78,77,1,77,70,7,0
2021,South Kesteven 003C,E01026327,619,384,218,166,2,2,167,158,9,59,51,8,7
2021,South Kesteven 003D,E01026328,596,251,105,146,7,7,285,259,26,47,39,8,6
2021,South Kesteven 001C,E01026329,797,598,380,218,3,3,74,63,11,121,94,27,1
2021,South Kesteven 012A,E01026330,868,713,407,306,0,0,63,55,8,91,75,16,1
2021,South Kesteven 009B,E01026331,1108,688,384,304,12,12,187,116,71,221,195,26,0
2021,South Kesteven 007E,E01026332,940,731,446,285,2,2,72,64,8,131,106,25,4
2021,South Kesteven 001D,E01026333,1080,878,470,408,6,6,81,68,13,115,89,26,0
2021,South Kesteven 013A,E01026334,638,554,312,242,1,1,29,27,2,52,44,8,2
2021,South Kesteven 013B,E01026335,722,543,353,190,2,2,39,31,8,138,123,15,0
2021,South Kesteven 013C,E01026336,807,455,257,198,7,7,261,81,180,82,73,9,2
2021,South Kesteven 013D,E01026337,937,715,378,337,17,17,115,45,70,90,78,12,0
2021,South Kesteven 009C,E01026338,540,412,241,171,6,6,53,50,3,67,52,15,2
2021,South Kesteven 009D,E01026339,568,379,149,230,9,9,91,34,57,89,78,11,0
2021,South Kesteven 002B,E01026340,1005,644,375,269,24,24,204,145,59,128,103,25,5
2021,South Kesteven 008B,E01026341,668,505,304,201,4,4,91,75,16,67,49,18,1
2021,South Kesteven 008C,E01026342,585,467,218,249,1,1,11,9,2,106,87,19,0
2021,South Kesteven 006D,E01026343,942,351,185,166,6,6,125,43,82,457,431,26,3
2021,South Kesteven 006E,E01026344,667,406,187,219,2,2,11,7,4,247,232,15,1
2021,South Kesteven 006F,E01026345,729,472,272,200,2,2,146,139,7,107,91,16,2
2021,South Kesteven 015D,E01026346,516,367,199,168,3,3,47,46,1,96,86,10,3
2021,South Kesteven 015E,E01026347,831,491,279,212,10,10,132,107,25,196,183,13,2
2021,South Kesteven 015F,E01026348,485,288,134,154,3,3,135,128,7,57,37,20,2
2021,South Kesteven 016A,E01026349,768,409,247,162,4,4,217,200,17,134,123,11,4
2021,South Kesteven 016B,E01026350,991,516,384,132,23,23,144,62,82,308,276,32,0
2021,South Kesteven 016C,E01026351,850,402,268,134,4,4,93,50,43,350,316,34,1
2021,South Kesteven 003E,E01026352,563,509,335,174,1,1,4,3,1,49,37,12,0
2021,South Kesteven 003F,E01026353,864,354,224,130,3,3,182,98,84,322,292,30,3
2021,South Kesteven 003G,E01026354,488,440,286,154,3,3,4,2,2,41,34,7,0
2021,South Kesteven 002C,E01026355,1109,918,602,316,3,3,56,42,14,131,106,25,1
2021,South Kesteven 016D,E01026356,588,454,209,245,1,1,4,3,1,129,121,8,0
2021,South Kesteven 016E,E01026357,588,431,256,175,6,6,33,25,8,118,110,8,0
2021,South Kesteven 016F,E01026358,625,523,318,205,2,2,14,13,1,86,82,4,0
2021,South Kesteven 016G,E01026359,1035,825,416,409,44,44,82,8,74,83,74,9,1
2021,South Kesteven 012B,E01026360,915,741,441,300,3,3,73,56,17,98,82,16,0
2021,South Kesteven 008D,E01026361,1181,816,466,350,15,15,154,117,37,195,166,29,1
2021,South Kesteven 012C,E01026362,693,605,310,295,1,1,19,9,10,68,61,7,0
2021,South Kesteven 012D,E01026363,861,730,554,176,8,8,27,23,4,96,72,24,0
2021,South Kesteven 012E,E01026364,814,677,419,258,12,12,56,42,14,69,54,15,0
2021,South Kesteven 002D,E01026365,1024,890,607,283,3,3,46,40,6,85,58,27,0
2021,West Lindsey 011A,E01026366,1070,753,419,334,25,25,168,24,144,124,93,31,0
2021,West Lindsey 001A,E01026367,801,409,270,139,0,0,162,39,123,230,193,37,0
2021,West Lindsey 001B,E01026368,843,656,362,294,9,9,61,15,46,117,99,18,0
2021,West Lindsey 011B,E01026369,593,408,233,175,4,4,92,13,79,89,70,19,0
2021,West Lindsey 011C,E01026370,1154,950,527,423,7,7,37,7,30,158,141,17,2
2021,West Lindsey 011D,E01026371,529,483,297,186,2,2,7,1,6,37,32,5,0
2021,West Lindsey 008A,E01026372,1081,862,519,343,22,22,89,22,67,107,79,28,1
2021,West Lindsey 011E,E01026373,942,758,447,311,8,8,79,17,62,97,77,20,0
2021,West Lindsey 006A,E01026374,617,168,82,86,2,2,384,165,219,61,54,7,2
2021,West Lindsey 006B,E01026375,846,368,189,179,10,10,302,101,201,166,154,12,0
2021,West Lindsey 006C,E01026376,759,350,226,124,3,3,314,114,200,92,77,15,0
2021,West Lindsey 006D,E01026377,917,528,238,290,18,18,253,105,148,115,100,15,3
2021,West Lindsey 004A,E01026378,738,381,219,162,1,1,107,29,78,246,236,10,3
2021,West Lindsey 004B,E01026379,826,503,291,212,2,2,66,13,53,254,233,21,1
2021,West Lindsey 002A,E01026380,1077,779,339,440,1,1,92,33,59,205,189,16,0
2021,West Lindsey 004C,E01026381,877,441,252,189,18,18,207,33,174,211,197,14,0
2021,West Lindsey 004D,E01026382,787,485,260,225,4,4,51,10,41,246,225,21,1
2021,West Lindsey 004E,E01026383,734,218,143,75,3,3,64,13,51,449,429,20,0
2021,West Lindsey 004F,E01026384,1102,402,222,180,8,8,189,29,160,503,477,26,0
2021,West Lindsey 005A,E01026385,496,367,252,115,4,4,28,7,21,97,81,16,0
2021,West Lindsey 005B,E01026386,535,279,149,130,1,1,23,8,15,232,200,32,0
2021,West Lindsey 001C,E01026387,1144,933,587,346,3,3,76,14,62,130,92,38,2
2021,West Lindsey 007A,E01026388,964,824,535,289,5,5,37,3,34,98,80,18,0
2021,West Lindsey 003A,E01026389,910,554,334,220,4,4,46,8,38,306,279,27,0
2021,West Lindsey 003B,E01026390,877,504,329,175,8,8,218,50,168,145,130,15,2
2021,West Lindsey 003C,E01026391,897,704,478,226,13,13,44,8,36,134,109,25,2
2021,West Lindsey 003D,E01026392,1338,1064,673,391,8,8,93,18,75,173,142,31,0
2021,West Lindsey 010A,E01026393,688,614,413,201,7,7,9,0,9,58,40,18,0
2021,West Lindsey 010B,E01026394,993,728,325,403,5,5,78,18,60,181,158,23,1
2021,West Lindsey 010C,E01026395,752,588,419,169,16,16,71,6,65,77,65,12,0
2021,West Lindsey 009A,E01026396,639,539,383,156,23,23,29,3,26,48,37,11,0
2021,West Lindsey 009C,E01026398,784,488,289,199,25,25,158,31,127,112,95,17,1
2021,West Lindsey 005C,E01026399,653,496,249,247,2,2,57,12,45,98,79,19,0
2021,West Lindsey 009D,E01026400,608,400,140,260,0,0,8,1,7,200,105,95,0
2021,West Lindsey 002B,E01026401,653,584,363,221,0,0,7,3,4,62,48,14,0
2021,West Lindsey 002C,E01026402,854,677,404,273,10,10,31,11,20,136,119,17,0
2021,West Lindsey 002D,E01026403,556,453,262,191,6,6,51,17,34,46,32,14,0
2021,West Lindsey 007B,E01026404,1059,836,470,366,2,2,95,26,69,126,99,27,0
2021,West Lindsey 010D,E01026405,607,500,267,233,11,11,41,14,27,55,38,17,0
2021,West Lindsey 010E,E01026406,514,479,292,187,0,0,3,1,2,32,20,12,0
2021,West Lindsey 002E,E01026407,595,434,224,210,2,2,67,24,43,92,76,16,0
2021,West Lindsey 002F,E01026408,595,446,287,159,10,10,65,17,48,74,64,10,0
2021,West Lindsey 007C,E01026409,564,459,257,202,1,1,35,10,25,69,41,28,0
2021,West Lindsey 007D,E01026410,783,666,528,138,2,2,50,13,37,65,45,20,0
2021,West Lindsey 005D,E01026411,1102,826,513,313,3,3,75,17,58,198,151,47,0
2021,West Lindsey 008B,E01026412,846,639,381,258,20,20,92,22,70,95,74,21,0
2021,West Lindsey 008C,E01026413,893,770,465,305,7,7,32,2,30,84,70,14,0
2021,West Lindsey 008D,E01026414,813,602,326,276,16,16,39,6,33,156,129,27,0
2021,West Lindsey 003E,E01026415,494,319,190,129,3,3,12,3,9,160,138,22,0
2021,West Lindsey 001D,E01026416,571,350,221,129,8,8,82,20,62,131,114,17,0
2021,Breckland 010A,E01026419,515,393,233,160,2,2,34,2,32,86,71,15,0
2021,Breckland 010B,E01026420,527,440,275,165,0,0,28,3,25,59,33,26,0
2021,Breckland 013A,E01026421,774,594,374,220,3,3,67,0,67,110,90,20,0
2021,Breckland 011B,E01026423,795,503,273,230,4,4,117,26,91,171,144,27,0
2021,Breckland 012A,E01026424,935,699,439,260,2,2,84,18,66,150,121,29,0
2021,Breckland 005A,E01026425,857,409,236,173,4,4,297,68,229,146,127,19,1
2021,Breckland 005B,E01026426,1198,513,278,235,1,1,345,67,278,337,317,20,2
2021,Breckland 005C,E01026427,1060,763,481,282,17,17,99,30,69,181,157,24,0
2021,Breckland 003A,E01026428,1083,756,412,344,0,0,169,46,123,157,143,14,1
2021,Breckland 003B,E01026429,699,396,245,151,1,1,132,29,103,169,142,27,1
2021,Breckland 003C,E01026430,929,672,354,318,28,28,133,11,122,96,79,17,0
2021,Breckland 003D,E01026431,517,386,250,136,0,0,73,10,63,58,42,16,0
2021,Breckland 005D,E01026432,627,545,347,198,2,2,11,2,9,69,55,14,0
2021,Breckland 005E,E01026433,626,321,146,175,2,2,73,11,62,230,218,12,0
2021,Breckland 005F,E01026434,916,665,416,249,2,2,31,6,25,218,189,29,0
2021,Breckland 013B,E01026435,911,595,319,276,3,3,90,8,82,223,174,49,0
2021,Breckland 001A,E01026436,1050,816,485,331,4,4,96,15,81,134,106,28,0
2021,Breckland 008A,E01026437,599,455,321,134,0,0,80,17,63,63,50,13,1
2021,Breckland 008B,E01026438,468,325,225,100,2,2,58,13,45,82,66,16,1
2021,Breckland 014A,E01026439,837,656,400,256,9,9,39,7,32,133,117,16,0
2021,Breckland 014B,E01026440,477,306,179,127,0,0,29,8,21,142,77,65,0
2021,Breckland 014C,E01026441,677,470,293,177,1,1,131,31,100,75,65,10,0
2021,Breckland 002A,E01026442,964,693,485,208,5,5,117,15,102,149,116,33,0
2021,Breckland 002B,E01026443,884,583,380,203,0,0,117,25,92,184,152,32,0
2021,Breckland 012B,E01026444,916,605,395,210,2,2,148,26,122,161,130,31,0
2021,Breckland 002C,E01026445,1127,783,518,265,15,15,191,36,155,138,102,36,0
2021,Breckland 004A,E01026446,986,765,528,237,3,3,109,22,87,109,82,27,0
2021,Breckland 011C,E01026447,795,347,149,198,17,17,291,55,236,138,128,10,2
2021,Breckland 013C,E01026448,982,826,462,364,1,1,32,0,32,123,106,17,0
2021,Breckland 011D,E01026449,859,521,309,212,5,5,73,7,66,260,233,27,0
2021,Breckland 011E,E01026450,806,636,364,272,7,7,18,3,15,145,126,19,0
2021,Breckland 008C,E01026451,1048,767,438,329,0,0,140,26,114,140,104,36,1
2021,Breckland 004B,E01026452,738,542,361,181,1,1,90,12,78,105,81,24,0
2021,Breckland 004C,E01026453,652,458,301,157,3,3,76,17,59,115,85,30,0
2021,Breckland 004D,E01026454,634,475,198,277,5,5,11,3,8,143,129,14,0
2021,Breckland 007B,E01026456,535,439,304,135,0,0,5,0,5,91,74,17,0
2021,Breckland 007C,E01026457,654,565,445,120,0,0,24,4,20,65,55,10,0
2021,Breckland 007D,E01026458,789,452,271,181,3,3,218,23,195,116,98,18,0
2021,Breckland 007E,E01026459,717,405,307,98,9,9,181,34,147,122,106,16,0
2021,Breckland 001C,E01026461,693,563,383,180,7,7,42,6,36,81,71,10,0
2021,Breckland 002D,E01026462,1015,836,522,314,5,5,62,9,53,112,84,28,0
2021,Breckland 010D,E01026464,549,435,281,154,1,1,34,9,25,79,63,16,0
2021,Breckland 015A,E01026465,810,342,183,159,6,6,232,54,178,230,215,15,0
2021,Breckland 015B,E01026466,774,358,141,217,4,4,197,39,158,211,195,16,4
2021,Breckland 015C,E01026467,764,169,78,91,2,2,488,130,358,104,97,7,1
2021,Breckland 016A,E01026468,1124,546,331,215,7,7,140,23,117,431,406,25,0
2021,Breckland 016B,E01026469,692,411,246,165,9,9,80,8,72,192,158,34,0
2021,Breckland 016C,E01026470,1132,729,269,460,10,10,22,3,19,371,357,14,0
2021,Breckland 016D,E01026471,519,338,165,173,18,18,10,0,10,153,141,12,0
2021,Breckland 016E,E01026472,497,409,222,187,2,2,6,1,5,80,62,18,0
2021,Breckland 016F,E01026473,564,424,208,216,2,2,14,3,11,124,105,19,0
2021,Breckland 017A,E01026474,827,402,225,177,2,2,241,55,186,182,169,13,0
2021,Breckland 017B,E01026475,669,431,244,187,1,1,151,43,108,86,77,9,0
2021,Breckland 017C,E01026476,590,280,134,146,7,7,191,59,132,110,102,8,2
2021,Breckland 017D,E01026477,700,245,119,126,3,3,359,100,259,93,79,14,0
2021,Breckland 017E,E01026478,622,264,115,149,1,1,242,42,200,114,104,10,1
2021,Breckland 006A,E01026479,663,493,298,195,1,1,119,12,107,50,23,27,0
2021,Breckland 006B,E01026480,714,594,377,217,11,11,20,4,16,89,72,17,0
2021,Breckland 006C,E01026481,535,395,206,189,10,10,79,16,63,51,36,15,0
2021,Breckland 001E,E01026483,499,282,182,100,0,0,99,28,71,118,99,19,0
2021,Breckland 006D,E01026484,658,517,324,193,0,0,56,6,50,85,60,25,0
2021,Breckland 006E,E01026485,486,394,255,139,1,1,34,7,27,57,37,20,0
2021,Breckland 009A,E01026486,903,706,486,220,18,18,69,17,52,108,98,10,2
2021,Breckland 009B,E01026487,886,604,276,328,9,9,55,5,50,218,176,42,0
2021,Breckland 009C,E01026488,644,216,142,74,3,3,191,38,153,232,207,25,2
2021,Breckland 009D,E01026489,682,531,386,145,5,5,53,5,48,93,79,14,0
2021,Breckland 009E,E01026490,889,715,458,257,11,11,40,7,33,123,115,8,0
2021,Breckland 010E,E01026491,1000,770,479,291,1,1,55,14,41,173,125,48,1
2021,Breckland 012C,E01026492,572,414,241,173,0,0,71,9,62,87,79,8,0
2021,Breckland 012D,E01026493,618,472,284,188,4,4,47,8,39,95,75,20,0
2021,Breckland 014D,E01026494,1008,765,472,293,0,0,82,8,74,161,131,30,0
2021,Breckland 008D,E01026495,649,442,315,127,9,9,128,21,107,70,52,18,0
2021,Breckland 008E,E01026496,514,422,304,118,0,0,22,2,20,70,52,18,0
2021,Broadland 018A,E01026497,711,525,360,165,10,10,28,2,26,148,129,19,0
2021,Broadland 018B,E01026498,606,410,277,133,1,1,123,15,108,72,58,14,0
2021,Broadland 001A,E01026499,789,422,306,116,0,0,236,35,201,131,113,18,0
2021,Broadland 001B,E01026500,739,600,400,200,0,0,49,4,45,90,75,15,0
2021,Broadland 001C,E01026501,711,533,366,167,11,11,72,7,65,95,72,23,0
2021,Broadland 001D,E01026502,906,597,324,273,28,28,145,11,134,136,108,28,0
2021,Broadland 001E,E01026503,932,750,478,272,1,1,67,5,62,114,102,12,0
2021,Broadland 014A,E01026504,630,470,310,160,1,1,33,2,31,126,106,20,0
2021,Broadland 014B,E01026505,870,538,257,281,32,32,241,26,215,59,44,15,0
2021,Broadland 014C,E01026506,622,565,367,198,1,1,10,1,9,46,34,12,0
2021,Broadland 014D,E01026507,613,505,307,198,11,11,44,6,38,53,42,11,0
2021,Broadland 017A,E01026508,628,464,297,167,4,4,79,10,69,81,67,14,0
2021,Broadland 017B,E01026509,822,673,388,285,17,17,34,2,32,98,88,10,0
2021,Broadland 017C,E01026510,776,650,425,225,9,9,22,0,22,95,84,11,0
2021,Broadland 017D,E01026511,491,378,215,163,3,3,62,7,55,48,33,15,0
2021,Broadland 014E,E01026512,569,402,245,157,4,4,121,14,107,41,32,9,1
2021,Broadland 014F,E01026513,619,503,297,206,10,10,43,5,38,63,52,11,0
2021,Broadland 003A,E01026514,638,472,269,203,12,12,65,11,54,89,77,12,0
2021,Broadland 003B,E01026515,484,400,246,154,2,2,21,6,15,61,50,11,0
2021,Broadland 003C,E01026516,542,345,199,146,3,3,121,16,105,73,65,8,0
2021,Broadland 003D,E01026517,694,514,338,176,2,2,37,0,37,141,123,18,0
2021,Broadland 007A,E01026518,544,383,167,216,10,10,82,8,74,69,62,7,0
2021,Broadland 007B,E01026519,744,474,210,264,4,4,44,3,41,222,201,21,0
2021,Broadland 007C,E01026520,504,409,293,116,0,0,56,6,50,39,34,5,0
2021,Broadland 007D,E01026521,517,436,299,137,3,3,10,1,9,68,62,6,0
2021,Broadland 002A,E01026522,631,429,251,178,9,9,88,14,74,105,84,21,0
2021,Broadland 002B,E01026523,791,513,310,203,3,3,122,16,106,153,124,29,0
2021,Broadland 002C,E01026524,639,480,291,189,2,2,63,8,55,94,73,21,0
2021,Broadland 002D,E01026525,535,398,266,132,1,1,35,5,30,101,72,29,0
2021,Broadland 010A,E01026526,647,500,348,152,0,0,96,11,85,51,39,12,0
2021,Broadland 010B,E01026527,645,580,402,178,1,1,10,1,9,54,39,15,0
2021,Broadland 010C,E01026528,600,480,319,161,3,3,67,12,55,49,36,13,1
2021,Broadland 010D,E01026529,728,543,333,210,0,0,114,9,105,71,61,10,0
2021,Broadland 011A,E01026530,814,661,386,275,8,8,27,1,26,118,97,21,0
2021,Broadland 011B,E01026531,829,751,449,302,2,2,5,1,4,71,55,16,0
2021,Broadland 011C,E01026532,747,609,352,257,7,7,53,9,44,78,63,15,0
2021,Broadland 004A,E01026533,543,464,330,134,9,9,24,0,24,46,36,10,0
2021,Broadland 004B,E01026534,655,504,276,228,5,5,55,5,50,91,61,30,0
2021,Broadland 004C,E01026535,962,682,340,342,20,20,121,17,104,139,121,18,0
2021,Broadland 004D,E01026536,782,574,327,247,2,2,100,16,84,106,89,17,0
2021,Broadland 004E,E01026537,584,470,200,270,3,3,38,1,37,73,63,10,0
2021,Broadland 018C,E01026538,704,469,291,178,12,12,125,19,106,98,79,19,0
2021,Broadland 018D,E01026539,683,554,334,220,3,3,60,4,56,64,48,16,2
2021,Broadland 009A,E01026540,643,590,419,171,0,0,2,0,2,51,44,7,0
2021,Broadland 009B,E01026541,1066,649,288,361,6,6,273,31,242,138,108,30,0
2021,Broadland 009C,E01026542,639,552,341,211,1,1,28,2,26,58,45,13,0
2021,Broadland 009D,E01026543,675,578,378,200,1,1,5,0,5,91,75,16,0
2021,Broadland 009E,E01026544,784,632,346,286,2,2,48,4,44,102,89,13,0
2021,Broadland 008A,E01026545,856,644,261,383,26,26,128,12,116,57,50,7,1
2021,Broadland 008B,E01026546,606,545,352,193,0,0,5,1,4,56,48,8,0
2021,Broadland 002E,E01026547,639,411,285,126,0,0,86,7,79,142,129,13,0
2021,Broadland 002F,E01026548,563,450,308,142,5,5,17,1,16,91,77,14,0
2021,Broadland 005A,E01026549,821,594,379,215,1,1,155,15,140,71,60,11,0
2021,Broadland 005B,E01026550,432,365,173,192,5,5,18,1,17,44,38,6,0
2021,Broadland 005C,E01026551,513,434,255,179,7,7,11,5,6,61,50,11,0
2021,Broadland 005D,E01026552,608,565,389,176,2,2,5,0,5,36,27,9,0
2021,Broadland 012A,E01026553,611,416,245,171,1,1,113,19,94,80,68,12,1
2021,Broadland 012B,E01026554,495,430,257,173,5,5,16,1,15,44,37,7,0
2021,Broadland 012C,E01026555,607,471,277,194,3,3,87,9,78,46,36,10,0
2021,Broadland 012D,E01026556,653,446,245,201,2,2,106,12,94,98,88,10,1
2021,Broadland 013A,E01026557,623,520,351,169,0,0,18,4,14,85,72,13,0
2021,Broadland 013B,E01026558,1079,799,379,420,30,30,142,14,128,108,99,9,0
2021,Broadland 013C,E01026559,613,536,328,208,2,2,13,0,13,62,53,9,0
2021,Broadland 013D,E01026560,614,559,385,174,0,0,12,0,12,43,34,9,0
2021,Broadland 006A,E01026562,458,418,218,200,2,2,7,1,6,31,27,4,0
2021,Broadland 006B,E01026563,581,375,151,224,8,8,97,14,83,101,91,10,0
2021,Broadland 006C,E01026564,600,475,236,239,5,5,42,6,36,78,63,15,0
2021,Broadland 006D,E01026565,521,301,126,175,8,8,62,8,54,150,144,6,0
2021,Broadland 006E,E01026566,638,496,286,210,2,2,49,6,43,91,81,10,0
2021,Broadland 006F,E01026567,755,706,532,174,0,0,5,0,5,44,30,14,0
2021,Broadland 006G,E01026568,623,566,321,245,1,1,6,2,4,50,43,7,0
2021,Broadland 015A,E01026569,724,489,308,181,1,1,180,28,152,54,43,11,0
2021,Broadland 015B,E01026570,746,653,409,244,1,1,25,2,23,67,53,14,0
2021,Broadland 015C,E01026571,661,567,338,229,4,4,14,2,12,76,68,8,0
2021,Broadland 015D,E01026572,637,572,366,206,2,2,13,2,11,50,36,14,0
2021,Broadland 015E,E01026573,632,429,248,181,3,3,151,23,128,49,39,10,0
2021,Broadland 016A,E01026574,683,579,287,292,15,15,5,1,4,84,78,6,0
2021,Broadland 016B,E01026575,796,576,356,220,0,0,106,7,99,114,92,22,0
2021,Broadland 016C,E01026576,805,587,259,328,5,5,49,6,43,164,152,12,0
2021,Broadland 016D,E01026577,772,539,332,207,0,0,80,16,64,152,141,11,1
2021,Broadland 008C,E01026578,856,654,323,331,15,15,103,7,96,84,72,12,0
2021,Broadland 008D,E01026579,689,575,355,220,4,4,54,3,51,56,40,16,0
2021,Broadland 008E,E01026580,808,635,426,209,7,7,87,8,79,78,63,15,1
2021,Great Yarmouth 008A,E01026581,680,568,323,245,2,2,26,9,17,84,73,11,0
2021,Great Yarmouth 008B,E01026582,917,787,488,299,9,9,16,13,3,105,80,25,0
2021,Great Yarmouth 008C,E01026583,578,434,281,153,0,0,82,71,11,62,53,9,0
2021,Great Yarmouth 008D,E01026584,667,578,379,199,5,5,18,12,6,66,52,14,0
2021,Great Yarmouth 013C,E01026587,1190,1025,429,596,1,1,64,22,42,100,87,13,0
2021,Great Yarmouth 013D,E01026588,1169,945,604,341,4,4,57,27,30,163,140,23,0
2021,Great Yarmouth 003A,E01026589,602,450,277,173,1,1,51,36,15,99,91,8,1
2021,Great Yarmouth 003B,E01026590,664,536,387,149,3,3,4,2,2,120,97,23,1
2021,Great Yarmouth 003C,E01026591,795,684,493,191,4,4,7,5,2,100,84,16,0
2021,Great Yarmouth 003D,E01026592,679,440,338,102,0,0,157,153,4,80,66,14,2
2021,Great Yarmouth 003E,E01026593,618,518,374,144,1,1,10,7,3,89,67,22,0
2021,Great Yarmouth 003F,E01026594,810,583,345,238,5,5,66,33,33,154,124,30,2
2021,Great Yarmouth 005A,E01026595,846,303,188,115,2,2,239,189,50,298,284,14,4
2021,Great Yarmouth 005B,E01026596,686,385,237,148,0,0,49,36,13,250,233,17,2
2021,Great Yarmouth 005C,E01026597,1007,183,112,71,5,5,351,163,188,467,437,30,1
2021,Great Yarmouth 005D,E01026598,855,212,130,82,9,9,111,43,68,522,498,24,1
2021,Great Yarmouth 004A,E01026599,589,298,164,134,2,2,28,7,21,261,244,17,0
2021,Great Yarmouth 007A,E01026600,666,337,195,142,1,1,215,184,31,110,95,15,3
2021,Great Yarmouth 009A,E01026601,699,402,221,181,3,3,69,18,51,225,207,18,0
2021,Great Yarmouth 009B,E01026602,737,513,309,204,5,5,132,120,12,85,77,8,2
2021,Great Yarmouth 009C,E01026603,766,243,111,132,0,0,425,415,10,86,68,18,12
2021,Great Yarmouth 009D,E01026604,730,249,131,118,1,1,400,361,39,77,67,10,3
2021,Great Yarmouth 001A,E01026605,774,666,447,219,2,2,17,16,1,89,65,24,0
2021,Great Yarmouth 001B,E01026606,663,509,392,117,0,0,78,69,9,76,52,24,0
2021,Great Yarmouth 001C,E01026607,822,630,443,187,2,2,56,46,10,133,107,26,1
2021,Great Yarmouth 002A,E01026608,608,524,353,171,0,0,25,25,0,59,48,11,0
2021,Great Yarmouth 002B,E01026609,511,359,221,138,4,4,72,67,5,76,52,24,0
2021,Great Yarmouth 010A,E01026610,660,412,193,219,1,1,13,7,6,234,212,22,0
2021,Great Yarmouth 010B,E01026611,622,460,334,126,2,2,30,9,21,130,121,9,0
2021,Great Yarmouth 010C,E01026612,1072,783,522,261,1,1,84,38,46,202,179,23,2
2021,Great Yarmouth 012A,E01026613,574,499,308,191,1,1,13,9,4,61,50,11,0
2021,Great Yarmouth 012B,E01026614,862,653,493,160,2,2,59,56,3,147,115,32,1
2021,Great Yarmouth 012C,E01026615,559,503,314,189,0,0,6,4,2,49,36,13,1
2021,Great Yarmouth 012D,E01026616,493,389,190,199,1,1,32,30,2,69,60,9,2
2021,Great Yarmouth 011A,E01026617,579,312,186,126,2,2,202,131,71,60,50,10,3
2021,Great Yarmouth 011B,E01026618,671,392,255,137,0,0,152,16,136,127,70,57,0
2021,Great Yarmouth 011C,E01026619,604,228,93,135,1,1,298,291,7,74,66,8,3
2021,Great Yarmouth 011D,E01026620,683,264,117,147,0,0,344,308,36,63,52,11,12
2021,Great Yarmouth 011E,E01026621,563,365,194,171,1,1,124,108,16,71,57,14,2
2021,Great Yarmouth 006A,E01026622,631,160,94,66,0,0,331,295,36,132,129,3,8
2021,Great Yarmouth 006B,E01026623,827,272,181,91,1,1,80,13,67,474,453,21,0
2021,Great Yarmouth 006C,E01026624,933,253,169,84,10,10,156,78,78,512,496,16,2
2021,Great Yarmouth 006D,E01026625,791,104,63,41,0,0,584,542,42,91,79,12,12
2021,Great Yarmouth 006E,E01026626,972,289,189,100,3,3,106,61,45,572,543,29,2
2021,Great Yarmouth 001D,E01026627,628,570,423,147,1,1,3,1,2,54,40,14,0
2021,Great Yarmouth 001E,E01026628,794,656,385,271,15,15,54,32,22,69,51,18,0
2021,Great Yarmouth 001F,E01026629,664,509,301,208,0,0,56,51,5,99,84,15,0
2021,Great Yarmouth 010D,E01026630,667,381,214,167,2,2,128,120,8,153,136,17,3
2021,Great Yarmouth 010E,E01026631,788,483,277,206,1,1,24,22,2,280,254,26,0
2021,Great Yarmouth 009E,E01026632,814,491,294,197,4,4,96,80,16,220,196,24,3
2021,Great Yarmouth 007B,E01026633,764,388,191,197,1,1,83,32,51,292,270,22,0
2021,Great Yarmouth 007C,E01026634,624,365,186,179,2,2,45,29,16,212,205,7,0
2021,Great Yarmouth 007D,E01026635,1061,329,155,174,1,1,305,159,146,423,407,16,3
2021,Great Yarmouth 002C,E01026636,684,557,392,165,2,2,50,49,1,74,51,23,1
2021,Great Yarmouth 002D,E01026637,920,797,521,276,2,2,15,8,7,106,81,25,0
2021,Great Yarmouth 002E,E01026638,693,470,248,222,2,2,118,98,20,101,85,16,2
2021,Great Yarmouth 004B,E01026639,608,436,261,175,0,0,14,10,4,158,137,21,0
2021,Great Yarmouth 004C,E01026640,743,516,352,164,0,0,155,129,26,68,53,15,4
2021,Great Yarmouth 004D,E01026641,612,211,114,97,0,0,343,328,15,55,46,9,3
2021,King's Lynn and West Norfolk 014A,E01026642,615,521,337,184,5,5,22,8,14,67,58,9,0
2021,King's Lynn and West Norfolk 014B,E01026643,612,454,297,157,0,0,27,12,15,131,116,15,0
2021,King's Lynn and West Norfolk 014C,E01026644,481,107,35,72,1,1,33,4,29,340,82,258,0
2021,King's Lynn and West Norfolk 002A,E01026645,590,389,313,76,9,9,81,16,65,111,89,22,0
2021,King's Lynn and West Norfolk 002B,E01026646,749,466,358,108,4,4,145,36,109,134,109,25,0
2021,King's Lynn and West Norfolk 008A,E01026647,956,794,524,270,1,1,75,15,60,86,62,24,0
2021,King's Lynn and West Norfolk 019A,E01026648,726,481,307,174,4,4,85,15,70,156,132,24,0
2021,King's Lynn and West Norfolk 019B,E01026649,744,525,303,222,2,2,52,10,42,165,144,21,0
2021,King's Lynn and West Norfolk 019C,E01026650,457,208,128,80,1,1,31,3,28,216,83,133,1
2021,King's Lynn and West Norfolk 019D,E01026651,1085,790,463,327,3,3,107,23,84,185,150,35,0
2021,King's Lynn and West Norfolk 019E,E01026652,582,394,229,165,2,2,94,25,69,92,72,20,0
2021,King's Lynn and West Norfolk 004A,E01026653,866,766,571,195,0,0,5,1,4,95,77,18,0
2021,King's Lynn and West Norfolk 004B,E01026654,746,422,307,115,1,1,202,23,179,120,102,18,1
2021,King's Lynn and West Norfolk 004C,E01026655,674,529,375,154,6,6,15,1,14,124,104,20,0
2021,King's Lynn and West Norfolk 002C,E01026656,817,529,362,167,4,4,128,25,103,156,123,33,0
2021,King's Lynn and West Norfolk 016A,E01026659,726,486,280,206,1,1,130,25,105,109,88,21,0
2021,King's Lynn and West Norfolk 016B,E01026660,752,589,365,224,2,2,69,11,58,92,65,27,0
2021,King's Lynn and West Norfolk 016C,E01026661,682,557,334,223,1,1,40,11,29,84,63,21,0
2021,King's Lynn and West Norfolk 010A,E01026662,1097,346,104,242,29,29,409,129,280,312,297,15,1
2021,King's Lynn and West Norfolk 010B,E01026663,710,304,149,155,2,2,294,69,225,110,93,17,0
2021,King's Lynn and West Norfolk 010C,E01026664,963,462,200,262,15,15,110,23,87,376,354,22,0
2021,King's Lynn and West Norfolk 012A,E01026665,1076,749,478,271,4,4,154,20,134,168,142,26,1
2021,King's Lynn and West Norfolk 009A,E01026666,774,276,121,155,4,4,358,139,219,134,119,15,2
2021,King's Lynn and West Norfolk 009B,E01026667,669,472,253,219,0,0,23,5,18,174,159,15,0
2021,King's Lynn and West Norfolk 009C,E01026668,663,436,233,203,2,2,37,9,28,188,174,14,0
2021,King's Lynn and West Norfolk 006A,E01026669,879,723,400,323,10,10,24,5,19,122,99,23,0
2021,King's Lynn and West Norfolk 006B,E01026670,668,381,160,221,6,6,192,52,140,89,82,7,0
2021,King's Lynn and West Norfolk 006C,E01026671,534,489,259,230,1,1,7,0,7,37,30,7,0
2021,King's Lynn and West Norfolk 006D,E01026672,616,526,319,207,2,2,14,4,10,74,64,10,0
2021,King's Lynn and West Norfolk 006E,E01026673,630,467,242,225,4,4,11,2,9,148,131,17,0
2021,King's Lynn and West Norfolk 012B,E01026674,513,431,296,135,0,0,39,10,29,43,29,14,0
2021,King's Lynn and West Norfolk 012C,E01026675,546,447,260,187,1,1,39,8,31,59,41,18,0
2021,King's Lynn and West Norfolk 003A,E01026676,813,702,548,154,2,2,14,2,12,95,80,15,0
2021,King's Lynn and West Norfolk 003B,E01026677,717,431,292,139,2,2,187,25,162,96,78,18,1
2021,King's Lynn and West Norfolk 003C,E01026678,764,619,490,129,2,2,30,0,30,113,92,21,0
2021,King's Lynn and West Norfolk 018A,E01026679,1072,758,458,300,5,5,118,16,102,189,148,41,2
2021,King's Lynn and West Norfolk 001A,E01026680,847,559,446,113,9,9,193,27,166,85,70,15,1
2021,King's Lynn and West Norfolk 001B,E01026681,624,482,392,90,1,1,29,2,27,111,91,20,1
2021,King's Lynn and West Norfolk 001C,E01026682,553,405,327,78,1,1,62,3,59,85,69,16,0
2021,King's Lynn and West Norfolk 001D,E01026683,676,388,301,87,3,3,28,4,24,256,239,17,1
2021,King's Lynn and West Norfolk 013A,E01026684,552,450,272,178,1,1,41,8,33,60,44,16,0
2021,King's Lynn and West Norfolk 013B,E01026685,557,440,300,140,1,1,64,7,57,52,36,16,0
2021,King's Lynn and West Norfolk 007A,E01026687,794,235,96,139,7,7,460,145,315,88,72,16,4
2021,King's Lynn and West Norfolk 007B,E01026688,595,249,110,139,3,3,269,105,164,74,63,11,0
2021,King's Lynn and West Norfolk 007C,E01026689,688,244,122,122,2,2,61,20,41,381,358,23,0
2021,King's Lynn and West Norfolk 007D,E01026690,669,276,115,161,2,2,299,100,199,89,79,10,3
2021,King's Lynn and West Norfolk 005A,E01026691,472,394,240,154,2,2,42,4,38,34,27,7,0
2021,King's Lynn and West Norfolk 005B,E01026692,519,436,280,156,2,2,7,2,5,74,65,9,0
2021,King's Lynn and West Norfolk 009D,E01026693,957,647,354,293,10,10,129,30,99,169,136,33,2
2021,King's Lynn and West Norfolk 012D,E01026694,1184,739,472,267,4,4,178,51,127,261,213,48,2
2021,King's Lynn and West Norfolk 002D,E01026695,973,662,444,218,3,3,134,32,102,173,130,43,1
2021,King's Lynn and West Norfolk 015A,E01026696,494,348,197,151,0,0,87,25,62,58,44,14,1
2021,King's Lynn and West Norfolk 015B,E01026697,587,454,273,181,4,4,34,8,26,95,67,28,0
2021,King's Lynn and West Norfolk 011B,E01026699,966,150,109,41,8,8,402,102,300,402,385,17,4
2021,King's Lynn and West Norfolk 011C,E01026700,758,241,135,106,1,1,230,43,187,284,269,15,2
2021,King's Lynn and West Norfolk 003D,E01026701,834,703,553,150,5,5,34,0,34,91,72,19,1
2021,King's Lynn and West Norfolk 003E,E01026702,623,415,304,111,0,0,86,14,72,122,102,20,0
2021,King's Lynn and West Norfolk 003F,E01026703,500,340,259,81,4,4,53,11,42,103,76,27,0
2021,King's Lynn and West Norfolk 011D,E01026704,721,236,104,132,9,9,327,121,206,148,135,13,1
2021,King's Lynn and West Norfolk 011E,E01026705,716,500,242,258,19,19,110,16,94,87,68,19,0
2021,King's Lynn and West Norfolk 011F,E01026706,862,551,237,314,6,6,85,23,62,220,201,19,0
2021,King's Lynn and West Norfolk 005C,E01026708,594,544,356,188,3,3,15,5,10,32,18,14,0
2021,King's Lynn and West Norfolk 005D,E01026709,766,652,385,267,2,2,30,3,27,82,77,5,0
2021,King's Lynn and West Norfolk 005E,E01026710,495,431,290,141,0,0,13,2,11,51,42,9,0
2021,King's Lynn and West Norfolk 008B,E01026711,630,377,224,153,1,1,168,23,145,84,66,18,0
2021,King's Lynn and West Norfolk 008C,E01026712,790,629,362,267,2,2,64,14,50,95,77,18,0
2021,King's Lynn and West Norfolk 008D,E01026713,673,572,363,209,1,1,46,8,38,54,41,13,0
2021,King's Lynn and West Norfolk 010D,E01026714,896,676,368,308,5,5,39,2,37,176,148,28,0
2021,King's Lynn and West Norfolk 016D,E01026715,669,520,317,203,2,2,28,4,24,118,100,18,1
2021,King's Lynn and West Norfolk 016E,E01026716,831,610,384,226,5,5,104,19,85,109,84,25,3
2021,King's Lynn and West Norfolk 016F,E01026717,694,520,305,215,0,0,62,28,34,111,84,27,1
2021,King's Lynn and West Norfolk 004D,E01026718,1042,550,365,185,9,9,126,33,93,356,258,98,1
2021,King's Lynn and West Norfolk 013C,E01026719,995,797,424,373,2,2,95,23,72,100,78,22,1
2021,King's Lynn and West Norfolk 013D,E01026720,573,471,273,198,0,0,31,8,23,71,54,17,0
2021,King's Lynn and West Norfolk 013E,E01026721,580,456,269,187,0,0,60,20,40,63,45,18,1
2021,King's Lynn and West Norfolk 015C,E01026722,1120,846,452,394,2,2,86,14,72,186,158,28,0
2021,King's Lynn and West Norfolk 014D,E01026723,683,587,347,240,3,3,28,6,22,65,51,14,0
2021,King's Lynn and West Norfolk 014E,E01026724,790,596,358,238,2,2,92,25,67,100,80,20,0
2021,King's Lynn and West Norfolk 014F,E01026725,647,519,350,169,0,0,69,16,53,59,42,17,0
2021,King's Lynn and West Norfolk 015D,E01026726,920,697,402,295,2,2,88,23,65,133,105,28,0
2021,King's Lynn and West Norfolk 018B,E01026727,1150,846,560,286,3,3,90,24,66,211,163,48,0
2021,King's Lynn and West Norfolk 018C,E01026728,1111,844,517,327,4,4,138,25,113,124,108,16,1
2021,North Norfolk 008A,E01026729,995,717,456,261,5,5,81,13,68,192,161,31,0
2021,North Norfolk 008B,E01026730,1157,800,502,298,7,7,159,23,136,189,162,27,2
2021,North Norfolk 006C,E01026733,1069,739,540,199,12,12,168,21,147,150,117,33,0
2021,North Norfolk 003A,E01026734,597,251,175,76,4,4,32,1,31,310,296,14,0
2021,North Norfolk 003B,E01026735,677,332,278,54,3,3,19,1,18,322,305,17,1
2021,North Norfolk 003C,E01026736,664,419,318,101,4,4,159,14,145,81,71,10,1
2021,North Norfolk 006D,E01026737,1058,787,522,265,10,10,93,15,78,168,130,38,0
2021,North Norfolk 007A,E01026738,1082,798,577,221,9,9,154,28,126,120,95,25,1
2021,North Norfolk 002A,E01026739,928,629,492,137,10,10,138,19,119,151,108,43,0
2021,North Norfolk 012A,E01026740,1123,826,598,228,3,3,71,11,60,223,177,46,0
2021,North Norfolk 004A,E01026741,861,649,517,132,3,3,124,14,110,84,66,18,1
2021,North Norfolk 004B,E01026742,870,719,586,133,16,16,37,3,34,98,79,19,0
2021,North Norfolk 004C,E01026743,1141,615,496,119,15,15,332,49,283,179,155,24,0
2021,North Norfolk 014A,E01026744,1095,778,578,200,27,27,159,22,137,131,107,24,0
2021,North Norfolk 011A,E01026745,846,534,339,195,18,18,177,39,138,117,94,23,0
2021,North Norfolk 011B,E01026746,796,591,402,189,3,3,32,4,28,170,148,22,0
2021,North Norfolk 011C,E01026747,690,315,185,130,4,4,178,44,134,190,174,16,3
2021,North Norfolk 011D,E01026748,707,619,459,160,1,1,17,3,14,70,59,11,0
2021,North Norfolk 011E,E01026749,727,371,241,130,8,8,243,34,209,104,86,18,1
2021,North Norfolk 007B,E01026750,687,431,318,113,8,8,126,26,100,122,109,13,0
2021,North Norfolk 007C,E01026751,701,516,428,88,12,12,61,6,55,112,100,12,0
2021,North Norfolk 007D,E01026752,690,518,377,141,7,7,65,12,53,100,78,22,0
2021,North Norfolk 015D,E01026753,782,365,255,110,11,11,306,55,251,100,92,8,0
2021,North Norfolk 015C,E01026754,641,449,286,163,5,5,62,4,58,123,116,7,2
2021,North Norfolk 015E,E01026755,565,488,392,96,0,0,40,5,35,37,29,8,0
2021,North Norfolk 015B,E01026756,592,334,220,114,3,3,176,27,149,79,60,19,0
2021,North Norfolk 015A,E01026757,670,527,339,188,3,3,19,1,18,121,111,10,0
2021,North Norfolk 016B,E01026758,681,445,276,169,1,1,41,8,33,194,171,23,0
2021,North Norfolk 016C,E01026759,611,372,240,132,2,2,189,27,162,47,32,15,1
2021,North Norfolk 016D,E01026760,850,614,281,333,6,6,57,11,46,173,143,30,0
2021,North Norfolk 016A,E01026761,746,497,351,146,10,10,113,24,89,126,115,11,0
2021,North Norfolk 002B,E01026763,599,230,169,61,1,1,204,46,158,163,134,29,1
2021,North Norfolk 002C,E01026764,675,444,379,65,10,10,111,19,92,110,83,27,0
2021,North Norfolk 002D,E01026765,627,423,328,95,5,5,108,32,76,91,65,26,0
2021,North Norfolk 005B,E01026766,1050,777,512,265,16,16,113,8,105,144,115,29,0
2021,North Norfolk 012B,E01026767,549,409,269,140,0,0,71,21,50,69,50,19,0
2021,North Norfolk 012C,E01026768,575,361,120,241,1,1,32,5,27,181,163,18,0
2021,North Norfolk 014B,E01026769,995,776,583,193,0,0,93,17,76,126,106,20,0
2021,North Norfolk 001A,E01026770,918,560,429,131,2,2,27,2,25,329,265,64,0
2021,North Norfolk 001B,E01026771,718,501,363,138,1,1,133,24,109,83,72,11,0
2021,North Norfolk 001C,E01026772,821,665,528,137,3,3,24,1,23,129,112,17,0
2021,North Norfolk 001D,E01026773,960,722,566,156,2,2,111,13,98,125,98,27,0
2021,North Norfolk 013A,E01026774,738,568,353,215,1,1,51,8,43,118,103,15,0
2021,North Norfolk 013B,E01026775,587,301,180,121,5,5,205,27,178,76,67,9,0
2021,North Norfolk 013C,E01026776,965,599,429,170,3,3,46,7,39,317,301,16,0
2021,North Norfolk 003D,E01026777,633,506,386,120,9,9,67,3,64,51,43,8,0
2021,North Norfolk 003E,E01026778,743,517,420,97,2,2,85,8,77,139,118,21,0
2021,North Norfolk 003F,E01026779,548,308,188,120,1,1,132,29,103,106,85,21,1
2021,North Norfolk 009A,E01026780,1195,791,470,321,8,8,82,17,65,313,262,51,1
2021,North Norfolk 005C,E01026781,965,774,579,195,1,1,54,10,44,136,102,34,0
2021,North Norfolk 009B,E01026782,991,544,358,186,3,3,163,28,135,281,215,66,0
2021,North Norfolk 014C,E01026783,850,695,524,171,1,1,60,6,54,94,76,18,0
2021,North Norfolk 014D,E01026784,487,284,183,101,0,0,142,26,116,60,41,19,1
2021,North Norfolk 014E,E01026785,624,513,369,144,0,0,52,8,44,59,42,17,0
2021,North Norfolk 013D,E01026786,959,714,515,199,0,0,66,25,41,179,153,26,0
2021,North Norfolk 009C,E01026787,465,311,206,105,4,4,67,6,61,82,74,8,1
2021,North Norfolk 008C,E01026788,570,428,296,132,2,2,60,8,52,80,63,17,0
2021,North Norfolk 012D,E01026789,509,399,252,147,2,2,46,10,36,62,44,18,0
2021,North Norfolk 012E,E01026790,483,323,201,122,1,1,65,9,56,94,82,12,0
2021,Norwich 005A,E01026791,663,208,109,99,3,3,334,245,89,111,104,7,7
2021,Norwich 005B,E01026792,617,343,191,152,6,6,178,113,65,90,80,10,0
2021,Norwich 005C,E01026793,641,175,83,92,2,2,346,276,70,117,113,4,1
2021,Norwich 005D,E01026794,838,414,193,221,7,7,265,97,168,152,139,13,0
2021,Norwich 005F,E01026796,668,158,107,51,5,5,272,237,35,231,221,10,2
2021,Norwich 001A,E01026797,1177,592,174,418,1,1,264,142,122,320,294,26,0
2021,Norwich 001B,E01026798,693,218,79,139,1,1,373,335,38,100,91,9,1
2021,Norwich 001C,E01026799,649,280,104,176,2,2,282,238,44,85,70,15,0
2021,Norwich 001D,E01026800,950,264,126,138,6,6,498,415,83,178,163,15,4
2021,Norwich 001E,E01026801,680,547,342,205,0,0,43,37,6,90,78,12,0
2021,Norwich 001F,E01026802,806,404,235,169,2,2,181,87,94,218,195,23,1
2021,Norwich 004A,E01026803,660,325,160,165,2,2,261,201,60,70,60,10,2
2021,Norwich 004B,E01026804,636,423,252,171,1,1,146,136,10,66,51,15,0
2021,Norwich 004C,E01026805,657,335,165,170,0,0,264,226,38,56,44,12,2
2021,Norwich 004D,E01026806,503,421,261,160,1,1,18,15,3,63,54,9,0
2021,Norwich 004E,E01026807,554,330,159,171,0,0,104,95,9,119,108,11,1
2021,Norwich 004F,E01026808,525,151,63,88,0,0,320,307,13,53,48,5,1
2021,Norwich 004G,E01026809,749,267,154,113,16,16,398,369,29,65,53,12,3
2021,Norwich 012A,E01026810,745,505,344,161,1,1,125,61,64,113,105,8,1
2021,Norwich 012B,E01026811,722,585,407,178,0,0,58,51,7,79,64,15,0
2021,Norwich 012C,E01026812,710,561,336,225,3,3,30,11,19,116,96,20,0
2021,Norwich 012D,E01026813,638,572,405,167,2,2,13,8,5,51,41,10,0
2021,Norwich 012E,E01026814,648,244,150,94,2,2,229,225,4,171,156,15,2
2021,Norwich 012F,E01026815,659,501,312,189,1,1,13,9,4,144,125,19,0
2021,Norwich 013A,E01026816,1015,449,241,208,6,6,231,87,144,327,309,18,2
2021,Norwich 013B,E01026817,738,348,221,127,1,1,254,175,79,134,119,15,1
2021,Norwich 013C,E01026818,651,310,140,170,0,0,278,256,22,63,50,13,0
2021,Norwich 013D,E01026819,636,240,84,156,6,6,322,311,11,68,60,8,0
2021,Norwich 013E,E01026820,803,311,155,156,5,5,391,345,46,92,80,12,4
2021,Norwich 013F,E01026821,712,339,174,165,1,1,283,274,9,88,70,18,1
2021,Norwich 017A,E01026823,1270,416,256,160,4,4,322,216,106,525,499,26,3
2021,Norwich 016D,E01026824,987,219,118,101,1,1,535,502,33,222,197,25,10
2021,Norwich 016A,E01026825,776,266,125,141,3,3,242,176,66,264,240,24,1
2021,Norwich 016B,E01026826,985,194,81,113,3,3,460,239,221,326,307,19,2
2021,Norwich 016C,E01026827,954,190,85,105,1,1,604,456,148,155,141,14,4
2021,Norwich 002A,E01026828,679,255,117,138,1,1,377,299,78,45,39,6,1
2021,Norwich 002B,E01026829,918,313,124,189,18,18,341,287,54,246,232,14,0
2021,Norwich 002C,E01026830,678,199,99,100,2,2,322,234,88,153,137,16,2
2021,Norwich 002D,E01026831,673,346,151,195,2,2,57,34,23,268,248,20,0
2021,Norwich 002E,E01026832,515,194,86,108,2,2,278,261,17,39,32,7,2
2021,Norwich 002F,E01026833,731,119,48,71,16,16,546,432,114,47,39,8,3
2021,Norwich 002G,E01026834,668,240,109,131,0,0,336,254,82,92,81,11,0
2021,Norwich 009A,E01026835,670,321,171,150,1,1,34,8,26,314,299,15,0
2021,Norwich 009B,E01026836,637,404,233,171,0,0,15,8,7,218,201,17,0
2021,Norwich 009C,E01026837,798,371,219,152,3,3,110,43,67,313,293,20,1
2021,Norwich 009D,E01026838,644,430,237,193,1,1,16,9,7,197,186,11,0
2021,Norwich 009E,E01026839,672,307,146,161,1,1,28,13,15,335,315,20,1
2021,Norwich 009F,E01026840,768,434,211,223,4,4,26,18,8,304,277,27,0
2021,Norwich 003A,E01026841,732,346,144,202,3,3,57,39,18,324,297,27,2
2021,Norwich 003B,E01026842,880,485,221,264,5,5,49,33,16,341,314,27,0
2021,Norwich 003C,E01026843,914,441,206,235,0,0,273,253,20,197,177,20,3
2021,Norwich 003D,E01026844,872,376,152,224,12,12,308,259,49,173,159,14,3
2021,Norwich 003E,E01026845,803,413,148,265,7,7,33,16,17,347,316,31,3
2021,Norwich 003F,E01026846,884,391,149,242,5,5,66,38,28,422,393,29,0
2021,Norwich 015A,E01026848,1016,218,124,94,3,3,648,437,211,146,133,13,1
2021,Norwich 015B,E01026849,996,503,289,214,6,6,64,17,47,423,402,21,0
2021,Norwich 015C,E01026850,1008,500,235,265,6,6,178,122,56,322,303,19,2
2021,Norwich 011A,E01026852,608,475,308,167,3,3,26,17,9,104,91,13,0
2021,Norwich 011B,E01026853,1088,334,186,148,2,2,485,368,117,264,235,29,3
2021,Norwich 011D,E01026855,855,454,257,197,1,1,50,43,7,350,323,27,0
2021,Norwich 011E,E01026856,859,389,220,169,2,2,57,48,9,409,388,21,2
2021,Norwich 011F,E01026857,748,367,219,148,2,2,154,80,74,224,209,15,1
2021,Norwich 010A,E01026858,733,163,111,52,1,1,366,305,61,201,194,7,2
2021,Norwich 010B,E01026859,645,271,176,95,39,39,225,45,180,110,100,10,0
2021,Norwich 010C,E01026860,467,198,133,65,4,4,121,115,6,144,138,6,0
2021,Norwich 010D,E01026861,540,108,66,42,7,7,259,149,110,166,159,7,0
2021,Norwich 010E,E01026862,508,227,138,89,3,3,192,117,75,86,79,7,0
2021,Norwich 006A,E01026863,803,388,212,176,2,2,123,80,43,288,273,15,2
2021,Norwich 006B,E01026864,670,410,215,195,3,3,148,94,54,106,90,16,3
2021,Norwich 006C,E01026865,803,155,60,95,8,8,438,358,80,201,182,19,1
2021,Norwich 006D,E01026866,839,395,207,188,2,2,160,115,45,282,266,16,0
2021,Norwich 006E,E01026867,566,171,84,87,18,18,296,275,21,79,74,5,2
2021,Norwich 006F,E01026868,584,112,65,47,10,10,338,246,92,121,113,8,3
2021,Norwich 006G,E01026869,675,194,85,109,1,1,423,383,40,56,50,6,1
2021,South Norfolk 005A,E01026870,879,454,288,166,3,3,171,43,128,251,228,23,0
2021,South Norfolk 005B,E01026871,574,464,319,145,32,32,14,3,11,64,51,13,0
2021,South Norfolk 013A,E01026872,1050,729,481,248,11,11,140,22,118,170,146,24,0
2021,South Norfolk 014A,E01026873,553,438,300,138,7,7,44,7,37,64,53,11,0
2021,South Norfolk 014B,E01026874,634,457,299,158,1,1,86,20,66,90,66,24,0
2021,South Norfolk 006A,E01026875,469,393,262,131,3,3,15,2,13,58,48,10,0
2021,South Norfolk 006B,E01026876,691,517,334,183,2,2,105,32,73,67,52,15,0
2021,South Norfolk 011A,E01026877,660,550,362,188,6,6,34,5,29,70,50,20,0
2021,South Norfolk 011B,E01026878,491,360,191,169,1,1,74,18,56,56,39,17,0
2021,South Norfolk 008A,E01026879,517,345,228,117,5,5,95,24,71,72,55,17,0
2021,South Norfolk 008B,E01026880,605,512,360,152,1,1,24,3,21,68,48,20,0
2021,South Norfolk 002A,E01026881,811,560,279,281,9,9,82,8,74,160,136,24,0
2021,South Norfolk 002C,E01026883,886,670,362,308,7,7,91,21,70,118,89,29,0
2021,South Norfolk 007A,E01026884,1051,718,256,462,34,34,193,41,152,106,93,13,0
2021,South Norfolk 007B,E01026885,624,476,248,228,9,9,41,10,31,98,79,19,0
2021,South Norfolk 014C,E01026886,594,500,311,189,9,9,43,8,35,42,30,12,0
2021,South Norfolk 014D,E01026887,668,471,273,198,3,3,87,18,69,107,94,13,0
2021,South Norfolk 015A,E01026888,786,428,294,134,4,4,259,74,185,94,80,14,1
2021,South Norfolk 015B,E01026889,771,586,416,170,2,2,41,12,29,142,121,21,0
2021,South Norfolk 015D,E01026891,875,442,301,141,2,2,222,43,179,208,187,21,1
2021,South Norfolk 012A,E01026892,574,351,232,119,5,5,106,17,89,112,91,21,0
2021,South Norfolk 012B,E01026893,582,479,299,180,1,1,15,2,13,87,73,14,0
2021,South Norfolk 012C,E01026894,1094,838,554,284,6,6,128,34,94,122,90,32,0
2021,South Norfolk 002D,E01026895,593,476,253,223,9,9,42,10,32,66,47,19,0
2021,South Norfolk 002E,E01026896,503,392,240,152,2,2,38,3,35,71,55,16,0
2021,South Norfolk 011C,E01026897,1188,985,607,378,7,7,77,25,52,117,93,24,2
2021,South Norfolk 010A,E01026898,637,480,291,189,6,6,81,23,58,70,56,14,0
2021,South Norfolk 010B,E01026899,680,520,308,212,0,0,23,5,18,137,116,21,0
2021,South Norfolk 013B,E01026900,705,480,334,146,8,8,119,13,106,98,88,10,0
2021,South Norfolk 013C,E01026901,606,463,302,161,12,12,36,6,30,94,80,14,1
2021,South Norfolk 013D,E01026902,1122,647,391,256,49,49,221,54,167,204,188,16,1
2021,South Norfolk 012D,E01026903,493,399,259,140,0,0,23,4,19,71,51,20,0
2021,South Norfolk 012E,E01026904,581,449,277,172,1,1,91,18,73,40,24,16,0
2021,South Norfolk 003A,E01026905,517,286,201,85,1,1,199,50,149,31,24,7,0
2021,South Norfolk 003B,E01026906,758,619,393,226,9,9,63,15,48,67,56,11,0
2021,South Norfolk 003C,E01026907,832,665,389,276,7,7,45,10,35,114,97,17,1
2021,South Norfolk 003D,E01026908,1003,723,232,491,24,24,68,7,61,188,171,17,0
2021,South Norfolk 004A,E01026909,695,449,299,150,0,0,171,33,138,73,62,11,2
2021,South Norfolk 004B,E01026910,708,602,380,222,8,8,21,5,16,77,59,18,0
2021,South Norfolk 008C,E01026911,677,387,212,175,2,2,194,43,151,94,82,12,0
2021,South Norfolk 008D,E01026912,755,596,339,257,5,5,47,12,35,107,90,17,0
2021,South Norfolk 009A,E01026913,747,502,243,259,11,11,149,18,131,85,72,13,0
2021,South Norfolk 009B,E01026914,804,649,347,302,18,18,52,4,48,85,68,17,0
2021,South Norfolk 009C,E01026915,837,711,390,321,4,4,31,7,24,91,77,14,0
2021,South Norfolk 017A,E01026916,919,829,558,271,3,3,6,1,5,81,59,22,0
2021,South Norfolk 017C,E01026917,657,496,334,162,19,19,92,12,80,50,39,11,0
2021,South Norfolk 017B,E01026918,772,663,406,257,4,4,8,1,7,97,83,14,0
2021,South Norfolk 009D,E01026919,628,432,226,206,2,2,111,29,82,82,67,15,1
2021,South Norfolk 009E,E01026920,500,422,267,155,0,0,37,11,26,41,31,10,0
2021,South Norfolk 005C,E01026921,624,504,340,164,6,6,6,2,4,108,96,12,0
2021,South Norfolk 005D,E01026922,680,389,267,122,4,4,208,49,159,79,70,9,0
2021,South Norfolk 016D,E01026924,742,558,354,204,2,2,128,18,110,53,42,11,1
2021,South Norfolk 017D,E01026925,1087,492,227,265,27,27,410,58,352,158,140,18,0
2021,South Norfolk 006D,E01026927,830,695,432,263,0,0,37,4,33,97,84,13,1
2021,South Norfolk 006E,E01026928,854,585,295,290,9,9,150,28,122,110,92,18,0
2021,South Norfolk 008E,E01026929,594,470,289,181,2,2,36,9,27,86,78,8,0
2021,South Norfolk 008F,E01026930,664,540,342,198,5,5,63,13,50,56,47,9,0
2021,South Norfolk 015E,E01026931,469,417,276,141,0,0,5,1,4,47,33,14,0
2021,South Norfolk 015F,E01026932,594,412,251,161,7,7,63,15,48,112,106,6,0
2021,South Norfolk 014E,E01026934,500,356,242,114,21,21,61,20,41,62,58,4,0
2021,South Norfolk 014F,E01026935,581,444,271,173,1,1,30,8,22,106,85,21,0
2021,South Norfolk 006F,E01026936,766,594,360,234,12,12,93,20,73,67,55,12,0
2021,South Norfolk 006G,E01026937,691,480,254,226,4,4,68,18,50,138,117,21,1
2021,South Norfolk 011D,E01026938,923,703,375,328,12,12,47,5,42,161,138,23,0
2021,South Norfolk 011E,E01026939,729,579,347,232,10,10,48,9,39,92,75,17,0
2021,South Norfolk 011F,E01026940,857,516,219,297,16,16,214,42,172,109,96,13,2
2021,South Norfolk 009F,E01026941,525,436,299,137,1,1,31,8,23,57,37,20,0
2021,South Norfolk 009G,E01026942,459,398,232,166,2,2,8,3,5,51,40,11,0
2021,South Norfolk 010C,E01026943,660,525,336,189,1,1,50,12,38,84,59,25,0
2021,South Norfolk 010D,E01026944,518,428,249,179,3,3,38,5,33,49,39,10,0
2021,South Norfolk 004C,E01026947,543,404,235,169,3,3,58,19,39,78,60,18,0
2021,South Norfolk 004D,E01026948,519,434,280,154,0,0,25,2,23,60,45,15,0
2021,North Northamptonshire 005A,E01026949,645,306,172,134,1,1,201,149,52,135,126,9,2
2021,North Northamptonshire 005B,E01026950,640,269,122,147,0,0,202,155,47,165,154,11,4
2021,North Northamptonshire 005C,E01026951,514,245,111,134,1,1,165,116,49,103,93,10,0
2021,North Northamptonshire 005D,E01026952,616,437,210,227,1,1,68,40,28,110,96,14,0
2021,North Northamptonshire 009A,E01026953,604,496,302,194,0,0,39,32,7,69,54,15,0
2021,North Northamptonshire 009B,E01026954,579,298,141,157,10,10,157,145,12,112,100,12,2
2021,North Northamptonshire 009C,E01026955,561,505,282,223,2,2,2,1,1,52,44,8,0
2021,North Northamptonshire 009D,E01026956,921,539,198,341,11,11,192,151,41,173,155,18,6
2021,North Northamptonshire 006A,E01026957,841,361,179,182,2,2,270,199,71,204,180,24,4
2021,North Northamptonshire 006B,E01026958,781,368,141,227,1,1,195,166,29,217,201,16,0
2021,North Northamptonshire 007A,E01026959,644,344,187,157,0,0,137,128,9,160,141,19,3
2021,North Northamptonshire 007B,E01026960,624,223,127,96,3,3,221,181,40,177,153,24,0
2021,North Northamptonshire 007C,E01026961,502,238,100,138,0,0,137,130,7,126,118,8,1
2021,North Northamptonshire 004A,E01026962,598,354,189,165,3,3,112,101,11,127,110,17,2
2021,North Northamptonshire 008A,E01026963,545,222,72,150,2,2,216,9,207,105,96,9,0
2021,North Northamptonshire 007D,E01026965,601,219,85,134,2,2,196,183,13,183,176,7,1
2021,North Northamptonshire 007E,E01026966,578,366,215,151,1,1,132,124,8,79,74,5,0
2021,North Northamptonshire 007F,E01026967,724,385,189,196,1,1,170,156,14,164,151,13,4
2021,North Northamptonshire 007G,E01026968,696,198,100,98,1,1,307,284,23,185,174,11,5
2021,North Northamptonshire 003A,E01026969,790,413,222,191,0,0,234,212,22,141,119,22,2
2021,North Northamptonshire 003B,E01026970,661,449,200,249,1,1,116,111,5,91,77,14,4
2021,North Northamptonshire 002A,E01026971,733,422,225,197,2,2,166,151,15,140,133,7,3
2021,North Northamptonshire 003C,E01026972,757,427,172,255,0,0,164,155,9,166,142,24,0
2021,North Northamptonshire 004B,E01026973,591,417,212,205,0,0,72,64,8,102,85,17,0
2021,North Northamptonshire 004C,E01026974,485,399,250,149,1,1,38,32,6,47,35,12,0
2021,North Northamptonshire 004D,E01026975,647,292,135,157,4,4,235,211,24,112,99,13,4
2021,North Northamptonshire 003D,E01026976,626,351,158,193,1,1,152,143,9,120,109,11,2
2021,North Northamptonshire 002B,E01026979,669,499,274,225,5,5,56,25,31,108,87,21,1
2021,North Northamptonshire 002C,E01026980,696,582,340,242,1,1,41,35,6,72,58,14,0
2021,North Northamptonshire 003E,E01026981,502,379,220,159,2,2,36,28,8,84,76,8,1
2021,North Northamptonshire 002D,E01026982,884,409,161,248,27,27,259,120,139,185,170,15,4
2021,North Northamptonshire 003F,E01026983,451,250,142,108,1,1,88,83,5,111,102,9,1
2021,North Northamptonshire 004E,E01026984,807,446,227,219,3,3,196,185,11,162,145,17,0
2021,North Northamptonshire 004F,E01026985,848,582,279,303,42,42,142,107,35,82,73,9,0
2021,West Northamptonshire 016A,E01026986,1155,607,213,394,7,7,280,59,221,261,246,15,0
2021,West Northamptonshire 010A,E01026987,515,398,235,163,2,2,64,19,45,51,44,7,0
2021,West Northamptonshire 016B,E01026988,618,290,126,164,4,4,221,72,149,102,90,12,1
2021,West Northamptonshire 010B,E01026989,606,364,172,192,21,21,118,7,111,103,96,7,0
2021,West Northamptonshire 016C,E01026991,770,635,451,184,2,2,34,4,30,99,85,14,0
2021,West Northamptonshire 016D,E01026992,1025,381,195,186,6,6,330,61,269,306,271,35,2
2021,West Northamptonshire 042A,E01026993,871,716,438,278,2,2,57,15,42,96,73,23,0
2021,West Northamptonshire 004A,E01026994,520,387,218,169,7,7,82,13,69,44,34,10,0
2021,West Northamptonshire 005A,E01026998,987,719,338,381,27,27,74,10,64,166,149,17,1
2021,West Northamptonshire 004B,E01026999,823,601,418,183,2,2,138,23,115,82,73,9,0
2021,West Northamptonshire 002A,E01027000,640,427,198,229,2,2,120,32,88,90,71,19,1
2021,West Northamptonshire 002B,E01027001,763,636,268,368,16,16,47,2,45,64,57,7,0
2021,West Northamptonshire 002C,E01027002,673,548,315,233,2,2,37,3,34,86,63,23,0
2021,West Northamptonshire 002D,E01027003,638,482,269,213,19,19,40,3,37,97,85,12,0
2021,West Northamptonshire 042B,E01027004,831,620,366,254,6,6,84,17,67,120,98,22,1
2021,West Northamptonshire 001A,E01027005,919,714,375,339,8,8,71,16,55,126,100,26,0
2021,West Northamptonshire 004C,E01027006,1032,782,399,383,24,24,112,17,95,114,99,15,0
2021,West Northamptonshire 022A,E01027007,653,376,141,235,11,11,126,37,89,139,127,12,1
2021,West Northamptonshire 022B,E01027008,903,634,335,299,11,11,25,8,17,233,207,26,0
2021,West Northamptonshire 022C,E01027009,629,255,108,147,2,2,221,69,152,150,136,14,1
2021,West Northamptonshire 016E,E01027010,534,441,263,178,1,1,56,12,44,36,29,7,0
2021,West Northamptonshire 027A,E01027011,950,744,439,305,13,13,88,15,73,105,91,14,0
2021,West Northamptonshire 010C,E01027012,979,605,284,321,18,18,201,51,150,155,140,15,0
2021,West Northamptonshire 022D,E01027013,703,214,91,123,9,9,390,113,277,89,81,8,1
2021,West Northamptonshire 005B,E01027015,595,517,307,210,11,11,27,5,22,40,32,8,0
2021,West Northamptonshire 005C,E01027016,635,484,270,214,3,3,21,5,16,127,112,15,0
2021,West Northamptonshire 027B,E01027017,858,506,245,261,15,15,260,39,221,77,59,18,0
2021,West Northamptonshire 003A,E01027018,1020,865,401,464,23,23,57,11,46,75,59,16,0
2021,West Northamptonshire 003B,E01027019,857,518,242,276,43,43,179,36,143,116,90,26,1
2021,West Northamptonshire 003C,E01027020,736,593,297,296,18,18,49,5,44,76,67,9,0
2021,West Northamptonshire 005D,E01027021,794,630,387,243,7,7,45,7,38,112,94,18,0
2021,West Northamptonshire 002E,E01027022,771,602,341,261,3,3,68,22,46,98,82,16,0
2021,West Northamptonshire 003D,E01027023,888,682,392,290,6,6,124,36,88,76,58,18,0
2021,West Northamptonshire 027C,E01027024,748,631,351,280,3,3,29,12,17,85,70,15,0
2021,West Northamptonshire 027D,E01027025,816,472,214,258,12,12,204,37,167,128,115,13,0
2021,West Northamptonshire 001B,E01027026,874,688,361,327,12,12,79,10,69,95,72,23,0
2021,West Northamptonshire 005E,E01027027,1067,782,369,413,19,19,120,19,101,146,120,26,0
2021,West Northamptonshire 042C,E01027028,932,763,374,389,7,7,24,4,20,137,122,15,1
2021,West Northamptonshire 042D,E01027029,993,603,197,406,29,29,249,47,202,112,103,9,0
2021,West Northamptonshire 001C,E01027030,776,609,355,254,5,5,51,16,35,111,93,18,0
2021,North Northamptonshire 010A,E01027031,876,625,379,246,12,12,87,8,79,152,118,34,0
2021,North Northamptonshire 011A,E01027032,815,540,322,218,5,5,115,15,100,154,124,30,1
2021,North Northamptonshire 001A,E01027033,839,577,319,258,17,17,133,17,116,112,91,21,0
2021,North Northamptonshire 035A,E01027034,754,443,261,182,1,1,209,32,177,100,86,14,1
2021,North Northamptonshire 035B,E01027035,638,381,191,190,7,7,169,25,144,81,68,13,0
2021,North Northamptonshire 035C,E01027037,977,827,367,460,10,10,17,4,13,123,100,23,0
2021,North Northamptonshire 027A,E01027038,824,472,212,260,25,25,213,18,195,114,105,9,0
2021,North Northamptonshire 027B,E01027039,870,563,244,319,7,7,145,17,128,154,139,15,1
2021,North Northamptonshire 027C,E01027040,790,616,301,315,5,5,41,6,35,128,117,11,0
2021,North Northamptonshire 027D,E01027041,752,317,163,154,10,10,275,41,234,149,137,12,1
2021,North Northamptonshire 027E,E01027042,717,623,259,364,3,3,21,3,18,70,64,6,0
2021,North Northamptonshire 001B,E01027043,974,657,355,302,15,15,142,29,113,160,127,33,0
2021,North Northamptonshire 010B,E01027044,925,723,413,310,8,8,69,16,53,125,107,18,0
2021,North Northamptonshire 011B,E01027045,889,641,362,279,4,4,123,18,105,121,98,23,0
2021,North Northamptonshire 010C,E01027046,681,497,270,227,23,23,55,7,48,106,98,8,0
2021,North Northamptonshire 010D,E01027047,588,367,239,128,1,1,144,31,113,76,68,8,0
2021,North Northamptonshire 010E,E01027048,682,378,258,120,12,12,109,15,94,183,141,42,0
2021,North Northamptonshire 010F,E01027049,526,347,244,103,14,14,53,9,44,112,92,20,0
2021,North Northamptonshire 001C,E01027050,933,712,475,237,11,11,94,15,79,116,92,24,0
2021,North Northamptonshire 025A,E01027051,924,560,224,336,11,11,177,21,156,175,154,21,1
2021,North Northamptonshire 025B,E01027052,625,509,223,286,5,5,24,8,16,87,78,9,0
2021,North Northamptonshire 025C,E01027053,918,742,332,410,15,15,54,5,49,107,89,18,0
2021,North Northamptonshire 025D,E01027054,509,451,270,181,0,0,5,3,2,53,42,11,0
2021,North Northamptonshire 025E,E01027055,556,424,220,204,16,16,36,10,26,80,70,10,0
2021,North Northamptonshire 025F,E01027056,638,343,169,174,1,1,213,31,182,80,73,7,1
2021,North Northamptonshire 024A,E01027057,955,746,349,397,18,18,107,17,90,84,61,23,0
2021,North Northamptonshire 037A,E01027058,730,393,188,205,5,5,259,41,218,73,64,9,0
2021,North Northamptonshire 037B,E01027059,809,486,254,232,3,3,67,14,53,253,234,19,0
2021,North Northamptonshire 037C,E01027060,1029,455,219,236,40,40,208,23,185,325,295,30,1
2021,North Northamptonshire 034A,E01027061,1107,750,257,493,2,2,171,25,146,184,169,15,0
2021,North Northamptonshire 034B,E01027062,1010,619,299,320,8,8,183,27,156,199,182,17,1
2021,North Northamptonshire 034C,E01027063,765,649,374,275,3,3,23,3,20,90,78,12,0
2021,North Northamptonshire 034D,E01027064,670,579,324,255,9,9,13,1,12,69,58,11,0
2021,North Northamptonshire 037D,E01027065,921,451,205,246,6,6,151,22,129,312,293,19,1
2021,North Northamptonshire 039A,E01027066,795,709,384,325,2,2,5,1,4,79,68,11,0
2021,North Northamptonshire 039B,E01027067,755,658,423,235,9,9,18,4,14,70,59,11,0
2021,North Northamptonshire 037E,E01027069,897,444,225,219,7,7,253,32,221,192,173,19,1
2021,North Northamptonshire 039C,E01027070,673,569,322,247,0,0,13,4,9,91,75,16,0
2021,North Northamptonshire 039D,E01027071,603,507,260,247,1,1,35,3,32,60,53,7,0
2021,North Northamptonshire 034E,E01027072,643,283,153,130,5,5,307,50,257,48,42,6,0
2021,North Northamptonshire 034F,E01027073,903,639,330,309,1,1,110,20,90,152,135,17,1
2021,North Northamptonshire 024B,E01027074,874,703,395,308,0,0,89,17,72,82,68,14,0
2021,North Northamptonshire 011C,E01027075,802,626,296,330,3,3,37,3,34,136,122,14,0
2021,North Northamptonshire 011D,E01027076,975,595,314,281,23,23,180,26,154,177,161,16,0
2021,North Northamptonshire 024C,E01027078,913,664,409,255,9,9,133,21,112,106,83,23,1
2021,North Northamptonshire 015A,E01027079,778,521,238,283,0,0,43,10,33,214,187,27,0
2021,North Northamptonshire 015B,E01027080,762,655,372,283,1,1,13,3,10,93,77,16,0
2021,North Northamptonshire 016A,E01027081,622,339,122,217,2,2,170,157,13,105,91,14,6
2021,North Northamptonshire 016B,E01027082,790,325,139,186,20,20,205,90,115,240,226,14,0
2021,North Northamptonshire 016C,E01027083,656,248,124,124,2,2,300,280,20,100,90,10,6
2021,North Northamptonshire 021A,E01027084,941,781,358,423,30,30,46,4,42,84,70,14,0
2021,North Northamptonshire 021B,E01027085,640,479,258,221,14,14,87,53,34,60,43,17,0
2021,North Northamptonshire 021C,E01027086,833,716,352,364,12,12,25,5,20,80,70,10,0
2021,North Northamptonshire 015C,E01027087,492,365,207,158,1,1,29,25,4,96,92,4,1
2021,North Northamptonshire 015D,E01027088,483,383,188,195,2,2,3,1,2,95,90,5,0
2021,North Northamptonshire 015E,E01027089,850,662,349,313,19,19,37,3,34,132,117,15,0
2021,North Northamptonshire 012A,E01027090,714,488,272,216,0,0,60,39,21,166,146,20,0
2021,North Northamptonshire 023A,E01027091,799,477,260,217,14,14,209,112,97,99,86,13,0
2021,North Northamptonshire 023B,E01027092,759,552,297,255,27,27,91,23,68,89,78,11,0
2021,North Northamptonshire 013A,E01027094,666,539,307,232,0,0,60,50,10,64,61,3,3
2021,North Northamptonshire 013B,E01027095,667,490,214,276,17,17,92,55,37,67,54,13,1
2021,North Northamptonshire 019A,E01027096,456,387,221,166,2,2,3,1,2,64,53,11,0
2021,North Northamptonshire 019B,E01027097,621,485,288,197,5,5,28,2,26,103,97,6,0
2021,North Northamptonshire 019C,E01027098,480,367,198,169,3,3,27,5,22,83,77,6,0
2021,North Northamptonshire 019D,E01027099,660,570,363,207,3,3,9,3,6,78,65,13,0
2021,North Northamptonshire 022A,E01027100,772,552,328,224,21,21,86,48,38,112,96,16,1
2021,North Northamptonshire 023C,E01027102,803,609,313,296,21,21,78,39,39,94,84,10,1
2021,North Northamptonshire 012B,E01027103,725,548,298,250,0,0,85,59,26,88,75,13,4
2021,North Northamptonshire 018A,E01027104,1147,449,213,236,18,18,262,199,63,417,388,29,1
2021,North Northamptonshire 017A,E01027105,1117,344,137,207,10,10,110,12,98,651,627,24,2
2021,North Northamptonshire 017B,E01027106,908,308,140,168,2,2,105,26,79,493,464,29,0
2021,North Northamptonshire 013C,E01027107,585,435,245,190,4,4,45,31,14,101,92,9,0
2021,North Northamptonshire 013D,E01027108,544,517,339,178,0,0,1,1,0,26,16,10,0
2021,North Northamptonshire 013E,E01027109,507,383,211,172,0,0,62,48,14,62,58,4,0
2021,North Northamptonshire 017C,E01027111,950,438,185,253,17,17,68,25,43,426,402,24,1
2021,North Northamptonshire 017D,E01027112,1004,482,198,284,4,4,73,39,34,443,406,37,2
2021,North Northamptonshire 018B,E01027113,1010,566,263,303,4,4,140,53,87,297,276,21,3
2021,North Northamptonshire 022B,E01027114,697,522,260,262,3,3,48,40,8,123,108,15,1
2021,North Northamptonshire 018C,E01027115,798,617,281,336,25,25,81,10,71,75,68,7,0
2021,North Northamptonshire 018D,E01027116,801,549,209,340,2,2,20,5,15,230,218,12,0
2021,North Northamptonshire 018E,E01027117,616,389,253,136,12,12,40,8,32,175,164,11,0
2021,North Northamptonshire 020A,E01027119,742,516,284,232,0,0,121,112,9,104,89,15,1
2021,North Northamptonshire 021D,E01027120,521,414,198,216,0,0,5,2,3,102,96,6,0
2021,North Northamptonshire 021E,E01027121,880,775,309,466,24,24,44,2,42,37,30,7,0
2021,North Northamptonshire 019E,E01027122,504,430,276,154,1,1,9,5,4,64,52,12,0
2021,North Northamptonshire 014A,E01027123,676,533,306,227,1,1,81,77,4,59,50,9,2
2021,North Northamptonshire 014B,E01027125,740,645,364,281,1,1,22,5,17,72,58,14,0
2021,North Northamptonshire 014C,E01027126,1115,668,316,352,5,5,136,92,44,306,278,28,0
2021,North Northamptonshire 016D,E01027127,799,288,114,174,0,0,436,337,99,67,62,5,8
2021,North Northamptonshire 016E,E01027128,665,369,163,206,1,1,212,196,16,80,72,8,3
2021,North Northamptonshire 012C,E01027129,993,793,495,298,9,9,94,74,20,96,72,24,1
2021,North Northamptonshire 022C,E01027130,786,565,300,265,7,7,112,44,68,101,88,13,1
2021,North Northamptonshire 022D,E01027131,1025,344,143,201,18,18,473,307,166,179,166,13,11
2021,West Northamptonshire 030A,E01027132,956,324,127,197,12,12,92,13,79,526,502,24,2
2021,West Northamptonshire 030B,E01027133,824,436,219,217,8,8,28,10,18,352,327,25,0
2021,West Northamptonshire 030C,E01027134,719,336,151,185,5,5,46,3,43,332,301,31,0
2021,West Northamptonshire 030D,E01027135,757,526,244,282,0,0,45,28,17,186,170,16,0
2021,West Northamptonshire 019A,E01027136,749,390,145,245,2,2,58,28,30,299,275,24,0
2021,West Northamptonshire 024A,E01027137,634,272,91,181,4,4,171,104,67,182,165,17,5
2021,West Northamptonshire 024B,E01027138,638,498,245,253,11,11,28,21,7,101,82,19,0
2021,West Northamptonshire 024C,E01027139,661,420,179,241,6,6,62,38,24,172,159,13,1
2021,West Northamptonshire 026A,E01027140,666,352,221,131,7,7,164,153,11,141,106,35,2
2021,West Northamptonshire 024D,E01027141,773,643,264,379,4,4,32,3,29,93,81,12,1
2021,West Northamptonshire 026B,E01027142,634,393,184,209,10,10,127,80,47,102,88,14,2
2021,West Northamptonshire 008A,E01027143,654,495,237,258,7,7,71,9,62,81,75,6,0
2021,West Northamptonshire 008B,E01027144,644,596,376,220,2,2,5,2,3,41,34,7,0
2021,West Northamptonshire 006A,E01027145,610,437,240,197,14,14,75,45,30,83,74,9,1
2021,West Northamptonshire 008C,E01027146,662,562,322,240,1,1,17,8,9,82,69,13,0
2021,West Northamptonshire 008D,E01027147,944,518,262,256,13,13,229,171,58,180,151,29,4
2021,West Northamptonshire 006B,E01027148,585,516,269,247,4,4,7,3,4,58,51,7,0
2021,West Northamptonshire 006C,E01027149,602,467,278,189,1,1,48,43,5,86,80,6,0
2021,West Northamptonshire 033A,E01027151,814,265,111,154,43,43,148,128,20,354,334,20,4
2021,West Northamptonshire 032A,E01027152,777,232,99,133,3,3,155,80,75,387,369,18,0
2021,West Northamptonshire 032B,E01027153,1167,190,69,121,30,30,444,329,115,492,470,22,11
2021,West Northamptonshire 032C,E01027154,842,257,106,151,8,8,120,74,46,457,434,23,0
2021,West Northamptonshire 031A,E01027155,1058,253,98,155,21,21,142,41,101,637,610,27,5
2021,West Northamptonshire 038A,E01027156,502,250,105,145,1,1,173,163,10,76,65,11,2
2021,West Northamptonshire 037A,E01027158,647,366,156,210,4,4,28,6,22,248,237,11,1
2021,West Northamptonshire 038B,E01027159,517,427,196,231,1,1,27,25,2,62,49,13,0
2021,West Northamptonshire 038C,E01027160,744,533,212,321,6,6,11,3,8,194,180,14,0
2021,West Northamptonshire 038D,E01027161,673,266,95,171,11,11,328,229,99,64,56,8,4
2021,West Northamptonshire 041A,E01027162,683,428,175,253,1,1,50,36,14,203,192,11,1
2021,West Northamptonshire 041B,E01027163,571,503,290,213,2,2,2,0,2,64,59,5,0
2021,West Northamptonshire 041C,E01027164,621,396,139,257,0,0,9,3,6,216,203,13,0
2021,West Northamptonshire 041D,E01027165,490,428,171,257,2,2,4,1,3,56,50,6,0
2021,West Northamptonshire 041E,E01027166,640,456,171,285,2,2,5,2,3,177,168,9,0
2021,West Northamptonshire 041F,E01027167,586,474,241,233,3,3,8,3,5,101,91,10,0
2021,West Northamptonshire 017A,E01027168,767,238,87,151,9,9,381,302,79,137,126,11,2
2021,West Northamptonshire 017B,E01027169,564,423,194,229,2,2,39,27,12,100,87,13,0
2021,West Northamptonshire 017C,E01027170,637,300,117,183,2,2,214,185,29,118,106,12,3
2021,West Northamptonshire 012A,E01027171,734,421,205,216,3,3,198,172,26,103,91,12,9
2021,West Northamptonshire 012B,E01027172,669,539,298,241,9,9,27,18,9,94,80,14,0
2021,West Northamptonshire 017D,E01027173,617,358,123,235,2,2,155,126,29,102,87,15,0
2021,West Northamptonshire 009A,E01027174,520,467,280,187,5,5,7,2,5,41,39,2,0
2021,West Northamptonshire 009B,E01027175,626,365,136,229,7,7,98,82,16,156,140,16,0
2021,West Northamptonshire 026C,E01027176,599,415,180,235,7,7,101,94,7,75,67,8,1
2021,West Northamptonshire 026D,E01027177,693,261,90,171,16,16,285,251,34,125,118,7,6
2021,West Northamptonshire 009C,E01027178,783,310,92,218,76,76,278,181,97,119,107,12,0
2021,West Northamptonshire 018A,E01027179,815,583,248,335,7,7,97,79,18,128,104,24,0
2021,West Northamptonshire 018B,E01027180,824,520,245,275,7,7,210,139,71,81,66,15,6
2021,West Northamptonshire 018C,E01027181,802,645,378,267,0,0,44,5,39,113,103,10,0
2021,West Northamptonshire 012C,E01027182,605,508,309,199,0,0,21,6,15,76,62,14,0
2021,West Northamptonshire 012D,E01027183,715,560,375,185,48,48,51,5,46,56,41,15,0
2021,West Northamptonshire 025A,E01027184,655,348,151,197,2,2,45,10,35,260,233,27,0
2021,West Northamptonshire 025B,E01027185,556,266,104,162,1,1,125,112,13,161,147,14,3
2021,West Northamptonshire 019B,E01027186,663,513,250,263,1,1,10,4,6,139,130,9,0
2021,West Northamptonshire 025C,E01027187,605,290,120,170,11,11,58,7,51,245,212,33,1
2021,West Northamptonshire 019C,E01027188,767,442,183,259,18,18,182,143,39,121,103,18,4
2021,West Northamptonshire 025D,E01027189,753,437,194,243,5,5,84,57,27,226,199,27,1
2021,West Northamptonshire 013A,E01027190,781,542,318,224,6,6,96,24,72,137,123,14,0
2021,West Northamptonshire 013B,E01027191,924,401,148,253,53,53,207,30,177,263,242,21,0
2021,West Northamptonshire 015A,E01027192,579,313,124,189,2,2,23,6,17,239,214,25,2
2021,West Northamptonshire 013C,E01027193,638,563,306,257,2,2,5,1,4,68,60,8,0
2021,West Northamptonshire 013D,E01027194,625,552,348,204,3,3,7,2,5,63,51,12,0
2021,West Northamptonshire 011A,E01027195,656,219,99,120,6,6,223,116,107,208,191,17,0
2021,West Northamptonshire 014A,E01027196,534,327,174,153,1,1,66,63,3,137,129,8,3
2021,West Northamptonshire 014B,E01027197,599,297,117,180,8,8,181,135,46,110,103,7,3
2021,West Northamptonshire 014C,E01027198,734,232,94,138,36,36,304,222,82,161,154,7,1
2021,West Northamptonshire 014D,E01027199,499,148,48,100,0,0,265,229,36,85,79,6,1
2021,West Northamptonshire 009D,E01027200,593,247,100,147,10,10,161,134,27,174,152,22,1
2021,West Northamptonshire 037B,E01027201,934,692,340,352,27,27,73,26,47,142,124,18,0
2021,West Northamptonshire 037C,E01027202,674,492,256,236,1,1,105,94,11,72,56,16,4
2021,West Northamptonshire 044A,E01027203,576,444,150,294,3,3,14,2,12,115,107,8,0
2021,West Northamptonshire 044B,E01027204,654,480,215,265,3,3,96,39,57,74,66,8,1
2021,West Northamptonshire 044C,E01027205,734,594,178,416,2,2,10,5,5,128,120,8,0
2021,West Northamptonshire 028A,E01027207,610,555,339,216,1,1,2,1,1,52,45,7,0
2021,West Northamptonshire 023A,E01027208,618,507,237,270,1,1,20,16,4,90,83,7,0
2021,West Northamptonshire 023B,E01027209,549,403,174,229,2,2,4,1,3,140,132,8,0
2021,West Northamptonshire 028B,E01027210,460,367,188,179,3,3,52,43,9,38,30,8,0
2021,West Northamptonshire 023C,E01027211,643,584,371,213,3,3,4,1,3,52,42,10,0
2021,West Northamptonshire 023D,E01027212,621,465,198,267,8,8,25,3,22,123,111,12,0
2021,West Northamptonshire 020A,E01027213,709,448,220,228,14,14,127,104,23,116,97,19,4
2021,West Northamptonshire 020B,E01027214,734,403,216,187,0,0,218,193,25,111,94,17,2
2021,West Northamptonshire 028C,E01027215,612,477,254,223,0,0,75,61,14,60,50,10,0
2021,West Northamptonshire 020C,E01027216,912,723,372,351,5,5,46,20,26,138,121,17,0
2021,West Northamptonshire 028D,E01027217,1061,859,457,402,10,10,58,4,54,134,109,25,0
2021,West Northamptonshire 007A,E01027218,715,633,396,237,9,9,6,2,4,67,56,11,0
2021,West Northamptonshire 007B,E01027219,817,700,432,268,8,8,17,6,11,92,75,17,0
2021,West Northamptonshire 019D,E01027220,603,505,324,181,2,2,33,22,11,63,49,14,0
2021,West Northamptonshire 007C,E01027221,809,603,342,261,23,23,58,8,50,125,106,19,0
2021,West Northamptonshire 007D,E01027222,488,435,232,203,1,1,3,1,2,49,40,9,0
2021,West Northamptonshire 034A,E01027224,952,283,134,149,6,6,257,208,49,402,380,22,4
2021,West Northamptonshire 031B,E01027225,764,235,90,145,3,3,57,8,49,469,449,20,0
2021,West Northamptonshire 034B,E01027226,953,261,95,166,7,7,218,128,90,463,430,33,4
2021,West Northamptonshire 031C,E01027227,739,242,96,146,1,1,51,1,50,445,426,19,0
2021,West Northamptonshire 031D,E01027228,1027,275,107,168,12,12,135,86,49,601,573,28,4
2021,West Northamptonshire 015B,E01027229,635,282,110,172,9,9,206,190,16,135,128,7,3
2021,West Northamptonshire 015C,E01027230,693,286,97,189,23,23,225,158,67,156,147,9,3
2021,West Northamptonshire 015D,E01027231,832,320,108,212,1,1,376,338,38,126,115,11,9
2021,West Northamptonshire 006D,E01027232,846,580,170,410,10,10,87,65,22,165,150,15,4
2021,West Northamptonshire 036A,E01027233,489,248,77,171,9,9,146,131,15,85,80,5,1
2021,West Northamptonshire 036B,E01027234,685,496,193,303,14,14,74,39,35,101,81,20,0
2021,West Northamptonshire 036C,E01027235,657,206,62,144,6,6,335,229,106,107,97,10,3
2021,West Northamptonshire 033B,E01027236,701,548,326,222,2,2,38,18,20,113,96,17,0
2021,West Northamptonshire 033C,E01027237,904,550,240,310,8,8,56,25,31,289,258,31,1
2021,West Northamptonshire 033D,E01027238,962,330,150,180,12,12,208,145,63,409,377,32,3
2021,West Northamptonshire 021A,E01027239,681,263,99,164,9,9,313,246,67,89,84,5,7
2021,West Northamptonshire 020D,E01027240,507,266,130,136,4,4,189,81,108,46,42,4,2
2021,West Northamptonshire 021B,E01027241,715,234,107,127,27,27,194,110,84,259,241,18,1
2021,West Northamptonshire 021C,E01027242,618,301,121,180,4,4,236,213,23,72,61,11,5
2021,West Northamptonshire 021D,E01027243,705,333,108,225,3,3,269,235,34,95,83,12,5
2021,West Northamptonshire 021E,E01027244,683,179,64,115,5,5,435,357,78,59,52,7,5
2021,West Northamptonshire 011B,E01027245,677,413,168,245,10,10,106,95,11,147,137,10,1
2021,West Northamptonshire 009E,E01027246,747,344,129,215,9,9,236,220,16,158,144,14,0
2021,West Northamptonshire 011C,E01027247,672,469,167,302,12,12,67,49,18,124,118,6,0
2021,West Northamptonshire 011D,E01027248,584,249,100,149,2,2,203,176,27,126,111,15,4
2021,West Northamptonshire 011E,E01027249,665,299,129,170,2,2,219,194,25,143,133,10,2
2021,West Northamptonshire 039A,E01027250,597,495,266,229,1,1,11,4,7,90,82,8,0
2021,West Northamptonshire 036D,E01027252,629,360,149,211,10,10,118,106,12,140,132,8,1
2021,West Northamptonshire 039B,E01027253,737,588,310,278,42,42,38,3,35,69,64,5,0
2021,West Northamptonshire 039C,E01027254,827,662,281,381,13,13,38,1,37,114,102,12,0
2021,West Northamptonshire 029A,E01027255,625,535,289,246,8,8,24,4,20,58,44,14,0
2021,West Northamptonshire 029B,E01027256,631,558,328,230,5,5,9,6,3,59,49,10,0
2021,West Northamptonshire 034C,E01027257,498,436,249,187,1,1,27,22,5,33,27,6,1
2021,West Northamptonshire 029C,E01027258,497,433,219,214,3,3,4,2,2,57,51,6,0
2021,West Northamptonshire 024E,E01027259,607,458,229,229,8,8,16,2,14,125,111,14,0
2021,West Northamptonshire 029D,E01027260,644,570,356,214,3,3,29,18,11,41,32,9,1
2021,West Northamptonshire 049A,E01027261,847,669,341,328,5,5,61,13,48,112,85,27,0
2021,West Northamptonshire 045A,E01027262,732,570,331,239,5,5,52,12,40,105,77,28,0
2021,West Northamptonshire 046A,E01027263,867,644,412,232,10,10,108,31,77,104,80,24,1
2021,West Northamptonshire 053A,E01027264,684,462,271,191,6,6,53,14,39,163,142,21,0
2021,West Northamptonshire 051A,E01027265,664,570,317,253,1,1,18,6,12,75,65,10,0
2021,West Northamptonshire 053B,E01027267,536,326,148,178,7,7,87,10,77,116,98,18,0
2021,West Northamptonshire 053C,E01027268,531,415,171,244,3,3,26,7,19,87,77,10,0
2021,West Northamptonshire 053D,E01027269,765,356,173,183,7,7,237,47,190,165,155,10,0
2021,West Northamptonshire 051B,E01027270,584,507,195,312,3,3,4,1,3,70,61,9,0
2021,West Northamptonshire 051C,E01027271,636,464,185,279,6,6,36,6,30,130,119,11,0
2021,West Northamptonshire 051D,E01027272,596,520,232,288,3,3,9,1,8,64,56,8,0
2021,West Northamptonshire 043A,E01027273,819,572,342,230,5,5,135,42,93,106,87,19,1
2021,West Northamptonshire 043B,E01027274,987,779,300,479,34,34,103,7,96,71,54,17,0
2021,West Northamptonshire 043C,E01027275,651,520,308,212,11,11,53,10,43,66,51,15,1
2021,West Northamptonshire 045B,E01027277,773,598,358,240,7,7,53,13,40,114,93,21,1
2021,West Northamptonshire 046B,E01027279,958,650,341,309,17,17,188,41,147,100,77,23,3
2021,West Northamptonshire 050A,E01027280,1060,853,357,496,17,17,45,4,41,145,117,28,0
2021,West Northamptonshire 050B,E01027281,714,492,242,250,24,24,144,35,109,54,44,10,0
2021,West Northamptonshire 040A,E01027282,733,530,261,269,12,12,147,39,108,44,38,6,0
2021,West Northamptonshire 040B,E01027283,693,566,326,240,8,8,32,5,27,86,69,17,1
2021,West Northamptonshire 046C,E01027284,780,663,352,311,2,2,49,12,37,66,53,13,0
2021,West Northamptonshire 040C,E01027285,747,597,345,252,1,1,79,22,57,70,55,15,0
2021,West Northamptonshire 040D,E01027286,678,517,306,211,6,6,88,26,62,66,45,21,1
2021,West Northamptonshire 040E,E01027287,738,592,361,231,8,8,73,18,55,65,48,17,0
2021,West Northamptonshire 052A,E01027288,996,665,359,306,20,20,181,45,136,130,113,17,0
2021,West Northamptonshire 045C,E01027289,769,555,311,244,8,8,120,22,98,85,71,14,1
2021,West Northamptonshire 052B,E01027290,929,687,408,279,5,5,75,10,65,162,103,59,0
2021,West Northamptonshire 048A,E01027291,714,611,336,275,6,6,25,3,22,72,58,14,0
2021,West Northamptonshire 048B,E01027292,506,289,141,148,4,4,168,49,119,45,38,7,0
2021,West Northamptonshire 048C,E01027293,557,474,260,214,9,9,12,2,10,62,49,13,0
2021,West Northamptonshire 046D,E01027294,796,652,290,362,10,10,68,16,52,66,55,11,0
2021,West Northamptonshire 049B,E01027295,1111,825,359,466,41,41,132,24,108,113,100,13,0
2021,West Northamptonshire 052C,E01027296,876,635,362,273,14,14,90,18,72,137,109,28,0
2021,West Northamptonshire 047A,E01027297,765,582,328,254,2,2,78,16,62,103,85,18,0
2021,West Northamptonshire 047B,E01027298,1196,1055,337,718,19,19,49,5,44,73,62,11,0
2021,West Northamptonshire 047C,E01027299,640,396,217,179,12,12,159,37,122,71,59,12,2
2021,West Northamptonshire 045D,E01027300,615,527,239,288,4,4,27,1,26,57,50,7,0
2021,West Northamptonshire 047D,E01027301,994,611,283,328,50,50,109,28,81,224,210,14,0
2021,West Northamptonshire 047E,E01027302,721,297,139,158,49,49,268,52,216,106,97,9,1
2021,West Northamptonshire 045E,E01027303,760,547,280,267,9,9,43,7,36,161,140,21,0
2021,West Northamptonshire 048D,E01027304,745,599,376,223,0,0,37,5,32,109,92,17,0
2021,West Northamptonshire 048E,E01027305,793,562,321,241,3,3,79,20,59,149,110,39,0
2021,West Northamptonshire 049C,E01027306,783,626,346,280,2,2,65,11,54,90,72,18,0
2021,West Northamptonshire 050C,E01027307,935,702,401,301,15,15,100,16,84,118,94,24,0
2021,West Northamptonshire 043D,E01027308,711,465,268,197,1,1,62,18,44,183,167,16,0
2021,North Northamptonshire 033A,E01027309,652,562,343,219,1,1,24,5,19,65,52,13,0
2021,North Northamptonshire 033B,E01027310,598,190,83,107,1,1,303,154,149,101,99,2,3
2021,North Northamptonshire 033C,E01027311,520,405,247,158,10,10,29,18,11,76,65,11,0
2021,North Northamptonshire 033D,E01027312,642,378,209,169,3,3,184,75,109,77,62,15,0
2021,North Northamptonshire 030A,E01027313,672,330,199,131,6,6,39,6,33,297,282,15,0
2021,North Northamptonshire 030B,E01027314,962,332,190,142,2,2,135,31,104,493,466,27,0
2021,North Northamptonshire 030C,E01027316,917,480,186,294,56,56,107,21,86,274,256,18,0
2021,North Northamptonshire 036A,E01027317,664,379,197,182,2,2,195,62,133,88,79,9,0
2021,North Northamptonshire 036B,E01027318,596,193,68,125,3,3,330,145,185,68,63,5,2
2021,North Northamptonshire 036C,E01027319,617,365,163,202,6,6,140,41,99,106,92,14,0
2021,North Northamptonshire 036D,E01027320,804,482,184,298,22,22,163,66,97,137,119,18,0
2021,North Northamptonshire 036E,E01027321,656,532,180,352,9,9,44,17,27,71,61,10,0
2021,North Northamptonshire 038A,E01027322,559,408,226,182,2,2,46,11,35,102,88,14,1
2021,North Northamptonshire 038B,E01027323,831,598,239,359,22,22,127,42,85,84,75,9,0
2021,North Northamptonshire 038C,E01027324,499,437,270,167,1,1,18,5,13,43,38,5,0
2021,North Northamptonshire 038D,E01027325,837,630,308,322,3,3,77,12,65,127,115,12,0
2021,North Northamptonshire 026A,E01027326,745,561,347,214,17,17,61,12,49,106,89,17,0
2021,North Northamptonshire 026B,E01027327,727,402,198,204,2,2,184,64,120,139,123,16,0
2021,North Northamptonshire 026C,E01027328,649,419,210,209,7,7,126,46,80,96,80,16,1
2021,North Northamptonshire 038E,E01027329,812,679,437,242,6,6,60,18,42,67,42,25,0
2021,North Northamptonshire 028A,E01027330,669,349,137,212,13,13,186,70,116,119,109,10,2
2021,North Northamptonshire 028B,E01027331,643,293,174,119,7,7,206,79,127,137,129,8,0
2021,North Northamptonshire 028C,E01027332,646,556,353,203,1,1,7,5,2,82,67,15,0
2021,North Northamptonshire 028D,E01027333,855,708,318,390,1,1,6,3,3,140,127,13,0
2021,North Northamptonshire 028E,E01027334,512,135,46,89,2,2,313,164,149,60,55,5,2
2021,North Northamptonshire 040A,E01027335,638,547,353,194,2,2,30,7,23,59,50,9,0
2021,North Northamptonshire 040B,E01027336,695,410,217,193,10,10,160,62,98,115,94,21,0
2021,North Northamptonshire 040C,E01027337,796,646,352,294,5,5,31,11,20,114,100,14,0
2021,North Northamptonshire 026D,E01027338,1020,812,441,371,7,7,106,22,84,95,69,26,0
2021,North Northamptonshire 031A,E01027339,553,208,87,121,1,1,281,69,212,63,58,5,0
2021,North Northamptonshire 031B,E01027340,652,394,204,190,2,2,179,73,106,77,66,11,0
2021,North Northamptonshire 031C,E01027341,664,302,124,178,19,19,227,95,132,111,101,10,5
2021,North Northamptonshire 031D,E01027342,718,237,86,151,45,45,312,19,293,124,114,10,0
2021,North Northamptonshire 029A,E01027343,614,514,295,219,2,2,7,5,2,91,82,9,0
2021,North Northamptonshire 029B,E01027344,645,506,279,227,1,1,49,3,46,89,81,8,0
2021,North Northamptonshire 029C,E01027345,484,443,262,181,0,0,5,2,3,36,30,6,0
2021,North Northamptonshire 029D,E01027346,580,476,198,278,1,1,8,2,6,95,85,10,0
2021,North Northamptonshire 029E,E01027347,750,675,359,316,3,3,2,2,0,70,57,13,0
2021,North Northamptonshire 040D,E01027348,952,731,405,326,3,3,78,18,60,140,120,20,0
2021,North Northamptonshire 032A,E01027350,695,427,241,186,2,2,119,37,82,147,124,23,0
2021,North Northamptonshire 032B,E01027351,769,346,178,168,14,14,307,114,193,101,84,17,1
2021,North Northamptonshire 032C,E01027352,632,289,148,141,5,5,106,26,80,231,216,15,1
2021,North Northamptonshire 038F,E01027353,988,802,522,280,6,6,52,13,39,128,102,26,0
2021,North Northamptonshire 040E,E01027354,1071,665,310,355,7,7,165,63,102,232,210,22,2
2021,North Northamptonshire 040F,E01027355,683,586,318,268,1,1,23,5,18,73,61,12,0
2021,Northumberland 004A,E01027356,1034,665,432,233,18,18,137,32,105,214,175,39,0
2021,Northumberland 004B,E01027357,539,486,350,136,5,5,10,7,3,38,32,6,0
2021,Northumberland 005A,E01027358,1021,553,360,193,2,2,250,129,121,216,171,45,0
2021,Northumberland 005B,E01027359,1040,459,267,192,1,1,432,385,47,146,117,29,2
2021,Northumberland 006A,E01027361,826,537,372,165,1,1,122,58,64,166,138,28,0
2021,Northumberland 006B,E01027362,829,550,296,254,4,4,156,80,76,119,97,22,0
2021,Northumberland 006C,E01027363,554,203,116,87,0,0,306,285,21,43,30,13,2
2021,Northumberland 006D,E01027364,849,692,474,218,3,3,41,20,21,113,89,24,0
2021,Northumberland 007A,E01027365,1100,795,533,262,9,9,91,46,45,205,154,51,0
2021,Northumberland 004C,E01027366,726,472,345,127,0,0,69,46,23,185,140,45,0
2021,Northumberland 004D,E01027367,663,369,215,154,2,2,61,32,29,231,133,98,0
2021,Northumberland 007B,E01027368,796,490,334,156,0,0,126,67,59,180,138,42,0
2021,Northumberland 007C,E01027369,730,590,434,156,5,5,53,39,14,82,59,23,0
2021,Northumberland 006E,E01027370,927,807,539,268,3,3,51,41,10,66,48,18,0
2021,Northumberland 006F,E01027371,792,506,277,229,0,0,183,150,33,102,84,18,1
2021,Northumberland 006G,E01027372,1125,871,625,246,23,23,113,31,82,118,95,23,0
2021,Northumberland 007D,E01027373,964,578,413,165,8,8,97,42,55,281,218,63,0
2021,Northumberland 003A,E01027374,944,566,401,165,11,11,175,45,130,192,155,37,0
2021,Northumberland 003B,E01027375,866,414,309,105,0,0,48,17,31,404,291,113,0
2021,Northumberland 001A,E01027376,751,420,232,188,2,2,239,85,154,88,70,18,2
2021,Northumberland 001B,E01027377,936,460,358,102,10,10,147,37,110,319,290,29,0
2021,Northumberland 002A,E01027378,507,420,295,125,1,1,15,5,10,71,51,20,0
2021,Northumberland 002B,E01027379,714,591,407,184,2,2,13,4,9,108,95,13,0
2021,Northumberland 002C,E01027380,626,369,253,116,5,5,85,23,62,166,137,29,1
2021,Northumberland 003C,E01027381,879,440,303,137,3,3,82,26,56,354,279,75,0
2021,Northumberland 002D,E01027382,812,507,390,117,3,3,114,25,89,187,148,39,1
2021,Northumberland 003D,E01027383,592,386,273,113,6,6,102,29,73,98,75,23,0
2021,Northumberland 003E,E01027384,653,439,338,101,5,5,76,18,58,132,95,37,1
2021,Northumberland 001C,E01027385,492,253,133,120,3,3,183,62,121,52,42,10,1
2021,Northumberland 002E,E01027386,602,433,299,134,4,4,100,25,75,65,50,15,0
2021,Northumberland 001D,E01027387,878,457,317,140,7,7,242,88,154,172,146,26,0
2021,Northumberland 001E,E01027388,617,279,163,116,0,0,241,77,164,97,87,10,0
2021,Northumberland 001F,E01027389,709,429,271,158,9,9,156,66,90,115,101,14,0
2021,Northumberland 003F,E01027390,1020,628,475,153,3,3,241,67,174,148,113,35,0
2021,Northumberland 024A,E01027391,604,358,192,166,1,1,138,98,40,107,92,15,0
2021,Northumberland 022A,E01027392,928,372,160,212,0,0,452,345,107,100,90,10,4
2021,Northumberland 022B,E01027393,601,247,117,130,1,1,281,272,9,68,64,4,4
2021,Northumberland 031A,E01027394,532,404,259,145,0,0,10,5,5,118,100,18,0
2021,Northumberland 042J,E01027395,901,468,145,323,17,17,267,128,139,147,131,16,2
2021,Northumberland 042H,E01027396,547,293,146,147,0,0,165,143,22,85,74,11,4
2021,Northumberland 042I,E01027397,618,288,145,143,1,1,265,256,9,60,51,9,4
2021,Northumberland 029A,E01027398,877,359,157,202,0,0,378,360,18,136,124,12,4
2021,Northumberland 042E,E01027399,596,511,247,264,0,0,6,2,4,79,68,11,0
2021,Northumberland 042A,E01027400,484,458,166,292,1,1,9,5,4,16,14,2,0
2021,Northumberland 042C,E01027401,535,511,276,235,1,1,4,1,3,19,15,4,0
2021,Northumberland 042B,E01027402,489,461,240,221,0,0,10,5,5,18,14,4,0
2021,Northumberland 042D,E01027403,483,441,259,182,10,10,5,1,4,27,19,8,0
2021,Northumberland 042F,E01027404,926,814,308,506,10,10,10,6,4,92,75,17,0
2021,Northumberland 042G,E01027405,629,561,367,194,0,0,10,5,5,58,51,7,0
2021,Northumberland 031B,E01027406,604,513,374,139,0,0,8,4,4,83,64,19,0
2021,Northumberland 031C,E01027407,620,508,328,180,1,1,12,6,6,98,89,9,1
2021,Northumberland 031D,E01027408,686,396,227,169,2,2,146,98,48,142,131,11,0
2021,Northumberland 029B,E01027409,748,497,319,178,4,4,103,55,48,144,120,24,0
2021,Northumberland 031E,E01027410,655,604,379,225,1,1,7,3,4,43,34,9,0
2021,Northumberland 029C,E01027411,624,322,188,134,2,2,212,174,38,87,77,10,1
2021,Northumberland 029D,E01027412,910,369,102,267,5,5,460,103,357,76,69,7,0
2021,Northumberland 029E,E01027413,944,553,282,271,29,29,233,43,190,129,115,14,0
2021,Northumberland 023A,E01027414,643,383,215,168,0,0,24,5,19,236,202,34,0
2021,Northumberland 023B,E01027415,754,324,211,113,0,0,184,112,72,244,222,22,2
2021,Northumberland 022C,E01027416,751,160,99,61,0,0,451,333,118,138,123,15,2
2021,Northumberland 030A,E01027417,688,573,383,190,0,0,58,53,5,57,47,10,0
2021,Northumberland 030B,E01027418,780,580,297,283,1,1,123,109,14,76,64,12,0
2021,Northumberland 030C,E01027419,759,531,344,187,2,2,143,107,36,81,70,11,2
2021,Northumberland 030D,E01027420,594,478,303,175,1,1,77,73,4,38,26,12,0
2021,Northumberland 030E,E01027421,734,394,219,175,5,5,259,227,32,70,52,18,6
2021,Northumberland 024B,E01027422,808,393,218,175,2,2,312,259,53,99,91,8,2
2021,Northumberland 024C,E01027423,622,336,197,139,0,0,210,200,10,74,61,13,2
2021,Northumberland 022D,E01027424,792,304,158,146,3,3,352,311,41,131,118,13,2
2021,Northumberland 025B,E01027426,803,364,96,268,16,16,350,303,47,72,60,12,1
2021,Northumberland 025C,E01027427,943,380,205,175,1,1,332,254,78,227,204,23,3
2021,Northumberland 025D,E01027428,627,538,319,219,1,1,7,2,5,81,66,15,0
2021,Northumberland 024D,E01027429,856,348,202,146,0,0,416,269,147,88,69,19,4
2021,Northumberland 024E,E01027430,698,334,214,120,4,4,293,273,20,67,57,10,0
2021,Northumberland 023C,E01027431,844,367,191,176,1,1,203,139,64,267,245,22,6
2021,Northumberland 032A,E01027432,819,446,267,179,2,2,125,97,28,244,228,16,2
2021,Northumberland 032B,E01027433,1196,754,246,508,37,37,273,149,124,127,108,19,5
2021,Northumberland 032C,E01027434,631,445,275,170,1,1,120,113,7,65,57,8,0
2021,Northumberland 032D,E01027435,703,372,227,145,3,3,243,183,60,85,67,18,0
2021,Northumberland 032E,E01027436,696,452,237,215,0,0,167,146,21,75,66,9,2
2021,Northumberland 026A,E01027437,755,685,438,247,5,5,10,5,5,55,42,13,0
2021,Northumberland 026B,E01027438,621,509,299,210,3,3,16,10,6,93,81,12,0
2021,Northumberland 026C,E01027439,766,704,358,346,3,3,7,6,1,52,40,12,0
2021,Northumberland 026D,E01027440,627,559,339,220,7,7,7,5,2,53,40,13,1
2021,Northumberland 023E,E01027442,795,453,252,201,0,0,163,14,149,179,164,15,0
2021,Northumberland 008A,E01027443,754,327,160,167,11,11,309,117,192,105,89,16,2
2021,Northumberland 008B,E01027444,594,473,275,198,1,1,35,15,20,85,65,20,0
2021,Northumberland 008C,E01027445,771,596,344,252,1,1,60,17,43,114,95,19,0
2021,Northumberland 008D,E01027446,605,534,345,189,1,1,8,6,2,62,52,10,0
2021,Northumberland 015A,E01027447,785,442,282,160,3,3,64,10,54,276,233,43,0
2021,Northumberland 034A,E01027449,691,567,380,187,1,1,54,12,42,69,46,23,0
2021,Northumberland 015C,E01027450,761,608,387,221,2,2,53,19,34,98,65,33,0
2021,Northumberland 008E,E01027451,824,417,261,156,0,0,243,63,180,164,148,16,0
2021,Northumberland 016A,E01027452,636,462,306,156,1,1,64,31,33,109,90,19,0
2021,Northumberland 016B,E01027453,883,509,374,135,8,8,165,34,131,200,181,19,1
2021,Northumberland 018A,E01027455,623,575,383,192,1,1,9,6,3,38,27,11,0
2021,Northumberland 018B,E01027456,517,491,344,147,1,1,4,2,2,21,14,7,0
2021,Northumberland 011A,E01027457,727,597,354,243,14,14,31,6,25,85,76,9,0
2021,Northumberland 018C,E01027458,985,840,463,377,5,5,51,27,24,89,76,13,0
2021,Northumberland 018D,E01027460,733,620,395,225,3,3,33,11,22,77,62,15,0
2021,Northumberland 016E,E01027461,609,316,197,119,4,4,221,94,127,64,58,6,4
2021,Northumberland 011B,E01027462,937,388,195,193,2,2,358,118,240,189,172,17,0
2021,Northumberland 011C,E01027463,825,678,374,304,2,2,47,10,37,98,82,16,0
2021,Northumberland 033A,E01027464,620,514,344,170,0,0,27,11,16,79,59,20,0
2021,Northumberland 033B,E01027465,647,526,328,198,1,1,26,11,15,94,81,13,0
2021,Northumberland 033C,E01027466,608,413,261,152,1,1,132,29,103,62,47,15,0
2021,Northumberland 034B,E01027468,524,504,326,178,0,0,1,1,0,19,16,3,0
2021,Northumberland 034C,E01027469,529,502,313,189,0,0,2,2,0,25,21,4,0
2021,Northumberland 034D,E01027471,752,707,414,293,0,0,10,6,4,35,23,12,0
2021,Northumberland 034E,E01027472,634,357,213,144,1,1,64,22,42,212,158,54,0
2021,Northumberland 015D,E01027473,1142,877,413,464,9,9,52,13,39,204,171,33,0
2021,Northumberland 008F,E01027474,856,509,244,265,2,2,203,72,131,140,123,17,2
2021,Northumberland 008G,E01027475,667,559,377,182,1,1,41,3,38,66,43,23,0
2021,Northumberland 035A,E01027476,1198,697,445,252,11,11,264,79,185,224,197,27,2
2021,Northumberland 040A,E01027477,536,426,296,130,0,0,7,0,7,103,78,25,0
2021,Northumberland 040B,E01027478,514,345,234,111,3,3,80,39,41,85,71,14,1
2021,Northumberland 019A,E01027479,1006,614,409,205,12,12,155,42,113,225,182,43,0
2021,Northumberland 019B,E01027480,554,368,213,155,2,2,33,9,24,151,126,25,0
2021,Northumberland 043A,E01027481,813,503,357,146,7,7,132,40,92,170,138,32,1
2021,Northumberland 043B,E01027482,730,570,394,176,2,2,98,28,70,60,48,12,0
2021,Northumberland 036A,E01027483,559,367,221,146,0,0,54,14,40,138,100,38,0
2021,Northumberland 037A,E01027484,948,738,509,229,10,10,63,13,50,137,102,35,0
2021,Northumberland 037B,E01027485,694,395,259,136,1,1,212,85,127,86,69,17,0
2021,Northumberland 037C,E01027486,513,353,245,108,0,0,47,16,31,113,103,10,0
2021,Northumberland 037D,E01027487,545,363,248,115,1,1,80,31,49,101,81,20,0
2021,Northumberland 040C,E01027488,1046,617,360,257,34,34,175,61,114,220,191,29,0
2021,Northumberland 035B,E01027489,666,476,305,171,5,5,127,44,83,58,41,17,0
2021,Northumberland 035C,E01027490,825,478,290,188,0,0,208,73,135,138,120,18,1
2021,Northumberland 035D,E01027491,646,571,412,159,3,3,7,3,4,65,52,13,0
2021,Northumberland 035E,E01027492,774,630,405,225,7,7,19,9,10,118,99,19,0
2021,Northumberland 035F,E01027493,689,231,128,103,1,1,327,132,195,129,122,7,1
2021,Northumberland 035G,E01027494,1179,903,595,308,18,18,72,32,40,186,160,26,0
2021,Northumberland 040D,E01027495,520,341,252,89,2,2,67,8,59,110,96,14,0
2021,Northumberland 036B,E01027496,549,360,204,156,12,12,120,38,82,57,47,10,0
2021,Northumberland 038A,E01027497,1017,746,376,370,0,0,162,85,77,109,84,25,0
2021,Northumberland 038B,E01027498,1191,535,241,294,8,8,499,218,281,148,126,22,1
2021,Northumberland 038C,E01027499,811,679,366,313,2,2,84,38,46,46,35,11,0
2021,Northumberland 038D,E01027500,786,401,220,181,7,7,204,98,106,174,157,17,0
2021,Northumberland 019C,E01027503,741,492,341,151,4,4,93,18,75,152,115,37,0
2021,Northumberland 043C,E01027504,790,653,428,225,3,3,20,7,13,114,93,21,0
2021,Northumberland 040E,E01027505,577,429,311,118,5,5,34,5,29,108,78,30,1
2021,Northumberland 043E,E01027507,568,508,311,197,3,3,21,5,16,36,26,10,0
2021,Northumberland 036C,E01027508,512,376,214,162,5,5,55,14,41,76,68,8,0
2021,Northumberland 043D,E01027509,618,482,325,157,22,22,59,15,44,55,47,8,0
2021,Northumberland 040F,E01027510,530,340,224,116,2,2,78,22,56,110,92,18,0
2021,Northumberland 019D,E01027511,500,286,183,103,1,1,49,7,42,163,144,19,1
2021,Northumberland 037E,E01027512,461,276,196,80,0,0,28,5,23,157,123,34,0
2021,Northumberland 036D,E01027513,884,728,462,266,1,1,61,27,34,93,78,15,1
2021,Northumberland 021A,E01027514,755,567,349,218,9,9,101,37,64,78,67,11,0
2021,Northumberland 020A,E01027515,717,432,238,194,0,0,113,42,71,172,148,24,0
2021,Northumberland 021B,E01027516,495,325,202,123,17,17,103,42,61,50,46,4,0
2021,Northumberland 020B,E01027517,879,548,309,239,0,0,80,41,39,251,222,29,0
2021,Northumberland 020C,E01027518,630,258,130,128,1,1,320,186,134,49,35,14,2
2021,Northumberland 020D,E01027519,607,280,141,139,1,1,198,126,72,128,119,9,0
2021,Northumberland 021C,E01027520,625,576,326,250,2,2,4,3,1,43,35,8,0
2021,Northumberland 021D,E01027521,748,675,289,386,1,1,20,14,6,52,43,9,0
2021,Northumberland 021E,E01027522,625,280,142,138,5,5,223,122,101,117,94,23,0
2021,Northumberland 021F,E01027523,530,298,159,139,0,0,123,62,61,109,88,21,0
2021,Northumberland 041B,E01027524,881,581,211,370,9,9,93,29,64,198,169,29,0
2021,Northumberland 041A,E01027525,897,452,228,224,14,14,258,126,132,172,152,20,1
2021,Northumberland 041D,E01027526,517,487,322,165,0,0,4,1,3,26,18,8,0
2021,Northumberland 041C,E01027527,590,225,107,118,2,2,283,174,109,79,66,13,1
2021,Northumberland 010A,E01027528,691,309,179,130,19,19,143,52,91,220,195,25,0
2021,Northumberland 010B,E01027529,477,351,201,150,0,0,11,4,7,115,104,11,0
2021,Northumberland 017A,E01027530,614,327,165,162,0,0,223,120,103,64,53,11,0
2021,Northumberland 017B,E01027531,722,424,219,205,1,1,175,99,76,122,105,17,0
2021,Northumberland 041H,E01027532,984,720,392,328,8,8,45,15,30,210,171,39,1
2021,Northumberland 013A,E01027533,952,217,123,94,0,0,583,299,284,150,136,14,2
2021,Northumberland 017C,E01027534,858,430,232,198,0,0,268,125,143,160,143,17,0
2021,Northumberland 017D,E01027535,644,582,394,188,0,0,11,4,7,51,43,8,0
2021,Northumberland 041E,E01027536,580,421,258,163,5,5,97,65,32,57,42,15,0
2021,Northumberland 041F,E01027537,600,357,206,151,0,0,140,66,74,101,79,22,2
2021,Northumberland 041G,E01027538,703,625,362,263,6,6,18,3,15,54,41,13,0
2021,Northumberland 010C,E01027539,735,311,196,115,1,1,66,11,55,356,327,29,1
2021,Northumberland 013B,E01027540,829,250,128,122,6,6,358,190,168,215,198,17,0
2021,Northumberland 009A,E01027541,832,532,363,169,1,1,93,47,46,206,169,37,0
2021,Northumberland 009B,E01027542,839,340,217,123,4,4,324,155,169,169,150,19,2
2021,Northumberland 009C,E01027543,562,261,139,122,2,2,232,127,105,65,54,11,2
2021,Northumberland 009D,E01027544,640,457,313,144,2,2,79,38,41,100,81,19,2
2021,Northumberland 010D,E01027545,843,353,209,144,2,2,197,75,122,290,272,18,1
2021,Northumberland 010E,E01027546,749,331,179,152,0,0,83,12,71,334,309,25,1
2021,Northumberland 013E,E01027549,1098,950,305,645,8,8,45,13,32,95,69,26,0
2021,Northumberland 020E,E01027550,605,357,191,166,1,1,114,63,51,132,116,16,1
2021,Northumberland 020F,E01027551,689,271,123,148,0,0,258,125,133,159,147,12,1
2021,Northumberland 020G,E01027552,604,373,220,153,3,3,81,25,56,147,125,22,0
2021,Northumberland 017E,E01027553,751,486,268,218,3,3,124,30,94,138,108,30,0
2021,Northumberland 017F,E01027554,624,525,351,174,2,2,33,18,15,64,50,14,0
2021,Craven 008A,E01027555,855,715,464,251,1,1,40,10,30,99,86,13,0
2021,Craven 007A,E01027556,831,683,360,323,7,7,55,15,40,86,72,14,0
2021,Craven 009D,E01027557,663,423,297,126,1,1,11,1,10,228,179,49,0
2021,Craven 001A,E01027558,882,739,497,242,5,5,22,5,17,115,86,29,1
2021,Craven 001B,E01027559,813,540,344,196,1,1,129,37,92,142,120,22,1
2021,Craven 007B,E01027560,1042,838,413,425,0,0,55,12,43,149,126,23,0
2021,Craven 009E,E01027561,848,654,403,251,4,4,57,13,44,133,118,15,0
2021,Craven 009C,E01027562,674,498,329,169,8,8,24,3,21,144,98,46,0
2021,Craven 007C,E01027563,721,499,334,165,3,3,109,42,67,110,94,16,0
2021,Craven 008B,E01027564,583,296,162,134,15,15,131,27,104,140,130,10,1
2021,Craven 008C,E01027565,678,573,334,239,3,3,3,0,3,99,86,13,0
2021,Craven 008D,E01027566,584,464,263,201,3,3,32,6,26,85,71,14,0
2021,Craven 009B,E01027567,763,521,392,129,10,10,115,20,95,117,80,37,0
2021,Craven 003A,E01027568,1011,791,481,310,0,0,83,11,72,137,112,25,0
2021,Craven 001C,E01027569,606,484,362,122,1,1,19,2,17,102,77,25,0
2021,Craven 001D,E01027570,1141,783,527,256,4,4,141,20,121,213,170,43,0
2021,Craven 003B,E01027571,813,640,470,170,11,11,35,6,29,126,92,34,1
2021,Craven 003C,E01027572,1059,698,497,201,3,3,106,14,92,252,214,38,0
2021,Craven 003D,E01027573,820,564,431,133,15,15,119,9,110,122,101,21,0
2021,Craven 005A,E01027574,768,667,434,233,25,25,15,4,11,61,54,7,0
2021,Craven 005B,E01027575,894,660,381,279,0,0,131,23,108,103,86,17,0
2021,Craven 009F,E01027576,794,703,479,224,14,14,40,4,36,37,25,12,0
2021,Craven 005C,E01027577,983,646,404,242,6,6,60,11,49,271,250,21,0
2021,Craven 006A,E01027578,771,406,240,166,2,2,17,3,14,346,318,28,0
2021,Craven 005D,E01027579,517,259,120,139,0,0,198,46,152,58,49,9,2
2021,Craven 006B,E01027580,494,208,114,94,2,2,235,53,182,49,43,6,0
2021,Craven 006D,E01027582,729,501,273,228,7,7,80,11,69,140,124,16,1
2021,Craven 008E,E01027583,845,679,418,261,1,1,26,4,22,139,123,16,0
2021,Craven 008F,E01027584,856,562,294,268,20,20,192,28,164,79,61,18,3
2021,Craven 009A,E01027585,839,655,508,147,3,3,37,2,35,144,111,33,0
2021,Craven 007D,E01027586,881,615,370,245,1,1,33,3,30,232,197,35,0
2021,Hambleton 006A,E01027587,620,386,247,139,0,0,178,13,165,56,44,12,0
2021,Hambleton 006B,E01027588,790,524,289,235,11,11,63,7,56,192,171,21,0
2021,Hambleton 006C,E01027589,904,620,345,275,12,12,145,18,127,127,99,28,0
2021,Hambleton 003A,E01027590,1158,767,378,389,20,20,231,15,216,140,120,20,0
2021,Hambleton 001A,E01027591,738,612,405,207,3,3,48,3,45,75,50,25,0
2021,Hambleton 003B,E01027592,759,617,407,210,0,0,27,2,25,115,80,35,0
2021,Hambleton 006D,E01027593,787,552,393,159,2,2,60,4,56,173,134,39,0
2021,Hambleton 010A,E01027594,907,462,276,186,9,9,286,22,264,150,131,19,0
2021,Hambleton 010B,E01027595,863,610,409,201,16,16,97,9,88,140,112,28,0
2021,Hambleton 010C,E01027596,837,625,459,166,7,7,101,12,89,104,83,21,0
2021,Hambleton 001B,E01027597,708,547,362,185,11,11,33,0,33,117,94,23,0
2021,Hambleton 002A,E01027598,841,739,535,204,3,3,20,3,17,79,62,17,0
2021,Hambleton 001C,E01027599,791,357,210,147,11,11,302,38,264,121,108,13,0
2021,Hambleton 011A,E01027600,804,574,337,237,1,1,78,6,72,151,114,37,0
2021,Hambleton 010D,E01027601,840,647,373,274,2,2,56,2,54,135,95,40,0
2021,Hambleton 005A,E01027603,879,629,374,255,16,16,88,7,81,146,87,59,0
2021,Hambleton 005B,E01027604,826,646,433,213,13,13,32,5,27,135,91,44,0
2021,Hambleton 013D,E01027605,748,413,225,188,7,7,97,5,92,230,205,25,1
2021,Hambleton 012E,E01027606,688,575,413,162,1,1,21,4,17,91,77,14,0
2021,Hambleton 005C,E01027607,548,511,389,122,0,0,3,1,2,34,28,6,0
2021,Hambleton 013B,E01027608,766,323,171,152,16,16,221,25,196,206,189,17,0
2021,Hambleton 012D,E01027609,547,217,93,124,6,6,253,30,223,71,63,8,0
2021,Hambleton 012C,E01027610,746,445,272,173,1,1,171,21,150,129,122,7,0
2021,Hambleton 013A,E01027612,741,295,179,116,1,1,373,39,334,72,60,12,0
2021,Hambleton 003C,E01027613,754,547,350,197,8,8,43,5,38,156,124,32,0
2021,Hambleton 005D,E01027614,573,485,316,169,1,1,47,2,45,40,32,8,0
2021,Hambleton 005E,E01027615,506,472,308,164,0,0,2,0,2,32,28,4,0
2021,Hambleton 013C,E01027616,676,375,207,168,4,4,190,24,166,107,93,14,0
2021,Hambleton 003D,E01027617,456,329,216,113,3,3,29,1,28,95,77,18,0
2021,Hambleton 002B,E01027618,1062,875,582,293,1,1,66,3,63,120,91,29,0
2021,Hambleton 011B,E01027619,894,649,360,289,7,7,91,5,86,147,100,47,0
2021,Hambleton 008A,E01027620,889,550,309,241,15,15,80,5,75,243,222,21,1
2021,Hambleton 010E,E01027622,856,660,458,202,3,3,62,8,54,131,94,37,0
2021,Hambleton 001D,E01027623,576,515,365,150,2,2,6,0,6,53,41,12,0
2021,Hambleton 002C,E01027624,573,510,373,137,5,5,21,4,17,37,28,9,0
2021,Hambleton 001E,E01027625,849,386,257,129,13,13,347,63,284,103,86,17,0
2021,Hambleton 002D,E01027626,712,554,364,190,8,8,79,8,71,71,52,19,0
2021,Hambleton 002E,E01027627,798,604,410,194,2,2,56,2,54,136,105,31,0
2021,Hambleton 007B,E01027628,812,548,353,195,0,0,66,3,63,198,153,45,0
2021,Hambleton 009B,E01027629,650,226,131,95,4,4,355,47,308,63,55,8,2
2021,Hambleton 008B,E01027630,936,427,246,181,4,4,161,15,146,344,311,33,0
2021,Hambleton 008C,E01027631,703,530,378,152,2,2,12,1,11,159,143,16,0
2021,Hambleton 008D,E01027632,693,523,284,239,1,1,69,8,61,99,75,24,1
2021,Hambleton 007C,E01027633,784,606,414,192,3,3,21,3,18,154,106,48,0
2021,Hambleton 011C,E01027634,827,665,377,288,5,5,61,7,54,96,76,20,0
2021,Hambleton 009C,E01027635,1023,665,378,287,5,5,115,10,105,238,114,124,0
2021,Hambleton 009D,E01027636,870,649,443,206,5,5,57,5,52,159,122,37,0
2021,Hambleton 008E,E01027637,833,629,439,190,4,4,32,1,31,168,124,44,0
2021,Harrogate 010A,E01027638,601,512,302,210,1,1,12,9,3,76,67,9,0
2021,Harrogate 010B,E01027639,578,488,316,172,4,4,11,3,8,75,60,15,0
2021,Harrogate 010C,E01027640,650,508,273,235,1,1,52,46,6,88,73,15,1
2021,Harrogate 008A,E01027641,477,446,257,189,0,0,2,1,1,29,24,5,0
2021,Harrogate 007A,E01027642,638,521,357,164,2,2,19,8,11,96,76,20,0
2021,Harrogate 003A,E01027643,703,505,346,159,4,4,81,43,38,113,89,24,0
2021,Harrogate 005A,E01027644,670,440,256,184,6,6,102,67,35,122,113,9,0
2021,Harrogate 005B,E01027645,853,578,325,253,29,29,68,29,39,178,162,16,0
2021,Harrogate 007B,E01027646,706,573,359,214,10,10,37,25,12,85,68,17,1
2021,Harrogate 005C,E01027647,790,642,412,230,5,5,63,31,32,80,65,15,0
2021,Harrogate 014A,E01027648,672,468,262,206,7,7,128,69,59,68,60,8,1
2021,Harrogate 013A,E01027649,871,538,239,299,11,11,110,68,42,210,196,14,2
2021,Harrogate 014B,E01027650,644,512,279,233,1,1,57,28,29,74,67,7,0
2021,Harrogate 013B,E01027651,604,268,116,152,2,2,291,225,66,43,32,11,0
2021,Harrogate 015A,E01027652,767,491,282,209,5,5,34,8,26,237,222,15,0
2021,Harrogate 020A,E01027653,778,526,321,205,16,16,145,9,136,91,78,13,0
2021,Harrogate 020B,E01027654,476,404,248,156,1,1,4,3,1,67,62,5,0
2021,Harrogate 015B,E01027655,574,403,268,135,0,0,47,5,42,124,110,14,0
2021,Harrogate 019A,E01027656,970,622,453,169,1,1,30,4,26,317,294,23,0
2021,Harrogate 013C,E01027657,596,309,116,193,9,9,35,17,18,243,224,19,0
2021,Harrogate 013D,E01027658,774,445,216,229,8,8,38,11,27,283,266,17,0
2021,Harrogate 015C,E01027659,965,361,166,195,1,1,87,13,74,516,484,32,0
2021,Harrogate 017A,E01027660,637,523,317,206,0,0,56,47,9,57,48,9,1
2021,Harrogate 017B,E01027661,618,480,272,208,2,2,80,14,66,56,45,11,0
2021,Harrogate 017C,E01027662,452,414,221,193,1,1,4,2,2,30,22,8,3
2021,Harrogate 017D,E01027663,625,510,306,204,11,11,8,4,4,95,82,13,1
2021,Harrogate 008C,E01027665,549,405,226,179,18,18,36,3,33,90,75,15,0
2021,Harrogate 001A,E01027666,747,558,366,192,6,6,45,36,9,137,100,37,1
2021,Harrogate 001B,E01027667,596,418,264,154,4,4,37,17,20,137,95,42,0
2021,Harrogate 009A,E01027668,713,487,290,197,9,9,67,24,43,149,130,19,1
2021,Harrogate 009B,E01027669,960,533,306,227,0,0,242,145,97,179,157,22,6
2021,Harrogate 012A,E01027670,665,575,348,227,5,5,7,2,5,78,67,11,0
2021,Harrogate 012B,E01027671,632,593,377,216,1,1,2,0,2,36,31,5,0
2021,Harrogate 012C,E01027672,683,622,386,236,2,2,6,4,2,53,48,5,0
2021,Harrogate 009C,E01027673,955,559,362,197,5,5,136,94,42,253,228,25,2
2021,Harrogate 007C,E01027674,545,492,291,201,2,2,10,2,8,41,28,13,0
2021,Harrogate 007D,E01027675,1175,966,516,450,36,36,88,10,78,85,72,13,0
2021,Harrogate 009D,E01027676,701,458,205,253,7,7,169,113,56,66,57,9,1
2021,Harrogate 015D,E01027677,753,409,240,169,2,2,34,7,27,308,290,18,0
2021,Harrogate 015E,E01027678,1020,224,104,120,6,6,148,9,139,642,595,47,0
2021,Harrogate 019B,E01027679,786,504,361,143,1,1,18,11,7,263,236,27,0
2021,Harrogate 015F,E01027680,764,345,226,119,1,1,42,18,24,376,355,21,0
2021,Harrogate 006A,E01027681,713,528,340,188,3,3,55,40,15,127,106,21,0
2021,Harrogate 018A,E01027682,706,572,376,196,3,3,15,6,9,116,96,20,0
2021,Harrogate 016A,E01027683,732,556,296,260,42,42,65,22,43,68,56,12,1
2021,Harrogate 016B,E01027684,583,436,239,197,1,1,56,27,29,90,71,19,0
2021,Harrogate 001C,E01027685,573,365,266,99,5,5,101,78,23,102,83,19,0
2021,Harrogate 001D,E01027686,463,323,216,107,1,1,11,2,9,128,100,28,0
2021,Harrogate 005D,E01027687,834,603,331,272,15,15,89,31,58,127,94,33,0
2021,Harrogate 003B,E01027688,710,526,344,182,1,1,64,59,5,117,87,30,2
2021,Harrogate 011A,E01027689,645,426,219,207,2,2,70,45,25,147,135,12,0
2021,Harrogate 010D,E01027690,637,519,304,215,2,2,24,3,21,92,71,21,0
2021,Harrogate 011B,E01027691,678,499,228,271,6,6,42,4,38,131,120,11,0
2021,Harrogate 013E,E01027692,562,265,125,140,3,3,92,28,64,200,188,12,2
2021,Harrogate 006B,E01027693,771,626,406,220,6,6,10,6,4,129,99,30,0
2021,Harrogate 018B,E01027694,495,381,222,159,4,4,42,32,10,67,55,12,1
2021,Harrogate 016C,E01027695,710,553,296,257,6,6,70,55,15,81,65,16,0
2021,Harrogate 016D,E01027696,669,526,288,238,11,11,47,13,34,85,65,20,0
2021,Harrogate 017E,E01027697,587,508,271,237,0,0,19,12,7,60,52,8,0
2021,Harrogate 020C,E01027698,636,542,328,214,1,1,9,2,7,84,74,10,0
2021,Harrogate 021A,E01027699,524,484,296,188,0,0,6,2,4,34,23,11,0
2021,Harrogate 021B,E01027700,585,489,279,210,4,4,39,18,21,53,47,6,0
2021,Harrogate 006C,E01027701,678,488,327,161,1,1,46,29,17,142,110,32,1
2021,Harrogate 006D,E01027702,517,321,225,96,3,3,92,74,18,100,81,19,1
2021,Harrogate 016E,E01027703,835,611,348,263,5,5,49,38,11,170,144,26,0
2021,Harrogate 012D,E01027704,532,427,281,146,2,2,27,18,9,76,55,21,0
2021,Harrogate 004A,E01027705,779,493,262,231,3,3,116,58,58,167,147,20,0
2021,Harrogate 004B,E01027706,959,469,300,169,3,3,210,131,79,276,258,18,1
2021,Harrogate 004C,E01027707,809,548,316,232,2,2,105,54,51,153,132,21,1
2021,Harrogate 004D,E01027708,593,497,335,162,1,1,21,16,5,74,65,9,0
2021,Harrogate 004E,E01027709,546,483,317,166,1,1,26,13,13,36,28,8,0
2021,Harrogate 004F,E01027710,501,254,159,95,1,1,185,140,45,59,48,11,2
2021,Harrogate 004G,E01027711,513,307,157,150,5,5,123,96,27,78,66,12,0
2021,Harrogate 002A,E01027712,593,435,235,200,18,18,48,3,45,92,65,27,0
2021,Harrogate 002B,E01027713,799,495,323,172,2,2,82,32,50,219,199,20,1
2021,Harrogate 002C,E01027714,772,530,365,165,6,6,82,37,45,152,139,13,2
2021,Harrogate 002D,E01027715,421,232,133,99,1,1,28,2,26,160,43,117,0
2021,Harrogate 020D,E01027716,612,554,339,215,1,1,8,3,5,49,36,13,0
2021,Harrogate 020E,E01027717,610,533,246,287,2,2,5,4,1,70,58,12,0
2021,Harrogate 020F,E01027718,812,605,346,259,31,31,68,6,62,108,95,13,0
2021,Harrogate 020G,E01027719,645,527,315,212,6,6,22,2,20,90,76,14,0
2021,Harrogate 011C,E01027720,824,479,187,292,25,25,180,88,92,134,120,14,6
2021,Harrogate 011D,E01027721,654,522,284,238,4,4,6,2,4,122,110,12,0
2021,Harrogate 008D,E01027722,597,490,205,285,6,6,11,2,9,90,79,11,0
2021,Harrogate 011E,E01027723,733,359,174,185,1,1,253,96,157,116,102,14,4
2021,Harrogate 021C,E01027724,697,576,329,247,1,1,54,42,12,66,51,15,0
2021,Harrogate 021D,E01027725,657,488,276,212,8,8,70,46,24,90,73,17,1
2021,Harrogate 014C,E01027726,758,515,248,267,18,18,82,3,79,143,127,16,0
2021,Harrogate 014D,E01027727,804,474,227,247,28,28,155,60,95,145,135,10,2
2021,Harrogate 014E,E01027728,612,511,313,198,3,3,34,27,7,64,51,13,0
2021,Harrogate 014F,E01027729,665,349,147,202,3,3,129,33,96,183,168,15,1
2021,Harrogate 019C,E01027730,696,458,265,193,5,5,31,4,27,202,190,12,0
2021,Harrogate 019D,E01027731,636,436,213,223,2,2,41,36,5,156,141,15,1
2021,Harrogate 019E,E01027732,544,408,246,162,0,0,16,4,12,120,106,14,0
2021,Harrogate 017F,E01027733,513,459,272,187,9,9,0,0,0,45,39,6,0
2021,Harrogate 018C,E01027734,708,581,348,233,12,12,32,15,17,83,60,23,0
2021,Harrogate 018D,E01027735,689,528,354,174,1,1,15,9,6,144,120,24,1
2021,Harrogate 003C,E01027736,706,470,248,222,3,3,63,54,9,170,132,38,0
2021,Harrogate 003D,E01027737,645,362,194,168,9,9,50,34,16,224,69,155,0
2021,Harrogate 010E,E01027738,580,423,194,229,5,5,19,11,8,133,117,16,0
2021,Harrogate 010F,E01027739,467,319,147,172,4,4,17,8,9,127,117,10,0
2021,Harrogate 013F,E01027740,944,228,135,93,12,12,614,547,67,74,55,19,16
2021,Harrogate 010G,E01027741,620,497,310,187,6,6,67,47,20,49,41,8,1
2021,Richmondshire 005A,E01027742,616,427,307,120,8,8,80,17,63,101,78,23,0
2021,Richmondshire 001A,E01027743,548,409,269,140,2,2,41,37,4,96,77,19,0
2021,Richmondshire 006A,E01027744,602,412,307,105,3,3,28,17,11,159,129,30,0
2021,Richmondshire 003A,E01027745,651,463,239,224,3,3,72,48,24,113,92,21,0
2021,Richmondshire 003B,E01027746,662,468,272,196,1,1,88,43,45,102,87,15,3
2021,Richmondshire 003C,E01027747,528,305,163,142,4,4,66,15,51,153,54,99,0
2021,Richmondshire 003D,E01027748,543,399,258,141,3,3,64,49,15,76,58,18,1
2021,Richmondshire 004A,E01027749,835,367,150,217,0,0,365,312,53,99,85,14,4
2021,Richmondshire 001B,E01027751,546,427,260,167,1,1,24,21,3,94,70,24,0
2021,Richmondshire 001C,E01027752,550,337,234,103,0,0,44,23,21,169,131,38,0
2021,Richmondshire 005B,E01027753,577,430,333,97,2,2,35,18,17,110,76,34,0
2021,Richmondshire 006B,E01027756,752,504,292,212,8,8,107,30,77,132,80,52,1
2021,Richmondshire 006D,E01027758,607,436,295,141,3,3,25,20,5,142,109,33,1
2021,Richmondshire 001D,E01027759,635,463,279,184,0,0,54,50,4,117,85,32,1
2021,Richmondshire 006E,E01027760,570,362,270,92,1,1,57,44,13,150,103,47,0
2021,Richmondshire 001E,E01027761,528,426,302,124,1,1,19,17,2,81,60,21,1
2021,Richmondshire 001F,E01027762,593,416,280,136,3,3,43,28,15,130,90,40,1
2021,Richmondshire 005C,E01027763,520,373,288,85,3,3,26,9,17,118,85,33,0
2021,Richmondshire 005D,E01027764,537,362,280,82,3,3,49,35,14,121,91,30,2
2021,Richmondshire 002A,E01027765,683,480,285,195,20,20,89,58,31,94,73,21,0
2021,Richmondshire 002B,E01027766,609,332,205,127,6,6,155,100,55,112,96,16,4
2021,Richmondshire 002C,E01027767,628,509,338,171,4,4,38,27,11,76,58,18,1
2021,Richmondshire 002D,E01027768,504,434,298,136,3,3,8,3,5,59,42,17,0
2021,Richmondshire 002E,E01027769,594,363,252,111,1,1,150,130,20,79,65,14,1
2021,Richmondshire 002F,E01027770,859,462,322,140,2,2,130,58,72,265,230,35,0
2021,Richmondshire 004E,E01027771,425,88,45,43,2,2,36,12,24,299,41,258,0
2021,Richmondshire 004F,E01027772,558,429,223,206,1,1,10,7,3,118,107,11,0
2021,Richmondshire 005E,E01027773,517,385,287,98,2,2,22,12,10,108,65,43,0
2021,Ryedale 007A,E01027774,813,610,394,216,4,4,58,8,50,141,107,34,0
2021,Ryedale 003A,E01027775,702,507,344,163,1,1,69,8,61,125,91,34,0
2021,Ryedale 001A,E01027776,687,559,405,154,1,1,21,2,19,106,79,27,0
2021,Ryedale 001B,E01027777,617,441,324,117,4,4,15,1,14,157,112,45,0
2021,Ryedale 007B,E01027778,1013,667,406,261,1,1,96,10,86,249,203,46,0
2021,Ryedale 004A,E01027779,486,245,160,85,1,1,53,4,49,186,151,35,1
2021,Ryedale 003B,E01027780,975,551,369,182,23,23,92,9,83,309,234,75,0
2021,Ryedale 003C,E01027781,670,408,323,85,12,12,129,11,118,120,95,25,1
2021,Ryedale 007C,E01027782,807,535,355,180,5,5,72,6,66,195,159,36,0
2021,Ryedale 001C,E01027783,886,643,488,155,3,3,31,3,28,209,165,44,0
2021,Ryedale 001D,E01027784,786,436,297,139,1,1,188,19,169,161,139,22,0
2021,Ryedale 010A,E01027786,728,620,457,163,2,2,11,1,10,95,80,15,0
2021,Ryedale 009A,E01027787,824,396,248,148,26,26,267,35,232,134,109,25,1
2021,Ryedale 010B,E01027788,748,521,340,181,3,3,150,17,133,74,61,13,0
2021,Ryedale 010D,E01027790,860,513,281,232,3,3,77,13,64,267,237,30,0
2021,Ryedale 010C,E01027791,720,597,374,223,2,2,32,6,26,89,77,12,0
2021,Ryedale 002A,E01027792,1137,846,620,226,10,10,84,5,79,197,168,29,0
2021,Ryedale 002B,E01027793,680,422,286,136,1,1,177,22,155,80,66,14,0
2021,Ryedale 002C,E01027794,900,729,534,195,9,9,56,5,51,106,92,14,0
2021,Ryedale 002D,E01027795,771,423,258,165,2,2,224,30,194,121,105,16,1
2021,Ryedale 004B,E01027796,819,514,340,174,3,3,134,9,125,168,147,21,0
2021,Ryedale 007D,E01027797,714,491,306,185,4,4,44,2,42,175,156,19,0
2021,Ryedale 004C,E01027798,865,541,322,219,2,2,136,11,125,186,149,37,0
2021,Ryedale 007E,E01027799,790,614,413,201,5,5,72,5,67,99,70,29,0
2021,Ryedale 003D,E01027800,772,589,415,174,1,1,34,1,33,148,111,37,0
2021,Ryedale 002E,E01027801,806,624,469,155,15,15,59,1,58,108,85,23,0
2021,Ryedale 002F,E01027802,728,551,385,166,0,0,26,4,22,151,113,38,0
2021,Ryedale 004D,E01027803,779,502,309,193,3,3,92,12,80,182,143,39,0
2021,Scarborough 010A,E01027804,905,224,145,79,1,1,80,16,64,600,565,35,0
2021,Scarborough 006A,E01027805,714,306,210,96,2,2,213,37,176,192,167,25,1
2021,Scarborough 006B,E01027806,919,165,90,75,1,1,248,31,217,502,464,38,3
2021,Scarborough 011A,E01027807,703,511,321,190,3,3,90,11,79,99,82,17,0
2021,Scarborough 011B,E01027808,756,656,415,241,3,3,15,1,14,82,73,9,0
2021,Scarborough 011C,E01027809,646,578,419,159,2,2,13,0,13,53,39,14,0
2021,Scarborough 008A,E01027810,650,396,202,194,0,0,3,0,3,251,235,16,0
2021,Scarborough 008B,E01027811,668,405,201,204,1,1,29,1,28,233,220,13,0
2021,Scarborough 008C,E01027812,780,319,163,156,3,3,67,5,62,391,362,29,0
2021,Scarborough 002A,E01027813,836,591,426,165,11,11,81,8,73,153,113,40,0
2021,Scarborough 013A,E01027814,737,498,342,156,17,17,61,5,56,161,140,21,0
2021,Scarborough 013B,E01027815,611,474,314,160,2,2,40,8,32,95,72,23,0
2021,Scarborough 013C,E01027816,741,628,400,228,6,6,56,6,50,51,43,8,0
2021,Scarborough 012A,E01027817,646,257,132,125,1,1,331,65,266,57,50,7,0
2021,Scarborough 011D,E01027818,890,540,249,291,24,24,194,19,175,132,116,16,0
2021,Scarborough 012B,E01027819,911,366,124,242,44,44,434,89,345,67,53,14,0
2021,Scarborough 012C,E01027820,529,210,86,124,0,0,228,64,164,91,78,13,0
2021,Scarborough 004A,E01027821,660,552,407,145,5,5,26,3,23,77,53,24,0
2021,Scarborough 002B,E01027822,611,438,302,136,4,4,51,6,45,118,96,22,0
2021,Scarborough 004B,E01027823,671,493,347,146,2,2,122,32,90,54,46,8,0
2021,Scarborough 009A,E01027824,775,379,265,114,6,6,297,34,263,91,75,16,2
2021,Scarborough 009B,E01027825,926,443,154,289,1,1,205,49,156,277,254,23,0
2021,Scarborough 009C,E01027826,659,424,217,207,1,1,46,4,42,188,172,16,0
2021,Scarborough 014A,E01027827,815,437,352,85,12,12,67,11,56,297,270,27,2
2021,Scarborough 014B,E01027828,975,694,556,138,45,45,157,31,126,78,64,14,1
2021,Scarborough 014C,E01027829,745,601,499,102,1,1,33,7,26,110,90,20,0
2021,Scarborough 014D,E01027830,741,441,270,171,6,6,167,31,136,127,109,18,0
2021,Scarborough 014E,E01027833,724,526,391,135,3,3,94,18,76,101,79,22,0
2021,Scarborough 014F,E01027834,748,629,454,175,1,1,14,1,13,104,87,17,0
2021,Scarborough 014G,E01027835,777,581,381,200,1,1,72,8,64,123,94,29,0
2021,Scarborough 004E,E01027836,996,781,504,277,10,10,66,12,54,139,121,18,0
2021,Scarborough 001A,E01027837,655,283,189,94,2,2,308,56,252,58,48,10,4
2021,Scarborough 003A,E01027838,721,603,421,182,8,8,33,3,30,77,62,15,0
2021,Scarborough 001B,E01027839,840,617,382,235,25,25,87,15,72,111,82,29,0
2021,Scarborough 002C,E01027840,943,626,444,182,8,8,181,50,131,128,99,29,0
2021,Scarborough 002D,E01027841,581,366,278,88,0,0,27,2,25,188,161,27,0
2021,Scarborough 005A,E01027842,722,565,377,188,1,1,90,26,64,66,52,14,0
2021,Scarborough 005B,E01027843,635,408,210,198,3,3,134,24,110,87,71,16,3
2021,Scarborough 005C,E01027844,659,607,404,203,0,0,17,1,16,35,29,6,0
2021,Scarborough 005D,E01027845,709,609,382,227,1,1,14,4,10,85,72,13,0
2021,Scarborough 006D,E01027847,1007,299,194,105,3,3,109,16,93,596,570,26,0
2021,Scarborough 007A,E01027849,516,412,290,122,1,1,10,3,7,93,78,15,0
2021,Scarborough 007B,E01027850,605,326,175,151,4,4,181,50,131,94,77,17,0
2021,Scarborough 008D,E01027851,631,478,272,206,3,3,8,0,8,142,135,7,0
2021,Scarborough 010B,E01027852,886,314,207,107,3,3,43,9,34,526,495,31,0
2021,Scarborough 010C,E01027853,620,353,254,99,0,0,43,3,40,224,206,18,0
2021,Scarborough 010D,E01027854,835,306,229,77,3,3,25,5,20,501,472,29,0
2021,Scarborough 005E,E01027855,824,691,479,212,28,28,38,11,27,67,52,15,0
2021,Scarborough 005F,E01027856,658,450,350,100,40,40,113,17,96,55,46,9,0
2021,Scarborough 004F,E01027857,550,434,297,137,3,3,6,1,5,107,83,24,0
2021,Scarborough 012D,E01027858,622,568,360,208,0,0,5,0,5,49,44,5,0
2021,Scarborough 013D,E01027859,766,652,384,268,8,8,11,1,10,95,71,24,0
2021,Scarborough 012E,E01027860,671,498,283,215,28,28,86,14,72,59,48,11,0
2021,Scarborough 009D,E01027861,671,421,260,161,2,2,64,15,49,184,171,13,0
2021,Scarborough 008E,E01027862,799,389,218,171,1,1,69,6,63,340,303,37,0
2021,Scarborough 009E,E01027863,649,523,380,143,2,2,59,2,57,65,55,10,0
2021,Scarborough 003B,E01027864,616,284,164,120,2,2,258,66,192,72,51,21,0
2021,Scarborough 003C,E01027865,609,336,237,99,1,1,97,16,81,175,155,20,0
2021,Scarborough 003D,E01027866,876,563,343,220,20,20,207,19,188,86,69,17,0
2021,Scarborough 011E,E01027867,663,584,386,198,3,3,21,1,20,55,45,10,0
2021,Scarborough 010E,E01027868,1161,763,616,147,4,4,58,1,57,336,306,30,0
2021,Scarborough 001E,E01027871,719,527,372,155,5,5,86,16,70,101,88,13,0
2021,Scarborough 007C,E01027872,606,345,193,152,4,4,215,41,174,39,31,8,3
2021,Scarborough 009F,E01027873,701,483,331,152,26,26,94,7,87,98,78,20,0
2021,Scarborough 007D,E01027874,655,192,96,96,0,0,396,97,299,67,58,9,0
2021,Selby 002A,E01027875,767,611,338,273,4,4,23,12,11,129,99,30,0
2021,Selby 003A,E01027876,683,582,274,308,9,9,22,19,3,70,58,12,0
2021,Selby 003B,E01027877,809,640,244,396,6,6,93,64,29,70,63,7,0
2021,Selby 005A,E01027878,557,350,165,185,1,1,84,8,76,122,113,9,0
2021,Selby 007A,E01027879,562,475,283,192,1,1,5,4,1,81,69,12,0
2021,Selby 007B,E01027880,625,567,360,207,0,0,19,11,8,39,31,8,0
2021,Selby 006A,E01027881,825,520,270,250,39,39,207,67,140,57,42,15,2
2021,Selby 007C,E01027882,734,667,361,306,1,1,11,7,4,55,40,15,0
2021,Selby 008A,E01027883,446,363,210,153,2,2,29,19,10,52,42,10,0
2021,Selby 008B,E01027884,681,528,231,297,2,2,30,22,8,121,102,19,0
2021,Selby 008C,E01027885,758,608,293,315,12,12,61,41,20,77,67,10,0
2021,Selby 002B,E01027886,601,467,235,232,5,5,52,28,24,77,66,11,0
2021,Selby 002C,E01027887,688,569,328,241,0,0,25,15,10,94,78,16,0
2021,Selby 002D,E01027888,786,602,282,320,14,14,69,45,24,100,77,23,1
2021,Selby 010A,E01027889,775,545,276,269,2,2,102,88,14,125,99,26,1
2021,Selby 010B,E01027890,994,805,392,413,6,6,96,26,70,87,76,11,0
2021,Selby 009A,E01027891,778,629,368,261,3,3,70,44,26,76,61,15,0
2021,Selby 009B,E01027892,859,544,292,252,2,2,179,171,8,133,114,19,1
2021,Selby 009C,E01027893,931,780,427,353,19,19,66,27,39,64,54,10,2
2021,Selby 007D,E01027894,1157,896,421,475,37,37,139,21,118,85,76,9,0
2021,Selby 007E,E01027895,684,574,357,217,20,20,30,12,18,60,41,19,0
2021,Selby 008D,E01027896,825,670,321,349,2,2,65,41,24,87,75,12,1
2021,Selby 008E,E01027897,921,794,415,379,2,2,15,9,6,110,87,23,0
2021,Selby 009D,E01027899,715,599,316,283,0,0,50,31,19,66,54,12,0
2021,Selby 003C,E01027900,811,653,335,318,1,1,43,33,10,114,90,24,0
2021,Selby 003D,E01027901,740,643,365,278,8,8,19,9,10,70,59,11,0
2021,Selby 003E,E01027902,618,440,233,207,0,0,99,65,34,76,64,12,3
2021,Selby 003F,E01027903,441,355,207,148,2,2,13,4,9,71,65,6,0
2021,Selby 002E,E01027904,1014,792,402,390,10,10,83,61,22,129,110,19,0
2021,Selby 006B,E01027906,659,396,200,196,12,12,168,130,38,79,73,6,4
2021,Selby 005C,E01027907,568,174,65,109,0,0,335,243,92,55,43,12,4
2021,Selby 005D,E01027908,834,240,106,134,4,4,256,121,135,331,315,16,3
2021,Selby 005E,E01027909,1084,392,192,200,3,3,257,137,120,431,403,28,1
2021,Selby 006E,E01027913,504,464,268,196,0,0,5,4,1,35,23,12,0
2021,Selby 004B,E01027914,700,608,359,249,3,3,7,4,3,82,65,17,0
2021,Selby 004C,E01027915,918,610,268,342,10,10,194,136,58,102,81,21,2
2021,Selby 004D,E01027916,721,435,205,230,6,6,191,166,25,88,76,12,1
2021,Selby 001A,E01027918,660,388,199,189,1,1,128,122,6,141,129,12,2
2021,Selby 001B,E01027919,525,353,167,186,0,0,33,28,5,138,121,17,1
2021,Selby 001C,E01027920,489,394,241,153,1,1,49,47,2,45,35,10,0
2021,Selby 001D,E01027921,908,516,306,210,3,3,284,231,53,100,90,10,5
2021,Selby 001E,E01027922,825,667,345,322,8,8,72,39,33,78,62,16,0
2021,Selby 010C,E01027923,1000,798,469,329,2,2,92,73,19,106,87,19,2
2021,Selby 010D,E01027924,917,770,373,397,16,16,37,23,14,94,77,17,0
2021,Ashfield 015A,E01027925,858,711,358,353,5,5,82,37,45,60,45,15,0
2021,Ashfield 016A,E01027926,676,535,330,205,3,3,32,8,24,106,97,9,0
2021,Ashfield 014A,E01027927,993,563,260,303,4,4,252,178,74,173,158,15,1
2021,Ashfield 014B,E01027928,964,504,236,268,7,7,88,49,39,364,333,31,1
2021,Ashfield 016B,E01027930,797,400,162,238,3,3,294,231,63,95,86,9,5
2021,Ashfield 014C,E01027932,968,555,273,282,0,0,101,46,55,312,298,14,0
2021,Ashfield 014D,E01027933,688,381,196,185,0,0,54,43,11,253,240,13,0
2021,Ashfield 013C,E01027934,568,470,247,223,0,0,16,13,3,81,75,6,1
2021,Ashfield 013D,E01027935,501,394,177,217,0,0,46,39,7,61,57,4,0
2021,Ashfield 013E,E01027936,648,611,398,213,0,0,7,5,2,30,23,7,0
2021,Ashfield 014E,E01027937,662,307,145,162,3,3,174,136,38,172,149,23,6
2021,Ashfield 015B,E01027938,501,462,246,216,1,1,5,3,2,33,30,3,0
2021,Ashfield 016C,E01027939,602,225,102,123,2,2,306,293,13,65,57,8,4
2021,Ashfield 015C,E01027940,562,502,294,208,2,2,3,1,2,55,48,7,0
2021,Ashfield 016D,E01027941,578,416,250,166,0,0,90,56,34,72,62,10,0
2021,Ashfield 016E,E01027942,1055,760,217,543,13,13,155,111,44,125,114,11,2
2021,Ashfield 015D,E01027943,623,477,282,195,0,0,19,16,3,127,107,20,0
2021,Ashfield 015E,E01027944,647,584,364,220,1,1,4,4,0,58,48,10,0
2021,Ashfield 012A,E01027945,754,544,308,236,2,2,53,11,42,155,131,24,0
2021,Ashfield 012B,E01027946,625,484,281,203,1,1,79,72,7,61,48,13,0
2021,Ashfield 009A,E01027947,707,547,304,243,3,3,39,8,31,118,97,21,0
2021,Ashfield 009B,E01027948,939,726,366,360,6,6,27,10,17,180,162,18,0
2021,Ashfield 007A,E01027949,649,502,299,203,1,1,15,12,3,131,112,19,0
2021,Ashfield 009C,E01027950,1053,724,377,347,4,4,158,135,23,167,148,19,0
2021,Ashfield 007B,E01027951,658,241,155,86,0,0,317,311,6,97,88,9,3
2021,Ashfield 008A,E01027952,815,351,177,174,3,3,249,194,55,207,187,20,5
2021,Ashfield 007C,E01027953,640,526,330,196,3,3,50,42,8,58,50,8,3
2021,Ashfield 007D,E01027954,677,400,185,215,2,2,110,6,104,164,149,15,1
2021,Ashfield 008B,E01027955,544,305,162,143,0,0,35,29,6,204,183,21,0
2021,Ashfield 008C,E01027956,665,296,158,138,0,0,307,246,61,53,45,8,9
2021,Ashfield 009D,E01027957,534,409,226,183,1,1,58,57,1,66,50,16,0
2021,Ashfield 008D,E01027958,600,319,141,178,0,0,181,150,31,93,76,17,7
2021,Ashfield 009E,E01027959,746,687,248,439,2,2,3,3,0,54,43,11,0
2021,Ashfield 011A,E01027960,735,492,314,178,1,1,129,106,23,112,93,19,1
2021,Ashfield 011B,E01027961,814,700,429,271,3,3,22,16,6,89,77,12,0
2021,Ashfield 011C,E01027962,643,533,269,264,5,5,34,27,7,71,57,14,0
2021,Ashfield 011D,E01027963,641,400,213,187,3,3,173,169,4,62,55,7,3
2021,Ashfield 005A,E01027964,599,351,177,174,1,1,140,135,5,106,92,14,1
2021,Ashfield 005B,E01027965,558,220,107,113,1,1,212,191,21,120,107,13,5
2021,Ashfield 003A,E01027966,625,238,126,112,3,3,318,292,26,60,46,14,6
2021,Ashfield 004A,E01027967,782,350,191,159,1,1,78,55,23,353,331,22,0
2021,Ashfield 005C,E01027968,574,218,133,85,2,2,243,190,53,105,98,7,6
2021,Ashfield 006A,E01027969,576,390,217,173,1,1,60,45,15,124,108,16,1
2021,Ashfield 002A,E01027970,608,496,294,202,2,2,7,6,1,103,92,11,0
2021,Ashfield 002B,E01027971,590,521,325,196,1,1,5,2,3,63,51,12,0
2021,Ashfield 004B,E01027972,947,701,332,369,5,5,123,99,24,118,102,16,0
2021,Ashfield 007E,E01027973,640,587,335,252,1,1,7,2,5,44,37,7,1
2021,Ashfield 005D,E01027974,642,213,97,116,10,10,331,285,46,83,79,4,5
2021,Ashfield 006B,E01027975,699,450,245,205,6,6,92,56,36,151,139,12,0
2021,Ashfield 005E,E01027976,902,380,186,194,8,8,317,291,26,193,173,20,4
2021,Ashfield 004C,E01027977,864,471,229,242,1,1,201,112,89,184,159,25,7
2021,Ashfield 004D,E01027978,858,276,140,136,7,7,178,46,132,396,374,22,1
2021,Ashfield 001A,E01027979,742,609,418,191,2,2,25,19,6,106,90,16,0
2021,Ashfield 001B,E01027980,653,356,171,185,0,0,219,191,28,75,65,10,3
2021,Ashfield 001C,E01027981,730,620,408,212,1,1,42,19,23,66,59,7,1
2021,Ashfield 002C,E01027982,659,461,298,163,3,3,88,84,4,107,88,19,0
2021,Ashfield 001D,E01027983,667,363,194,169,1,1,97,53,44,206,193,13,0
2021,Ashfield 002D,E01027984,637,507,287,220,2,2,45,44,1,82,73,9,1
2021,Ashfield 004E,E01027985,867,570,227,343,3,3,80,68,12,212,196,16,2
2021,Ashfield 003B,E01027986,652,358,219,139,0,0,163,142,21,128,111,17,3
2021,Ashfield 003C,E01027987,916,495,195,300,1,1,229,128,101,188,175,13,3
2021,Ashfield 006C,E01027988,661,519,340,179,0,0,11,8,3,131,117,14,0
2021,Ashfield 006D,E01027989,732,563,415,148,8,8,56,41,15,105,97,8,0
2021,Ashfield 003D,E01027990,783,630,319,311,1,1,23,17,6,129,117,12,0
2021,Ashfield 006E,E01027991,515,356,204,152,2,2,115,83,32,42,39,3,0
2021,Ashfield 006F,E01027992,1016,865,329,536,21,21,25,3,22,105,90,15,0
2021,Ashfield 012C,E01027993,656,572,338,234,2,2,5,5,0,77,58,19,0
2021,Ashfield 012D,E01027994,653,502,322,180,7,7,60,45,15,83,70,13,1
2021,Ashfield 010A,E01027995,667,585,353,232,1,1,14,5,9,67,56,11,0
2021,Ashfield 010B,E01027996,863,547,274,273,3,3,209,191,18,101,89,12,3
2021,Ashfield 010C,E01027997,1032,896,434,462,3,3,19,4,15,114,102,12,0
2021,Ashfield 010D,E01027998,835,640,396,244,1,1,38,31,7,156,139,17,0
2021,Bassetlaw 002A,E01027999,1074,838,522,316,3,3,126,85,41,106,84,22,1
2021,Bassetlaw 001A,E01028000,1036,802,495,307,1,1,57,50,7,176,150,26,0
2021,Bassetlaw 004A,E01028001,585,225,109,116,1,1,300,285,15,56,50,6,3
2021,Bassetlaw 004B,E01028002,609,531,343,188,0,0,26,19,7,52,43,9,0
2021,Bassetlaw 004C,E01028003,649,486,265,221,11,11,80,76,4,69,58,11,3
2021,Bassetlaw 004D,E01028004,705,613,400,213,3,3,18,17,1,71,51,20,0
2021,Bassetlaw 002B,E01028005,823,677,447,230,2,2,52,34,18,92,64,28,0
2021,Bassetlaw 015A,E01028006,551,408,269,139,1,1,63,55,8,79,56,23,0
2021,Bassetlaw 015B,E01028007,502,434,246,188,1,1,19,6,13,48,34,14,0
2021,Bassetlaw 008A,E01028008,504,236,138,98,2,2,193,178,15,72,66,6,1
2021,Bassetlaw 008B,E01028009,633,568,420,148,2,2,6,3,3,57,43,14,0
2021,Bassetlaw 008C,E01028010,684,604,343,261,8,8,15,3,12,57,51,6,0
2021,Bassetlaw 008D,E01028011,847,369,230,139,0,0,258,230,28,216,198,18,4
2021,Bassetlaw 008E,E01028012,643,426,237,189,0,0,55,52,3,162,147,15,0
2021,Bassetlaw 005A,E01028013,880,623,373,250,1,1,128,108,20,125,110,15,3
2021,Bassetlaw 005B,E01028014,750,331,169,162,2,2,333,288,45,80,71,9,4
2021,Bassetlaw 005C,E01028015,707,574,309,265,1,1,35,33,2,97,86,11,0
2021,Bassetlaw 005D,E01028016,658,500,342,158,2,2,73,63,10,83,71,12,0
2021,Bassetlaw 010A,E01028017,1075,634,222,412,19,19,286,213,73,132,117,15,4
2021,Bassetlaw 010B,E01028018,639,499,324,175,2,2,52,45,7,86,75,11,0
2021,Bassetlaw 010C,E01028019,630,355,172,183,3,3,182,173,9,89,79,10,1
2021,Bassetlaw 010D,E01028020,908,362,181,181,4,4,119,20,99,423,398,25,0
2021,Bassetlaw 010E,E01028021,772,605,315,290,2,2,75,16,59,89,77,12,1
2021,Bassetlaw 008F,E01028022,743,460,228,232,0,0,109,30,79,172,154,18,2
2021,Bassetlaw 003A,E01028023,1071,835,487,348,8,8,89,75,14,138,115,23,1
2021,Bassetlaw 001B,E01028024,913,677,341,336,7,7,116,89,27,112,96,16,1
2021,Bassetlaw 001C,E01028025,626,414,207,207,1,1,66,37,29,144,128,16,1
2021,Bassetlaw 001D,E01028026,681,385,203,182,4,4,200,176,24,91,80,11,1
2021,Bassetlaw 001E,E01028027,732,501,287,214,5,5,104,45,59,119,109,10,3
2021,Bassetlaw 001F,E01028028,979,591,237,354,4,4,271,211,60,108,103,5,5
2021,Bassetlaw 004E,E01028029,627,377,176,201,2,2,145,129,16,103,85,18,0
2021,Bassetlaw 004F,E01028030,497,378,194,184,1,1,46,45,1,72,55,17,0
2021,Bassetlaw 002C,E01028031,522,363,196,167,0,0,106,98,8,53,47,6,0
2021,Bassetlaw 002D,E01028032,590,498,291,207,6,6,25,18,7,61,48,13,0
2021,Bassetlaw 015C,E01028033,891,714,430,284,2,2,46,33,13,129,77,52,0
2021,Bassetlaw 003B,E01028034,1060,827,498,329,5,5,136,117,19,92,75,17,0
2021,Bassetlaw 002E,E01028035,1017,807,467,340,9,9,71,44,27,130,100,30,0
2021,Bassetlaw 003C,E01028036,898,694,451,243,2,2,38,38,0,164,119,45,0
2021,Bassetlaw 015D,E01028037,769,570,327,243,6,6,31,23,8,162,135,27,0
2021,Bassetlaw 015E,E01028038,661,410,230,180,0,0,171,159,12,76,66,10,4
2021,Bassetlaw 015F,E01028039,569,472,324,148,7,7,31,21,10,58,41,17,1
2021,Bassetlaw 016E,E01028042,597,471,260,211,0,0,37,31,6,89,71,18,0
2021,Bassetlaw 014C,E01028043,621,491,293,198,0,0,32,32,0,97,75,22,1
2021,Bassetlaw 016F,E01028044,790,333,166,167,3,3,354,333,21,97,84,13,3
2021,Bassetlaw 016G,E01028045,855,506,257,249,5,5,245,232,13,97,83,14,2
2021,Bassetlaw 006A,E01028046,689,515,288,227,6,6,21,15,6,147,131,16,0
2021,Bassetlaw 006B,E01028047,1046,929,258,671,2,2,15,4,11,100,89,11,0
2021,Bassetlaw 006C,E01028048,622,539,235,304,0,0,30,29,1,53,47,6,0
2021,Bassetlaw 006D,E01028049,769,468,222,246,1,1,206,160,46,94,76,18,0
2021,Bassetlaw 006E,E01028050,760,589,279,310,4,4,29,17,12,136,126,10,2
2021,Bassetlaw 016A,E01028051,730,513,329,184,2,2,114,111,3,100,83,17,1
2021,Bassetlaw 016B,E01028052,695,625,376,249,1,1,12,10,2,57,48,9,0
2021,Bassetlaw 016C,E01028053,797,363,236,127,3,3,287,262,25,138,119,19,6
2021,Bassetlaw 016D,E01028054,571,519,299,220,1,1,6,4,2,45,37,8,0
2021,Bassetlaw 009A,E01028055,847,271,151,120,4,4,303,238,65,264,245,19,5
2021,Bassetlaw 009B,E01028056,615,416,237,179,2,2,99,81,18,97,86,11,1
2021,Bassetlaw 012A,E01028057,631,262,142,120,3,3,46,15,31,320,296,24,0
2021,Bassetlaw 009C,E01028058,899,744,329,415,8,8,52,38,14,95,85,10,0
2021,Bassetlaw 009D,E01028059,652,571,230,341,1,1,4,2,2,76,72,4,0
2021,Bassetlaw 013A,E01028060,828,720,434,286,5,5,25,7,18,78,60,18,0
2021,Bassetlaw 013B,E01028061,629,530,298,232,1,1,4,3,1,94,80,14,0
2021,Bassetlaw 013C,E01028062,1026,477,294,183,2,2,93,27,66,454,422,32,0
2021,Bassetlaw 014D,E01028063,744,663,408,255,1,1,6,4,2,74,49,25,0
2021,Bassetlaw 014E,E01028064,524,332,179,153,1,1,125,98,27,66,53,13,0
2021,Bassetlaw 012B,E01028065,738,182,84,98,3,3,409,306,103,141,128,13,3
2021,Bassetlaw 012C,E01028066,698,261,113,148,1,1,292,277,15,142,132,10,2
2021,Bassetlaw 013D,E01028067,645,381,185,196,2,2,168,157,11,94,79,15,0
2021,Bassetlaw 012D,E01028068,880,314,155,159,20,20,194,119,75,350,335,15,2
2021,Broxtowe 014A,E01028069,517,432,240,192,0,0,2,2,0,83,78,5,0
2021,Broxtowe 014B,E01028070,481,448,297,151,1,1,3,1,2,29,24,5,0
2021,Broxtowe 011A,E01028073,811,320,196,124,3,3,221,197,24,263,246,17,4
2021,Broxtowe 011B,E01028074,833,326,169,157,4,4,187,136,51,313,301,12,3
2021,Broxtowe 011C,E01028075,710,290,162,128,5,5,63,38,25,351,335,16,1
2021,Broxtowe 009A,E01028076,609,364,221,143,0,0,95,29,66,149,132,17,1
2021,Broxtowe 009B,E01028077,593,273,123,150,0,0,191,135,56,129,120,9,0
2021,Broxtowe 009C,E01028078,636,345,171,174,1,1,118,103,15,171,160,11,1
2021,Broxtowe 009D,E01028079,535,297,166,131,0,0,13,10,3,225,214,11,0
2021,Broxtowe 012A,E01028080,824,502,239,263,8,8,64,30,34,250,240,10,0
2021,Broxtowe 012B,E01028081,557,368,231,137,4,4,43,38,5,142,128,14,0
2021,Broxtowe 012C,E01028082,512,434,228,206,0,0,4,2,2,74,72,2,0
2021,Broxtowe 012D,E01028083,639,260,132,128,0,0,163,48,115,216,207,9,0
2021,Broxtowe 009E,E01028084,742,628,361,267,2,2,3,2,1,109,98,11,0
2021,Broxtowe 011D,E01028085,941,478,268,210,0,0,98,44,54,365,335,30,0
2021,Broxtowe 011E,E01028086,753,479,247,232,0,0,37,26,11,236,219,17,1
2021,Broxtowe 007A,E01028087,713,606,403,203,0,0,3,3,0,104,96,8,0
2021,Broxtowe 007B,E01028088,628,548,349,199,0,0,3,1,2,77,69,8,0
2021,Broxtowe 007C,E01028089,536,491,306,185,0,0,3,3,0,42,34,8,0
2021,Broxtowe 007D,E01028090,625,424,224,200,1,1,139,132,7,59,41,18,2
2021,Broxtowe 007E,E01028091,620,544,329,215,1,1,4,1,3,70,61,9,1
2021,Broxtowe 001A,E01028092,519,388,207,181,5,5,75,59,16,51,44,7,0
2021,Broxtowe 001B,E01028093,462,421,276,145,0,0,0,0,0,41,32,9,0
2021,Broxtowe 014C,E01028094,739,545,295,250,2,2,86,66,20,105,91,14,1
2021,Broxtowe 014D,E01028095,622,460,253,207,0,0,86,77,9,73,66,7,3
2021,Broxtowe 014E,E01028096,852,676,411,265,3,3,30,10,20,143,135,8,0
2021,Broxtowe 013A,E01028097,616,566,387,179,1,1,3,3,0,46,39,7,0
2021,Broxtowe 013B,E01028098,676,257,127,130,0,0,242,223,19,172,53,119,5
2021,Broxtowe 013C,E01028099,625,524,293,231,1,1,29,27,2,71,60,11,0
2021,Broxtowe 013D,E01028100,790,576,333,243,1,1,121,115,6,89,75,14,3
2021,Broxtowe 013E,E01028101,649,287,128,159,2,2,265,256,9,92,76,16,3
2021,Broxtowe 004A,E01028102,591,449,247,202,2,2,37,35,2,103,82,21,0
2021,Broxtowe 004B,E01028103,546,311,176,135,2,2,170,77,93,62,56,6,1
2021,Broxtowe 004C,E01028104,701,599,303,296,0,0,28,18,10,74,62,12,0
2021,Broxtowe 016A,E01028105,514,392,208,184,0,0,50,40,10,72,59,13,0
2021,Broxtowe 016B,E01028106,662,516,317,199,3,3,35,13,22,108,93,15,0
2021,Broxtowe 001C,E01028107,638,549,306,243,2,2,26,22,4,61,54,7,0
2021,Broxtowe 001D,E01028108,663,561,350,211,1,1,18,18,0,83,68,15,0
2021,Broxtowe 003A,E01028109,789,565,349,216,3,3,109,64,45,111,92,19,1
2021,Broxtowe 002A,E01028110,681,305,140,165,7,7,276,184,92,90,87,3,3
2021,Broxtowe 002B,E01028111,687,468,286,182,9,9,109,61,48,101,85,16,0
2021,Broxtowe 002C,E01028112,799,403,223,180,24,24,178,133,45,191,167,24,3
2021,Broxtowe 002D,E01028113,619,314,155,159,1,1,234,203,31,66,58,8,4
2021,Broxtowe 001E,E01028114,678,479,279,200,0,0,39,6,33,160,145,15,0
2021,Broxtowe 003B,E01028115,729,657,399,258,1,1,10,1,9,61,52,9,0
2021,Broxtowe 003C,E01028116,783,636,303,333,3,3,42,7,35,102,90,12,0
2021,Broxtowe 003D,E01028117,635,559,261,298,1,1,17,2,15,58,51,7,0
2021,Broxtowe 003E,E01028118,775,693,491,202,0,0,29,28,1,53,40,13,0
2021,Broxtowe 016C,E01028119,788,617,287,330,1,1,4,1,3,166,153,13,0
2021,Broxtowe 016D,E01028120,655,609,359,250,0,0,4,3,1,42,34,8,0
2021,Broxtowe 016E,E01028121,585,502,282,220,0,0,5,2,3,78,71,7,0
2021,Broxtowe 004D,E01028122,740,413,201,212,4,4,233,227,6,86,75,11,4
2021,Broxtowe 004E,E01028123,760,629,350,279,1,1,42,40,2,87,80,7,1
2021,Broxtowe 004F,E01028124,682,602,360,242,1,1,18,16,2,60,55,5,1
2021,Broxtowe 008A,E01028125,848,690,377,313,1,1,49,36,13,108,93,15,0
2021,Broxtowe 008B,E01028126,575,399,209,190,3,3,79,61,18,90,79,11,4
2021,Broxtowe 008C,E01028127,742,355,201,154,4,4,289,270,19,88,73,15,6
2021,Broxtowe 010A,E01028128,741,637,392,245,0,0,2,0,2,102,92,10,0
2021,Broxtowe 010B,E01028129,662,459,251,208,0,0,159,112,47,43,33,10,1
2021,Broxtowe 010C,E01028130,908,464,204,260,0,0,261,208,53,179,160,19,4
2021,Broxtowe 010D,E01028131,651,534,276,258,0,0,18,12,6,99,83,16,0
2021,Broxtowe 010E,E01028132,438,263,132,131,0,0,109,106,3,66,48,18,0
2021,Broxtowe 010F,E01028133,698,376,172,204,2,2,50,33,17,269,251,18,1
2021,Broxtowe 008D,E01028134,650,424,190,234,4,4,43,33,10,179,163,16,0
2021,Broxtowe 015A,E01028135,560,530,320,210,0,0,1,1,0,29,25,4,0
2021,Broxtowe 015B,E01028136,665,604,335,269,0,0,7,4,3,54,51,3,0
2021,Broxtowe 015C,E01028137,1006,765,366,399,0,0,20,3,17,221,202,19,0
2021,Broxtowe 015D,E01028138,580,390,259,131,20,20,48,46,2,121,113,8,1
2021,Broxtowe 015E,E01028139,588,501,279,222,0,0,11,6,5,76,65,11,0
2021,Gedling 016A,E01028142,944,722,387,335,9,9,62,6,56,151,132,19,0
2021,Gedling 004A,E01028143,622,401,222,179,5,5,122,74,48,90,83,7,4
2021,Gedling 006A,E01028144,649,421,187,234,1,1,52,26,26,175,159,16,0
2021,Gedling 016B,E01028146,645,544,270,274,0,0,8,0,8,93,81,12,0
2021,Gedling 016C,E01028147,479,221,91,130,1,1,178,157,21,79,71,8,0
2021,Gedling 008A,E01028148,1055,941,528,413,1,1,19,4,15,94,74,20,0
2021,Gedling 008B,E01028149,723,608,363,245,3,3,25,11,14,87,73,14,0
2021,Gedling 002A,E01028150,615,540,364,176,4,4,17,6,11,54,42,12,0
2021,Gedling 002B,E01028151,463,416,245,171,1,1,2,0,2,44,35,9,0
2021,Gedling 002C,E01028152,768,633,342,291,12,12,44,15,29,79,60,19,0
2021,Gedling 002D,E01028153,587,314,171,143,0,0,195,77,118,76,63,13,2
2021,Gedling 002E,E01028154,698,504,252,252,2,2,71,8,63,121,94,27,0
2021,Gedling 014A,E01028155,653,424,230,194,0,0,79,39,40,150,133,17,0
2021,Gedling 014B,E01028156,667,446,242,204,2,2,78,40,38,140,124,16,1
2021,Gedling 014C,E01028157,489,442,260,182,2,2,2,0,2,43,37,6,0
2021,Gedling 014D,E01028158,873,448,254,194,13,13,117,61,56,295,278,17,0
2021,Gedling 014E,E01028159,600,367,198,169,2,2,112,36,76,119,99,20,0
2021,Gedling 013A,E01028160,666,505,249,256,2,2,19,9,10,140,125,15,0
2021,Gedling 013B,E01028161,680,413,228,185,1,1,32,12,20,234,211,23,0
2021,Gedling 013C,E01028162,653,465,205,260,7,7,71,32,39,110,93,17,0
2021,Gedling 013D,E01028163,651,534,279,255,0,0,9,2,7,108,94,14,0
2021,Gedling 014F,E01028164,565,333,171,162,1,1,153,66,87,76,60,16,2
2021,Gedling 006B,E01028165,747,411,217,194,1,1,155,75,80,179,166,13,1
2021,Gedling 006C,E01028166,736,443,230,213,1,1,187,91,96,104,88,16,1
2021,Gedling 006D,E01028167,884,479,229,250,14,14,142,61,81,248,228,20,1
2021,Gedling 012A,E01028168,556,468,275,193,1,1,13,5,8,73,62,11,1
2021,Gedling 012B,E01028169,600,533,338,195,1,1,10,6,4,56,42,14,0
2021,Gedling 012C,E01028170,645,453,229,224,0,0,89,40,49,102,90,12,1
2021,Gedling 012D,E01028171,568,412,216,196,0,0,54,28,26,102,88,14,0
2021,Gedling 011A,E01028172,910,743,254,489,9,9,85,21,64,73,59,14,0
2021,Gedling 005A,E01028173,438,113,50,63,1,1,297,58,239,27,25,2,0
2021,Gedling 005B,E01028174,597,379,179,200,3,3,155,95,60,59,49,10,1
2021,Gedling 005C,E01028175,792,599,325,274,7,7,74,31,43,111,97,14,1
2021,Gedling 009A,E01028176,629,541,329,212,1,1,17,3,14,70,62,8,0
2021,Gedling 009B,E01028177,762,557,348,209,3,3,16,10,6,186,166,20,0
2021,Gedling 008C,E01028178,1093,928,557,371,9,9,44,17,27,111,98,13,1
2021,Gedling 007A,E01028179,588,518,306,212,3,3,3,0,3,64,56,8,0
2021,Gedling 007B,E01028180,674,540,344,196,2,2,44,13,31,88,73,15,0
2021,Gedling 007C,E01028181,700,508,287,221,7,7,2,1,1,183,172,11,0
2021,Gedling 007D,E01028182,653,464,239,225,1,1,79,9,70,106,92,14,3
2021,Gedling 007E,E01028183,608,526,358,168,2,2,13,6,7,65,49,16,2
2021,Gedling 015A,E01028184,484,412,199,213,0,0,6,3,3,66,61,5,0
2021,Gedling 015B,E01028185,898,482,214,268,24,24,121,46,75,271,251,20,0
2021,Gedling 015C,E01028186,800,342,138,204,5,5,193,99,94,260,236,24,0
2021,Gedling 015D,E01028187,675,285,109,176,2,2,101,34,67,287,266,21,0
2021,Gedling 015E,E01028188,638,412,166,246,7,7,53,11,42,166,151,15,0
2021,Gedling 001A,E01028189,1099,828,402,426,6,6,120,49,71,144,112,32,1
2021,Gedling 011B,E01028190,646,552,253,299,2,2,15,10,5,77,66,11,0
2021,Gedling 012E,E01028191,727,566,254,312,2,2,64,43,21,95,81,14,0
2021,Gedling 012F,E01028192,650,412,191,221,2,2,83,16,67,153,125,28,0
2021,Gedling 010A,E01028193,741,513,277,236,7,7,116,55,61,104,94,10,1
2021,Gedling 010B,E01028194,635,496,240,256,0,0,18,2,16,121,108,13,0
2021,Gedling 010C,E01028195,629,509,245,264,5,5,10,3,7,105,98,7,0
2021,Gedling 010D,E01028196,577,526,277,249,2,2,5,2,3,44,34,10,0
2021,Gedling 010E,E01028197,611,524,301,223,1,1,34,5,29,51,42,9,1
2021,Gedling 001B,E01028198,629,582,384,198,4,4,2,1,1,41,34,7,0
2021,Gedling 001C,E01028199,661,607,417,190,0,0,11,3,8,43,33,10,0
2021,Gedling 001D,E01028200,767,642,355,287,3,3,45,0,45,76,56,20,1
2021,Gedling 001E,E01028201,498,468,282,186,2,2,0,0,0,28,20,8,0
2021,Gedling 011C,E01028202,675,488,307,181,17,17,99,32,67,71,56,15,0
2021,Gedling 011D,E01028203,614,459,236,223,2,2,76,42,34,77,64,13,0
2021,Gedling 010F,E01028204,584,497,264,233,0,0,21,11,10,66,56,10,0
2021,Gedling 004B,E01028205,707,507,249,258,4,4,125,9,116,71,62,9,0
2021,Gedling 004C,E01028206,619,523,292,231,1,1,23,6,17,72,58,14,0
2021,Gedling 004D,E01028207,675,589,312,277,8,8,20,9,11,58,41,17,0
2021,Gedling 004E,E01028208,492,333,192,141,2,2,73,42,31,84,76,8,0
2021,Gedling 005D,E01028209,607,333,179,154,6,6,138,85,53,130,115,15,0
2021,Gedling 014G,E01028210,694,367,175,192,10,10,175,77,98,140,127,13,2
2021,Gedling 013E,E01028211,592,416,231,185,1,1,83,36,47,92,78,14,0
2021,Gedling 011E,E01028212,622,397,164,233,3,3,152,75,77,68,56,12,2
2021,Gedling 002F,E01028213,916,692,483,209,1,1,40,18,22,183,165,18,0
2021,Gedling 009C,E01028214,635,565,354,211,3,3,6,4,2,61,51,10,0
2021,Gedling 009D,E01028215,517,484,250,234,0,0,3,0,3,30,25,5,0
2021,Gedling 009E,E01028216,513,484,289,195,0,0,1,1,0,28,24,4,0
2021,Gedling 009F,E01028217,586,431,254,177,2,2,6,2,4,147,141,6,0
2021,Gedling 009G,E01028218,664,586,362,224,0,0,7,2,5,71,62,9,0
2021,Mansfield 013A,E01028219,669,613,383,230,1,1,13,10,3,42,34,8,0
2021,Mansfield 013B,E01028220,804,602,303,299,2,2,19,16,3,181,165,16,0
2021,Mansfield 013D,E01028222,1063,996,467,529,0,0,12,6,6,55,44,11,0
2021,Mansfield 002A,E01028223,597,375,147,228,5,5,121,95,26,92,82,10,4
2021,Mansfield 001A,E01028224,636,401,272,129,2,2,151,110,41,77,68,9,5
2021,Mansfield 002B,E01028225,661,441,264,177,2,2,106,86,20,108,88,20,4
2021,Mansfield 002C,E01028226,608,254,139,115,1,1,115,49,66,236,215,21,2
2021,Mansfield 008A,E01028227,624,273,165,108,0,0,111,45,66,240,226,14,0
2021,Mansfield 008B,E01028228,584,290,182,108,10,10,93,55,38,191,176,15,0
2021,Mansfield 006A,E01028229,703,453,287,166,0,0,167,141,26,74,67,7,9
2021,Mansfield 010A,E01028230,605,329,161,168,3,3,174,158,16,97,85,12,2
2021,Mansfield 010B,E01028231,634,340,163,177,2,2,221,216,5,64,54,10,7
2021,Mansfield 006B,E01028232,652,482,321,161,0,0,70,67,3,100,83,17,0
2021,Mansfield 009A,E01028233,866,402,232,170,0,0,118,52,66,346,327,19,0
2021,Mansfield 009B,E01028234,790,327,140,187,0,0,273,185,88,186,174,12,4
2021,Mansfield 011A,E01028235,681,597,346,251,1,1,14,9,5,69,63,6,0
2021,Mansfield 011B,E01028236,741,583,312,271,1,1,12,8,4,145,125,20,0
2021,Mansfield 007A,E01028237,700,566,338,228,3,3,29,17,12,101,91,10,1
2021,Mansfield 007B,E01028238,585,355,213,142,1,1,128,40,88,101,87,14,0
2021,Mansfield 007C,E01028239,708,494,278,216,0,0,28,14,14,186,173,13,0
2021,Mansfield 007D,E01028240,663,588,361,227,0,0,11,1,10,64,52,12,0
2021,Mansfield 005A,E01028242,736,577,361,216,2,2,9,5,4,148,133,15,0
2021,Mansfield 007F,E01028243,855,611,321,290,1,1,160,157,3,79,62,17,4
2021,Mansfield 010C,E01028244,730,497,308,189,3,3,95,30,65,134,110,24,1
2021,Mansfield 010D,E01028245,611,300,164,136,1,1,219,214,5,89,77,12,2
2021,Mansfield 010E,E01028246,748,646,379,267,1,1,3,2,1,98,88,10,0
2021,Mansfield 008C,E01028247,759,217,108,109,1,1,190,64,126,351,340,11,0
2021,Mansfield 010F,E01028248,666,438,235,203,4,4,81,73,8,142,130,12,1
2021,Mansfield 010G,E01028249,570,427,237,190,1,1,61,55,6,80,65,15,1
2021,Mansfield 005B,E01028250,620,483,299,184,2,2,19,17,2,115,99,16,1
2021,Mansfield 003A,E01028251,651,605,342,263,0,0,3,1,2,43,32,11,0
2021,Mansfield 003B,E01028252,814,507,275,232,3,3,226,174,52,77,69,8,1
2021,Mansfield 003C,E01028253,704,635,391,244,1,1,8,5,3,60,48,12,0
2021,Mansfield 012A,E01028254,573,435,282,153,1,1,50,22,28,87,74,13,0
2021,Mansfield 013E,E01028255,603,549,388,161,0,0,23,21,2,31,24,7,0
2021,Mansfield 012B,E01028256,845,253,116,137,1,1,495,356,139,92,83,9,4
2021,Mansfield 001B,E01028257,622,400,219,181,1,1,92,8,84,129,114,15,0
2021,Mansfield 001C,E01028258,705,498,343,155,2,2,123,99,24,82,74,8,0
2021,Mansfield 001D,E01028259,676,394,196,198,11,11,154,76,78,117,105,12,0
2021,Mansfield 002D,E01028260,794,589,343,246,1,1,100,93,7,103,82,21,1
2021,Mansfield 012C,E01028261,666,348,177,171,1,1,262,243,19,51,49,2,4
2021,Mansfield 011C,E01028262,615,552,323,229,1,1,6,2,4,56,46,10,0
2021,Mansfield 012D,E01028263,749,142,59,83,0,0,545,380,165,54,47,7,8
2021,Mansfield 011D,E01028264,813,711,404,307,2,2,26,24,2,74,62,12,0
2021,Mansfield 006E,E01028267,838,484,184,300,1,1,265,246,19,85,76,9,3
2021,Mansfield 008D,E01028268,1007,319,149,170,6,6,110,69,41,569,548,21,3
2021,Mansfield 008E,E01028269,788,323,170,153,1,1,55,11,44,409,391,18,0
2021,Mansfield 013F,E01028270,680,564,302,262,3,3,18,12,6,94,86,8,1
2021,Mansfield 004A,E01028271,820,342,171,171,14,14,227,119,108,232,219,13,5
2021,Mansfield 005C,E01028272,799,474,233,241,34,34,53,19,34,238,210,28,0
2021,Mansfield 005D,E01028273,625,484,272,212,0,0,30,25,5,111,99,12,0
2021,Mansfield 009C,E01028274,738,334,157,177,14,14,137,59,78,249,233,16,4
2021,Mansfield 009D,E01028275,678,284,126,158,2,2,280,231,49,110,94,16,2
2021,Mansfield 009E,E01028276,762,172,97,75,1,1,436,383,53,143,130,13,10
2021,Mansfield 003D,E01028277,624,558,348,210,0,0,22,7,15,41,27,14,3
2021,Mansfield 003E,E01028278,632,459,285,174,2,2,87,85,2,82,68,14,2
2021,Mansfield 004B,E01028279,697,364,179,185,14,14,241,213,28,72,56,16,6
2021,Mansfield 004C,E01028280,547,307,159,148,8,8,171,160,11,59,48,11,2
2021,Mansfield 004D,E01028281,588,248,98,150,7,7,201,174,27,128,113,15,4
2021,Mansfield 006F,E01028282,553,315,160,155,1,1,134,88,46,98,90,8,5
2021,Mansfield 004E,E01028283,950,724,346,378,7,7,50,13,37,169,155,14,0
2021,Mansfield 008F,E01028284,822,341,199,142,9,9,157,132,25,315,288,27,0
2021,Newark and Sherwood 011A,E01028285,535,397,188,209,1,1,15,11,4,120,103,17,2
2021,Newark and Sherwood 011B,E01028286,623,388,246,142,2,2,159,139,20,72,58,14,2
2021,Newark and Sherwood 011C,E01028287,680,554,322,232,0,0,39,32,7,87,74,13,0
2021,Newark and Sherwood 011D,E01028288,690,542,322,220,8,8,29,14,15,111,101,10,0
2021,Newark and Sherwood 011E,E01028289,640,499,309,190,4,4,8,6,2,129,117,12,0
2021,Newark and Sherwood 011F,E01028290,628,444,247,197,3,3,113,96,17,65,61,4,3
2021,Newark and Sherwood 011G,E01028291,838,602,211,391,13,13,132,116,16,90,83,7,1
2021,Newark and Sherwood 009A,E01028292,1127,947,432,515,15,15,36,4,32,129,106,23,0
2021,Newark and Sherwood 009B,E01028293,875,555,313,242,8,8,32,5,27,280,257,23,0
2021,Newark and Sherwood 007A,E01028294,933,425,202,223,14,14,192,114,78,302,273,29,0
2021,Newark and Sherwood 005A,E01028295,846,725,421,304,0,0,22,6,16,99,73,26,0
2021,Newark and Sherwood 006A,E01028296,760,526,273,253,28,28,98,22,76,108,86,22,0
2021,Newark and Sherwood 005B,E01028297,852,452,232,220,2,2,307,208,99,90,75,15,1
2021,Newark and Sherwood 006B,E01028298,656,515,283,232,1,1,45,8,37,95,75,20,0
2021,Newark and Sherwood 006C,E01028299,544,322,139,183,1,1,129,51,78,91,79,12,1
2021,Newark and Sherwood 006D,E01028300,662,378,192,186,2,2,186,123,63,95,87,8,1
2021,Newark and Sherwood 001A,E01028301,736,275,150,125,2,2,299,219,80,160,150,10,0
2021,Newark and Sherwood 001B,E01028302,712,504,317,187,2,2,112,71,41,93,82,11,1
2021,Newark and Sherwood 003A,E01028303,698,573,396,177,5,5,59,44,15,60,41,19,1
2021,Newark and Sherwood 007B,E01028304,628,265,149,116,4,4,224,190,34,131,123,8,4
2021,Newark and Sherwood 007C,E01028305,677,336,192,144,16,16,98,39,59,226,216,10,1
2021,Newark and Sherwood 007D,E01028306,687,438,203,235,10,10,148,114,34,88,81,7,3
2021,Newark and Sherwood 007E,E01028307,521,370,189,181,12,12,32,18,14,107,98,9,0
2021,Newark and Sherwood 010A,E01028308,746,583,398,185,0,0,43,35,8,120,104,16,0
2021,Newark and Sherwood 010B,E01028309,639,544,341,203,3,3,11,4,7,81,62,19,0
2021,Newark and Sherwood 007F,E01028310,1187,420,238,182,5,5,233,84,149,527,490,37,2
2021,Newark and Sherwood 007G,E01028311,908,316,203,113,8,8,227,42,185,355,329,26,2
2021,Newark and Sherwood 003B,E01028312,988,721,472,249,6,6,68,60,8,193,163,30,0
2021,Newark and Sherwood 002A,E01028313,848,444,272,172,7,7,261,221,40,133,109,24,3
2021,Newark and Sherwood 004A,E01028315,708,613,415,198,6,6,9,2,7,80,69,11,0
2021,Newark and Sherwood 004B,E01028316,809,565,372,193,18,18,146,125,21,78,64,14,2
2021,Newark and Sherwood 004C,E01028317,684,573,355,218,0,0,33,29,4,77,44,33,1
2021,Newark and Sherwood 010C,E01028318,607,332,166,166,1,1,213,207,6,61,54,7,0
2021,Newark and Sherwood 010D,E01028319,847,409,219,190,15,15,326,258,68,97,87,10,0
2021,Newark and Sherwood 010E,E01028320,750,293,150,143,0,0,391,359,32,61,56,5,5
2021,Newark and Sherwood 002C,E01028321,724,576,371,205,7,7,67,46,21,74,64,10,0
2021,Newark and Sherwood 002D,E01028322,930,665,377,288,0,0,182,172,10,80,66,14,3
2021,Newark and Sherwood 002E,E01028323,736,494,260,234,16,16,83,19,64,143,129,14,0
2021,Newark and Sherwood 012B,E01028325,539,445,266,179,4,4,43,31,12,47,37,10,0
2021,Newark and Sherwood 012C,E01028326,595,430,265,165,3,3,112,107,5,46,39,7,4
2021,Newark and Sherwood 005C,E01028327,831,598,320,278,16,16,127,111,16,89,67,22,1
2021,Newark and Sherwood 005D,E01028328,801,690,430,260,1,1,42,17,25,65,47,18,3
2021,Newark and Sherwood 005E,E01028329,651,547,339,208,0,0,26,23,3,78,57,21,0
2021,Newark and Sherwood 013A,E01028330,685,609,391,218,2,2,19,19,0,55,41,14,0
2021,Newark and Sherwood 013B,E01028331,634,478,308,170,5,5,76,68,8,73,57,16,2
2021,Newark and Sherwood 013C,E01028332,692,622,375,247,1,1,33,26,7,36,27,9,0
2021,Newark and Sherwood 009C,E01028333,635,438,244,194,1,1,61,15,46,135,124,11,0
2021,Newark and Sherwood 009D,E01028334,621,288,132,156,1,1,245,233,12,86,67,19,1
2021,Newark and Sherwood 009E,E01028335,959,423,264,159,27,27,148,99,49,361,343,18,0
2021,Newark and Sherwood 012D,E01028336,508,400,241,159,1,1,42,24,18,65,49,16,0
2021,Newark and Sherwood 003C,E01028337,634,565,364,201,7,7,14,8,6,48,34,14,0
2021,Newark and Sherwood 001C,E01028338,770,480,195,285,3,3,179,136,43,105,88,17,3
2021,Newark and Sherwood 001D,E01028339,761,450,181,269,1,1,83,11,72,227,197,30,0
2021,Newark and Sherwood 001E,E01028340,725,401,221,180,1,1,219,177,42,104,88,16,0
2021,Newark and Sherwood 006E,E01028342,634,406,196,210,2,2,44,3,41,182,168,14,0
2021,Newark and Sherwood 006F,E01028343,1064,716,325,391,4,4,232,193,39,109,80,29,3
2021,Newark and Sherwood 006G,E01028344,617,529,313,216,1,1,10,4,6,77,64,13,0
2021,Newark and Sherwood 008A,E01028345,1042,739,501,238,6,6,113,104,9,182,154,28,2
2021,Newark and Sherwood 008B,E01028346,950,762,510,252,3,3,62,52,10,123,98,25,0
2021,Newark and Sherwood 008C,E01028347,632,514,331,183,2,2,22,8,14,94,81,13,0
2021,Newark and Sherwood 008D,E01028348,590,370,224,146,21,21,132,72,60,66,49,17,1
2021,Newark and Sherwood 003D,E01028349,665,555,345,210,2,2,35,27,8,73,55,18,0
2021,Newark and Sherwood 003E,E01028350,547,390,201,189,2,2,85,59,26,69,54,15,1
2021,Newark and Sherwood 013D,E01028351,514,462,284,178,1,1,27,27,0,24,19,5,0
2021,Newark and Sherwood 012E,E01028352,473,426,274,152,4,4,6,6,0,37,25,12,0
2021,Newark and Sherwood 004D,E01028353,1186,967,580,387,0,0,113,81,32,106,91,15,0
2021,Rushcliffe 004A,E01028354,583,485,246,239,3,3,5,0,5,90,81,9,0
2021,Rushcliffe 004B,E01028355,656,490,231,259,3,3,68,13,55,95,86,9,0
2021,Rushcliffe 006A,E01028356,596,514,308,206,1,1,14,0,14,67,57,10,0
2021,Rushcliffe 002A,E01028357,633,579,369,210,3,3,4,1,3,47,36,11,0
2021,Rushcliffe 002B,E01028358,633,412,248,164,0,0,121,25,96,97,87,10,3
2021,Rushcliffe 002C,E01028359,761,616,303,313,9,9,29,5,24,107,94,13,0
2021,Rushcliffe 002D,E01028360,1184,818,283,535,26,26,96,10,86,244,217,27,0
2021,Rushcliffe 002E,E01028361,604,501,311,190,0,0,7,0,7,96,86,10,0
2021,Rushcliffe 002F,E01028362,595,307,179,128,5,5,230,53,177,53,40,13,0
2021,Rushcliffe 007A,E01028363,506,448,241,207,0,0,2,0,2,56,50,6,0
2021,Rushcliffe 007B,E01028364,677,554,314,240,1,1,3,0,3,119,100,19,0
2021,Rushcliffe 007C,E01028365,885,688,352,336,20,20,16,5,11,161,154,7,0
2021,Rushcliffe 009A,E01028366,528,308,133,175,8,8,150,43,107,62,52,10,0
2021,Rushcliffe 009B,E01028367,1001,768,315,453,55,55,94,21,73,84,72,12,0
2021,Rushcliffe 009C,E01028368,650,578,313,265,4,4,17,5,12,51,45,6,0
2021,Rushcliffe 009D,E01028369,605,350,157,193,4,4,168,46,122,83,72,11,0
2021,Rushcliffe 009E,E01028370,637,454,240,214,1,1,113,38,75,69,58,11,0
2021,Rushcliffe 001A,E01028371,917,752,435,317,10,10,63,9,54,92,67,25,0
2021,Rushcliffe 008A,E01028372,567,313,178,135,4,4,147,30,117,103,92,11,0
2021,Rushcliffe 008C,E01028374,582,356,193,163,7,7,174,31,143,42,33,9,3
2021,Rushcliffe 006B,E01028375,805,469,235,234,23,23,80,9,71,233,220,13,0
2021,Rushcliffe 006C,E01028376,679,501,306,195,1,1,7,3,4,170,155,15,0
2021,Rushcliffe 006D,E01028377,743,648,330,318,13,13,12,3,9,70,62,8,0
2021,Rushcliffe 014A,E01028378,909,728,443,285,0,0,65,22,43,116,97,19,0
2021,Rushcliffe 012A,E01028379,773,728,503,225,1,1,4,1,3,40,28,12,0
2021,Rushcliffe 013A,E01028380,556,280,126,154,15,15,191,54,137,70,60,10,0
2021,Rushcliffe 013B,E01028381,597,544,355,189,0,0,4,0,4,49,38,11,0
2021,Rushcliffe 013C,E01028382,647,555,362,193,9,9,5,2,3,78,73,5,0
2021,Rushcliffe 013D,E01028383,524,417,293,124,1,1,35,12,23,71,58,13,0
2021,Rushcliffe 004C,E01028384,704,498,216,282,1,1,8,3,5,196,185,11,1
2021,Rushcliffe 004D,E01028385,671,552,256,296,1,1,40,5,35,78,73,5,0
2021,Rushcliffe 004E,E01028386,646,483,224,259,5,5,7,1,6,151,140,11,0
2021,Rushcliffe 014B,E01028387,985,672,282,390,22,22,204,45,159,87,78,9,0
2021,Rushcliffe 015A,E01028388,679,598,315,283,3,3,14,1,13,64,55,9,0
2021,Rushcliffe 015B,E01028389,859,713,449,264,24,24,56,11,45,66,54,12,0
2021,Rushcliffe 015C,E01028390,1075,885,398,487,10,10,96,14,82,84,71,13,0
2021,Rushcliffe 007D,E01028391,839,754,439,315,1,1,24,1,23,60,54,6,0
2021,Rushcliffe 007E,E01028392,997,588,315,273,17,17,217,46,171,175,146,29,0
2021,Rushcliffe 003A,E01028393,496,454,309,145,1,1,2,0,2,39,32,7,0
2021,Rushcliffe 003B,E01028394,708,564,359,205,4,4,65,13,52,75,53,22,0
2021,Rushcliffe 003C,E01028395,579,506,286,220,3,3,14,5,9,56,49,7,0
2021,Rushcliffe 005A,E01028396,652,467,229,238,2,2,11,1,10,172,164,8,0
2021,Rushcliffe 006E,E01028397,691,550,300,250,2,2,51,7,44,88,81,7,0
2021,Rushcliffe 005B,E01028398,657,386,191,195,1,1,47,8,39,223,197,26,0
2021,Rushcliffe 005C,E01028399,483,337,152,185,1,1,30,2,28,115,109,6,0
2021,Rushcliffe 008D,E01028400,579,515,305,210,0,0,2,0,2,62,56,6,0
2021,Rushcliffe 008E,E01028401,487,383,204,179,4,4,43,8,35,57,51,6,0
2021,Rushcliffe 010A,E01028402,797,699,432,267,6,6,13,3,10,79,60,19,0
2021,Rushcliffe 001B,E01028403,971,763,509,254,8,8,82,15,67,117,94,23,1
2021,Rushcliffe 011A,E01028404,690,563,335,228,0,0,8,2,6,119,111,8,0
2021,Rushcliffe 011B,E01028405,1000,635,272,363,21,21,238,57,181,103,87,16,3
2021,Rushcliffe 011C,E01028406,721,507,243,264,7,7,115,47,68,92,81,11,0
2021,Rushcliffe 011D,E01028407,911,748,347,401,0,0,24,2,22,139,117,22,0
2021,Rushcliffe 014C,E01028408,862,661,385,276,1,1,53,8,45,147,117,30,0
2021,Rushcliffe 015D,E01028409,529,480,291,189,4,4,4,0,4,40,31,9,1
2021,Rushcliffe 015E,E01028410,553,442,251,191,2,2,29,6,23,80,74,6,0
2021,Rushcliffe 001C,E01028411,896,729,419,310,4,4,39,4,35,124,102,22,0
2021,Rushcliffe 012B,E01028412,829,770,482,288,6,6,7,1,6,46,35,11,0
2021,Rushcliffe 003D,E01028413,776,499,278,221,13,13,181,42,139,82,63,19,1
2021,Rushcliffe 003E,E01028414,722,606,409,197,8,8,9,1,8,98,79,19,1
2021,Rushcliffe 003F,E01028415,824,701,324,377,5,5,26,9,17,92,79,13,0
2021,Rushcliffe 005D,E01028416,784,259,123,136,5,5,125,16,109,394,376,18,1
2021,Rushcliffe 005E,E01028417,651,284,118,166,2,2,10,1,9,355,344,11,0
2021,Rushcliffe 005F,E01028418,700,266,119,147,4,4,142,12,130,288,282,6,0
2021,Rushcliffe 010B,E01028419,1107,837,484,353,15,15,153,24,129,102,86,16,0
2021,Rushcliffe 010C,E01028420,586,486,283,203,6,6,19,3,16,75,59,16,0
2021,Rushcliffe 012C,E01028421,926,801,491,310,5,5,21,4,17,99,85,14,0
2021,Cherwell 008A,E01028422,715,538,285,253,12,12,88,9,79,77,65,12,0
2021,Cherwell 008B,E01028423,698,547,320,227,10,10,41,2,39,100,82,18,0
2021,Cherwell 007A,E01028426,724,539,222,317,16,16,86,9,77,83,74,9,0
2021,Cherwell 007B,E01028427,690,311,155,156,12,12,49,5,44,318,302,16,0
2021,Cherwell 007C,E01028428,518,456,284,172,0,0,16,1,15,46,39,7,0
2021,Cherwell 007D,E01028429,507,356,221,135,0,0,82,6,76,69,58,11,0
2021,Cherwell 006A,E01028430,896,391,187,204,13,13,150,41,109,340,321,19,2
2021,Cherwell 006B,E01028431,684,536,326,210,4,4,40,6,34,104,94,10,0
2021,Cherwell 006C,E01028432,839,579,328,251,19,19,168,22,146,73,65,8,0
2021,Cherwell 006D,E01028433,750,638,451,187,3,3,32,11,21,77,62,15,0
2021,Cherwell 006E,E01028434,704,567,307,260,21,21,48,2,46,68,56,12,0
2021,Cherwell 004A,E01028435,1144,233,129,104,7,7,245,36,209,657,628,29,2
2021,Cherwell 004C,E01028437,581,347,143,204,7,7,22,4,18,205,181,24,0
2021,Cherwell 004E,E01028439,563,385,164,221,2,2,22,2,20,154,144,10,0
2021,Cherwell 004F,E01028440,736,276,112,164,5,5,70,10,60,385,373,12,0
2021,Cherwell 002A,E01028441,989,465,167,298,13,13,252,49,203,259,237,22,0
2021,Cherwell 002C,E01028443,588,404,204,200,6,6,37,4,33,141,129,12,0
2021,Cherwell 002D,E01028444,578,460,241,219,4,4,18,5,13,96,84,12,0
2021,Cherwell 003A,E01028445,504,280,111,169,1,1,130,26,104,92,80,12,1
2021,Cherwell 003B,E01028446,629,413,219,194,6,6,87,21,66,122,110,12,1
2021,Cherwell 003C,E01028447,559,258,121,137,9,9,103,17,86,189,179,10,0
2021,Cherwell 003D,E01028448,643,272,112,160,18,18,257,49,208,92,79,13,4
2021,Cherwell 005A,E01028449,544,249,114,135,0,0,225,43,182,68,62,6,2
2021,Cherwell 005B,E01028450,529,200,99,101,2,2,273,63,210,54,49,5,0
2021,Cherwell 005C,E01028451,498,337,198,139,2,2,92,17,75,67,57,10,0
2021,Cherwell 005D,E01028452,515,261,134,127,5,5,160,20,140,89,78,11,0
2021,Cherwell 005E,E01028453,494,267,105,162,3,3,169,39,130,55,47,8,0
2021,Cherwell 005F,E01028454,692,259,114,145,13,13,363,90,273,56,46,10,1
2021,Cherwell 013A,E01028455,575,476,210,266,9,9,25,3,22,65,63,2,0
2021,Cherwell 013B,E01028456,601,370,191,179,5,5,139,23,116,86,78,8,1
2021,Cherwell 013C,E01028457,503,437,215,222,1,1,1,0,1,64,58,6,0
2021,Cherwell 013D,E01028458,614,311,109,202,4,4,163,26,137,136,128,8,0
2021,Cherwell 012A,E01028459,649,387,149,238,2,2,24,3,21,236,218,18,0
2021,Cherwell 012B,E01028460,724,548,170,378,1,1,64,6,58,111,106,5,0
2021,Cherwell 012C,E01028461,670,412,147,265,4,4,44,3,41,210,190,20,0
2021,Cherwell 012D,E01028462,641,444,215,229,3,3,74,9,65,120,113,7,0
2021,Cherwell 015A,E01028463,1095,559,202,357,46,46,118,7,111,372,352,20,0
2021,Cherwell 015B,E01028464,691,445,165,280,7,7,55,4,51,184,176,8,0
2021,Cherwell 015C,E01028465,526,409,164,245,2,2,3,0,3,112,104,8,0
2021,Cherwell 014A,E01028466,679,374,161,213,6,6,220,37,183,79,66,13,0
2021,Cherwell 013E,E01028467,811,505,258,247,16,16,78,14,64,212,197,15,0
2021,Cherwell 014B,E01028469,601,535,362,173,1,1,9,0,9,56,48,8,0
2021,Cherwell 014C,E01028470,683,503,286,217,2,2,95,21,74,83,73,10,0
2021,Cherwell 014D,E01028471,474,247,114,133,0,0,170,24,146,56,50,6,1
2021,Cherwell 014E,E01028472,472,391,200,191,7,7,11,1,10,63,56,7,0
2021,Cherwell 014F,E01028473,614,504,256,248,2,2,10,3,7,98,87,11,0
2021,Cherwell 009A,E01028474,803,545,283,262,19,19,132,14,118,107,95,12,0
2021,Cherwell 008D,E01028476,1094,850,452,398,29,29,88,6,82,127,101,26,0
2021,Cherwell 011B,E01028477,1030,691,274,417,28,28,88,10,78,223,189,34,0
2021,Cherwell 011C,E01028478,463,297,90,207,1,1,27,3,24,138,63,75,0
2021,Cherwell 001A,E01028479,582,466,278,188,4,4,21,4,17,91,77,14,0
2021,Cherwell 001B,E01028480,673,506,296,210,7,7,68,12,56,92,78,14,0
2021,Cherwell 010A,E01028481,641,454,292,162,10,10,70,8,62,107,87,20,0
2021,Cherwell 010B,E01028482,575,490,289,201,9,9,30,7,23,46,35,11,0
2021,Cherwell 011D,E01028483,528,403,210,193,0,0,22,5,17,103,87,16,0
2021,Cherwell 011E,E01028484,463,321,174,147,1,1,59,11,48,82,56,26,0
2021,Cherwell 009B,E01028485,680,499,282,217,11,11,99,12,87,71,57,14,0
2021,Cherwell 009C,E01028486,540,439,286,153,2,2,17,3,14,82,58,24,0
2021,Cherwell 017A,E01028487,545,383,209,174,5,5,4,0,4,153,141,12,0
2021,Cherwell 019A,E01028488,657,373,201,172,8,8,24,2,22,252,235,17,0
2021,Cherwell 017B,E01028489,668,544,417,127,12,12,34,1,33,78,66,12,0
2021,Cherwell 017C,E01028490,523,373,222,151,2,2,86,21,65,62,52,10,0
2021,Cherwell 017D,E01028491,727,503,333,170,6,6,58,2,56,153,130,23,7
2021,Cherwell 018A,E01028492,661,492,329,163,3,3,18,1,17,148,133,15,0
2021,Cherwell 018B,E01028493,547,387,220,167,3,3,88,18,70,69,57,12,0
2021,Cherwell 017E,E01028494,470,231,125,106,2,2,147,96,51,88,83,5,2
2021,Cherwell 018C,E01028495,524,373,223,150,6,6,30,7,23,115,102,13,0
2021,Cherwell 018D,E01028496,522,340,174,166,1,1,96,7,89,85,72,13,0
2021,Cherwell 016B,E01028497,624,477,284,193,7,7,18,2,16,122,95,27,0
2021,Cherwell 016C,E01028498,681,458,250,208,11,11,131,18,113,81,64,17,0
2021,Cherwell 011F,E01028499,785,615,319,296,13,13,70,11,59,87,73,14,0
2021,Cherwell 016D,E01028500,558,384,181,203,18,18,101,11,90,55,42,13,0
2021,Cherwell 016E,E01028501,482,404,219,185,0,0,24,3,21,53,35,18,1
2021,Cherwell 016F,E01028502,513,416,231,185,7,7,16,1,15,74,60,14,0
2021,Cherwell 009D,E01028503,512,425,275,150,2,2,30,2,28,55,42,13,0
2021,Cherwell 009E,E01028504,584,462,270,192,1,1,43,7,36,78,53,25,0
2021,Cherwell 010D,E01028506,793,594,282,312,19,19,90,12,78,90,69,21,0
2021,Cherwell 010E,E01028507,598,473,280,193,5,5,28,3,25,92,78,14,0
2021,Cherwell 001C,E01028508,455,381,234,147,3,3,21,2,19,50,42,8,0
2021,Cherwell 019B,E01028510,665,558,341,217,0,0,14,2,12,93,70,23,0
2021,Cherwell 019C,E01028511,824,564,379,185,42,42,86,8,78,132,114,18,0
2021,Cherwell 019D,E01028512,755,505,277,228,52,52,115,16,99,83,75,8,0
2021,Oxford 005A,E01028513,926,224,76,148,35,35,381,311,70,284,269,15,2
2021,Oxford 005B,E01028514,548,180,87,93,3,3,282,238,44,78,68,10,5
2021,Oxford 007A,E01028515,681,423,206,217,5,5,50,43,7,203,188,15,0
2021,Oxford 005C,E01028516,939,430,232,198,0,0,307,214,93,201,184,17,1
2021,Oxford 017A,E01028517,500,212,69,143,23,23,191,108,83,74,70,4,0
2021,Oxford 017B,E01028518,644,171,93,78,6,6,421,300,121,44,39,5,2
2021,Oxford 017C,E01028519,591,261,136,125,2,2,180,174,6,145,125,20,3
2021,Oxford 018A,E01028520,606,191,96,95,4,4,328,300,28,81,72,9,2
2021,Oxford 008A,E01028521,565,97,66,31,2,2,72,27,45,394,299,95,0
2021,Oxford 008B,E01028522,704,85,50,35,8,8,277,136,141,331,310,21,3
2021,Oxford 010A,E01028523,602,153,80,73,6,6,236,121,115,207,185,22,0
2021,Oxford 010B,E01028524,627,182,78,104,6,6,288,270,18,146,137,9,5
2021,Oxford 010C,E01028525,712,206,101,105,19,19,351,235,116,132,120,12,4
2021,Oxford 010D,E01028526,523,162,108,54,0,0,84,72,12,276,266,10,1
2021,Oxford 015A,E01028527,667,469,240,229,6,6,20,15,5,172,161,11,0
2021,Oxford 015B,E01028528,592,294,168,126,5,5,19,5,14,274,251,23,0
2021,Oxford 015C,E01028529,638,237,109,128,21,21,211,198,13,164,154,10,5
2021,Oxford 015D,E01028530,675,378,162,216,7,7,65,60,5,219,207,12,6
2021,Oxford 019B,E01028531,825,382,179,203,19,19,95,14,81,327,310,17,2
2021,Oxford 019A,E01028532,1016,298,143,155,24,24,244,165,79,450,420,30,0
2021,Oxford 006A,E01028534,459,315,206,109,1,1,22,10,12,121,105,16,0
2021,Oxford 006B,E01028535,687,360,215,145,4,4,49,13,36,274,258,16,0
2021,Oxford 006C,E01028536,611,308,183,125,4,4,110,36,74,188,174,14,1
2021,Oxford 006D,E01028537,839,289,200,89,13,13,145,69,76,391,318,73,1
2021,Oxford 005D,E01028538,701,254,137,117,13,13,286,197,89,148,138,10,0
2021,Oxford 006E,E01028539,698,317,171,146,9,9,66,60,6,306,291,15,0
2021,Oxford 006F,E01028540,545,332,201,131,6,6,66,18,48,140,114,26,1
2021,Oxford 012A,E01028541,581,329,171,158,3,3,68,37,31,181,166,15,0
2021,Oxford 012B,E01028542,728,362,177,185,8,8,123,89,34,233,209,24,2
2021,Oxford 012C,E01028543,556,210,128,82,3,3,188,177,11,149,138,11,6
2021,Oxford 012D,E01028544,553,298,191,107,6,6,28,17,11,220,201,19,1
2021,Oxford 014A,E01028545,673,352,213,139,7,7,22,9,13,292,279,13,0
2021,Oxford 014B,E01028546,725,285,142,143,3,3,292,268,24,143,126,17,2
2021,Oxford 014C,E01028547,867,385,203,182,6,6,41,19,22,435,401,34,0
2021,Oxford 009A,E01028548,778,405,240,165,6,6,129,51,78,238,218,20,0
2021,Oxford 009B,E01028549,709,322,179,143,1,1,83,54,29,303,261,42,0
2021,Oxford 009C,E01028550,704,142,98,44,7,7,131,109,22,423,406,17,1
2021,Oxford 009D,E01028551,543,179,115,64,6,6,81,58,23,277,238,39,0
2021,Oxford 016A,E01028552,796,274,136,138,13,13,371,320,51,136,119,17,2
2021,Oxford 016B,E01028553,757,399,180,219,10,10,126,84,42,222,207,15,0
2021,Oxford 016C,E01028554,609,297,160,137,1,1,109,96,13,201,188,13,1
2021,Oxford 016D,E01028555,667,423,219,204,4,4,49,38,11,191,172,19,0
2021,Oxford 020B,E01028556,673,273,141,132,1,1,172,43,129,226,214,12,1
2021,Oxford 020D,E01028557,741,356,155,201,14,14,196,143,53,173,161,12,2
2021,Oxford 020C,E01028558,593,348,193,155,4,4,43,10,33,198,185,13,0
2021,Oxford 020A,E01028559,667,333,177,156,4,4,74,54,20,255,245,10,1
2021,Oxford 004A,E01028560,714,404,265,139,3,3,114,102,12,193,173,20,0
2021,Oxford 004B,E01028561,679,486,319,167,2,2,20,10,10,171,158,13,0
2021,Oxford 004C,E01028562,638,309,165,144,2,2,117,104,13,208,198,10,2
2021,Oxford 004D,E01028563,607,384,221,163,5,5,26,19,7,191,167,24,1
2021,Oxford 003A,E01028565,501,350,216,134,4,4,7,5,2,140,131,9,0
2021,Oxford 017D,E01028567,665,266,117,149,6,6,280,203,77,110,93,17,3
2021,Oxford 018B,E01028568,587,112,61,51,13,13,420,138,282,40,34,6,2
2021,Oxford 018C,E01028569,608,87,24,63,77,77,396,45,351,47,45,2,1
2021,Oxford 018D,E01028570,791,398,82,316,85,85,122,12,110,186,171,15,0
2021,Oxford 007B,E01028571,669,388,187,201,5,5,99,83,16,176,156,20,1
2021,Oxford 007C,E01028572,788,464,253,211,0,0,18,4,14,306,291,15,0
2021,Oxford 007D,E01028573,645,450,232,218,8,8,13,5,8,174,156,18,0
2021,Oxford 007E,E01028574,611,288,171,117,2,2,175,107,68,145,130,15,1
2021,Oxford 015E,E01028575,649,405,278,127,4,4,107,50,57,131,111,20,2
2021,Oxford 016E,E01028576,521,138,53,85,2,2,238,211,27,141,136,5,2
2021,Oxford 016F,E01028577,778,244,111,133,42,42,345,233,112,142,134,8,5
2021,Oxford 015F,E01028578,635,409,235,174,4,4,70,57,13,151,140,11,1
2021,Oxford 011A,E01028579,531,156,95,61,6,6,80,68,12,289,277,12,0
2021,Oxford 011B,E01028580,539,167,102,65,1,1,110,51,59,259,239,20,2
2021,Oxford 011C,E01028581,510,309,198,111,3,3,33,16,17,164,153,11,1
2021,Oxford 011D,E01028582,516,106,59,47,6,6,156,62,94,247,226,21,1
2021,Oxford 003C,E01028584,1052,613,404,209,28,28,114,27,87,297,265,32,0
2021,Oxford 011E,E01028586,620,226,136,90,1,1,83,23,60,310,300,10,0
2021,Oxford 011F,E01028587,686,186,107,79,6,6,108,22,86,385,364,21,1
2021,Oxford 011G,E01028588,466,113,71,42,0,0,39,14,25,314,293,21,0
2021,Oxford 002C,E01028591,525,312,228,84,1,1,36,9,27,176,137,39,0
2021,Oxford 002D,E01028592,461,227,156,71,5,5,17,6,11,212,167,45,0
2021,Oxford 001A,E01028594,672,500,333,167,3,3,42,11,31,127,119,8,0
2021,Oxford 001B,E01028595,663,439,253,186,20,20,110,65,45,93,81,12,1
2021,Oxford 001C,E01028596,632,418,253,165,4,4,61,55,6,148,138,10,1
2021,Oxford 001D,E01028597,636,324,189,135,4,4,143,133,10,164,154,10,1
2021,South Oxfordshire 005A,E01028598,1030,808,427,381,18,18,102,12,90,102,82,20,0
2021,South Oxfordshire 011A,E01028599,839,603,312,291,19,19,111,15,96,106,93,13,0
2021,South Oxfordshire 007A,E01028600,637,544,335,209,8,8,23,5,18,62,50,12,0
2021,South Oxfordshire 011B,E01028601,478,293,168,125,2,2,40,7,33,143,48,95,0
2021,South Oxfordshire 011C,E01028602,464,101,54,47,0,0,25,6,19,338,36,302,0
2021,South Oxfordshire 007B,E01028603,525,386,191,195,10,10,59,6,53,68,52,16,2
2021,South Oxfordshire 006A,E01028604,566,320,133,187,2,2,201,47,154,43,36,7,0
2021,South Oxfordshire 006B,E01028605,633,376,230,146,3,3,205,51,154,49,44,5,0
2021,South Oxfordshire 007C,E01028606,746,589,389,200,3,3,41,6,35,113,96,17,0
2021,South Oxfordshire 006C,E01028607,533,423,269,154,4,4,36,6,30,70,49,21,0
2021,South Oxfordshire 012A,E01028608,494,407,229,178,3,3,65,12,53,19,13,6,0
2021,South Oxfordshire 007D,E01028609,530,450,233,217,5,5,44,7,37,31,25,6,0
2021,South Oxfordshire 007E,E01028610,608,458,261,197,1,1,72,10,62,77,62,15,0
2021,South Oxfordshire 018A,E01028611,485,376,218,158,1,1,45,5,40,63,47,16,0
2021,South Oxfordshire 019A,E01028612,534,402,235,167,5,5,53,4,49,74,42,32,0
2021,South Oxfordshire 005B,E01028613,540,456,224,232,1,1,22,4,18,61,48,13,0
2021,South Oxfordshire 005C,E01028614,1026,708,275,433,52,52,194,25,169,72,62,10,0
2021,South Oxfordshire 005D,E01028615,795,655,418,237,16,16,54,6,48,70,46,24,0
2021,South Oxfordshire 005E,E01028616,722,577,276,301,16,16,66,7,59,63,54,9,0
2021,South Oxfordshire 012B,E01028617,876,684,365,319,20,20,77,10,67,95,83,12,0
2021,South Oxfordshire 015B,E01028619,752,533,281,252,6,6,141,22,119,72,62,10,0
2021,South Oxfordshire 010B,E01028622,859,567,253,314,60,60,63,17,46,166,128,38,3
2021,South Oxfordshire 010C,E01028623,685,419,200,219,4,4,107,16,91,155,143,12,0
2021,South Oxfordshire 010D,E01028624,882,656,288,368,23,23,84,12,72,118,98,20,1
2021,South Oxfordshire 009A,E01028625,781,501,155,346,9,9,13,1,12,258,249,9,0
2021,South Oxfordshire 009B,E01028626,620,462,165,297,2,2,4,1,3,152,142,10,0
2021,South Oxfordshire 009C,E01028627,623,393,157,236,13,13,58,7,51,159,150,9,0
2021,South Oxfordshire 009D,E01028628,688,482,178,304,26,26,51,12,39,129,115,14,0
2021,South Oxfordshire 009E,E01028629,621,362,139,223,9,9,49,5,44,201,195,6,0
2021,South Oxfordshire 013A,E01028630,697,403,174,229,12,12,37,1,36,245,239,6,0
2021,South Oxfordshire 013B,E01028631,486,321,171,150,2,2,67,11,56,96,91,5,0
2021,South Oxfordshire 013C,E01028632,551,308,137,171,2,2,175,42,133,66,51,15,0
2021,South Oxfordshire 013D,E01028633,702,320,160,160,8,8,192,34,158,182,173,9,0
2021,South Oxfordshire 014A,E01028634,514,463,248,215,1,1,9,1,8,41,31,10,0
2021,South Oxfordshire 014B,E01028635,648,431,222,209,3,3,133,22,111,81,77,4,0
2021,South Oxfordshire 014C,E01028636,584,260,152,108,1,1,222,36,186,93,79,14,8
2021,South Oxfordshire 014D,E01028637,854,657,294,363,42,42,68,9,59,87,74,13,0
2021,South Oxfordshire 002A,E01028638,639,501,331,170,5,5,46,6,40,87,59,28,0
2021,South Oxfordshire 002B,E01028639,583,399,215,184,9,9,73,12,61,102,90,12,0
2021,South Oxfordshire 002C,E01028640,577,396,243,153,0,0,91,11,80,90,60,30,0
2021,South Oxfordshire 006D,E01028641,529,451,314,137,3,3,7,0,7,68,58,10,0
2021,South Oxfordshire 018B,E01028642,556,439,234,205,6,6,58,4,54,53,29,24,0
2021,South Oxfordshire 018C,E01028643,552,426,244,182,3,3,46,4,42,76,60,16,1
2021,South Oxfordshire 015C,E01028644,743,519,308,211,13,13,85,8,77,125,108,17,1
2021,South Oxfordshire 018D,E01028645,650,550,380,170,1,1,10,0,10,89,76,13,0
2021,South Oxfordshire 004A,E01028646,492,330,195,135,2,2,92,10,82,68,51,17,0
2021,South Oxfordshire 004B,E01028647,646,483,289,194,5,5,51,4,47,107,84,23,0
2021,South Oxfordshire 015E,E01028649,610,470,278,192,3,3,64,10,54,73,49,24,0
2021,South Oxfordshire 016A,E01028650,847,620,336,284,7,7,100,18,82,120,109,11,0
2021,South Oxfordshire 016B,E01028651,785,465,312,153,2,2,212,29,183,105,90,15,1
2021,South Oxfordshire 016C,E01028652,1155,688,471,217,17,17,75,15,60,375,332,43,0
2021,South Oxfordshire 017A,E01028653,721,408,215,193,10,10,149,19,130,154,141,13,0
2021,South Oxfordshire 017B,E01028654,642,470,258,212,0,0,112,16,96,60,53,7,0
2021,South Oxfordshire 017C,E01028655,895,495,292,203,6,6,62,2,60,332,311,21,0
2021,South Oxfordshire 017D,E01028656,547,479,296,183,3,3,8,1,7,57,48,9,0
2021,South Oxfordshire 006E,E01028657,549,435,281,154,4,4,13,2,11,97,86,11,0
2021,South Oxfordshire 006F,E01028658,500,362,192,170,3,3,24,0,24,111,94,17,0
2021,South Oxfordshire 020A,E01028659,638,531,275,256,4,4,35,2,33,68,50,18,0
2021,South Oxfordshire 019B,E01028660,796,538,317,221,16,16,91,18,73,151,118,33,0
2021,South Oxfordshire 019C,E01028661,572,499,281,218,0,0,18,6,12,55,40,15,0
2021,South Oxfordshire 019D,E01028662,539,473,283,190,1,1,24,2,22,41,28,13,0
2021,South Oxfordshire 020B,E01028663,643,407,206,201,9,9,154,21,133,72,63,9,1
2021,South Oxfordshire 020C,E01028664,631,521,337,184,9,9,56,10,46,45,36,9,0
2021,South Oxfordshire 020D,E01028665,575,504,316,188,4,4,17,2,15,50,41,9,0
2021,South Oxfordshire 001A,E01028666,697,410,218,192,3,3,87,8,79,197,181,16,0
2021,South Oxfordshire 001B,E01028667,534,407,184,223,3,3,13,1,12,111,101,10,0
2021,South Oxfordshire 001C,E01028668,553,465,293,172,0,0,35,5,30,53,43,10,0
2021,South Oxfordshire 001D,E01028669,552,421,226,195,2,2,39,5,34,90,77,13,0
2021,South Oxfordshire 003A,E01028670,576,498,288,210,2,2,21,3,18,55,41,14,0
2021,South Oxfordshire 003B,E01028671,785,432,266,166,13,13,182,22,160,158,140,18,0
2021,South Oxfordshire 003C,E01028672,1097,821,460,361,46,46,147,10,137,83,57,26,0
2021,South Oxfordshire 003D,E01028673,803,491,188,303,26,26,172,19,153,114,97,17,0
2021,South Oxfordshire 012C,E01028674,566,445,257,188,23,23,56,7,49,42,36,6,0
2021,South Oxfordshire 012D,E01028675,510,325,151,174,2,2,137,22,115,46,36,10,0
2021,South Oxfordshire 012E,E01028676,968,529,233,296,32,32,277,46,231,130,113,17,0
2021,South Oxfordshire 012F,E01028677,790,425,282,143,26,26,125,18,107,214,182,32,0
2021,South Oxfordshire 008A,E01028678,668,484,272,212,6,6,53,14,39,125,100,25,0
2021,South Oxfordshire 008B,E01028679,882,579,310,269,4,4,121,16,105,177,139,38,1
2021,South Oxfordshire 008C,E01028680,789,584,357,227,10,10,66,5,61,129,111,18,0
2021,South Oxfordshire 004C,E01028681,548,480,315,165,3,3,8,0,8,57,45,12,0
2021,South Oxfordshire 004D,E01028682,522,385,231,154,1,1,80,12,68,56,48,8,0
2021,South Oxfordshire 002D,E01028683,611,523,343,180,8,8,27,4,23,53,44,9,0
2021,South Oxfordshire 004E,E01028684,667,451,259,192,1,1,44,4,40,171,148,23,0
2021,South Oxfordshire 018E,E01028685,514,404,253,151,7,7,59,6,53,43,35,8,1
2021,South Oxfordshire 018F,E01028686,514,375,206,169,4,4,73,12,61,62,35,27,0
2021,Vale of White Horse 005A,E01028688,502,367,194,173,1,1,65,14,51,69,64,5,0
2021,Vale of White Horse 005B,E01028689,634,375,186,189,5,5,106,83,23,146,134,12,2
2021,Vale of White Horse 008A,E01028690,710,430,265,165,3,3,149,23,126,127,117,10,1
2021,Vale of White Horse 008B,E01028691,765,460,235,225,15,15,225,39,186,64,51,13,1
2021,Vale of White Horse 008C,E01028692,517,201,99,102,3,3,270,60,210,42,32,10,1
2021,Vale of White Horse 004A,E01028693,602,538,316,222,0,0,7,2,5,57,49,8,0
2021,Vale of White Horse 004B,E01028694,610,439,211,228,3,3,10,0,10,158,146,12,0
2021,Vale of White Horse 005C,E01028695,645,541,303,238,1,1,18,4,14,85,58,27,0
2021,Vale of White Horse 006B,E01028696,537,475,298,177,1,1,13,0,13,48,29,19,0
2021,Vale of White Horse 006C,E01028697,690,342,158,184,5,5,202,32,170,137,125,12,4
2021,Vale of White Horse 006D,E01028698,665,435,206,229,4,4,61,4,57,165,147,18,0
2021,Vale of White Horse 005D,E01028699,647,540,314,226,1,1,18,3,15,88,80,8,0
2021,Vale of White Horse 006E,E01028700,712,330,152,178,2,2,301,38,263,79,69,10,0
2021,Vale of White Horse 004C,E01028701,639,461,247,214,5,5,96,19,77,77,68,9,0
2021,Vale of White Horse 008D,E01028702,512,432,238,194,0,0,45,4,41,35,28,7,0
2021,Vale of White Horse 006F,E01028703,850,374,177,197,29,29,236,22,214,208,187,21,3
2021,Vale of White Horse 008E,E01028704,881,538,335,203,21,21,174,27,147,147,123,24,1
2021,Vale of White Horse 004D,E01028705,485,437,262,175,4,4,2,1,1,42,36,6,0
2021,Vale of White Horse 004E,E01028706,597,493,284,209,3,3,7,0,7,94,86,8,0
2021,Vale of White Horse 004F,E01028707,605,533,281,252,3,3,13,1,12,56,50,6,0
2021,Vale of White Horse 001A,E01028708,777,548,323,225,5,5,90,13,77,132,112,20,2
2021,Vale of White Horse 001B,E01028709,786,632,395,237,1,1,23,1,22,130,117,13,0
2021,Vale of White Horse 001C,E01028710,818,649,362,287,21,21,48,4,44,98,73,25,2
2021,Vale of White Horse 001D,E01028711,674,489,296,193,1,1,84,10,74,100,83,17,0
2021,Vale of White Horse 015A,E01028712,948,735,463,272,6,6,101,11,90,106,73,33,0
2021,Vale of White Horse 016E,E01028713,1065,724,391,333,12,12,128,19,109,201,148,53,0
2021,Vale of White Horse 016F,E01028715,943,612,230,382,36,36,156,12,144,138,90,48,1
2021,Vale of White Horse 009A,E01028716,979,550,223,327,29,29,217,36,181,183,116,67,0
2021,Vale of White Horse 009B,E01028717,812,404,213,191,15,15,176,30,146,216,186,30,1
2021,Vale of White Horse 009C,E01028718,663,359,168,191,4,4,180,27,153,120,101,19,0
2021,Vale of White Horse 009D,E01028719,665,545,338,207,10,10,45,3,42,65,58,7,0
2021,Vale of White Horse 016G,E01028720,1115,817,491,326,10,10,160,19,141,128,91,37,0
2021,Vale of White Horse 011A,E01028721,518,427,193,234,8,8,14,2,12,69,60,9,0
2021,Vale of White Horse 011B,E01028722,700,514,347,167,4,4,42,6,36,140,83,57,0
2021,Vale of White Horse 011C,E01028723,926,633,316,317,35,35,202,28,174,56,40,16,0
2021,Vale of White Horse 011D,E01028724,514,457,274,183,2,2,20,1,19,35,29,6,0
2021,Vale of White Horse 011E,E01028725,1156,741,214,527,36,36,274,43,231,105,90,15,0
2021,Vale of White Horse 007A,E01028726,1162,893,467,426,31,31,109,18,91,129,99,30,0
2021,Vale of White Horse 015C,E01028728,532,343,159,184,7,7,134,17,117,48,42,6,0
2021,Vale of White Horse 015D,E01028729,726,534,221,313,19,19,81,16,65,92,76,16,0
2021,Vale of White Horse 015E,E01028730,662,417,262,155,3,3,51,3,48,191,157,34,0
2021,Vale of White Horse 010B,E01028731,841,537,244,293,29,29,218,23,195,57,43,14,0
2021,Vale of White Horse 010C,E01028732,706,481,203,278,16,16,105,17,88,104,90,14,0
2021,Vale of White Horse 002A,E01028733,565,432,263,169,0,0,49,7,42,84,69,15,0
2021,Vale of White Horse 002B,E01028734,648,520,305,215,5,5,10,2,8,113,86,27,0
2021,Vale of White Horse 002C,E01028735,660,503,295,208,5,5,71,10,61,81,67,14,0
2021,Vale of White Horse 007C,E01028737,982,751,445,306,5,5,70,15,55,156,124,32,0
2021,Vale of White Horse 003A,E01028738,450,153,80,73,0,0,45,7,38,252,47,205,0
2021,Vale of White Horse 003B,E01028739,935,630,332,298,26,26,166,28,138,113,88,25,0
2021,Vale of White Horse 002D,E01028740,679,514,261,253,3,3,7,1,6,155,132,23,0
2021,Vale of White Horse 002E,E01028741,643,470,234,236,9,9,50,6,44,114,108,6,0
2021,Vale of White Horse 002F,E01028742,912,469,245,224,18,18,158,23,135,267,238,29,0
2021,Vale of White Horse 003C,E01028743,438,317,247,70,4,4,20,8,12,95,29,66,2
2021,Vale of White Horse 003D,E01028744,543,443,290,153,1,1,37,9,28,62,38,24,0
2021,Vale of White Horse 016A,E01028745,728,469,279,190,24,24,79,8,71,156,76,80,0
2021,Vale of White Horse 016B,E01028746,650,481,284,197,16,16,104,13,91,49,40,9,0
2021,Vale of White Horse 016C,E01028747,564,296,124,172,13,13,69,8,61,186,48,138,0
2021,Vale of White Horse 016D,E01028748,567,241,111,130,15,15,122,15,107,189,78,111,0
2021,Vale of White Horse 009E,E01028749,1112,810,433,377,21,21,143,20,123,137,102,35,1
2021,Vale of White Horse 003E,E01028750,567,320,177,143,2,2,167,38,129,78,44,34,0
2021,Vale of White Horse 003F,E01028751,586,490,328,162,3,3,30,4,26,63,53,10,0
2021,Vale of White Horse 003G,E01028752,673,531,310,221,3,3,59,11,48,80,70,10,0
2021,Vale of White Horse 010D,E01028753,711,455,227,228,8,8,185,29,156,63,53,10,0
2021,Vale of White Horse 010E,E01028754,657,525,267,258,13,13,55,6,49,64,56,8,0
2021,Vale of White Horse 014A,E01028755,781,582,300,282,9,9,136,25,111,53,38,15,1
2021,Vale of White Horse 015F,E01028757,958,496,238,258,84,84,273,40,233,104,95,9,1
2021,Vale of White Horse 014C,E01028758,695,612,344,268,3,3,42,3,39,38,36,2,0
2021,Vale of White Horse 014D,E01028759,727,471,218,253,16,16,168,14,154,72,59,13,0
2021,Vale of White Horse 014E,E01028760,492,351,212,139,3,3,73,11,62,65,46,19,0
2021,Vale of White Horse 014F,E01028761,513,374,221,153,10,10,85,7,78,44,34,10,0
2021,West Oxfordshire 012A,E01028762,769,510,281,229,6,6,91,17,74,162,113,49,0
2021,West Oxfordshire 003A,E01028763,913,692,416,276,14,14,103,13,90,104,86,18,0
2021,West Oxfordshire 015A,E01028764,762,604,371,233,7,7,24,6,18,127,106,21,0
2021,West Oxfordshire 015B,E01028765,1006,619,335,284,37,37,251,42,209,99,76,23,0
2021,West Oxfordshire 012C,E01028767,887,567,399,168,10,10,175,17,158,134,103,31,1
2021,West Oxfordshire 014A,E01028771,675,398,232,166,5,5,146,17,129,126,110,16,0
2021,West Oxfordshire 013D,E01028772,1002,744,284,460,28,28,58,9,49,172,165,7,0
2021,West Oxfordshire 014B,E01028773,599,409,244,165,4,4,55,5,50,131,106,25,0
2021,West Oxfordshire 014C,E01028774,564,242,137,105,7,7,70,14,56,245,65,180,0
2021,West Oxfordshire 014D,E01028775,563,413,255,158,3,3,6,0,6,141,129,12,0
2021,West Oxfordshire 003B,E01028776,828,559,352,207,3,3,75,11,64,190,135,55,1
2021,West Oxfordshire 005A,E01028777,553,401,255,146,8,8,48,5,43,96,79,17,0
2021,West Oxfordshire 005B,E01028778,688,467,315,152,8,8,143,15,128,70,57,13,0
2021,West Oxfordshire 005C,E01028779,490,386,230,156,7,7,48,2,46,49,40,9,0
2021,West Oxfordshire 001A,E01028780,1032,725,436,289,20,20,79,10,69,208,176,32,0
2021,West Oxfordshire 001B,E01028781,725,352,149,203,25,25,309,64,245,38,30,8,1
2021,West Oxfordshire 001C,E01028782,663,539,332,207,1,1,32,5,27,91,71,20,0
2021,West Oxfordshire 001D,E01028783,836,507,334,173,9,9,139,28,111,181,167,14,0
2021,West Oxfordshire 007A,E01028784,1023,735,439,296,22,22,130,18,112,136,101,35,0
2021,West Oxfordshire 011A,E01028785,703,498,293,205,4,4,73,15,58,128,116,12,0
2021,West Oxfordshire 011B,E01028786,615,473,308,165,27,27,55,6,49,60,49,11,0
2021,West Oxfordshire 011C,E01028787,597,307,176,131,8,8,193,36,157,89,76,13,0
2021,West Oxfordshire 006A,E01028788,872,613,384,229,22,22,74,3,71,163,136,27,0
2021,West Oxfordshire 006B,E01028789,810,594,335,259,16,16,63,8,55,137,108,29,0
2021,West Oxfordshire 006C,E01028790,632,426,219,207,26,26,124,13,111,56,41,15,0
2021,West Oxfordshire 006D,E01028791,610,541,339,202,1,1,13,3,10,55,47,8,0
2021,West Oxfordshire 007B,E01028792,462,371,229,142,7,7,14,3,11,70,56,14,0
2021,West Oxfordshire 007C,E01028793,634,476,266,210,6,6,88,11,77,64,48,16,0
2021,West Oxfordshire 007D,E01028794,606,499,327,172,5,5,32,12,20,70,45,25,0
2021,West Oxfordshire 002A,E01028795,678,465,279,186,2,2,74,9,65,137,90,47,0
2021,West Oxfordshire 002B,E01028796,527,309,201,108,10,10,76,10,66,132,81,51,0
2021,West Oxfordshire 002C,E01028797,525,370,223,147,8,8,70,3,67,77,60,17,0
2021,West Oxfordshire 003C,E01028798,990,680,398,282,24,24,136,15,121,150,114,36,0
2021,West Oxfordshire 005D,E01028799,888,661,391,270,20,20,112,13,99,94,75,19,1
2021,West Oxfordshire 011D,E01028800,622,393,226,167,7,7,116,34,82,106,86,20,0
2021,West Oxfordshire 015C,E01028801,613,473,279,194,12,12,71,8,63,56,45,11,1
2021,West Oxfordshire 015D,E01028802,653,544,334,210,11,11,18,6,12,79,54,25,1
2021,West Oxfordshire 004B,E01028804,601,458,276,182,5,5,52,4,48,86,72,14,0
2021,West Oxfordshire 002D,E01028806,825,611,338,273,2,2,71,15,56,141,100,41,0
2021,West Oxfordshire 010A,E01028807,1057,542,341,201,31,31,126,12,114,358,324,34,0
2021,West Oxfordshire 010B,E01028808,966,548,296,252,89,89,220,17,203,108,97,11,1
2021,West Oxfordshire 009A,E01028809,532,110,69,41,0,0,395,14,381,27,23,4,0
2021,West Oxfordshire 008A,E01028810,592,443,218,225,6,6,12,1,11,131,118,13,0
2021,West Oxfordshire 008B,E01028811,615,321,168,153,4,4,222,35,187,68,59,9,0
2021,West Oxfordshire 008D,E01028813,521,289,137,152,3,3,172,19,153,57,53,4,0
2021,West Oxfordshire 008E,E01028814,652,526,315,211,6,6,10,0,10,110,100,10,0
2021,West Oxfordshire 008F,E01028815,514,471,309,162,1,1,3,0,3,39,31,8,0
2021,West Oxfordshire 010C,E01028816,496,366,210,156,8,8,32,2,30,90,80,10,0
2021,West Oxfordshire 010D,E01028817,597,423,228,195,13,13,75,3,72,86,79,7,0
2021,West Oxfordshire 010E,E01028818,865,539,363,176,9,9,73,5,68,244,214,30,0
2021,West Oxfordshire 010F,E01028819,897,442,276,166,32,32,312,43,269,111,86,25,0
2021,West Oxfordshire 009B,E01028820,1136,823,297,526,69,69,128,11,117,116,94,22,0
2021,West Oxfordshire 009C,E01028821,635,412,163,249,10,10,76,5,71,136,125,11,1
2021,West Oxfordshire 009D,E01028822,645,511,263,248,17,17,6,0,6,111,104,7,0
2021,West Oxfordshire 004D,E01028823,648,419,259,160,4,4,56,7,49,169,155,14,0
2021,West Oxfordshire 004E,E01028824,798,516,297,219,28,28,114,12,102,140,125,15,0
2021,West Oxfordshire 004F,E01028825,564,407,226,181,4,4,38,3,35,115,92,23,0
2021,Shropshire 027A,E01028826,789,545,379,166,3,3,121,80,41,119,102,17,1
2021,Shropshire 027B,E01028827,603,365,206,159,5,5,150,103,47,81,48,33,2
2021,Shropshire 034A,E01028828,689,455,275,180,6,6,95,44,51,128,95,33,5
2021,Shropshire 034B,E01028829,573,482,335,147,2,2,44,23,21,45,35,10,0
2021,Shropshire 031A,E01028830,724,533,384,149,3,3,21,2,19,167,145,22,0
2021,Shropshire 031B,E01028831,640,545,328,217,2,2,24,0,24,69,53,16,0
2021,Shropshire 033A,E01028832,872,512,327,185,1,1,122,26,96,236,208,28,1
2021,Shropshire 033B,E01028833,655,453,299,154,0,0,70,21,49,132,116,16,0
2021,Shropshire 033C,E01028834,703,539,351,188,3,3,83,68,15,76,59,17,2
2021,Shropshire 033D,E01028835,692,511,286,225,7,7,70,45,25,102,96,6,2
2021,Shropshire 031C,E01028836,637,340,186,154,4,4,223,156,67,68,56,12,2
2021,Shropshire 031D,E01028837,638,523,346,177,7,7,25,11,14,83,72,11,0
2021,Shropshire 029A,E01028838,755,395,237,158,18,18,222,133,89,118,103,15,2
2021,Shropshire 029B,E01028839,599,516,345,171,4,4,14,2,12,65,55,10,0
2021,Shropshire 029C,E01028840,556,449,243,206,0,0,53,39,14,54,46,8,0
2021,Shropshire 029D,E01028841,687,337,217,120,2,2,139,91,48,207,190,17,2
2021,Shropshire 034C,E01028842,701,533,317,216,5,5,48,22,26,115,97,18,0
2021,Shropshire 035A,E01028843,700,463,329,134,3,3,56,18,38,178,152,26,0
2021,Shropshire 027C,E01028844,445,140,103,37,0,0,22,2,20,283,109,174,0
2021,Shropshire 027D,E01028845,894,761,536,225,1,1,23,8,15,108,85,23,1
2021,Shropshire 035B,E01028846,820,640,443,197,1,1,45,24,21,134,102,32,0
2021,Shropshire 034D,E01028847,606,370,236,134,2,2,48,30,18,186,151,35,0
2021,Shropshire 035C,E01028848,772,689,457,232,12,12,10,3,7,61,47,14,0
2021,Shropshire 035D,E01028849,898,446,273,173,9,9,259,161,98,182,153,29,2
2021,Shropshire 029E,E01028850,1027,644,363,281,13,13,129,22,107,241,213,28,0
2021,Shropshire 029F,E01028851,842,612,466,146,17,17,80,24,56,132,104,28,1
2021,Shropshire 029G,E01028852,711,455,320,135,0,0,122,90,32,134,114,20,0
2021,Shropshire 025A,E01028853,607,269,151,118,4,4,274,188,86,58,54,4,2
2021,Shropshire 025B,E01028854,645,480,300,180,3,3,62,12,50,100,83,17,0
2021,Shropshire 025C,E01028855,1164,903,398,505,12,12,83,19,64,166,142,24,0
2021,Shropshire 025D,E01028856,785,503,230,273,21,21,128,45,83,132,111,21,1
2021,Shropshire 035E,E01028858,939,745,579,166,2,2,53,18,35,139,119,20,0
2021,Shropshire 034E,E01028859,671,432,256,176,1,1,41,33,8,196,170,26,1
2021,Shropshire 010A,E01028860,941,720,383,337,17,17,102,12,90,102,88,14,0
2021,Shropshire 013A,E01028861,612,419,229,190,13,13,40,6,34,140,116,24,0
2021,Shropshire 010B,E01028862,731,594,355,239,6,6,43,9,34,88,67,21,0
2021,Shropshire 010C,E01028863,568,426,269,157,2,2,65,8,57,75,55,20,0
2021,Shropshire 004A,E01028864,664,499,333,166,2,2,56,10,46,107,90,17,0
2021,Shropshire 004B,E01028865,823,669,481,188,1,1,48,6,42,105,95,10,0
2021,Shropshire 004C,E01028866,672,410,277,133,3,3,41,9,32,218,199,19,0
2021,Shropshire 004D,E01028867,774,505,284,221,4,4,157,28,129,107,93,14,1
2021,Shropshire 009A,E01028868,596,471,289,182,2,2,61,10,51,62,51,11,0
2021,Shropshire 009B,E01028869,676,537,277,260,4,4,70,16,54,65,52,13,0
2021,Shropshire 013B,E01028870,611,505,312,193,2,2,34,5,29,70,49,21,0
2021,Shropshire 009C,E01028871,521,336,189,147,9,9,80,10,70,96,73,23,0
2021,Shropshire 004E,E01028872,599,469,304,165,1,1,21,4,17,108,90,18,0
2021,Shropshire 005A,E01028873,957,349,214,135,6,6,314,76,238,287,271,16,1
2021,Shropshire 005B,E01028874,672,522,388,134,3,3,72,12,60,75,61,14,0
2021,Shropshire 005C,E01028875,1113,848,420,428,15,15,108,21,87,142,132,10,0
2021,Shropshire 005D,E01028876,834,472,259,213,8,8,168,33,135,185,166,19,1
2021,Shropshire 005E,E01028877,550,474,293,181,3,3,17,6,11,56,42,14,0
2021,Shropshire 005F,E01028878,679,493,302,191,1,1,62,11,51,123,110,13,0
2021,Shropshire 005G,E01028879,664,392,219,173,2,2,165,49,116,105,94,11,0
2021,Shropshire 002A,E01028880,718,525,309,216,5,5,113,26,87,74,54,20,1
2021,Shropshire 002B,E01028881,580,493,346,147,5,5,9,4,5,73,54,19,0
2021,Shropshire 002C,E01028882,659,445,271,174,1,1,38,6,32,175,143,32,0
2021,Shropshire 013C,E01028883,583,328,173,155,14,14,46,6,40,195,88,107,0
2021,Shropshire 013D,E01028884,643,439,243,196,3,3,137,14,123,64,53,11,0
2021,Shropshire 008A,E01028886,798,428,239,189,9,9,172,25,147,188,170,18,1
2021,Shropshire 008B,E01028887,719,586,367,219,0,0,59,6,53,74,60,14,0
2021,Shropshire 010D,E01028888,680,544,320,224,11,11,43,4,39,82,66,16,0
2021,Shropshire 008C,E01028889,655,526,390,136,1,1,37,6,31,90,76,14,1
2021,Shropshire 008D,E01028890,650,379,242,137,1,1,120,15,105,150,134,16,0
2021,Shropshire 001A,E01028891,847,366,222,144,5,5,161,31,130,314,290,24,1
2021,Shropshire 001B,E01028892,814,701,453,248,8,8,24,6,18,81,66,15,0
2021,Shropshire 002D,E01028893,644,529,328,201,2,2,42,6,36,71,46,25,0
2021,Shropshire 001C,E01028894,592,382,212,170,12,12,136,21,115,62,53,9,0
2021,Shropshire 001D,E01028895,717,439,258,181,4,4,109,25,84,165,151,14,0
2021,Shropshire 001E,E01028896,943,583,359,224,10,10,124,21,103,226,207,19,0
2021,Shropshire 001F,E01028897,657,489,295,194,1,1,110,30,80,55,42,13,2
2021,Shropshire 010E,E01028898,613,506,326,180,3,3,30,11,19,74,59,15,0
2021,Shropshire 002E,E01028899,808,660,372,288,7,7,64,11,53,77,61,16,0
2021,Shropshire 006C,E01028902,564,415,297,118,10,10,53,13,40,86,68,18,0
2021,Shropshire 006D,E01028903,621,340,247,93,4,4,214,138,76,59,54,5,4
2021,Shropshire 006E,E01028904,632,401,216,185,3,3,140,81,59,85,74,11,3
2021,Shropshire 006F,E01028905,774,360,165,195,2,2,253,117,136,158,146,12,1
2021,Shropshire 007A,E01028906,697,205,127,78,1,1,127,23,104,364,337,27,0
2021,Shropshire 007B,E01028907,895,689,421,268,1,1,30,8,22,175,157,18,0
2021,Shropshire 007C,E01028908,751,237,127,110,14,14,210,109,101,289,273,16,1
2021,Shropshire 006G,E01028909,620,360,171,189,6,6,167,113,54,86,70,16,1
2021,Shropshire 003A,E01028910,535,457,282,175,8,8,10,1,9,60,44,16,0
2021,Shropshire 003B,E01028911,556,478,305,173,3,3,26,12,14,49,36,13,0
2021,Shropshire 003C,E01028912,627,292,137,155,5,5,226,126,100,101,85,16,3
2021,Shropshire 011A,E01028913,737,597,395,202,3,3,46,30,16,91,68,23,0
2021,Shropshire 012A,E01028914,464,360,226,134,4,4,42,29,13,58,39,19,0
2021,Shropshire 012B,E01028915,662,533,320,213,1,1,55,27,28,73,59,14,0
2021,Shropshire 007D,E01028916,701,609,453,156,1,1,30,20,10,61,49,12,0
2021,Shropshire 007E,E01028917,643,430,247,183,0,0,30,4,26,183,166,17,0
2021,Shropshire 011B,E01028918,643,444,265,179,7,7,68,36,32,124,98,26,0
2021,Shropshire 011C,E01028919,502,389,221,168,0,0,39,19,20,74,52,22,0
2021,Shropshire 003D,E01028920,533,356,227,129,1,1,124,77,47,48,31,17,4
2021,Shropshire 003E,E01028921,785,571,322,249,5,5,116,42,74,93,75,18,0
2021,Shropshire 012C,E01028922,509,408,262,146,2,2,12,7,5,87,65,22,0
2021,Shropshire 012D,E01028923,662,551,366,185,7,7,37,15,22,67,50,17,0
2021,Shropshire 007F,E01028924,792,522,272,250,8,8,166,80,86,94,77,17,2
2021,Shropshire 003F,E01028925,541,467,309,158,0,0,6,5,1,68,54,14,0
2021,Shropshire 003G,E01028926,611,352,212,140,0,0,154,97,57,105,84,21,0
2021,Shropshire 011D,E01028927,499,404,238,166,4,4,26,13,13,65,61,4,0
2021,Shropshire 011E,E01028928,695,496,300,196,4,4,123,69,54,71,61,10,1
2021,Shropshire 014A,E01028929,601,490,304,186,3,3,9,1,8,99,84,15,0
2021,Shropshire 017A,E01028930,786,581,279,302,8,8,53,5,48,144,131,13,0
2021,Shropshire 017B,E01028931,1059,508,247,261,17,17,213,45,168,320,289,31,1
2021,Shropshire 015A,E01028933,643,448,234,214,8,8,79,28,51,108,93,15,0
2021,Shropshire 015B,E01028934,598,291,165,126,8,8,241,101,140,58,48,10,0
2021,Shropshire 024A,E01028935,666,591,366,225,11,11,17,4,13,47,37,10,0
2021,Shropshire 024B,E01028936,918,761,480,281,11,11,27,8,19,119,99,20,0
2021,Shropshire 024C,E01028937,619,483,283,200,3,3,74,15,59,58,55,3,1
2021,Shropshire 022A,E01028938,825,500,310,190,2,2,82,17,65,241,216,25,0
2021,Shropshire 022B,E01028939,800,489,261,228,9,9,47,6,41,255,243,12,0
2021,Shropshire 023A,E01028940,683,537,318,219,2,2,72,21,51,72,63,9,0
2021,Shropshire 020B,E01028942,695,548,263,285,3,3,39,5,34,104,90,14,1
2021,Shropshire 020C,E01028943,1105,704,387,317,12,12,44,11,33,345,315,30,0
2021,Shropshire 017C,E01028944,984,558,335,223,15,15,194,60,134,216,199,17,1
2021,Shropshire 017D,E01028945,1010,474,244,230,2,2,188,56,132,345,318,27,1
2021,Shropshire 021A,E01028947,778,689,472,217,8,8,30,7,23,51,39,12,0
2021,Shropshire 021B,E01028948,629,424,284,140,0,0,154,48,106,49,42,7,2
2021,Shropshire 021C,E01028949,693,569,361,208,4,4,32,7,25,88,69,19,0
2021,Shropshire 028A,E01028950,1067,799,500,299,11,11,100,16,84,155,124,31,2
2021,Shropshire 020D,E01028951,855,627,357,270,3,3,139,23,116,85,76,9,1
2021,Shropshire 023B,E01028952,772,582,381,201,7,7,7,0,7,176,157,19,0
2021,Shropshire 020E,E01028953,648,571,352,219,4,4,12,1,11,61,53,8,0
2021,Shropshire 026A,E01028954,545,449,310,139,3,3,27,6,21,66,48,18,0
2021,Shropshire 026B,E01028955,552,351,194,157,12,12,152,43,109,36,24,12,1
2021,Shropshire 015C,E01028956,633,517,318,199,1,1,46,13,33,69,61,8,0
2021,Shropshire 015D,E01028957,658,155,80,75,2,2,426,153,273,73,63,10,2
2021,Shropshire 015E,E01028958,744,452,256,196,2,2,193,47,146,97,81,16,0
2021,Shropshire 028B,E01028960,617,492,344,148,1,1,19,11,8,105,87,18,0
2021,Shropshire 028C,E01028961,528,353,219,134,4,4,25,4,21,146,107,39,0
2021,Shropshire 023C,E01028962,650,246,117,129,1,1,338,109,229,64,56,8,1
2021,Shropshire 023D,E01028963,652,586,367,219,0,0,13,4,9,53,40,13,0
2021,Shropshire 023E,E01028964,837,710,414,296,9,9,26,1,25,92,76,16,0
2021,Shropshire 018A,E01028965,615,345,199,146,13,13,175,46,129,82,65,17,0
2021,Shropshire 018B,E01028966,521,470,274,196,3,3,18,2,16,30,18,12,0
2021,Shropshire 018C,E01028967,639,227,107,120,0,0,347,118,229,62,57,5,3
2021,Shropshire 018D,E01028968,569,354,184,170,0,0,159,35,124,56,50,6,0
2021,Shropshire 014B,E01028969,621,461,261,200,5,5,67,8,59,87,75,12,1
2021,Shropshire 014C,E01028970,608,406,260,146,1,1,101,18,83,100,81,19,0
2021,Shropshire 014D,E01028971,994,679,426,253,16,16,127,21,106,172,149,23,0
2021,Shropshire 019B,E01028972,825,698,434,264,12,12,24,3,21,91,63,28,0
2021,Shropshire 019C,E01028973,968,499,284,215,3,3,145,27,118,320,285,35,1
2021,Shropshire 023F,E01028974,490,381,232,149,3,3,24,2,22,82,51,31,0
2021,Shropshire 026C,E01028975,831,522,292,230,14,14,175,43,132,118,98,20,2
2021,Shropshire 026D,E01028976,743,641,437,204,0,0,13,6,7,89,75,14,0
2021,Shropshire 026E,E01028977,875,648,422,226,10,10,109,27,82,108,80,28,0
2021,Shropshire 014E,E01028978,679,486,270,216,4,4,79,18,61,110,93,17,0
2021,Shropshire 014F,E01028979,502,347,198,149,11,11,78,21,57,66,49,17,0
2021,Shropshire 028D,E01028980,955,642,418,224,2,2,96,17,79,215,189,26,0
2021,Shropshire 016B,E01028981,715,517,279,238,12,12,80,19,61,106,84,22,0
2021,Shropshire 016C,E01028982,636,417,198,219,0,0,124,47,77,94,73,21,1
2021,Shropshire 016D,E01028983,795,373,191,182,2,2,356,129,227,62,52,10,2
2021,Shropshire 022C,E01028984,664,374,232,142,1,1,172,43,129,115,102,13,2
2021,Shropshire 021D,E01028985,631,494,336,158,2,2,21,2,19,114,103,11,0
2021,Shropshire 022D,E01028986,952,785,412,373,7,7,69,8,61,91,76,15,0
2021,Shropshire 018E,E01028988,723,485,256,229,24,24,101,34,67,112,103,9,1
2021,Shropshire 018F,E01028989,633,369,209,160,4,4,194,56,138,65,57,8,1
2021,Shropshire 032A,E01028990,482,360,247,113,4,4,42,9,33,76,56,20,0
2021,Shropshire 030B,E01028992,723,425,321,104,9,9,150,12,138,138,111,27,1
2021,Shropshire 036A,E01028993,621,445,306,139,2,2,29,7,22,145,122,23,0
2021,Shropshire 037A,E01028994,552,391,303,88,3,3,74,4,70,84,67,17,0
2021,Shropshire 039A,E01028995,636,452,294,158,0,0,80,7,73,104,89,15,0
2021,Shropshire 039B,E01028996,560,471,343,128,6,6,15,3,12,68,50,18,0
2021,Shropshire 032B,E01028997,1146,859,696,163,21,21,152,17,135,114,94,20,0
2021,Shropshire 032C,E01028998,1110,847,678,169,4,4,93,13,80,166,138,28,0
2021,Shropshire 039C,E01028999,670,520,373,147,4,4,56,7,49,90,65,25,0
2021,Shropshire 039D,E01029000,497,434,330,104,1,1,18,1,17,44,34,10,0
2021,Shropshire 039E,E01029001,906,704,449,255,8,8,75,7,68,119,102,17,0
2021,Shropshire 039F,E01029002,605,346,204,142,1,1,138,18,120,120,105,15,0
2021,Shropshire 037B,E01029003,1032,818,665,153,10,10,53,8,45,151,112,39,0
2021,Shropshire 037C,E01029005,537,388,301,87,0,0,25,4,21,124,105,19,0
2021,Shropshire 038A,E01029006,733,498,367,131,9,9,136,29,107,90,81,9,0
2021,Shropshire 038B,E01029007,484,202,135,67,5,5,215,30,185,62,54,8,0
2021,Shropshire 038D,E01029009,549,433,316,117,4,4,12,3,9,100,87,13,0
2021,Shropshire 038E,E01029010,557,318,197,121,8,8,124,16,108,107,91,16,0
2021,Shropshire 038F,E01029011,666,419,303,116,9,9,134,11,123,104,85,19,0
2021,Shropshire 038G,E01029012,788,550,357,193,36,36,69,6,63,133,120,13,0
2021,Shropshire 036C,E01029013,789,517,374,143,15,15,69,5,64,188,159,29,0
2021,Shropshire 036D,E01029014,497,200,111,89,2,2,207,29,178,88,78,10,0
2021,Shropshire 037D,E01029016,621,471,359,112,10,10,26,1,25,114,86,28,0
2021,Mendip 006A,E01029018,973,768,415,353,1,1,52,8,44,151,123,28,1
2021,Mendip 013A,E01029019,1099,871,559,312,14,14,49,5,44,165,128,37,0
2021,Mendip 010A,E01029020,626,457,264,193,4,4,77,15,62,88,70,18,0
2021,Mendip 010B,E01029021,517,423,256,167,3,3,21,4,17,70,48,22,0
2021,Mendip 001A,E01029022,645,512,311,201,7,7,32,11,21,94,72,22,0
2021,Mendip 001B,E01029023,565,416,261,155,10,10,68,16,52,71,58,13,0
2021,Mendip 002A,E01029024,932,690,402,288,13,13,109,19,90,120,103,17,0
2021,Mendip 002B,E01029025,578,336,185,151,8,8,160,42,118,73,61,12,1
2021,Mendip 010C,E01029027,611,456,269,187,12,12,60,11,49,83,68,15,0
2021,Mendip 010D,E01029028,558,375,240,135,4,4,69,15,54,110,102,8,0
2021,Mendip 007A,E01029029,737,394,241,153,8,8,221,76,145,114,102,12,0
2021,Mendip 003A,E01029030,788,682,396,286,1,1,8,2,6,97,86,11,0
2021,Mendip 003B,E01029031,678,580,360,220,2,2,13,5,8,83,76,7,0
2021,Mendip 003C,E01029032,505,461,364,97,0,0,3,1,2,41,39,2,0
2021,Mendip 003D,E01029033,627,480,291,189,3,3,8,1,7,136,124,12,0
2021,Mendip 003E,E01029034,592,446,250,196,0,0,8,0,8,138,132,6,0
2021,Mendip 004A,E01029036,867,391,220,171,22,22,206,66,140,247,230,17,1
2021,Mendip 007C,E01029037,629,422,205,217,3,3,88,19,69,115,105,10,1
2021,Mendip 007D,E01029038,666,373,174,199,12,12,165,58,107,116,103,13,0
2021,Mendip 007E,E01029039,643,487,314,173,4,4,74,19,55,77,62,15,1
2021,Mendip 007F,E01029040,734,506,299,207,8,8,69,18,51,151,131,20,0
2021,Mendip 004B,E01029041,986,462,237,225,16,16,269,47,222,239,213,26,0
2021,Mendip 004C,E01029042,689,260,144,116,2,2,276,69,207,150,136,14,1
2021,Mendip 004D,E01029043,705,484,212,272,14,14,108,17,91,99,84,15,0
2021,Mendip 001C,E01029044,599,390,195,195,1,1,84,20,64,123,113,10,1
2021,Mendip 004E,E01029045,709,455,254,201,10,10,118,14,104,126,112,14,0
2021,Mendip 011A,E01029046,802,329,217,112,17,17,130,8,122,326,306,20,0
2021,Mendip 012A,E01029047,610,418,265,153,7,7,62,4,58,123,112,11,0
2021,Mendip 011D,E01029050,1187,771,459,312,51,51,194,22,172,170,153,17,1
2021,Mendip 011E,E01029051,701,555,408,147,1,1,44,4,40,101,86,15,0
2021,Mendip 005A,E01029052,876,651,423,228,2,2,119,28,91,104,88,16,0
2021,Mendip 001D,E01029053,979,714,449,265,3,3,51,15,36,211,174,37,0
2021,Mendip 012B,E01029054,688,537,284,253,5,5,52,5,47,94,72,22,0
2021,Mendip 012C,E01029055,514,413,259,154,7,7,24,7,17,70,54,16,0
2021,Mendip 006B,E01029056,969,711,423,288,3,3,15,2,13,240,196,44,0
2021,Mendip 001E,E01029057,944,727,437,290,6,6,76,8,68,135,101,34,0
2021,Mendip 010E,E01029058,952,710,470,240,3,3,94,13,81,143,113,30,2
2021,Mendip 013B,E01029059,924,724,498,226,3,3,65,9,56,132,92,40,0
2021,Mendip 005B,E01029060,812,649,415,234,3,3,32,5,27,128,102,26,0
2021,Mendip 009A,E01029062,726,199,97,102,11,11,202,49,153,312,296,16,2
2021,Mendip 009B,E01029063,1093,723,334,389,29,29,118,18,100,223,205,18,0
2021,Mendip 006C,E01029064,681,504,289,215,2,2,20,1,19,155,140,15,0
2021,Mendip 009C,E01029065,660,554,290,264,11,11,18,2,16,77,63,14,0
2021,Mendip 009D,E01029066,748,508,284,224,5,5,78,14,64,157,145,12,0
2021,Mendip 009E,E01029067,736,432,232,200,10,10,202,44,158,92,85,7,0
2021,Mendip 002D,E01029068,506,284,164,120,0,0,105,5,100,117,92,25,0
2021,Mendip 014A,E01029070,1118,670,317,353,23,23,99,9,90,326,297,29,0
2021,Mendip 014B,E01029071,705,420,236,184,7,7,122,24,98,156,131,25,0
2021,Mendip 014C,E01029072,763,316,146,170,27,27,277,35,242,143,124,19,0
2021,Mendip 014D,E01029073,556,321,190,131,2,2,94,11,83,138,117,21,1
2021,Mendip 012D,E01029074,547,452,298,154,2,2,20,4,16,73,54,19,0
2021,Mendip 014E,E01029075,641,417,275,142,9,9,110,24,86,103,88,15,2
2021,Mendip 012E,E01029076,922,745,441,304,10,10,43,6,37,124,97,27,0
2021,Mendip 013C,E01029077,851,654,416,238,1,1,41,10,31,155,98,57,0
2021,Mendip 008A,E01029078,989,637,486,151,11,11,96,6,90,245,212,33,0
2021,Mendip 008B,E01029079,754,389,251,138,6,6,219,56,163,139,131,8,1
2021,Mendip 008C,E01029080,785,552,341,211,21,21,100,9,91,111,95,16,1
2021,Mendip 008D,E01029081,957,600,389,211,32,32,103,19,84,222,195,27,0
2021,Mendip 008E,E01029082,657,536,386,150,9,9,12,2,10,100,86,14,0
2021,Mendip 005D,E01029083,554,441,342,99,0,0,17,1,16,96,58,38,0
2021,Mendip 006D,E01029084,670,477,313,164,3,3,113,38,75,77,67,10,0
2021,Sedgemoor 001A,E01029085,882,619,342,277,6,6,106,65,41,151,130,21,0
2021,Sedgemoor 003A,E01029086,905,782,474,308,2,2,23,15,8,98,68,30,0
2021,Sedgemoor 002C,E01029089,917,735,428,307,12,12,74,43,31,96,79,17,0
2021,Sedgemoor 010B,E01029091,739,483,218,265,1,1,7,4,3,248,231,17,0
2021,Sedgemoor 010C,E01029092,609,476,206,270,10,10,7,4,3,115,101,14,1
2021,Sedgemoor 008A,E01029093,729,320,164,156,0,0,137,16,121,272,259,13,0
2021,Sedgemoor 009A,E01029094,848,487,222,265,2,2,19,8,11,340,318,22,0
2021,Sedgemoor 009B,E01029095,833,259,126,133,3,3,159,47,112,412,390,22,0
2021,Sedgemoor 008B,E01029096,687,396,182,214,24,24,88,42,46,179,159,20,0
2021,Sedgemoor 013A,E01029097,614,268,140,128,2,2,183,90,93,159,151,8,2
2021,Sedgemoor 013B,E01029098,798,353,160,193,5,5,209,78,131,230,205,25,1
2021,Sedgemoor 013C,E01029099,497,251,123,128,1,1,168,124,44,72,66,6,5
2021,Sedgemoor 013D,E01029100,538,235,113,122,0,0,212,138,74,90,79,11,1
2021,Sedgemoor 014A,E01029101,479,338,180,158,7,7,68,42,26,65,56,9,1
2021,Sedgemoor 011A,E01029102,834,536,239,297,5,5,120,64,56,172,156,16,1
2021,Sedgemoor 011B,E01029103,610,562,358,204,3,3,4,2,2,41,34,7,0
2021,Sedgemoor 011C,E01029104,771,637,311,326,19,19,57,7,50,58,44,14,0
2021,Sedgemoor 013E,E01029105,794,286,159,127,3,3,407,270,137,91,80,11,7
2021,Sedgemoor 008C,E01029106,636,194,115,79,1,1,376,321,55,62,50,12,3
2021,Sedgemoor 008D,E01029107,628,310,157,153,0,0,264,201,63,54,44,10,0
2021,Sedgemoor 010D,E01029108,951,670,446,224,3,3,94,50,44,182,165,17,2
2021,Sedgemoor 008E,E01029109,516,281,133,148,1,1,162,135,27,72,64,8,0
2021,Sedgemoor 009C,E01029110,1049,456,220,236,2,2,285,105,180,305,283,22,1
2021,Sedgemoor 009D,E01029111,973,507,202,305,4,4,214,148,66,247,224,23,1
2021,Sedgemoor 009E,E01029112,1171,504,337,167,7,7,114,31,83,545,516,29,1
2021,Sedgemoor 002D,E01029113,730,649,448,201,6,6,8,3,5,67,55,12,0
2021,Sedgemoor 004A,E01029114,696,596,442,154,1,1,25,6,19,74,62,12,0
2021,Sedgemoor 002E,E01029115,730,644,439,205,2,2,14,9,5,70,62,8,0
2021,Sedgemoor 004B,E01029116,835,439,310,129,3,3,83,30,53,309,281,28,1
2021,Sedgemoor 004C,E01029117,796,508,349,159,3,3,17,10,7,267,241,26,1
2021,Sedgemoor 005A,E01029118,720,601,366,235,3,3,16,10,6,100,86,14,0
2021,Sedgemoor 004D,E01029119,780,499,323,176,3,3,176,113,63,101,83,18,1
2021,Sedgemoor 004E,E01029120,660,499,303,196,6,6,5,2,3,150,137,13,0
2021,Sedgemoor 007A,E01029121,537,470,292,178,1,1,8,6,2,58,34,24,0
2021,Sedgemoor 007B,E01029122,615,488,310,178,4,4,18,9,9,105,89,16,0
2021,Sedgemoor 007C,E01029123,487,312,203,109,4,4,102,70,32,69,52,17,0
2021,Sedgemoor 007D,E01029124,860,625,426,199,4,4,101,54,47,130,104,26,0
2021,Sedgemoor 007E,E01029125,579,459,287,172,5,5,34,18,16,81,59,22,0
2021,Sedgemoor 001B,E01029126,676,517,328,189,3,3,61,46,15,93,78,15,2
2021,Sedgemoor 001C,E01029127,831,513,334,179,17,17,124,60,64,176,155,21,1
2021,Sedgemoor 001D,E01029128,771,683,413,270,3,3,15,8,7,70,58,12,0
2021,Sedgemoor 001E,E01029129,903,704,400,304,33,33,95,19,76,71,59,12,0
2021,Sedgemoor 012A,E01029130,892,726,471,255,6,6,66,38,28,93,67,26,1
2021,Sedgemoor 005B,E01029131,1060,421,199,222,32,32,280,81,199,323,311,12,4
2021,Sedgemoor 005C,E01029132,652,235,117,118,13,13,341,230,111,58,50,8,5
2021,Sedgemoor 005D,E01029133,585,474,336,138,0,0,48,31,17,61,46,15,2
2021,Sedgemoor 005E,E01029134,936,600,363,237,5,5,216,55,161,113,92,21,2
2021,Sedgemoor 006A,E01029135,750,608,400,208,32,32,46,30,16,64,47,17,0
2021,Sedgemoor 006B,E01029136,910,687,413,274,14,14,124,77,47,83,64,19,2
2021,Sedgemoor 012B,E01029137,712,598,370,228,2,2,34,20,14,78,60,18,0
2021,Sedgemoor 012C,E01029138,615,491,291,200,8,8,49,26,23,67,58,9,0
2021,Sedgemoor 012D,E01029139,641,545,355,190,2,2,26,15,11,68,56,12,0
2021,Sedgemoor 014C,E01029142,662,547,337,210,6,6,14,3,11,95,79,16,0
2021,Sedgemoor 014D,E01029143,626,371,212,159,2,2,164,124,40,87,68,19,2
2021,Sedgemoor 014E,E01029144,506,420,240,180,4,4,20,12,8,62,52,10,0
2021,Sedgemoor 006C,E01029145,982,793,438,355,15,15,74,29,45,100,85,15,0
2021,Sedgemoor 003B,E01029147,705,619,404,215,6,6,17,6,11,63,47,16,0
2021,Sedgemoor 003C,E01029148,667,524,347,177,5,5,56,25,31,81,70,11,1
2021,Sedgemoor 003D,E01029149,584,480,277,203,3,3,35,25,10,65,43,22,1
2021,Sedgemoor 012E,E01029150,539,469,297,172,0,0,11,7,4,59,50,9,0
2021,Sedgemoor 012F,E01029151,613,501,320,181,5,5,42,18,24,65,52,13,0
2021,Sedgemoor 006D,E01029152,1021,727,459,268,7,7,187,105,82,98,81,17,2
2021,South Somerset 024A,E01029153,1083,862,621,241,7,7,67,10,57,147,118,29,0
2021,South Somerset 008A,E01029154,828,532,337,195,11,11,145,15,130,140,120,20,0
2021,South Somerset 005A,E01029155,809,663,466,197,2,2,46,6,40,98,79,19,0
2021,South Somerset 008B,E01029156,884,608,356,252,9,9,119,14,105,148,124,24,0
2021,South Somerset 001A,E01029157,618,319,194,125,6,6,167,32,135,125,95,30,1
2021,South Somerset 001B,E01029158,562,398,219,179,10,10,39,8,31,115,94,21,0
2021,South Somerset 018A,E01029159,837,624,249,375,35,35,72,11,61,106,94,12,0
2021,South Somerset 013A,E01029161,660,383,173,210,28,28,87,8,79,162,149,13,0
2021,South Somerset 013B,E01029162,757,402,229,173,10,10,69,9,60,276,265,11,0
2021,South Somerset 010A,E01029163,982,769,506,263,2,2,77,13,64,134,87,47,0
2021,South Somerset 006A,E01029164,666,473,307,166,16,16,90,13,77,87,66,21,0
2021,South Somerset 006B,E01029165,530,434,295,139,1,1,40,8,32,55,46,9,0
2021,South Somerset 002A,E01029166,1044,820,542,278,7,7,46,7,39,171,122,49,0
2021,South Somerset 002B,E01029167,786,388,228,160,11,11,235,34,201,152,129,23,0
2021,South Somerset 002C,E01029168,848,651,469,182,17,17,47,10,37,133,107,26,0
2021,South Somerset 022A,E01029169,729,532,296,236,23,23,73,4,69,101,87,14,0
2021,South Somerset 023A,E01029170,554,229,121,108,2,2,222,43,179,101,91,10,0
2021,South Somerset 023B,E01029171,1082,656,401,255,1,1,189,37,152,235,211,24,1
2021,South Somerset 022B,E01029172,649,551,340,211,3,3,18,2,16,77,65,12,0
2021,South Somerset 022C,E01029173,627,351,186,165,19,19,124,17,107,133,119,14,0
2021,South Somerset 023C,E01029174,491,379,251,128,0,0,54,8,46,58,53,5,0
2021,South Somerset 023D,E01029175,997,483,285,198,21,21,254,62,192,237,218,19,2
2021,South Somerset 022D,E01029176,592,463,279,184,1,1,30,4,26,97,85,12,1
2021,South Somerset 022E,E01029177,628,216,124,92,15,15,313,71,242,80,67,13,4
2021,South Somerset 020A,E01029178,692,578,394,184,1,1,48,10,38,65,51,14,0
2021,South Somerset 020B,E01029179,502,309,193,116,1,1,122,31,91,69,64,5,1
2021,South Somerset 020C,E01029180,651,467,290,177,2,2,96,18,78,86,66,20,0
2021,South Somerset 020D,E01029181,603,466,301,165,1,1,59,7,52,76,57,19,1
2021,South Somerset 021A,E01029182,734,574,357,217,3,3,38,2,36,118,100,18,1
2021,South Somerset 021B,E01029183,704,481,249,232,17,17,135,35,100,71,62,9,0
2021,South Somerset 021C,E01029184,834,659,439,220,12,12,38,4,34,125,107,18,0
2021,South Somerset 021D,E01029185,873,575,373,202,0,0,75,8,67,223,210,13,0
2021,South Somerset 021E,E01029186,742,411,254,157,8,8,207,31,176,116,106,10,0
2021,South Somerset 007A,E01029187,507,322,205,117,16,16,119,23,96,50,38,12,0
2021,South Somerset 007B,E01029188,683,594,403,191,0,0,15,3,12,74,60,14,0
2021,South Somerset 017A,E01029189,493,349,222,127,2,2,103,25,78,39,29,10,0
2021,South Somerset 017B,E01029190,649,510,339,171,5,5,21,1,20,113,91,22,0
2021,South Somerset 017C,E01029191,584,401,252,149,8,8,109,32,77,66,50,16,0
2021,South Somerset 017D,E01029192,618,435,270,165,10,10,83,22,61,90,73,17,0
2021,South Somerset 019A,E01029193,959,563,336,227,5,5,159,33,126,230,201,29,2
2021,South Somerset 019B,E01029194,1196,904,550,354,12,12,101,10,91,179,157,22,0
2021,South Somerset 019C,E01029195,726,476,312,164,8,8,149,32,117,93,86,7,0
2021,South Somerset 007C,E01029196,734,537,333,204,22,22,99,19,80,76,48,28,0
2021,South Somerset 007D,E01029197,556,443,281,162,2,2,42,2,40,69,58,11,0
2021,South Somerset 006C,E01029198,450,161,59,102,1,1,72,11,61,215,66,149,1
2021,South Somerset 006D,E01029199,867,626,357,269,4,4,77,12,65,159,132,27,1
2021,South Somerset 004A,E01029200,741,415,278,137,10,10,140,36,104,176,157,19,0
2021,South Somerset 004B,E01029201,816,599,371,228,6,6,81,9,72,130,116,14,0
2021,South Somerset 009A,E01029202,574,320,186,134,5,5,190,44,146,58,53,5,1
2021,South Somerset 009B,E01029203,654,531,326,205,0,0,43,6,37,80,64,16,0
2021,South Somerset 009C,E01029204,566,479,301,178,4,4,24,5,19,59,47,12,0
2021,South Somerset 009D,E01029205,787,559,325,234,4,4,89,19,70,135,113,22,0
2021,South Somerset 008C,E01029206,756,484,296,188,14,14,153,27,126,105,86,19,0
2021,South Somerset 008D,E01029207,685,536,333,203,6,6,42,4,38,101,89,12,0
2021,South Somerset 019D,E01029208,534,412,257,155,3,3,71,13,58,47,35,12,1
2021,South Somerset 019E,E01029209,596,513,353,160,4,4,11,1,10,68,51,17,0
2021,South Somerset 002D,E01029210,729,593,363,230,13,13,46,6,40,77,52,25,0
2021,South Somerset 002E,E01029211,620,499,339,160,9,9,52,6,46,60,43,17,0
2021,South Somerset 017E,E01029212,516,421,274,147,4,4,28,2,26,63,55,8,0
2021,South Somerset 017F,E01029213,570,424,305,119,5,5,82,16,66,59,34,25,0
2021,South Somerset 017G,E01029214,489,387,252,135,4,4,47,16,31,51,39,12,0
2021,South Somerset 017H,E01029215,524,307,193,114,16,16,145,26,119,56,45,11,0
2021,South Somerset 010B,E01029216,732,594,427,167,7,7,45,10,35,86,66,20,0
2021,South Somerset 010C,E01029217,748,590,392,198,2,2,58,12,46,97,82,15,1
2021,South Somerset 010D,E01029218,950,567,393,174,18,18,223,33,190,141,118,23,1
2021,South Somerset 024B,E01029219,605,530,379,151,2,2,9,1,8,64,49,15,0
2021,South Somerset 024C,E01029220,555,424,252,172,3,3,84,16,68,44,34,10,0
2021,South Somerset 001C,E01029221,1035,771,520,251,5,5,50,11,39,209,153,56,0
2021,South Somerset 004C,E01029222,707,588,371,217,5,5,46,5,41,68,45,23,0
2021,South Somerset 004D,E01029223,534,444,297,147,9,9,23,3,20,57,41,16,1
2021,South Somerset 003A,E01029224,875,692,457,235,18,18,66,8,58,99,74,25,0
2021,South Somerset 003B,E01029225,1093,845,527,318,21,21,124,12,112,103,84,19,0
2021,South Somerset 003C,E01029226,841,492,342,150,1,1,200,44,156,148,130,18,0
2021,South Somerset 005B,E01029227,940,655,355,300,22,22,151,19,132,111,98,13,1
2021,South Somerset 005C,E01029228,912,594,345,249,1,1,98,17,81,219,145,74,0
2021,South Somerset 005D,E01029229,1062,513,287,226,4,4,214,45,169,331,300,31,0
2021,South Somerset 024D,E01029230,1034,789,552,237,8,8,79,15,64,157,112,45,1
2021,South Somerset 014A,E01029231,664,426,245,181,5,5,112,36,76,121,105,16,0
2021,South Somerset 015A,E01029232,666,326,150,176,4,4,70,10,60,266,245,21,0
2021,South Somerset 014B,E01029233,683,289,135,154,3,3,261,73,188,129,113,16,1
2021,South Somerset 014C,E01029235,625,383,216,167,7,7,128,40,88,107,101,6,0
2021,South Somerset 014D,E01029236,621,257,126,131,4,4,264,80,184,93,82,11,3
2021,South Somerset 014E,E01029237,731,277,136,141,42,42,335,88,247,74,62,12,3
2021,South Somerset 011A,E01029238,646,332,177,155,8,8,198,68,130,106,95,11,2
2021,South Somerset 015C,E01029239,838,298,174,124,6,6,248,56,192,286,257,29,0
2021,South Somerset 015D,E01029240,655,460,215,245,0,0,27,4,23,168,150,18,0
2021,South Somerset 016A,E01029241,881,474,194,280,26,26,161,30,131,218,196,22,2
2021,South Somerset 018B,E01029242,655,475,251,224,3,3,55,13,42,122,106,16,0
2021,South Somerset 018C,E01029243,769,633,455,178,0,0,50,10,40,84,73,11,2
2021,South Somerset 018D,E01029244,644,572,362,210,1,1,5,2,3,66,57,9,0
2021,South Somerset 016B,E01029245,943,690,364,326,9,9,72,15,57,171,149,22,1
2021,South Somerset 016C,E01029246,622,462,277,185,0,0,28,5,23,132,118,14,0
2021,South Somerset 013C,E01029247,614,198,94,104,7,7,322,93,229,80,63,17,7
2021,South Somerset 012B,E01029248,640,351,190,161,4,4,167,38,129,118,105,13,0
2021,South Somerset 016D,E01029249,642,371,221,150,2,2,185,56,129,83,66,17,1
2021,South Somerset 012C,E01029250,549,471,291,180,3,3,14,4,10,61,56,5,0
2021,South Somerset 012D,E01029251,727,637,368,269,3,3,32,7,25,54,47,7,1
2021,South Somerset 011B,E01029252,607,468,283,185,3,3,12,1,11,124,73,51,0
2021,South Somerset 011D,E01029254,592,550,368,182,2,2,14,1,13,26,21,5,0
2021,South Somerset 013D,E01029255,598,382,239,143,0,0,82,23,59,134,67,67,0
2021,Somerset West and Taunton 012A,E01029256,926,664,361,303,31,31,147,68,79,83,66,17,1
2021,Somerset West and Taunton 012B,E01029257,895,533,267,266,5,5,228,181,47,128,110,18,1
2021,Somerset West and Taunton 006A,E01029258,701,557,328,229,6,6,28,13,15,110,96,14,0
2021,Somerset West and Taunton 006B,E01029259,640,430,264,166,4,4,134,109,25,69,58,11,3
2021,Somerset West and Taunton 006C,E01029260,934,652,267,385,5,5,89,10,79,188,168,20,0
2021,Somerset West and Taunton 019A,E01029261,972,775,479,296,4,4,65,36,29,127,91,36,1
2021,Somerset West and Taunton 017A,E01029262,1001,828,542,286,3,3,45,39,6,125,93,32,0
2021,Somerset West and Taunton 016A,E01029263,587,420,231,189,1,1,24,15,9,141,128,13,1
2021,Somerset West and Taunton 016B,E01029264,584,505,320,185,2,2,8,5,3,69,61,8,0
2021,Somerset West and Taunton 016C,E01029265,607,519,352,167,1,1,8,3,5,79,70,9,0
2021,Somerset West and Taunton 015A,E01029266,588,363,272,91,4,4,63,46,17,157,137,20,1
2021,Somerset West and Taunton 013A,E01029267,757,545,366,179,1,1,106,95,11,105,90,15,0
2021,Somerset West and Taunton 006D,E01029268,686,542,343,199,1,1,48,33,15,95,77,18,0
2021,Somerset West and Taunton 017B,E01029269,868,708,435,273,11,11,38,26,12,111,87,24,0
2021,Somerset West and Taunton 019B,E01029270,968,751,465,286,3,3,58,41,17,155,119,36,1
2021,Somerset West and Taunton 009A,E01029271,828,644,414,230,12,12,67,50,17,105,83,22,0
2021,Somerset West and Taunton 009B,E01029273,588,475,268,207,11,11,35,20,15,67,53,14,0
2021,Somerset West and Taunton 009C,E01029274,790,666,426,240,18,18,54,18,36,52,42,10,0
2021,Somerset West and Taunton 009D,E01029275,591,459,316,143,12,12,58,35,23,61,52,9,1
2021,Somerset West and Taunton 007A,E01029276,589,444,295,149,4,4,41,36,5,99,80,19,1
2021,Somerset West and Taunton 012C,E01029277,624,376,167,209,18,18,92,47,45,137,122,15,1
2021,Somerset West and Taunton 007B,E01029278,621,449,284,165,0,0,75,47,28,94,72,22,3
2021,Somerset West and Taunton 009E,E01029279,665,488,295,193,11,11,59,39,20,101,84,17,6
2021,Somerset West and Taunton 014A,E01029280,752,343,164,179,7,7,299,173,126,102,87,15,1
2021,Somerset West and Taunton 014B,E01029281,773,422,212,210,5,5,245,169,76,101,87,14,0
2021,Somerset West and Taunton 008A,E01029282,636,378,187,191,3,3,25,21,4,229,220,9,1
2021,Somerset West and Taunton 014C,E01029283,785,463,248,215,8,8,232,173,59,81,69,12,1
2021,Somerset West and Taunton 015B,E01029284,1090,375,256,119,18,18,276,117,159,419,383,36,2
2021,Somerset West and Taunton 011A,E01029285,1180,505,250,255,4,4,68,14,54,603,558,45,0
2021,Somerset West and Taunton 015C,E01029286,797,344,156,188,19,19,150,37,113,284,261,23,0
2021,Somerset West and Taunton 011B,E01029287,741,380,171,209,0,0,29,3,26,332,302,30,0
2021,Somerset West and Taunton 011C,E01029288,668,477,270,207,8,8,33,10,23,150,131,19,0
2021,Somerset West and Taunton 011D,E01029289,963,521,289,232,1,1,76,20,56,365,324,41,0
2021,Somerset West and Taunton 007C,E01029290,651,422,225,197,1,1,78,19,59,150,132,18,0
2021,Somerset West and Taunton 008B,E01029291,772,400,235,165,2,2,210,193,17,157,143,14,3
2021,Somerset West and Taunton 014D,E01029292,665,194,90,104,0,0,395,261,134,73,64,9,3
2021,Somerset West and Taunton 014E,E01029293,633,118,34,84,0,0,456,427,29,56,48,8,3
2021,Somerset West and Taunton 008C,E01029294,731,557,283,274,0,0,6,3,3,168,155,13,0
2021,Somerset West and Taunton 019C,E01029295,705,568,343,225,3,3,5,3,2,129,118,11,0
2021,Somerset West and Taunton 019D,E01029296,814,657,369,288,4,4,75,53,22,78,57,21,0
2021,Somerset West and Taunton 010A,E01029297,616,243,124,119,0,0,313,295,18,53,48,5,7
2021,Somerset West and Taunton 010B,E01029298,608,354,181,173,4,4,194,180,14,56,46,10,0
2021,Somerset West and Taunton 011E,E01029299,792,382,225,157,1,1,159,114,45,248,231,17,2
2021,Somerset West and Taunton 011F,E01029300,1081,585,299,286,23,23,140,10,130,332,310,22,1
2021,Somerset West and Taunton 015D,E01029301,1163,621,461,160,4,4,166,80,86,367,343,24,5
2021,Somerset West and Taunton 016D,E01029302,760,583,381,202,0,0,31,22,9,146,112,34,0
2021,Somerset West and Taunton 015E,E01029303,829,696,484,212,1,1,12,6,6,120,82,38,0
2021,Somerset West and Taunton 010C,E01029304,635,263,146,117,2,2,296,197,99,71,67,4,3
2021,Somerset West and Taunton 010D,E01029305,606,413,219,194,3,3,120,116,4,67,59,8,3
2021,Somerset West and Taunton 007D,E01029306,622,459,298,161,0,0,110,96,14,50,42,8,3
2021,Somerset West and Taunton 010E,E01029307,575,235,114,121,3,3,279,238,41,53,44,9,5
2021,Somerset West and Taunton 016E,E01029308,882,740,457,283,3,3,47,29,18,92,70,22,0
2021,Somerset West and Taunton 017C,E01029310,863,684,458,226,5,5,21,5,16,153,131,22,0
2021,Somerset West and Taunton 018A,E01029311,995,516,219,297,11,11,339,226,113,126,113,13,3
2021,Somerset West and Taunton 018B,E01029312,603,416,221,195,0,0,109,85,24,75,61,14,3
2021,Somerset West and Taunton 018C,E01029313,725,502,212,290,1,1,81,45,36,141,130,11,0
2021,Somerset West and Taunton 017D,E01029315,662,579,431,148,4,4,10,4,6,69,55,14,0
2021,Somerset West and Taunton 018D,E01029316,890,508,315,193,2,2,124,93,31,251,228,23,5
2021,Somerset West and Taunton 008D,E01029317,793,563,216,347,7,7,127,102,25,95,88,7,1
2021,Somerset West and Taunton 007E,E01029319,837,582,203,379,32,32,76,5,71,147,140,7,0
2021,Somerset West and Taunton 013B,E01029320,791,487,297,190,15,15,161,111,50,128,111,17,0
2021,Somerset West and Taunton 013C,E01029321,981,779,533,246,3,3,25,20,5,172,131,41,2
2021,Somerset West and Taunton 002A,E01029322,733,435,337,98,7,7,168,13,155,121,104,17,2
2021,Somerset West and Taunton 001A,E01029324,750,441,239,202,3,3,195,27,168,111,91,20,0
2021,Somerset West and Taunton 005A,E01029325,954,659,495,164,3,3,144,20,124,148,116,32,0
2021,Somerset West and Taunton 003A,E01029326,587,381,291,90,5,5,120,7,113,80,65,15,1
2021,Somerset West and Taunton 004A,E01029327,895,665,466,199,2,2,79,9,70,149,112,37,0
2021,Somerset West and Taunton 005B,E01029328,969,600,443,157,6,6,204,20,184,159,123,36,0
2021,Somerset West and Taunton 001B,E01029329,787,500,354,146,1,1,41,12,29,245,215,30,0
2021,Somerset West and Taunton 001C,E01029330,994,671,537,134,8,8,31,9,22,284,251,33,0
2021,Somerset West and Taunton 002B,E01029331,725,610,491,119,1,1,39,17,22,75,61,14,0
2021,Somerset West and Taunton 002C,E01029333,564,296,213,83,2,2,163,18,145,103,89,14,0
2021,Somerset West and Taunton 003B,E01029334,563,402,309,93,3,3,73,6,67,85,64,21,0
2021,Somerset West and Taunton 004B,E01029335,516,401,293,108,1,1,37,4,33,77,49,28,0
2021,Somerset West and Taunton 002D,E01029336,991,576,477,99,3,3,222,17,205,189,149,40,1
2021,Somerset West and Taunton 004C,E01029337,952,641,442,199,5,5,113,11,102,193,170,23,0
2021,Somerset West and Taunton 005C,E01029338,783,540,411,129,5,5,70,8,62,168,118,50,0
2021,Somerset West and Taunton 003C,E01029339,721,393,252,141,9,9,220,25,195,99,89,10,0
2021,Somerset West and Taunton 003D,E01029341,692,435,316,119,2,2,68,11,57,187,171,16,0
2021,Somerset West and Taunton 004D,E01029342,528,434,339,95,3,3,17,3,14,74,57,17,0
2021,Somerset West and Taunton 004E,E01029343,750,472,348,124,0,0,55,8,47,223,205,18,0
2021,Cannock Chase 003A,E01029345,815,575,235,340,2,2,81,57,24,155,141,14,2
2021,Cannock Chase 003B,E01029346,771,326,173,153,13,13,287,170,117,142,133,9,3
2021,Cannock Chase 003C,E01029347,686,601,365,236,8,8,18,9,9,58,46,12,1
2021,Cannock Chase 003D,E01029348,696,505,252,253,0,0,95,90,5,95,79,16,1
2021,Cannock Chase 008A,E01029349,655,323,179,144,11,11,236,156,80,82,68,14,3
2021,Cannock Chase 008B,E01029350,720,345,188,157,0,0,218,188,30,154,141,13,3
2021,Cannock Chase 008C,E01029351,616,302,140,162,2,2,223,202,21,88,77,11,1
2021,Cannock Chase 008D,E01029352,575,384,203,181,3,3,24,8,16,164,156,8,0
2021,Cannock Chase 011A,E01029353,684,434,289,145,2,2,130,102,28,111,101,10,7
2021,Cannock Chase 007A,E01029354,664,445,228,217,0,0,139,113,26,75,65,10,5
2021,Cannock Chase 007B,E01029355,638,347,175,172,3,3,207,131,76,74,61,13,7
2021,Cannock Chase 007C,E01029356,631,293,158,135,13,13,258,138,120,64,57,7,3
2021,Cannock Chase 007D,E01029357,671,385,192,193,34,34,188,119,69,60,52,8,4
2021,Cannock Chase 007E,E01029358,502,176,71,105,11,11,249,226,23,61,53,8,5
2021,Cannock Chase 012A,E01029359,1101,474,141,333,13,13,292,102,190,320,300,20,2
2021,Cannock Chase 012B,E01029360,715,372,228,144,5,5,159,114,45,178,151,27,1
2021,Cannock Chase 012C,E01029361,626,372,203,169,0,0,143,133,10,107,98,9,4
2021,Cannock Chase 012D,E01029362,728,300,132,168,21,21,296,218,78,110,101,9,1
2021,Cannock Chase 012E,E01029363,671,436,250,186,1,1,145,141,4,81,63,18,8
2021,Cannock Chase 011B,E01029364,749,561,356,205,1,1,44,14,30,143,120,23,0
2021,Cannock Chase 011C,E01029365,709,469,261,208,2,2,119,57,62,118,104,14,1
2021,Cannock Chase 011D,E01029366,764,680,471,209,3,3,23,23,0,58,44,14,0
2021,Cannock Chase 011E,E01029367,1008,602,324,278,3,3,209,66,143,192,171,21,2
2021,Cannock Chase 001A,E01029368,520,489,309,180,0,0,3,2,1,27,20,7,1
2021,Cannock Chase 001B,E01029369,504,414,247,167,1,1,3,1,2,86,69,17,0
2021,Cannock Chase 001C,E01029370,583,540,345,195,0,0,5,5,0,38,31,7,0
2021,Cannock Chase 001D,E01029371,626,471,224,247,9,9,44,33,11,101,90,11,1
2021,Cannock Chase 002A,E01029372,516,205,78,127,1,1,236,227,9,73,67,6,1
2021,Cannock Chase 002B,E01029373,882,550,242,308,2,2,166,94,72,163,146,17,1
2021,Cannock Chase 003E,E01029374,948,687,365,322,2,2,19,7,12,240,224,16,0
2021,Cannock Chase 010A,E01029375,889,703,288,415,0,0,68,5,63,118,109,9,0
2021,Cannock Chase 010B,E01029376,722,493,187,306,9,9,63,3,60,157,149,8,0
2021,Cannock Chase 010C,E01029377,511,452,185,267,1,1,6,3,3,52,51,1,0
2021,Cannock Chase 010D,E01029378,655,545,245,300,6,6,14,7,7,90,78,12,0
2021,Cannock Chase 006A,E01029379,663,501,176,325,2,2,80,64,16,80,75,5,0
2021,Cannock Chase 009A,E01029380,562,497,200,297,4,4,5,4,1,55,53,2,1
2021,Cannock Chase 009B,E01029381,687,376,201,175,0,0,165,156,9,140,124,16,6
2021,Cannock Chase 009C,E01029382,764,498,247,251,2,2,85,81,4,179,168,11,0
2021,Cannock Chase 004A,E01029383,774,629,267,362,11,11,49,11,38,85,79,6,0
2021,Cannock Chase 004B,E01029385,677,566,315,251,9,9,23,9,14,79,66,13,0
2021,Cannock Chase 005B,E01029386,629,407,212,195,0,0,128,127,1,93,83,10,1
2021,Cannock Chase 005C,E01029387,649,413,205,208,1,1,142,131,11,92,81,11,1
2021,Cannock Chase 004C,E01029388,638,323,144,179,1,1,214,179,35,92,79,13,8
2021,Cannock Chase 005D,E01029389,842,527,284,243,3,3,56,22,34,256,230,26,0
2021,Cannock Chase 004D,E01029390,448,198,101,97,1,1,179,173,6,64,54,10,6
2021,Cannock Chase 009D,E01029391,703,569,308,261,1,1,30,15,15,103,89,14,0
2021,Cannock Chase 009E,E01029392,843,717,308,409,15,15,29,7,22,82,71,11,0
2021,Cannock Chase 008E,E01029393,738,585,335,250,2,2,66,56,10,85,73,12,0
2021,Cannock Chase 013A,E01029394,665,534,328,206,2,2,78,71,7,51,37,14,0
2021,Cannock Chase 013B,E01029395,1082,874,360,514,11,11,90,26,64,107,84,23,0
2021,Cannock Chase 013C,E01029396,739,542,292,250,10,10,73,55,18,113,99,14,1
2021,Cannock Chase 013D,E01029397,1032,596,226,370,0,0,301,263,38,131,118,13,4
2021,Cannock Chase 006B,E01029398,688,532,323,209,0,0,102,68,34,52,45,7,2
2021,Cannock Chase 006C,E01029399,665,459,207,252,2,2,59,54,5,145,133,12,0
2021,Cannock Chase 006D,E01029400,645,444,228,216,1,1,119,116,3,80,68,12,1
2021,Cannock Chase 002C,E01029401,669,489,268,221,0,0,56,54,2,124,112,12,0
2021,Cannock Chase 001E,E01029402,933,768,464,304,4,4,19,1,18,142,126,16,0
2021,Cannock Chase 002D,E01029403,608,414,222,192,1,1,115,96,19,78,69,9,0
2021,Cannock Chase 002E,E01029404,917,358,215,143,8,8,190,35,155,359,332,27,2
2021,East Staffordshire 001A,E01029405,652,565,353,212,6,6,23,13,10,58,43,15,0
2021,East Staffordshire 001B,E01029406,494,429,250,179,1,1,10,5,5,54,46,8,0
2021,East Staffordshire 011A,E01029407,589,297,148,149,7,7,38,12,26,246,224,22,1
2021,East Staffordshire 011B,E01029408,883,329,155,174,9,9,127,39,88,418,377,41,0
2021,East Staffordshire 011C,E01029409,793,301,153,148,5,5,84,25,59,403,375,28,0
2021,East Staffordshire 011D,E01029410,623,319,166,153,3,3,15,6,9,286,256,30,0
2021,East Staffordshire 006A,E01029411,571,468,290,178,5,5,30,7,23,68,48,20,0
2021,East Staffordshire 006B,E01029412,613,483,317,166,5,5,45,9,36,80,66,14,0
2021,East Staffordshire 013A,E01029413,649,435,251,184,2,2,103,40,63,109,97,12,0
2021,East Staffordshire 013B,E01029414,684,498,287,211,1,1,16,9,7,169,155,14,0
2021,East Staffordshire 013C,E01029415,628,489,175,314,0,0,8,4,4,131,120,11,0
2021,East Staffordshire 013D,E01029416,1002,839,306,533,5,5,47,20,27,111,94,17,0
2021,East Staffordshire 013E,E01029417,809,677,284,393,2,2,65,24,41,65,51,14,0
2021,East Staffordshire 012A,E01029418,830,769,428,341,1,1,5,1,4,55,48,7,0
2021,East Staffordshire 012B,E01029419,687,593,338,255,3,3,12,3,9,79,66,13,0
2021,East Staffordshire 012C,E01029420,734,610,351,259,3,3,20,6,14,101,86,15,0
2021,East Staffordshire 001C,E01029422,453,370,224,146,1,1,27,4,23,54,31,23,1
2021,East Staffordshire 001D,E01029423,682,408,219,189,9,9,156,39,117,108,94,14,1
2021,East Staffordshire 006C,E01029424,434,326,204,122,0,0,41,16,25,67,53,14,0
2021,East Staffordshire 006D,E01029425,624,536,340,196,3,3,22,6,16,63,49,14,0
2021,East Staffordshire 008A,E01029426,920,390,152,238,4,4,167,61,106,358,324,34,1
2021,East Staffordshire 008B,E01029427,717,246,116,130,16,16,310,110,200,144,133,11,1
2021,East Staffordshire 008C,E01029428,953,659,181,478,1,1,53,18,35,240,215,25,0
2021,East Staffordshire 008D,E01029429,486,309,166,143,0,0,16,1,15,161,148,13,0
2021,East Staffordshire 002A,E01029430,1014,820,360,460,31,31,64,12,52,99,85,14,0
2021,East Staffordshire 002B,E01029431,683,382,201,181,33,33,188,81,107,78,67,11,2
2021,East Staffordshire 002C,E01029432,621,522,329,193,3,3,40,9,31,56,45,11,0
2021,East Staffordshire 002D,E01029433,608,383,213,170,3,3,160,67,93,62,58,4,0
2021,East Staffordshire 007A,E01029434,641,371,179,192,3,3,58,30,28,208,190,18,1
2021,East Staffordshire 007B,E01029435,636,502,319,183,3,3,28,10,18,103,81,22,0
2021,East Staffordshire 007C,E01029436,821,328,172,156,1,1,256,82,174,235,213,22,1
2021,East Staffordshire 007D,E01029437,1058,440,132,308,22,22,385,149,236,208,193,15,3
2021,East Staffordshire 007E,E01029438,636,517,333,184,0,0,42,21,21,77,67,10,0
2021,East Staffordshire 015A,E01029439,624,546,356,190,2,2,5,1,4,71,60,11,0
2021,East Staffordshire 015B,E01029440,523,392,236,156,0,0,15,7,8,116,107,9,0
2021,East Staffordshire 015C,E01029441,739,575,379,196,4,4,80,22,58,80,62,18,0
2021,East Staffordshire 015D,E01029442,656,577,291,286,15,15,28,10,18,36,33,3,0
2021,East Staffordshire 004A,E01029443,734,667,402,265,2,2,8,2,6,57,52,5,0
2021,East Staffordshire 004B,E01029444,721,570,376,194,1,1,87,25,62,63,51,12,0
2021,East Staffordshire 009A,E01029445,1049,335,133,202,4,4,239,106,133,468,434,34,3
2021,East Staffordshire 009B,E01029446,901,582,314,268,7,7,101,33,68,211,189,22,0
2021,East Staffordshire 009C,E01029447,606,253,147,106,10,10,38,14,24,305,276,29,0
2021,East Staffordshire 009D,E01029448,765,330,190,140,5,5,166,25,141,261,232,29,3
2021,East Staffordshire 014A,E01029449,724,512,306,206,11,11,47,9,38,154,141,13,0
2021,East Staffordshire 014B,E01029450,642,272,123,149,5,5,292,108,184,72,60,12,1
2021,East Staffordshire 014C,E01029451,874,508,299,209,2,2,159,54,105,204,179,25,1
2021,East Staffordshire 014D,E01029452,762,375,203,172,2,2,299,104,195,85,72,13,1
2021,East Staffordshire 014E,E01029453,685,237,116,121,4,4,351,146,205,90,81,9,3
2021,East Staffordshire 005A,E01029454,635,602,403,199,0,0,4,1,3,29,21,8,0
2021,East Staffordshire 005B,E01029455,745,666,369,297,1,1,7,1,6,71,61,10,0
2021,East Staffordshire 005C,E01029456,741,529,362,167,3,3,49,18,31,158,140,18,2
2021,East Staffordshire 005D,E01029457,535,450,240,210,0,0,7,3,4,78,70,8,0
2021,East Staffordshire 005E,E01029458,759,617,341,276,1,1,81,28,53,60,44,16,0
2021,East Staffordshire 003A,E01029459,649,515,255,260,11,11,13,3,10,110,102,8,0
2021,East Staffordshire 003B,E01029460,830,549,316,233,3,3,105,27,78,173,159,14,0
2021,East Staffordshire 003C,E01029461,870,548,267,281,1,1,126,42,84,195,173,22,0
2021,East Staffordshire 003D,E01029462,725,510,304,206,1,1,84,26,58,129,102,27,1
2021,East Staffordshire 004C,E01029463,502,420,256,164,1,1,11,5,6,70,50,20,0
2021,East Staffordshire 004D,E01029464,708,401,238,163,4,4,211,82,129,92,74,18,0
2021,East Staffordshire 004E,E01029465,968,776,409,367,18,18,47,21,26,126,118,8,1
2021,East Staffordshire 004F,E01029466,880,765,354,411,5,5,38,16,22,72,65,7,0
2021,East Staffordshire 001E,E01029467,912,709,454,255,2,2,59,17,42,142,111,31,0
2021,East Staffordshire 010A,E01029468,687,208,105,103,2,2,411,149,262,63,57,6,3
2021,East Staffordshire 010B,E01029469,777,629,392,237,5,5,40,16,24,103,92,11,0
2021,East Staffordshire 010C,E01029470,634,409,221,188,1,1,103,42,61,121,111,10,0
2021,East Staffordshire 010D,E01029471,725,544,293,251,1,1,7,1,6,173,147,26,0
2021,East Staffordshire 010E,E01029472,635,374,238,136,1,1,200,77,123,59,48,11,1
2021,East Staffordshire 006E,E01029473,621,515,314,201,4,4,28,4,24,74,60,14,0
2021,East Staffordshire 006F,E01029474,515,450,300,150,0,0,14,3,11,51,45,6,0
2021,Lichfield 009A,E01029475,879,728,458,270,8,8,39,3,36,104,88,16,0
2021,Lichfield 009B,E01029476,623,533,314,219,3,3,36,4,32,51,46,5,0
2021,Lichfield 002A,E01029477,698,628,405,223,1,1,6,0,6,63,48,15,0
2021,Lichfield 002B,E01029478,650,494,291,203,4,4,84,7,77,68,60,8,0
2021,Lichfield 001A,E01029480,828,660,331,329,0,0,15,0,15,153,139,14,0
2021,Lichfield 001C,E01029482,676,487,288,199,0,0,106,15,91,83,72,11,0
2021,Lichfield 005A,E01029483,629,593,378,215,2,2,4,0,4,30,27,3,0
2021,Lichfield 005B,E01029484,841,596,371,225,12,12,41,6,35,192,172,20,0
2021,Lichfield 005C,E01029485,657,566,355,211,4,4,4,1,3,83,70,13,0
2021,Lichfield 003A,E01029486,618,510,323,187,1,1,47,5,42,60,48,12,0
2021,Lichfield 006A,E01029487,743,358,209,149,4,4,314,51,263,67,59,8,0
2021,Lichfield 012A,E01029488,697,522,306,216,11,11,41,4,37,122,94,28,1
2021,Lichfield 009C,E01029489,661,606,410,196,3,3,6,0,6,46,35,11,0
2021,Lichfield 009D,E01029490,629,513,307,206,3,3,46,5,41,66,53,13,1
2021,Lichfield 007A,E01029491,785,513,318,195,4,4,125,22,103,143,125,18,0
2021,Lichfield 004A,E01029492,779,214,121,93,2,2,498,97,401,64,57,7,1
2021,Lichfield 006B,E01029493,805,660,362,298,3,3,57,9,48,85,70,15,0
2021,Lichfield 006C,E01029494,688,486,268,218,3,3,72,8,64,127,114,13,0
2021,Lichfield 006D,E01029495,675,572,334,238,3,3,31,5,26,69,54,15,0
2021,Lichfield 010A,E01029496,823,357,168,189,4,4,321,38,283,141,127,14,0
2021,Lichfield 001D,E01029498,844,671,396,275,11,11,82,15,67,80,61,19,0
2021,Lichfield 004B,E01029499,759,277,151,126,3,3,412,51,361,67,53,14,0
2021,Lichfield 005D,E01029500,736,593,352,241,6,6,84,7,77,53,43,10,0
2021,Lichfield 004C,E01029501,630,396,240,156,1,1,171,16,155,61,51,10,1
2021,Lichfield 012B,E01029502,667,429,229,200,2,2,165,14,151,69,57,12,2
2021,Lichfield 012C,E01029503,661,516,310,206,0,0,77,10,67,68,59,9,0
2021,Lichfield 012D,E01029504,808,430,217,213,2,2,176,22,154,200,181,19,0
2021,Lichfield 009E,E01029505,673,557,340,217,2,2,34,6,28,80,67,13,0
2021,Lichfield 009F,E01029506,760,695,488,207,3,3,16,3,13,45,38,7,1
2021,Lichfield 003B,E01029507,653,609,376,233,0,0,3,1,2,41,37,4,0
2021,Lichfield 003C,E01029508,944,774,439,335,1,1,69,6,63,100,88,12,0
2021,Lichfield 002D,E01029509,703,589,395,194,1,1,50,7,43,63,49,14,0
2021,Lichfield 007B,E01029511,695,602,366,236,2,2,17,2,15,74,63,11,0
2021,Lichfield 007C,E01029512,907,697,348,349,6,6,74,7,67,130,120,10,0
2021,Lichfield 011A,E01029513,516,486,273,213,0,0,6,1,5,24,20,4,0
2021,Lichfield 011B,E01029514,630,578,370,208,0,0,10,1,9,42,33,9,0
2021,Lichfield 003D,E01029515,798,664,422,242,0,0,51,5,46,83,61,22,0
2021,Lichfield 008A,E01029516,835,592,344,248,22,22,85,9,76,133,111,22,3
2021,Lichfield 008B,E01029517,861,675,345,330,16,16,85,7,78,85,71,14,0
2021,Lichfield 007D,E01029518,1176,951,490,461,10,10,61,7,54,154,138,16,0
2021,Lichfield 007E,E01029519,981,591,300,291,20,20,213,22,191,157,143,14,0
2021,Lichfield 005E,E01029520,609,589,374,215,0,0,4,1,3,16,10,6,0
2021,Lichfield 011C,E01029521,723,623,385,238,2,2,23,3,20,75,66,9,0
2021,Lichfield 011D,E01029522,647,471,267,204,0,0,100,14,86,76,62,14,0
2021,Lichfield 011E,E01029523,650,568,359,209,1,1,38,5,33,43,34,9,0
2021,Lichfield 005F,E01029524,783,495,277,218,3,3,166,17,149,119,108,11,0
2021,Lichfield 005G,E01029525,862,653,421,232,39,39,104,10,94,66,52,14,0
2021,Lichfield 004E,E01029526,988,460,314,146,26,26,225,29,196,277,236,41,0
2021,Lichfield 010B,E01029527,550,252,136,116,0,0,230,24,206,68,56,12,0
2021,Lichfield 010C,E01029528,544,383,215,168,1,1,50,8,42,110,100,10,0
2021,Lichfield 010D,E01029529,506,373,174,199,2,2,27,2,25,104,97,7,0
2021,Lichfield 008D,E01029531,695,619,395,224,1,1,15,0,15,60,47,13,0
2021,Newcastle-under-Lyme 005A,E01029532,637,472,271,201,9,9,78,13,65,78,65,13,0
2021,Newcastle-under-Lyme 005B,E01029533,643,507,306,201,2,2,88,38,50,46,38,8,0
2021,Newcastle-under-Lyme 005C,E01029534,692,575,352,223,2,2,19,7,12,96,79,17,0
2021,Newcastle-under-Lyme 005D,E01029535,608,319,141,178,2,2,201,66,135,85,77,8,1
2021,Newcastle-under-Lyme 004A,E01029536,656,599,394,205,0,0,5,0,5,52,44,8,0
2021,Newcastle-under-Lyme 006A,E01029537,627,442,224,218,0,0,114,45,69,71,61,10,0
2021,Newcastle-under-Lyme 006B,E01029538,662,358,161,197,1,1,250,79,171,51,37,14,2
2021,Newcastle-under-Lyme 006C,E01029539,615,519,306,213,0,0,61,24,37,35,27,8,0
2021,Newcastle-under-Lyme 003A,E01029540,613,444,292,152,4,4,130,29,101,35,22,13,0
2021,Newcastle-under-Lyme 003B,E01029541,742,473,197,276,12,12,177,61,116,80,70,10,0
2021,Newcastle-under-Lyme 003C,E01029542,762,547,280,267,8,8,68,21,47,139,129,10,0
2021,Newcastle-under-Lyme 003D,E01029543,490,237,109,128,3,3,203,66,137,47,36,11,0
2021,Newcastle-under-Lyme 004B,E01029544,541,446,211,235,2,2,54,17,37,38,31,7,1
2021,Newcastle-under-Lyme 004C,E01029545,611,488,270,218,6,6,49,13,36,68,51,17,0
2021,Newcastle-under-Lyme 004D,E01029546,476,412,180,232,1,1,4,2,2,59,48,11,0
2021,Newcastle-under-Lyme 007A,E01029547,646,246,95,151,0,0,220,90,130,178,159,19,2
2021,Newcastle-under-Lyme 007B,E01029548,581,228,132,96,0,0,240,89,151,112,102,10,1
2021,Newcastle-under-Lyme 014A,E01029549,770,453,274,179,2,2,230,74,156,84,73,11,1
2021,Newcastle-under-Lyme 014B,E01029551,647,501,255,246,1,1,41,13,28,104,91,13,0
2021,Newcastle-under-Lyme 006D,E01029552,617,432,231,201,0,0,129,45,84,56,44,12,0
2021,Newcastle-under-Lyme 010A,E01029553,690,345,154,191,8,8,260,97,163,77,64,13,0
2021,Newcastle-under-Lyme 010B,E01029554,833,264,89,175,48,48,414,130,284,105,95,10,2
2021,Newcastle-under-Lyme 011A,E01029555,791,377,212,165,2,2,225,73,152,187,161,26,0
2021,Newcastle-under-Lyme 005E,E01029556,1122,886,532,354,8,8,111,30,81,116,84,32,1
2021,Newcastle-under-Lyme 013A,E01029557,561,456,310,146,0,0,27,7,20,76,60,16,2
2021,Newcastle-under-Lyme 006E,E01029558,673,345,156,189,15,15,208,84,124,102,88,14,3
2021,Newcastle-under-Lyme 007C,E01029559,598,402,207,195,0,0,100,28,72,95,74,21,1
2021,Newcastle-under-Lyme 007D,E01029560,645,273,134,139,1,1,274,85,189,97,91,6,0
2021,Newcastle-under-Lyme 002A,E01029561,591,372,199,173,0,0,163,55,108,56,47,9,0
2021,Newcastle-under-Lyme 001A,E01029562,521,448,230,218,0,0,31,7,24,42,39,3,0
2021,Newcastle-under-Lyme 002B,E01029563,594,458,281,177,6,6,76,18,58,53,43,10,1
2021,Newcastle-under-Lyme 002C,E01029564,525,286,179,107,1,1,29,5,24,209,195,14,0
2021,Newcastle-under-Lyme 001B,E01029565,470,428,249,179,6,6,7,0,7,29,20,9,0
2021,Newcastle-under-Lyme 010C,E01029566,478,130,59,71,2,2,291,112,179,52,45,7,3
2021,Newcastle-under-Lyme 010D,E01029567,768,447,235,212,7,7,163,51,112,147,128,19,4
2021,Newcastle-under-Lyme 007E,E01029568,623,340,202,138,2,2,144,47,97,135,119,16,2
2021,Newcastle-under-Lyme 016A,E01029569,645,476,296,180,4,4,47,16,31,118,97,21,0
2021,Newcastle-under-Lyme 016B,E01029570,1138,961,563,398,12,12,42,12,30,123,88,35,0
2021,Newcastle-under-Lyme 016C,E01029571,556,464,318,146,0,0,56,7,49,36,26,10,0
2021,Newcastle-under-Lyme 016D,E01029572,657,598,363,235,1,1,8,4,4,50,39,11,0
2021,Newcastle-under-Lyme 013B,E01029573,618,509,287,222,4,4,28,8,20,77,70,7,0
2021,Newcastle-under-Lyme 013C,E01029574,683,499,311,188,12,12,80,6,74,91,72,19,1
2021,Newcastle-under-Lyme 013D,E01029575,462,257,150,107,0,0,142,44,98,61,45,16,2
2021,Newcastle-under-Lyme 012A,E01029576,501,375,210,165,4,4,37,16,21,85,39,46,0
2021,Newcastle-under-Lyme 009A,E01029577,693,547,300,247,3,3,17,4,13,126,105,21,0
2021,Newcastle-under-Lyme 011B,E01029578,821,434,249,185,2,2,267,50,217,116,94,22,2
2021,Newcastle-under-Lyme 009B,E01029579,761,569,326,243,1,1,73,16,57,117,102,15,1
2021,Newcastle-under-Lyme 009C,E01029580,596,489,280,209,2,2,15,5,10,90,76,14,0
2021,Newcastle-under-Lyme 001C,E01029581,686,596,338,258,3,3,19,5,14,68,61,7,0
2021,Newcastle-under-Lyme 001D,E01029582,780,678,384,294,0,0,41,10,31,61,48,13,0
2021,Newcastle-under-Lyme 008A,E01029583,683,431,220,211,2,2,117,13,104,133,110,23,0
2021,Newcastle-under-Lyme 008B,E01029584,535,426,211,215,2,2,39,12,27,68,56,12,0
2021,Newcastle-under-Lyme 008C,E01029585,637,444,236,208,3,3,25,3,22,165,147,18,0
2021,Newcastle-under-Lyme 001E,E01029586,533,491,343,148,0,0,10,3,7,32,27,5,0
2021,Newcastle-under-Lyme 001F,E01029587,533,471,277,194,1,1,8,3,5,53,43,10,0
2021,Newcastle-under-Lyme 002D,E01029588,776,454,250,204,1,1,180,54,126,140,128,12,1
2021,Newcastle-under-Lyme 015B,E01029589,514,465,284,181,10,10,6,1,5,33,30,3,0
2021,Newcastle-under-Lyme 015C,E01029590,602,475,319,156,1,1,73,25,48,53,44,9,0
2021,Newcastle-under-Lyme 014C,E01029591,732,338,207,131,10,10,294,92,202,89,78,11,1
2021,Newcastle-under-Lyme 012B,E01029593,1045,586,237,349,25,25,279,94,185,155,140,15,0
2021,Newcastle-under-Lyme 012C,E01029594,878,575,365,210,3,3,131,42,89,168,144,24,1
2021,Newcastle-under-Lyme 003E,E01029595,590,480,325,155,3,3,45,16,29,62,51,11,0
2021,Newcastle-under-Lyme 004E,E01029596,498,430,312,118,2,2,29,5,24,37,22,15,0
2021,Newcastle-under-Lyme 003F,E01029597,620,319,154,165,1,1,233,89,144,65,50,15,2
2021,Newcastle-under-Lyme 010E,E01029598,837,341,133,208,0,0,287,96,191,207,187,20,2
2021,Newcastle-under-Lyme 010F,E01029599,705,327,205,122,13,13,261,66,195,104,91,13,0
2021,Newcastle-under-Lyme 014D,E01029600,647,552,340,212,2,2,14,3,11,79,70,9,0
2021,Newcastle-under-Lyme 015E,E01029601,670,498,324,174,24,24,68,17,51,80,64,16,0
2021,Newcastle-under-Lyme 011C,E01029602,829,324,218,106,1,1,144,6,138,359,340,19,1
2021,Newcastle-under-Lyme 011D,E01029603,703,299,184,115,3,3,197,59,138,204,180,24,0
2021,Newcastle-under-Lyme 011E,E01029604,844,200,130,70,7,7,327,96,231,308,283,25,2
2021,Newcastle-under-Lyme 014E,E01029605,554,469,266,203,1,1,11,1,10,73,62,11,0
2021,Newcastle-under-Lyme 015F,E01029606,576,534,304,230,0,0,11,1,10,31,25,6,0
2021,Newcastle-under-Lyme 014F,E01029607,626,417,243,174,6,6,144,48,96,58,49,9,1
2021,Newcastle-under-Lyme 015G,E01029608,642,545,369,176,2,2,60,12,48,35,27,8,0
2021,Newcastle-under-Lyme 008D,E01029609,798,529,285,244,4,4,59,13,46,206,195,11,0
2021,Newcastle-under-Lyme 009D,E01029610,594,466,235,231,1,1,12,3,9,115,102,13,0
2021,Newcastle-under-Lyme 008E,E01029611,871,441,164,277,13,13,266,62,204,151,135,16,0
2021,Newcastle-under-Lyme 009E,E01029612,504,453,276,177,1,1,9,1,8,41,33,8,0
2021,South Staffordshire 008A,E01029613,611,508,325,183,1,1,42,5,37,60,41,19,0
2021,South Staffordshire 008B,E01029614,729,486,279,207,11,11,190,9,181,42,32,10,0
2021,South Staffordshire 008C,E01029615,561,239,132,107,3,3,244,27,217,73,64,9,2
2021,South Staffordshire 006A,E01029616,692,603,432,171,3,3,12,2,10,74,58,16,0
2021,South Staffordshire 003A,E01029617,687,581,401,180,3,3,25,3,22,78,65,13,0
2021,South Staffordshire 003B,E01029618,731,476,317,159,1,1,164,12,152,90,74,16,0
2021,South Staffordshire 006B,E01029619,900,685,438,247,11,11,130,12,118,74,59,15,0
2021,South Staffordshire 004A,E01029620,514,404,222,182,0,0,55,6,49,55,46,9,0
2021,South Staffordshire 002A,E01029621,614,516,290,226,0,0,45,2,43,53,40,13,0
2021,South Staffordshire 004B,E01029622,681,501,265,236,7,7,95,4,91,78,61,17,0
2021,South Staffordshire 004C,E01029623,498,323,212,111,0,0,150,14,136,25,20,5,0
2021,South Staffordshire 004D,E01029624,547,454,246,208,1,1,61,11,50,31,22,9,0
2021,South Staffordshire 004E,E01029625,485,421,294,127,2,2,13,0,13,49,39,10,0
2021,South Staffordshire 009A,E01029626,640,533,314,219,1,1,59,4,55,47,42,5,0
2021,South Staffordshire 008D,E01029627,650,321,196,125,0,0,247,20,227,76,65,11,6
2021,South Staffordshire 009B,E01029628,688,589,318,271,30,30,45,6,39,24,18,6,0
2021,South Staffordshire 009C,E01029629,480,465,300,165,0,0,3,0,3,12,10,2,0
2021,South Staffordshire 009D,E01029630,539,477,287,190,0,0,20,1,19,42,34,8,0
2021,South Staffordshire 009E,E01029631,570,441,233,208,2,2,36,2,34,91,79,12,0
2021,South Staffordshire 007A,E01029632,606,543,311,232,0,0,10,2,8,53,40,13,0
2021,South Staffordshire 007B,E01029633,753,612,344,268,16,16,90,4,86,35,30,5,0
2021,South Staffordshire 007C,E01029634,698,339,194,145,10,10,293,30,263,56,52,4,0
2021,South Staffordshire 007D,E01029635,716,364,208,156,3,3,277,24,253,72,59,13,0
2021,South Staffordshire 006C,E01029636,588,503,299,204,0,0,34,4,30,51,44,7,0
2021,South Staffordshire 006D,E01029637,676,542,250,292,2,2,52,8,44,80,70,10,0
2021,South Staffordshire 005A,E01029638,899,619,372,247,1,1,177,22,155,101,85,16,1
2021,South Staffordshire 005B,E01029639,523,399,226,173,1,1,94,9,85,29,22,7,0
2021,South Staffordshire 005C,E01029640,567,432,195,237,2,2,29,1,28,104,92,12,0
2021,South Staffordshire 004F,E01029641,839,702,361,341,20,20,58,5,53,59,49,10,0
2021,South Staffordshire 004G,E01029642,641,526,323,203,1,1,56,10,46,58,47,11,0
2021,South Staffordshire 005D,E01029643,632,334,195,139,1,1,255,27,228,42,35,7,0
2021,South Staffordshire 005E,E01029644,607,498,331,167,2,2,56,11,45,51,42,9,0
2021,South Staffordshire 013A,E01029645,1097,844,521,323,9,9,158,11,147,86,69,17,0
2021,South Staffordshire 002B,E01029646,631,400,164,236,0,0,156,16,140,75,63,12,0
2021,South Staffordshire 002C,E01029647,947,585,229,356,54,54,201,19,182,107,93,14,0
2021,South Staffordshire 002D,E01029648,587,394,246,148,0,0,132,13,119,61,51,10,0
2021,South Staffordshire 014A,E01029649,620,412,303,109,0,0,136,9,127,72,60,12,0
2021,South Staffordshire 014B,E01029650,670,592,392,200,3,3,21,2,19,54,42,12,0
2021,South Staffordshire 014C,E01029651,624,539,365,174,3,3,18,2,16,64,53,11,0
2021,South Staffordshire 014D,E01029652,685,614,349,265,2,2,7,0,7,62,53,9,0
2021,South Staffordshire 014E,E01029653,520,368,226,142,0,0,103,12,91,48,43,5,1
2021,South Staffordshire 015G,E01029654,983,760,458,302,10,10,126,4,122,86,69,17,1
2021,South Staffordshire 001A,E01029655,870,607,408,199,14,14,157,18,139,92,78,14,0
2021,South Staffordshire 001B,E01029656,749,609,362,247,1,1,17,3,14,122,108,14,0
2021,South Staffordshire 001C,E01029657,617,536,275,261,3,3,30,3,27,48,39,9,0
2021,South Staffordshire 001D,E01029658,916,572,257,315,70,70,178,26,152,96,75,21,0
2021,South Staffordshire 001E,E01029659,572,498,322,176,0,0,21,1,20,53,41,12,0
2021,South Staffordshire 001F,E01029660,974,661,401,260,21,21,157,23,134,135,119,16,0
2021,South Staffordshire 015C,E01029661,792,683,415,268,5,5,11,1,10,93,80,13,0
2021,South Staffordshire 015D,E01029662,815,735,396,339,2,2,12,3,9,66,61,5,0
2021,South Staffordshire 015E,E01029663,590,477,253,224,8,8,5,0,5,100,93,7,0
2021,South Staffordshire 015F,E01029664,663,463,272,191,15,15,60,10,50,125,114,11,0
2021,South Staffordshire 015A,E01029665,759,606,368,238,2,2,18,0,18,132,121,11,1
2021,South Staffordshire 015B,E01029666,735,231,120,111,1,1,404,35,369,99,91,8,0
2021,South Staffordshire 013B,E01029667,931,640,404,236,0,0,94,7,87,197,172,25,0
2021,South Staffordshire 003C,E01029668,549,462,303,159,1,1,9,2,7,77,64,13,0
2021,South Staffordshire 003D,E01029669,584,411,261,150,16,16,114,6,108,43,36,7,0
2021,South Staffordshire 003E,E01029670,631,431,258,173,0,0,38,1,37,162,139,23,0
2021,South Staffordshire 012A,E01029671,690,456,290,166,4,4,159,9,150,70,61,9,1
2021,South Staffordshire 013C,E01029672,628,526,298,228,1,1,30,5,25,71,58,13,0
2021,South Staffordshire 012B,E01029673,668,441,257,184,1,1,123,19,104,102,93,9,1
2021,South Staffordshire 013D,E01029674,688,622,361,261,3,3,26,2,24,37,28,9,0
2021,South Staffordshire 013E,E01029675,670,578,408,170,0,0,60,6,54,32,22,10,0
2021,South Staffordshire 012C,E01029676,552,342,207,135,17,17,117,6,111,73,63,10,3
2021,South Staffordshire 013F,E01029677,584,487,276,211,1,1,42,1,41,54,48,6,0
2021,South Staffordshire 013G,E01029678,681,603,340,263,0,0,10,2,8,68,60,8,0
2021,South Staffordshire 012D,E01029679,643,255,147,108,1,1,312,37,275,75,65,10,0
2021,South Staffordshire 012E,E01029680,638,479,283,196,1,1,87,8,79,71,63,8,0
2021,Stafford 002A,E01029681,491,315,165,150,0,0,123,39,84,53,49,4,0
2021,Stafford 002B,E01029682,700,559,369,190,0,0,87,31,56,53,38,15,1
2021,Stafford 002C,E01029683,532,420,274,146,3,3,37,13,24,69,51,18,3
2021,Stafford 014A,E01029684,584,507,270,237,6,6,4,2,2,67,53,14,0
2021,Stafford 014B,E01029685,638,581,360,221,1,1,4,1,3,52,39,13,0
2021,Stafford 011A,E01029686,599,522,323,199,3,3,5,1,4,69,58,11,0
2021,Stafford 008A,E01029687,874,723,445,278,0,0,34,3,31,117,100,17,0
2021,Stafford 015A,E01029688,1051,789,510,279,0,0,107,37,70,155,114,41,0
2021,Stafford 010A,E01029689,880,401,182,219,8,8,94,14,80,377,347,30,0
2021,Stafford 006A,E01029690,626,488,234,254,2,2,21,5,16,115,106,9,0
2021,Stafford 010B,E01029691,791,203,74,129,3,3,337,69,268,246,228,18,2
2021,Stafford 009A,E01029692,641,317,141,176,5,5,247,72,175,72,60,12,0
2021,Stafford 009B,E01029693,586,120,49,71,7,7,179,17,162,280,153,127,0
2021,Stafford 010C,E01029694,922,319,134,185,4,4,48,9,39,551,323,228,0
2021,Stafford 005A,E01029695,1116,760,459,301,27,27,186,37,149,142,124,18,1
2021,Stafford 005B,E01029696,647,479,301,178,1,1,49,14,35,118,91,27,0
2021,Stafford 005C,E01029697,545,437,242,195,1,1,32,13,19,75,61,14,0
2021,Stafford 005D,E01029698,798,657,380,277,13,13,41,7,34,87,74,13,0
2021,Stafford 010D,E01029699,950,476,208,268,11,11,177,17,160,286,266,20,0
2021,Stafford 011B,E01029700,533,458,242,216,1,1,5,4,1,69,61,8,0
2021,Stafford 001A,E01029702,641,453,280,173,0,0,131,38,93,57,52,5,0
2021,Stafford 001B,E01029703,661,546,280,266,4,4,33,5,28,78,59,19,0
2021,Stafford 001C,E01029704,637,516,339,177,8,8,62,19,43,51,36,15,0
2021,Stafford 001D,E01029705,636,592,404,188,0,0,8,2,6,36,28,8,0
2021,Stafford 015B,E01029706,770,631,374,257,19,19,52,19,33,68,50,18,0
2021,Stafford 015C,E01029707,688,436,271,165,5,5,143,39,104,101,77,24,3
2021,Stafford 015D,E01029708,884,690,388,302,10,10,60,20,40,124,98,26,0
2021,Stafford 015E,E01029709,663,577,374,203,0,0,22,5,17,64,50,14,0
2021,Stafford 008B,E01029710,652,574,400,174,1,1,17,7,10,60,53,7,0
2021,Stafford 008C,E01029711,662,552,327,225,4,4,44,7,37,62,44,18,0
2021,Stafford 008D,E01029712,867,703,381,322,8,8,99,23,76,56,47,9,1
2021,Stafford 008E,E01029713,815,614,375,239,17,17,106,14,92,78,69,9,0
2021,Stafford 012A,E01029714,648,560,323,237,0,0,7,3,4,81,72,9,0
2021,Stafford 013A,E01029715,756,339,156,183,25,25,264,41,223,128,119,9,0
2021,Stafford 013B,E01029716,660,325,186,139,2,2,245,76,169,86,71,15,2
2021,Stafford 013C,E01029717,759,279,156,123,3,3,403,114,289,73,62,11,1
2021,Stafford 006B,E01029718,803,712,395,317,1,1,10,1,9,80,65,15,0
2021,Stafford 007A,E01029719,714,504,297,207,9,9,100,24,76,100,79,21,1
2021,Stafford 007B,E01029720,661,260,112,148,1,1,312,127,185,87,83,4,1
2021,Stafford 007C,E01029721,712,592,332,260,4,4,26,4,22,90,81,9,0
2021,Stafford 009C,E01029722,695,423,202,221,0,0,104,33,71,168,138,30,0
2021,Stafford 011C,E01029723,679,562,330,232,5,5,19,4,15,93,78,15,0
2021,Stafford 011D,E01029724,685,595,322,273,0,0,5,2,3,85,78,7,0
2021,Stafford 009D,E01029725,1000,503,163,340,8,8,220,62,158,268,244,24,1
2021,Stafford 016A,E01029726,703,536,292,244,2,2,96,34,62,68,53,15,1
2021,Stafford 013D,E01029727,663,239,108,131,1,1,325,110,215,95,82,13,3
2021,Stafford 013E,E01029728,630,460,238,222,3,3,103,30,73,62,52,10,2
2021,Stafford 016B,E01029729,841,405,221,184,6,6,295,65,230,135,120,15,0
2021,Stafford 004A,E01029733,770,580,378,202,3,3,45,12,33,142,111,31,0
2021,Stafford 016C,E01029734,926,327,120,207,13,13,472,145,327,113,97,16,1
2021,Stafford 016D,E01029735,946,666,348,318,7,7,128,45,83,143,131,12,2
2021,Stafford 012B,E01029736,680,542,285,257,13,13,20,0,20,105,93,12,0
2021,Stafford 012C,E01029737,777,540,315,225,12,12,147,35,112,78,65,13,0
2021,Stafford 012D,E01029738,574,496,268,228,4,4,7,2,5,67,58,9,0
2021,Stafford 004B,E01029739,600,533,287,246,1,1,4,0,4,62,59,3,0
2021,Stafford 003A,E01029740,672,388,222,166,0,0,202,59,143,81,74,7,1
2021,Stafford 004C,E01029741,684,547,291,256,0,0,33,5,28,104,92,12,0
2021,Stafford 012E,E01029742,905,752,490,262,5,5,33,9,24,115,94,21,0
2021,Stafford 006C,E01029743,1043,902,362,540,14,14,19,14,5,108,91,17,0
2021,Stafford 003B,E01029744,1062,780,389,391,8,8,31,9,22,243,226,17,0
2021,Stafford 003C,E01029745,979,463,307,156,4,4,257,32,225,254,221,33,1
2021,Stafford 003D,E01029746,675,453,253,200,3,3,117,33,84,102,87,15,0
2021,Stafford 005E,E01029747,841,682,294,388,16,16,75,18,57,68,57,11,0
2021,Stafford 002D,E01029748,576,546,338,208,1,1,3,0,3,26,16,10,0
2021,Stafford 002E,E01029749,815,584,364,220,4,4,66,15,51,161,137,24,0
2021,Stafford 007D,E01029750,1013,603,244,359,32,32,234,36,198,144,128,16,0
2021,Stafford 006D,E01029751,771,630,395,235,7,7,83,31,52,50,40,10,1
2021,Stafford 007E,E01029752,522,233,143,90,9,9,223,62,161,56,45,11,1
2021,Stafford 003E,E01029753,905,624,318,306,21,21,161,40,121,99,85,14,0
2021,Stafford 004D,E01029754,773,621,357,264,21,21,68,19,49,63,55,8,0
2021,Stafford 004E,E01029755,649,583,412,171,1,1,17,2,15,48,40,8,0
2021,Stafford 003F,E01029756,810,532,239,293,5,5,82,8,74,190,167,23,1
2021,Stafford 014E,E01029757,632,532,292,240,2,2,5,0,5,93,79,14,0
2021,Stafford 014F,E01029758,673,612,379,233,1,1,10,2,8,50,41,9,0
2021,Stafford 014G,E01029759,737,647,405,242,2,2,10,2,8,78,68,10,0
2021,Stafford 014H,E01029760,730,654,406,248,8,8,28,6,22,40,33,7,0
2021,Staffordshire Moorlands 010A,E01029761,590,489,334,155,1,1,29,9,20,71,56,15,0
2021,Staffordshire Moorlands 008A,E01029762,691,624,385,239,1,1,14,5,9,52,43,9,0
2021,Staffordshire Moorlands 003A,E01029763,661,304,138,166,0,0,276,121,155,80,73,7,1
2021,Staffordshire Moorlands 003B,E01029764,661,476,193,283,1,1,87,28,59,97,91,6,0
2021,Staffordshire Moorlands 003C,E01029765,526,261,153,108,3,3,163,54,109,98,88,10,1
2021,Staffordshire Moorlands 003D,E01029766,618,381,195,186,0,0,154,47,107,83,75,8,0
2021,Staffordshire Moorlands 002A,E01029767,720,642,415,227,0,0,17,3,14,61,49,12,0
2021,Staffordshire Moorlands 004A,E01029768,689,580,384,196,8,8,42,7,35,59,51,8,0
2021,Staffordshire Moorlands 002B,E01029769,805,760,515,245,1,1,6,1,5,38,27,11,0
2021,Staffordshire Moorlands 002C,E01029770,925,817,496,321,11,11,24,0,24,73,55,18,0
2021,Staffordshire Moorlands 004B,E01029771,726,656,454,202,3,3,14,6,8,53,40,13,0
2021,Staffordshire Moorlands 004C,E01029772,768,627,384,243,0,0,45,9,36,95,79,16,1
2021,Staffordshire Moorlands 004D,E01029773,670,625,443,182,1,1,2,1,1,42,27,15,0
2021,Staffordshire Moorlands 003E,E01029774,938,611,317,294,2,2,94,33,61,231,209,22,0
2021,Staffordshire Moorlands 008B,E01029775,670,614,413,201,0,0,4,0,4,52,38,14,0
2021,Staffordshire Moorlands 008C,E01029776,738,682,443,239,2,2,5,2,3,49,35,14,0
2021,Staffordshire Moorlands 008D,E01029777,640,498,279,219,1,1,46,18,28,95,82,13,0
2021,Staffordshire Moorlands 012A,E01029778,759,636,412,224,5,5,37,21,16,81,57,24,0
2021,Staffordshire Moorlands 009A,E01029779,729,666,451,215,3,3,6,1,5,54,42,12,0
2021,Staffordshire Moorlands 009B,E01029780,671,563,318,245,1,1,53,18,35,52,39,13,2
2021,Staffordshire Moorlands 011A,E01029781,692,555,361,194,1,1,35,10,25,101,88,13,0
2021,Staffordshire Moorlands 010B,E01029782,849,561,306,255,1,1,157,51,106,129,118,11,1
2021,Staffordshire Moorlands 011B,E01029783,691,378,195,183,8,8,188,51,137,117,103,14,0
2021,Staffordshire Moorlands 013A,E01029784,926,834,529,305,1,1,11,4,7,80,60,20,0
2021,Staffordshire Moorlands 013B,E01029785,711,668,372,296,5,5,2,0,2,36,26,10,0
2021,Staffordshire Moorlands 011C,E01029786,589,522,315,207,0,0,11,0,11,56,44,12,0
2021,Staffordshire Moorlands 011D,E01029787,912,479,303,176,2,2,191,54,137,240,217,23,0
2021,Staffordshire Moorlands 013C,E01029788,538,475,303,172,0,0,16,1,15,47,35,12,0
2021,Staffordshire Moorlands 012B,E01029789,434,376,233,143,3,3,17,1,16,38,34,4,0
2021,Staffordshire Moorlands 013D,E01029790,748,609,334,275,1,1,82,24,58,55,43,12,1
2021,Staffordshire Moorlands 013E,E01029791,665,534,325,209,5,5,12,5,7,114,100,14,0
2021,Staffordshire Moorlands 006A,E01029792,978,827,471,356,0,0,25,8,17,126,106,20,0
2021,Staffordshire Moorlands 006B,E01029793,673,578,340,238,2,2,30,9,21,63,50,13,0
2021,Staffordshire Moorlands 009C,E01029794,600,506,341,165,2,2,17,5,12,75,55,20,0
2021,Staffordshire Moorlands 010C,E01029795,764,607,364,243,3,3,71,14,57,82,64,18,1
2021,Staffordshire Moorlands 010D,E01029796,660,525,307,218,0,0,60,17,43,75,58,17,0
2021,Staffordshire Moorlands 001A,E01029797,619,490,324,166,10,10,36,15,21,83,57,26,0
2021,Staffordshire Moorlands 012C,E01029798,720,549,342,207,3,3,72,29,43,96,85,11,0
2021,Staffordshire Moorlands 012D,E01029799,828,740,460,280,2,2,24,7,17,62,37,25,0
2021,Staffordshire Moorlands 012E,E01029800,673,598,354,244,0,0,8,4,4,67,57,10,0
2021,Staffordshire Moorlands 007A,E01029801,743,596,391,205,5,5,34,7,27,108,85,23,0
2021,Staffordshire Moorlands 002D,E01029802,743,655,455,200,2,2,15,4,11,71,51,20,0
2021,Staffordshire Moorlands 007B,E01029803,771,671,471,200,2,2,20,7,13,77,63,14,1
2021,Staffordshire Moorlands 005A,E01029804,961,524,313,211,2,2,35,5,30,400,368,32,0
2021,Staffordshire Moorlands 006C,E01029805,728,564,350,214,2,2,73,7,66,89,74,15,0
2021,Staffordshire Moorlands 001B,E01029806,680,567,386,181,5,5,29,5,24,79,65,14,0
2021,Staffordshire Moorlands 005B,E01029807,536,330,195,135,0,0,130,30,100,75,59,16,1
2021,Staffordshire Moorlands 001C,E01029808,702,445,273,172,20,20,118,35,83,117,104,13,2
2021,Staffordshire Moorlands 001D,E01029809,626,278,168,110,1,1,283,99,184,60,51,9,4
2021,Staffordshire Moorlands 001E,E01029810,579,335,190,145,1,1,163,63,100,80,70,10,0
2021,Staffordshire Moorlands 005C,E01029811,644,433,215,218,3,3,133,43,90,73,51,22,2
2021,Staffordshire Moorlands 005D,E01029812,1058,550,310,240,8,8,187,19,168,313,286,27,0
2021,Staffordshire Moorlands 006D,E01029813,945,818,464,354,4,4,34,11,23,88,77,11,1
2021,Staffordshire Moorlands 005E,E01029814,786,542,318,224,2,2,63,6,57,179,164,15,0
2021,Staffordshire Moorlands 006E,E01029815,677,555,386,169,1,1,58,10,48,62,55,7,1
2021,Staffordshire Moorlands 006F,E01029816,612,548,353,195,2,2,21,6,15,41,31,10,0
2021,Staffordshire Moorlands 007C,E01029817,749,568,398,170,3,3,65,15,50,113,88,25,0
2021,Staffordshire Moorlands 009D,E01029818,614,570,363,207,1,1,3,2,1,40,37,3,0
2021,Staffordshire Moorlands 009E,E01029819,717,665,405,260,1,1,7,3,4,43,28,15,1
2021,Tamworth 003A,E01029820,924,679,247,432,12,12,165,118,47,66,56,10,2
2021,Tamworth 003B,E01029821,627,521,317,204,3,3,20,15,5,83,69,14,0
2021,Tamworth 003C,E01029822,530,460,183,277,2,2,28,24,4,37,33,4,3
2021,Tamworth 004A,E01029823,648,553,351,202,3,3,30,27,3,62,50,12,0
2021,Tamworth 003D,E01029824,697,280,112,168,0,0,336,226,110,79,75,4,2
2021,Tamworth 006A,E01029825,514,440,244,196,2,2,10,8,2,62,55,7,0
2021,Tamworth 006B,E01029826,738,614,321,293,0,0,32,30,2,92,82,10,0
2021,Tamworth 006C,E01029827,550,255,93,162,0,0,223,199,24,71,62,9,1
2021,Tamworth 006D,E01029828,465,195,70,125,5,5,187,171,16,77,71,6,1
2021,Tamworth 010A,E01029829,847,582,238,344,10,10,136,57,79,118,107,11,1
2021,Tamworth 006E,E01029830,530,276,113,163,2,2,103,49,54,146,135,11,3
2021,Tamworth 004B,E01029831,647,398,203,195,2,2,134,128,6,112,102,10,1
2021,Tamworth 004C,E01029832,697,512,303,209,7,7,106,74,32,71,65,6,1
2021,Tamworth 005A,E01029833,696,534,236,298,12,12,46,7,39,103,93,10,1
2021,Tamworth 004D,E01029834,705,390,205,185,3,3,201,192,9,107,97,10,4
2021,Tamworth 002A,E01029835,1075,255,166,89,1,1,515,300,215,298,275,23,6
2021,Tamworth 002B,E01029836,767,456,178,278,15,15,166,78,88,130,123,7,0
2021,Tamworth 005B,E01029837,660,418,211,207,10,10,110,102,8,119,106,13,3
2021,Tamworth 005C,E01029838,711,430,211,219,2,2,25,20,5,254,246,8,0
2021,Tamworth 005D,E01029839,444,401,212,189,1,1,7,4,3,35,33,2,0
2021,Tamworth 007A,E01029840,454,188,70,118,1,1,193,187,6,71,64,7,1
2021,Tamworth 003E,E01029841,611,480,277,203,0,0,57,38,19,73,62,11,1
2021,Tamworth 007B,E01029842,495,211,89,122,1,1,204,199,5,76,67,9,3
2021,Tamworth 007C,E01029843,545,285,126,159,7,7,172,157,15,81,68,13,0
2021,Tamworth 004E,E01029844,488,435,227,208,3,3,9,6,3,41,37,4,0
2021,Tamworth 007D,E01029845,445,52,32,20,1,1,376,22,354,16,15,1,0
2021,Tamworth 001A,E01029846,669,514,236,278,9,9,87,62,25,59,52,7,0
2021,Tamworth 001B,E01029847,574,528,328,200,3,3,6,6,0,35,30,5,2
2021,Tamworth 001C,E01029848,500,436,268,168,0,0,25,5,20,39,33,6,0
2021,Tamworth 002C,E01029849,693,341,195,146,2,2,275,219,56,73,63,10,2
2021,Tamworth 002D,E01029850,591,290,150,140,9,9,169,145,24,119,105,14,4
2021,Tamworth 002E,E01029851,983,531,294,237,11,11,138,62,76,302,281,21,1
2021,Tamworth 001D,E01029852,750,468,290,178,1,1,213,164,49,67,54,13,1
2021,Tamworth 001E,E01029853,691,470,249,221,2,2,102,92,10,115,102,13,2
2021,Tamworth 001F,E01029854,1010,839,411,428,36,36,60,11,49,74,62,12,1
2021,Tamworth 008A,E01029855,578,431,198,233,1,1,113,46,67,33,31,2,0
2021,Tamworth 008B,E01029856,585,476,188,288,0,0,34,30,4,75,68,7,0
2021,Tamworth 008C,E01029857,611,381,149,232,1,1,150,113,37,79,76,3,0
2021,Tamworth 008D,E01029858,628,531,277,254,1,1,17,1,16,79,74,5,0
2021,Tamworth 007E,E01029859,715,278,80,198,2,2,312,283,29,121,111,10,2
2021,Tamworth 009A,E01029860,535,480,255,225,0,0,6,4,2,49,43,6,0
2021,Tamworth 009B,E01029861,587,419,244,175,1,1,101,66,35,65,57,8,1
2021,Tamworth 009C,E01029862,489,447,207,240,2,2,10,7,3,30,21,9,0
2021,Tamworth 009D,E01029863,772,621,322,299,1,1,30,23,7,120,109,11,0
2021,Tamworth 009E,E01029864,658,552,322,230,4,4,28,5,23,74,67,7,0
2021,Tamworth 008E,E01029865,606,542,244,298,0,0,6,1,5,58,55,3,0
2021,Tamworth 010C,E01029867,695,396,207,189,0,0,167,159,8,129,121,8,3
2021,Tamworth 010D,E01029868,526,475,249,226,0,0,16,15,1,35,31,4,0
2021,Tamworth 010E,E01029869,653,465,245,220,2,2,136,123,13,44,38,6,6
2021,Babergh 010A,E01029870,474,322,171,151,4,4,86,43,43,62,55,7,0
2021,Babergh 011A,E01029871,624,473,307,166,3,3,78,52,26,70,48,22,0
2021,Babergh 010B,E01029872,609,531,323,208,3,3,16,11,5,59,43,16,0
2021,Babergh 011B,E01029873,1005,689,469,220,7,7,143,100,43,160,136,24,6
2021,Babergh 011C,E01029874,741,630,352,278,0,0,14,10,4,97,84,13,0
2021,Babergh 009A,E01029875,994,746,451,295,8,8,120,59,61,119,95,24,1
2021,Babergh 001A,E01029876,963,679,424,255,10,10,145,87,58,128,92,36,1
2021,Babergh 005A,E01029877,568,458,268,190,6,6,38,32,6,66,51,15,0
2021,Babergh 005B,E01029878,549,449,274,175,0,0,30,25,5,70,60,10,0
2021,Babergh 005C,E01029879,711,557,301,256,3,3,77,57,20,73,57,16,1
2021,Babergh 006A,E01029880,829,603,376,227,2,2,99,55,44,125,102,23,0
2021,Babergh 002A,E01029881,862,689,426,263,2,2,68,38,30,102,71,31,1
2021,Babergh 010C,E01029882,642,475,313,162,2,2,101,70,31,64,51,13,0
2021,Babergh 010D,E01029883,884,740,481,259,3,3,28,21,7,113,88,25,0
2021,Babergh 002B,E01029884,745,458,261,197,0,0,148,91,57,138,123,15,1
2021,Babergh 002C,E01029885,1039,853,524,329,0,0,42,25,17,144,120,24,0
2021,Babergh 008A,E01029886,545,294,184,110,4,4,181,122,59,65,60,5,1
2021,Babergh 008B,E01029887,913,704,400,304,29,29,27,6,21,153,142,11,0
2021,Babergh 008C,E01029888,520,277,152,125,2,2,159,138,21,81,69,12,1
2021,Babergh 008D,E01029889,519,248,141,107,1,1,210,199,11,59,51,8,1
2021,Babergh 008E,E01029890,652,508,218,290,14,14,53,12,41,77,64,13,0
2021,Babergh 008F,E01029891,898,647,342,305,4,4,128,16,112,119,109,10,0
2021,Babergh 004A,E01029892,901,442,292,150,4,4,260,211,49,183,160,23,12
2021,Babergh 004C,E01029894,522,384,260,124,1,1,34,5,29,103,93,10,0
2021,Babergh 004D,E01029895,482,432,267,165,0,0,8,5,3,42,36,6,0
2021,Babergh 004E,E01029896,592,350,213,137,1,1,161,134,27,76,63,13,4
2021,Babergh 011D,E01029897,868,614,382,232,10,10,106,87,19,138,73,65,0
2021,Babergh 001B,E01029898,998,634,456,178,10,10,212,156,56,138,112,26,4
2021,Babergh 009B,E01029899,798,697,423,274,0,0,38,23,15,62,43,19,1
2021,Babergh 003A,E01029900,812,495,329,166,7,7,237,188,49,66,54,12,7
2021,Babergh 003B,E01029901,1142,853,592,261,4,4,50,19,31,235,198,37,0
2021,Babergh 009C,E01029902,939,740,477,263,4,4,81,56,25,110,92,18,4
2021,Babergh 010E,E01029903,619,553,352,201,22,22,14,7,7,30,22,8,0
2021,Babergh 010F,E01029904,709,590,353,237,7,7,59,25,34,53,41,12,0
2021,Babergh 010G,E01029905,484,401,244,157,0,0,23,18,5,60,48,12,0
2021,Babergh 009D,E01029906,813,583,376,207,3,3,95,72,23,132,95,37,0
2021,Babergh 001C,E01029907,1031,773,519,254,5,5,133,74,59,120,93,27,0
2021,Babergh 005D,E01029908,683,524,222,302,0,0,6,4,2,153,124,29,0
2021,Babergh 005E,E01029909,742,537,229,308,3,3,11,7,4,191,179,12,0
2021,Babergh 005F,E01029910,517,223,129,94,0,0,249,20,229,45,41,4,0
2021,Babergh 004F,E01029911,981,770,498,272,13,13,92,60,32,105,80,25,1
2021,Babergh 007A,E01029912,835,425,231,194,19,19,227,192,35,162,150,12,2
2021,Babergh 007B,E01029913,553,478,378,100,2,2,17,13,4,56,43,13,0
2021,Babergh 007C,E01029914,676,325,161,164,11,11,181,117,64,159,147,12,0
2021,Babergh 007D,E01029915,517,374,217,157,0,0,60,54,6,82,76,6,1
2021,Babergh 007E,E01029916,512,230,111,119,6,6,212,127,85,63,61,2,1
2021,Babergh 003C,E01029917,856,652,404,248,17,17,101,33,68,86,77,9,0
2021,Babergh 007F,E01029918,553,298,186,112,2,2,94,76,18,157,149,8,2
2021,Babergh 007G,E01029919,739,523,321,202,5,5,49,26,23,160,138,22,2
2021,Babergh 007H,E01029920,1086,470,345,125,13,13,210,138,72,392,361,31,1
2021,Babergh 006B,E01029921,542,479,321,158,2,2,16,5,11,45,36,9,0
2021,Babergh 006C,E01029922,633,441,271,170,0,0,131,87,44,58,47,11,3
2021,Babergh 006D,E01029923,597,498,282,216,1,1,23,8,15,75,60,15,0
2021,West Suffolk 015A,E01029925,1019,456,276,180,12,12,63,15,48,488,444,44,0
2021,West Suffolk 002A,E01029926,812,691,465,226,5,5,10,2,8,106,92,14,0
2021,West Suffolk 002B,E01029927,1112,480,267,213,13,13,319,89,230,296,270,26,4
2021,West Suffolk 002C,E01029928,841,463,261,202,21,21,83,23,60,274,233,41,0
2021,West Suffolk 002D,E01029929,1024,594,341,253,2,2,231,71,160,197,175,22,0
2021,West Suffolk 002E,E01029930,710,500,326,174,3,3,23,4,19,184,165,19,0
2021,West Suffolk 008A,E01029937,1034,641,315,326,7,7,192,38,154,194,161,33,0
2021,West Suffolk 004A,E01029938,558,225,89,136,3,3,220,68,152,108,98,10,2
2021,West Suffolk 004B,E01029939,805,469,277,192,3,3,29,8,21,304,289,15,0
2021,West Suffolk 004C,E01029940,591,304,163,141,5,5,193,58,135,86,74,12,3
2021,West Suffolk 007A,E01029941,816,511,287,224,0,0,107,31,76,198,164,34,0
2021,West Suffolk 001A,E01029942,721,502,310,192,2,2,25,5,20,191,176,15,1
2021,West Suffolk 001B,E01029944,781,538,365,173,1,1,81,20,61,161,143,18,0
2021,West Suffolk 003A,E01029945,988,701,376,325,20,20,106,28,78,161,139,22,0
2021,West Suffolk 004D,E01029946,936,467,257,210,15,15,232,61,171,222,203,19,0
2021,West Suffolk 004E,E01029947,1165,664,419,245,6,6,143,34,109,350,322,28,2
2021,West Suffolk 015B,E01029949,698,321,155,166,0,0,220,74,146,155,130,25,2
2021,West Suffolk 015C,E01029950,848,267,125,142,6,6,362,174,188,213,198,15,0
2021,West Suffolk 015D,E01029951,624,444,289,155,2,2,38,13,25,140,81,59,0
2021,West Suffolk 015E,E01029952,526,359,207,152,1,1,49,21,28,116,105,11,1
2021,West Suffolk 008B,E01029953,613,320,147,173,3,3,115,35,80,174,156,18,1
2021,West Suffolk 008C,E01029955,893,500,228,272,13,13,149,43,106,231,208,23,0
2021,West Suffolk 008D,E01029956,616,282,105,177,1,1,8,3,5,325,312,13,0
2021,West Suffolk 007B,E01029957,975,709,387,322,22,22,92,18,74,152,110,42,0
2021,Ipswich 007A,E01029958,644,397,191,206,1,1,58,32,26,187,179,8,1
2021,Ipswich 007C,E01029960,915,481,213,268,13,13,107,20,87,314,294,20,0
2021,Ipswich 007D,E01029961,610,345,155,190,7,7,27,10,17,230,217,13,1
2021,Ipswich 007E,E01029962,689,334,149,185,5,5,46,21,25,302,292,10,2
2021,Ipswich 009A,E01029963,659,592,383,209,1,1,14,7,7,52,41,11,0
2021,Ipswich 009B,E01029964,538,392,187,205,5,5,14,2,12,127,120,7,0
2021,Ipswich 009C,E01029965,619,548,329,219,0,0,7,3,4,64,57,7,0
2021,Ipswich 009D,E01029966,760,453,286,167,0,0,117,61,56,190,183,7,0
2021,Ipswich 009E,E01029967,608,562,393,169,0,0,6,5,1,40,36,4,0
2021,Ipswich 012A,E01029968,672,336,172,164,4,4,82,68,14,248,240,8,2
2021,Ipswich 012B,E01029969,588,365,179,186,5,5,77,35,42,141,130,11,0
2021,Ipswich 012C,E01029970,766,473,255,218,4,4,154,106,48,134,122,12,1
2021,Ipswich 012D,E01029971,631,275,113,162,2,2,286,238,48,64,56,8,4
2021,Ipswich 002A,E01029973,630,563,362,201,1,1,12,9,3,54,43,11,0
2021,Ipswich 002B,E01029974,629,523,256,267,2,2,21,8,13,83,68,15,0
2021,Ipswich 002C,E01029975,523,388,210,178,0,0,86,45,41,49,38,11,0
2021,Ipswich 002D,E01029976,634,500,273,227,1,1,67,64,3,66,55,11,0
2021,Ipswich 002E,E01029977,645,582,313,269,0,0,12,4,8,51,39,12,0
2021,Ipswich 016A,E01029978,541,373,196,177,1,1,99,86,13,66,54,12,2
2021,Ipswich 016B,E01029979,626,228,100,128,2,2,336,313,23,54,48,6,6
2021,Ipswich 016C,E01029980,672,226,84,142,4,4,367,262,105,69,61,8,6
2021,Ipswich 016D,E01029981,518,420,240,180,0,0,31,27,4,64,58,6,3
2021,Ipswich 016E,E01029982,513,238,83,155,1,1,236,204,32,36,28,8,2
2021,Ipswich 016F,E01029983,654,511,257,254,1,1,4,2,2,138,120,18,0
2021,Ipswich 010A,E01029984,606,344,155,189,3,3,171,166,5,85,77,8,3
2021,Ipswich 010B,E01029985,1117,476,204,272,20,20,210,105,105,411,376,35,0
2021,Ipswich 010C,E01029986,634,243,101,142,1,1,320,246,74,63,61,2,7
2021,Ipswich 010D,E01029987,592,285,144,141,1,1,253,233,20,50,48,2,3
2021,Ipswich 010E,E01029988,1058,264,147,117,6,6,334,145,189,453,429,24,1
2021,Ipswich 011B,E01029990,690,435,188,247,3,3,13,6,7,239,217,22,0
2021,Ipswich 011C,E01029991,675,606,364,242,3,3,13,10,3,53,41,12,0
2021,Ipswich 011D,E01029992,598,423,238,185,8,8,21,5,16,146,132,14,0
2021,Ipswich 014B,E01029994,619,222,95,127,1,1,337,320,17,53,41,12,6
2021,Ipswich 014C,E01029995,683,560,271,289,0,0,16,6,10,107,97,10,0
2021,Ipswich 014D,E01029996,626,373,204,169,2,2,169,163,6,82,67,15,0
2021,Ipswich 004A,E01029997,620,455,230,225,1,1,95,75,20,68,63,5,1
2021,Ipswich 004B,E01029998,753,389,201,188,0,0,298,194,104,63,53,10,3
2021,Ipswich 004C,E01029999,627,531,266,265,1,1,27,23,4,68,56,12,0
2021,Ipswich 004D,E01030000,641,470,212,258,1,1,21,4,17,149,134,15,0
2021,Ipswich 004E,E01030001,721,477,264,213,1,1,165,145,20,73,61,12,5
2021,Ipswich 008A,E01030002,956,525,271,254,3,3,131,41,90,297,274,23,0
2021,Ipswich 008B,E01030003,731,524,257,267,4,4,25,5,20,178,164,14,0
2021,Ipswich 008C,E01030004,498,432,230,202,1,1,10,6,4,55,46,9,0
2021,Ipswich 008D,E01030005,1178,669,220,449,26,26,135,34,101,348,331,17,0
2021,Ipswich 008E,E01030006,806,443,188,255,6,6,150,38,112,207,195,12,0
2021,Ipswich 005A,E01030007,895,561,244,317,7,7,69,10,59,258,246,12,0
2021,Ipswich 005B,E01030008,545,431,252,179,0,0,19,6,13,95,85,10,0
2021,Ipswich 005C,E01030009,586,463,287,176,1,1,13,8,5,109,91,18,0
2021,Ipswich 005D,E01030010,967,369,188,181,2,2,140,112,28,453,427,26,3
2021,Ipswich 005E,E01030011,670,564,384,180,4,4,56,12,44,45,39,6,1
2021,Ipswich 013A,E01030012,599,223,125,98,2,2,293,283,10,72,61,11,9
2021,Ipswich 013B,E01030013,617,335,170,165,1,1,212,203,9,65,56,9,4
2021,Ipswich 013C,E01030014,589,329,178,151,0,0,203,195,8,52,38,14,5
2021,Ipswich 013D,E01030015,530,467,287,180,1,1,5,3,2,57,45,12,0
2021,Ipswich 013E,E01030016,628,383,228,155,3,3,89,16,73,153,147,6,0
2021,Ipswich 015A,E01030017,635,299,176,123,0,0,282,121,161,52,45,7,2
2021,Ipswich 015B,E01030018,677,196,102,94,2,2,407,262,145,63,54,9,9
2021,Ipswich 015C,E01030019,635,502,300,202,5,5,59,10,49,69,54,15,0
2021,Ipswich 015D,E01030020,598,450,296,154,1,1,86,54,32,61,56,5,0
2021,Ipswich 015E,E01030021,620,196,118,78,0,0,375,30,345,49,43,6,0
2021,Ipswich 006A,E01030022,931,492,179,313,7,7,102,25,77,330,306,24,0
2021,Ipswich 006B,E01030023,858,280,110,170,2,2,141,77,64,435,418,17,0
2021,Ipswich 006C,E01030024,1038,206,94,112,6,6,378,219,159,445,421,24,3
2021,Ipswich 006D,E01030025,913,352,182,170,3,3,157,113,44,401,371,30,0
2021,Ipswich 006E,E01030026,779,419,158,261,10,10,92,20,72,258,241,17,0
2021,Ipswich 003A,E01030027,897,525,230,295,23,23,69,12,57,280,268,12,0
2021,Ipswich 003B,E01030028,702,468,216,252,0,0,145,73,72,87,74,13,2
2021,Ipswich 003C,E01030029,661,344,181,163,0,0,251,219,32,61,50,11,5
2021,Ipswich 003D,E01030030,964,526,204,322,14,14,198,33,165,225,205,20,1
2021,Ipswich 003E,E01030031,625,258,114,144,1,1,295,265,30,67,62,5,4
2021,Ipswich 001A,E01030032,515,196,73,123,5,5,272,260,12,40,31,9,2
2021,Ipswich 001B,E01030033,653,571,355,216,2,2,9,5,4,71,62,9,0
2021,Ipswich 001C,E01030034,642,580,416,164,1,1,13,8,5,48,35,13,0
2021,Ipswich 001D,E01030035,685,303,143,160,3,3,301,275,26,75,68,7,3
2021,Ipswich 001E,E01030036,770,329,132,197,0,0,394,316,78,41,34,7,6
2021,Mid Suffolk 005A,E01030037,531,398,232,166,19,19,52,40,12,62,50,12,0
2021,Mid Suffolk 005B,E01030038,507,418,274,144,4,4,26,22,4,59,35,24,0
2021,Mid Suffolk 002A,E01030039,578,465,297,168,1,1,42,38,4,68,50,18,2
2021,Mid Suffolk 004A,E01030040,540,393,257,136,1,1,68,40,28,78,56,22,0
2021,Mid Suffolk 011A,E01030041,984,799,482,317,4,4,83,69,14,96,78,18,2
2021,Mid Suffolk 012A,E01030042,756,622,387,235,8,8,43,15,28,82,67,15,1
2021,Mid Suffolk 011B,E01030043,1074,848,250,598,29,29,90,35,55,106,91,15,1
2021,Mid Suffolk 012B,E01030044,633,449,254,195,8,8,125,98,27,49,39,10,2
2021,Mid Suffolk 012C,E01030045,717,600,353,247,1,1,19,3,16,97,87,10,0
2021,Mid Suffolk 012D,E01030046,673,554,321,233,9,9,45,24,21,64,52,12,1
2021,Mid Suffolk 012E,E01030047,549,381,194,187,2,2,83,79,4,81,72,9,2
2021,Mid Suffolk 007A,E01030048,1054,760,471,289,7,7,132,64,68,151,123,28,4
2021,Mid Suffolk 004B,E01030049,760,568,333,235,7,7,75,62,13,108,78,30,2
2021,Mid Suffolk 004C,E01030050,1020,842,378,464,9,9,25,4,21,144,120,24,0
2021,Mid Suffolk 006A,E01030051,804,514,300,214,27,27,204,98,106,54,42,12,5
2021,Mid Suffolk 001A,E01030052,1011,656,440,216,8,8,197,140,57,149,124,25,1
2021,Mid Suffolk 003A,E01030053,1028,771,528,243,3,3,126,97,29,127,105,22,1
2021,Mid Suffolk 002B,E01030054,595,480,307,173,3,3,46,10,36,66,49,17,0
2021,Mid Suffolk 002C,E01030055,622,495,286,209,10,10,39,22,17,78,70,8,0
2021,Mid Suffolk 006B,E01030056,983,674,418,256,41,41,191,126,65,76,59,17,1
2021,Mid Suffolk 007B,E01030057,959,726,426,300,2,2,59,35,24,170,141,29,2
2021,Mid Suffolk 001B,E01030058,876,688,456,232,5,5,76,62,14,106,74,32,1
2021,Mid Suffolk 005C,E01030059,1059,817,514,303,11,11,118,78,40,113,77,36,0
2021,Mid Suffolk 010A,E01030060,760,529,297,232,1,1,107,79,28,123,100,23,0
2021,Mid Suffolk 011C,E01030061,856,510,317,193,4,4,173,109,64,166,148,18,3
2021,Mid Suffolk 011D,E01030062,715,564,345,219,5,5,21,8,13,125,112,13,0
2021,Mid Suffolk 009A,E01030063,1009,763,415,348,11,11,119,51,68,116,101,15,0
2021,Mid Suffolk 001C,E01030064,1028,825,538,287,4,4,85,63,22,113,83,30,1
2021,Mid Suffolk 006C,E01030065,921,719,474,245,5,5,107,75,32,90,72,18,0
2021,Mid Suffolk 002D,E01030066,705,528,350,178,2,2,105,85,20,70,51,19,0
2021,Mid Suffolk 002E,E01030067,583,446,297,149,4,4,20,12,8,113,95,18,0
2021,Mid Suffolk 002F,E01030068,762,549,313,236,11,11,111,73,38,90,73,17,1
2021,Mid Suffolk 009B,E01030069,636,543,351,192,3,3,38,22,16,52,42,10,0
2021,Mid Suffolk 011E,E01030070,540,274,190,84,11,11,32,12,20,223,37,186,0
2021,Mid Suffolk 010B,E01030071,715,494,289,205,2,2,56,17,39,163,139,24,0
2021,Mid Suffolk 009C,E01030072,761,527,333,194,4,4,68,39,29,162,151,11,0
2021,Mid Suffolk 008A,E01030073,783,499,371,128,2,2,227,169,58,54,45,9,1
2021,Mid Suffolk 009D,E01030075,824,723,280,443,0,0,7,3,4,94,77,17,0
2021,Mid Suffolk 010D,E01030076,743,473,233,240,1,1,92,69,23,175,157,18,2
2021,Mid Suffolk 008B,E01030077,704,318,179,139,21,21,265,167,98,98,80,18,2
2021,Mid Suffolk 010E,E01030078,728,566,326,240,3,3,10,5,5,149,131,18,0
2021,Mid Suffolk 008C,E01030079,603,262,136,126,6,6,282,164,118,51,41,10,2
2021,Mid Suffolk 008D,E01030080,684,501,297,204,1,1,94,84,10,87,72,15,1
2021,Mid Suffolk 005D,E01030081,1170,846,507,339,17,17,224,119,105,82,69,13,1
2021,Mid Suffolk 007C,E01030083,965,801,504,297,2,2,39,30,9,123,89,34,0
2021,Mid Suffolk 004D,E01030084,715,629,385,244,18,18,14,2,12,54,36,18,0
2021,Mid Suffolk 004E,E01030085,728,546,314,232,10,10,59,35,24,112,96,16,1
2021,Mid Suffolk 006D,E01030086,501,404,242,162,1,1,53,40,13,43,38,5,0
2021,Mid Suffolk 007D,E01030087,523,425,255,170,3,3,38,37,1,57,43,14,0
2021,Mid Suffolk 001D,E01030088,523,427,278,149,0,0,37,26,11,57,51,6,2
2021,Mid Suffolk 006E,E01030089,944,691,458,233,16,16,160,47,113,77,65,12,0
2021,Mid Suffolk 003C,E01030090,1023,780,511,269,2,2,73,57,16,168,129,39,0
2021,West Suffolk 011A,E01030091,999,395,275,120,9,9,130,28,102,465,433,32,0
2021,West Suffolk 014A,E01030092,789,411,256,155,1,1,174,32,142,203,185,18,0
2021,West Suffolk 011B,E01030093,904,424,277,147,2,2,177,26,151,301,282,19,0
2021,West Suffolk 006A,E01030094,600,358,185,173,0,0,83,29,54,159,120,39,0
2021,West Suffolk 005A,E01030095,544,438,233,205,3,3,58,19,39,45,33,12,0
2021,West Suffolk 005B,E01030096,624,518,349,169,3,3,44,22,22,59,41,18,0
2021,West Suffolk 005C,E01030097,534,380,257,123,3,3,99,45,54,50,38,12,2
2021,West Suffolk 010A,E01030098,1107,789,469,320,7,7,171,40,131,140,116,24,0
2021,West Suffolk 017A,E01030099,883,694,464,230,5,5,78,28,50,104,83,21,2
2021,West Suffolk 010B,E01030100,951,767,478,289,2,2,99,24,75,83,71,12,0
2021,West Suffolk 017B,E01030101,1118,699,469,230,9,9,258,101,157,151,127,24,1
2021,West Suffolk 016A,E01030104,1064,874,517,357,15,15,86,29,57,89,74,15,0
2021,West Suffolk 020A,E01030105,793,426,194,232,3,3,125,49,76,239,226,13,0
2021,West Suffolk 020B,E01030106,992,486,211,275,9,9,328,73,255,169,156,13,0
2021,West Suffolk 020C,E01030107,630,566,315,251,2,2,7,2,5,55,46,9,0
2021,West Suffolk 020D,E01030108,701,372,187,185,1,1,170,84,86,158,147,11,0
2021,West Suffolk 019A,E01030109,757,382,178,204,2,2,285,132,153,86,72,14,2
2021,West Suffolk 019B,E01030110,1165,637,274,363,25,25,325,112,213,177,158,19,1
2021,West Suffolk 019C,E01030111,524,473,258,215,1,1,11,5,6,39,31,8,0
2021,West Suffolk 019D,E01030112,835,544,268,276,4,4,127,26,101,160,138,22,0
2021,West Suffolk 020E,E01030113,914,542,274,268,10,10,173,53,120,189,171,18,0
2021,West Suffolk 020F,E01030114,542,235,100,135,0,0,201,105,96,105,94,11,1
2021,West Suffolk 021A,E01030115,899,402,156,246,6,6,337,178,159,152,138,14,2
2021,West Suffolk 021B,E01030116,855,670,275,395,3,3,46,7,39,136,125,11,0
2021,West Suffolk 021C,E01030117,653,463,219,244,5,5,45,10,35,140,129,11,0
2021,West Suffolk 021D,E01030118,619,343,143,200,1,1,172,50,122,103,96,7,0
2021,West Suffolk 010C,E01030119,933,729,445,284,13,13,86,34,52,105,80,25,0
2021,West Suffolk 006B,E01030121,981,711,447,264,4,4,157,43,114,106,80,26,3
2021,West Suffolk 018A,E01030122,860,703,360,343,5,5,65,16,49,87,70,17,0
2021,West Suffolk 014B,E01030123,795,345,223,122,10,10,387,112,275,53,49,4,0
2021,West Suffolk 014C,E01030124,739,581,389,192,3,3,16,2,14,139,110,29,0
2021,West Suffolk 014D,E01030125,615,394,257,137,5,5,151,77,74,65,51,14,0
2021,West Suffolk 012A,E01030127,518,340,200,140,3,3,6,2,4,169,157,12,0
2021,West Suffolk 012B,E01030128,597,388,198,190,2,2,16,2,14,191,183,8,0
2021,West Suffolk 012C,E01030129,579,470,282,188,4,4,11,3,8,94,83,11,0
2021,West Suffolk 009A,E01030130,587,352,193,159,8,8,154,48,106,70,54,16,3
2021,West Suffolk 009B,E01030131,497,149,65,84,0,0,319,131,188,28,24,4,1
2021,West Suffolk 006C,E01030132,458,234,159,75,1,1,30,9,21,193,63,130,0
2021,West Suffolk 006D,E01030133,614,344,220,124,1,1,63,19,44,205,173,32,1
2021,West Suffolk 010D,E01030134,486,340,199,141,5,5,83,31,52,56,53,3,2
2021,West Suffolk 010E,E01030135,552,444,271,173,5,5,17,8,9,86,60,26,0
2021,West Suffolk 011C,E01030137,857,465,235,230,25,25,63,19,44,304,289,15,0
2021,West Suffolk 016B,E01030138,1026,724,419,305,7,7,142,42,100,152,117,35,1
2021,West Suffolk 009C,E01030139,717,255,120,135,3,3,391,175,216,67,58,9,1
2021,West Suffolk 009D,E01030140,497,305,158,147,5,5,124,61,63,61,54,7,2
2021,West Suffolk 009E,E01030141,627,331,164,167,3,3,189,90,99,103,91,12,1
2021,West Suffolk 013A,E01030142,750,612,460,152,3,3,51,10,41,84,59,25,0
2021,West Suffolk 013B,E01030143,646,363,213,150,1,1,157,52,105,124,115,9,1
2021,West Suffolk 013C,E01030144,556,438,290,148,0,0,69,17,52,49,43,6,0
2021,West Suffolk 005D,E01030145,636,518,330,188,8,8,40,12,28,70,50,20,0
2021,West Suffolk 005E,E01030146,718,455,311,144,8,8,91,30,61,163,108,55,1
2021,West Suffolk 013D,E01030147,719,576,417,159,7,7,35,7,28,101,85,16,0
2021,West Suffolk 014E,E01030148,505,440,288,152,1,1,7,4,3,57,52,5,0
2021,West Suffolk 014F,E01030149,621,529,330,199,6,6,8,3,5,78,66,12,0
2021,West Suffolk 017C,E01030150,1004,712,433,279,4,4,123,35,88,162,133,29,3
2021,West Suffolk 018B,E01030151,1090,749,345,404,14,14,80,21,59,246,196,50,1
2021,East Suffolk 019A,E01030152,1039,824,691,133,0,0,93,10,83,122,87,35,0
2021,East Suffolk 019B,E01030153,589,353,274,79,1,1,130,27,103,105,87,18,0
2021,East Suffolk 017A,E01030154,953,752,508,244,5,5,75,9,66,121,87,34,0
2021,East Suffolk 022A,E01030155,871,638,406,232,4,4,107,14,93,122,106,16,0
2021,East Suffolk 028A,E01030158,741,650,515,135,2,2,38,13,25,51,35,16,0
2021,East Suffolk 028B,E01030159,659,498,309,189,0,0,39,8,31,122,107,15,0
2021,East Suffolk 029A,E01030160,806,405,247,158,1,1,274,39,235,126,107,19,0
2021,East Suffolk 029B,E01030161,732,456,195,261,0,0,132,23,109,144,131,13,0
2021,East Suffolk 030A,E01030162,742,318,211,107,3,3,119,26,93,302,281,21,0
2021,East Suffolk 030B,E01030163,781,374,206,168,2,2,154,26,128,251,232,19,0
2021,East Suffolk 028C,E01030164,697,588,400,188,0,0,22,4,18,87,78,9,0
2021,East Suffolk 030C,E01030165,873,510,355,155,3,3,65,17,48,294,268,26,1
2021,East Suffolk 028D,E01030166,669,601,458,143,1,1,12,4,8,55,43,12,0
2021,East Suffolk 030D,E01030167,619,492,338,154,1,1,11,2,9,115,103,12,0
2021,East Suffolk 029C,E01030168,656,273,171,102,2,2,303,50,253,78,67,11,0
2021,East Suffolk 029D,E01030169,826,385,211,174,0,0,169,30,139,271,259,12,1
2021,East Suffolk 029E,E01030170,761,355,209,146,4,4,319,52,267,82,64,18,1
2021,East Suffolk 027A,E01030171,785,590,347,243,2,2,64,8,56,129,115,14,0
2021,East Suffolk 017B,E01030172,951,714,430,284,4,4,77,8,69,156,131,25,0
2021,East Suffolk 017C,E01030173,934,557,338,219,5,5,219,17,202,153,120,33,0
2021,East Suffolk 017D,E01030174,570,420,268,152,3,3,55,4,51,92,79,13,0
2021,East Suffolk 021A,E01030175,1013,779,497,282,13,13,120,13,107,101,88,13,0
2021,East Suffolk 017E,E01030176,894,619,413,206,4,4,88,10,78,183,154,29,0
2021,East Suffolk 024A,E01030179,1062,720,289,431,4,4,100,6,94,238,224,14,0
2021,East Suffolk 024B,E01030180,563,472,279,193,0,0,2,1,1,89,76,13,0
2021,East Suffolk 025A,E01030181,813,573,293,280,2,2,29,3,26,209,201,8,0
2021,East Suffolk 024C,E01030183,858,768,566,202,3,3,11,5,6,76,67,9,0
2021,East Suffolk 024D,E01030184,799,581,403,178,1,1,142,16,126,74,55,19,1
2021,East Suffolk 022B,E01030185,869,523,351,172,3,3,237,32,205,104,92,12,2
2021,East Suffolk 018A,E01030186,734,530,380,150,5,5,122,28,94,77,64,13,0
2021,East Suffolk 019C,E01030187,721,434,291,143,7,7,207,25,182,73,64,9,0
2021,East Suffolk 019D,E01030188,857,439,260,179,3,3,88,14,74,327,287,40,0
2021,East Suffolk 019E,E01030189,736,426,284,142,0,0,190,27,163,119,108,11,1
2021,East Suffolk 025B,E01030190,1024,856,592,264,16,16,67,10,57,85,70,15,0
2021,East Suffolk 025C,E01030191,764,500,328,172,0,0,52,9,43,212,196,16,0
2021,East Suffolk 025D,E01030192,604,540,391,149,2,2,7,4,3,55,45,10,0
2021,East Suffolk 020A,E01030193,915,714,444,270,6,6,109,13,96,86,74,12,0
2021,East Suffolk 020B,E01030194,939,556,373,183,0,0,214,28,186,169,134,35,0
2021,East Suffolk 020C,E01030195,689,605,415,190,6,6,6,0,6,72,64,8,0
2021,East Suffolk 026A,E01030196,685,556,308,248,0,0,16,5,11,112,98,14,1
2021,East Suffolk 026B,E01030197,763,637,446,191,1,1,22,1,21,103,79,24,0
2021,East Suffolk 025E,E01030198,593,463,327,136,1,1,46,4,42,81,65,16,2
2021,East Suffolk 023A,E01030199,846,573,405,168,14,14,108,8,100,150,125,25,1
2021,East Suffolk 021B,E01030200,919,752,486,266,0,0,85,11,74,82,61,21,0
2021,East Suffolk 016A,E01030201,970,722,523,199,2,2,89,16,73,157,119,38,0
2021,East Suffolk 022C,E01030203,977,749,558,191,4,4,111,12,99,113,87,26,0
2021,East Suffolk 026C,E01030204,765,692,412,280,9,9,14,4,10,50,43,7,0
2021,East Suffolk 026D,E01030205,490,461,263,198,0,0,3,2,1,26,21,5,0
2021,East Suffolk 026E,E01030206,643,595,418,177,3,3,2,1,1,43,36,7,0
2021,East Suffolk 024E,E01030207,706,586,383,203,1,1,51,6,45,68,58,10,0
2021,East Suffolk 018B,E01030208,608,386,289,97,2,2,130,19,111,90,71,19,0
2021,East Suffolk 018C,E01030209,1118,708,477,231,8,8,190,41,149,212,190,22,0
2021,East Suffolk 018D,E01030210,1055,581,307,274,12,12,338,36,302,124,111,13,0
2021,East Suffolk 022D,E01030211,1106,682,523,159,2,2,116,15,101,306,268,38,0
2021,East Suffolk 018E,E01030212,934,723,545,178,2,2,74,12,62,135,108,27,0
2021,East Suffolk 027B,E01030214,533,417,234,183,1,1,16,6,10,99,93,6,0
2021,East Suffolk 027C,E01030215,795,487,224,263,8,8,170,25,145,130,118,12,0
2021,East Suffolk 027D,E01030216,647,579,354,225,0,0,12,3,9,56,47,9,0
2021,East Suffolk 027E,E01030217,617,481,299,182,8,8,73,7,66,55,43,12,0
2021,East Suffolk 027F,E01030218,661,523,298,225,3,3,42,8,34,93,84,9,0
2021,East Suffolk 016B,E01030219,929,703,524,179,3,3,91,4,87,132,92,40,0
2021,East Suffolk 020D,E01030220,1046,667,473,194,6,6,243,28,215,129,110,19,1
2021,East Suffolk 021C,E01030221,905,737,443,294,3,3,73,10,63,92,70,22,0
2021,East Suffolk 016C,E01030222,1002,769,595,174,5,5,74,17,57,151,118,33,3
2021,East Suffolk 010A,E01030223,853,481,318,163,12,12,197,93,104,162,148,14,1
2021,East Suffolk 010B,E01030224,789,572,429,143,0,0,85,39,46,132,112,20,0
2021,East Suffolk 010C,E01030225,874,429,286,143,10,10,78,17,61,356,328,28,1
2021,East Suffolk 011A,E01030226,805,548,314,234,4,4,130,61,69,123,112,11,0
2021,East Suffolk 010D,E01030227,631,285,171,114,11,11,260,210,50,69,57,12,6
2021,East Suffolk 010E,E01030228,767,590,409,181,3,3,77,14,63,97,76,21,0
2021,East Suffolk 015A,E01030229,975,716,518,198,5,5,147,108,39,107,87,20,0
2021,East Suffolk 013A,E01030230,936,541,354,187,9,9,122,79,43,263,229,34,1
2021,East Suffolk 013B,E01030231,668,436,266,170,2,2,151,91,60,79,61,18,0
2021,East Suffolk 013C,E01030232,689,493,311,182,5,5,100,80,20,91,75,16,0
2021,East Suffolk 007A,E01030233,636,592,385,207,0,0,3,1,2,41,35,6,0
2021,East Suffolk 008A,E01030234,665,325,160,165,1,1,148,6,142,191,174,17,0
2021,East Suffolk 007B,E01030235,655,548,370,178,2,2,30,27,3,74,61,13,1
2021,East Suffolk 008B,E01030236,852,575,334,241,5,5,130,80,50,140,118,22,2
2021,East Suffolk 008C,E01030237,1192,980,538,442,4,4,8,1,7,200,185,15,0
2021,East Suffolk 008D,E01030238,733,616,330,286,1,1,9,1,8,107,92,15,0
2021,East Suffolk 012A,E01030239,732,575,241,334,1,1,19,8,11,137,125,12,0
2021,East Suffolk 001A,E01030240,753,611,445,166,0,0,34,22,12,107,97,10,1
2021,East Suffolk 001B,E01030241,703,557,396,161,6,6,70,49,21,69,57,12,1
2021,East Suffolk 001C,E01030242,601,550,395,155,4,4,2,2,0,45,43,2,0
2021,East Suffolk 015B,E01030243,701,491,322,169,1,1,91,59,32,118,102,16,0
2021,East Suffolk 015C,E01030244,948,542,425,117,2,2,201,141,60,202,180,22,1
2021,East Suffolk 015D,E01030245,766,583,425,158,5,5,78,47,31,100,83,17,0
2021,East Suffolk 004A,E01030246,627,334,191,143,3,3,33,17,16,257,243,14,0
2021,East Suffolk 006A,E01030247,1030,167,105,62,1,1,471,260,211,391,373,18,0
2021,East Suffolk 004B,E01030248,637,335,182,153,11,11,66,16,50,222,205,17,3
2021,East Suffolk 004C,E01030249,824,316,183,133,0,0,138,54,84,370,340,30,0
2021,East Suffolk 004D,E01030250,1020,297,165,132,10,10,155,13,142,557,516,41,1
2021,East Suffolk 012B,E01030251,719,546,389,157,3,3,65,37,28,105,88,17,0
2021,East Suffolk 012C,E01030252,849,654,456,198,8,8,68,24,44,119,92,27,0
2021,East Suffolk 012D,E01030253,801,475,274,201,4,4,219,101,118,103,91,12,0
2021,East Suffolk 006B,E01030254,632,321,172,149,1,1,73,38,35,237,225,12,0
2021,East Suffolk 005A,E01030255,515,353,166,187,1,1,71,52,19,90,81,9,0
2021,East Suffolk 006C,E01030256,698,359,219,140,2,2,69,7,62,268,248,20,0
2021,East Suffolk 009A,E01030257,638,431,262,169,0,0,102,39,63,105,93,12,0
2021,East Suffolk 006D,E01030258,910,224,132,92,1,1,175,47,128,510,497,13,0
2021,East Suffolk 001D,E01030259,490,396,240,156,4,4,27,25,2,63,46,17,0
2021,East Suffolk 001E,E01030260,458,312,182,130,1,1,22,17,5,123,110,13,0
2021,East Suffolk 002A,E01030261,628,232,119,113,4,4,310,276,34,79,70,9,3
2021,East Suffolk 002B,E01030262,565,295,163,132,2,2,160,64,96,108,97,11,0
2021,East Suffolk 005B,E01030263,712,522,334,188,3,3,101,79,22,85,74,11,1
2021,East Suffolk 004E,E01030264,632,328,177,151,1,1,62,21,41,241,221,20,0
2021,East Suffolk 004F,E01030265,625,337,170,167,1,1,63,16,47,224,213,11,0
2021,East Suffolk 003A,E01030266,708,462,246,216,6,6,143,11,132,97,90,7,0
2021,East Suffolk 003B,E01030267,914,650,273,377,2,2,173,9,164,89,80,9,0
2021,East Suffolk 007C,E01030268,536,491,298,193,4,4,1,0,1,40,31,9,0
2021,East Suffolk 007D,E01030269,773,612,427,185,1,1,14,3,11,146,129,17,0
2021,East Suffolk 005C,E01030270,692,433,266,167,3,3,100,25,75,156,140,16,0
2021,East Suffolk 003C,E01030271,705,612,466,146,2,2,15,5,10,76,62,14,0
2021,East Suffolk 012E,E01030272,787,616,470,146,2,2,21,3,18,148,117,31,0
2021,East Suffolk 012F,E01030273,740,626,452,174,2,2,10,2,8,102,85,17,0
2021,East Suffolk 009B,E01030274,611,230,150,80,1,1,323,119,204,53,47,6,4
2021,East Suffolk 009C,E01030275,506,404,248,156,0,0,31,14,17,71,57,14,0
2021,East Suffolk 006E,E01030276,583,364,220,144,1,1,22,8,14,196,181,15,0
2021,East Suffolk 002C,E01030277,492,182,96,86,0,0,258,240,18,48,40,8,4
2021,East Suffolk 003D,E01030278,728,563,441,122,2,2,104,66,38,56,48,8,3
2021,East Suffolk 002D,E01030279,600,217,113,104,2,2,301,251,50,79,69,10,1
2021,East Suffolk 003E,E01030280,617,520,366,154,2,2,30,5,25,65,59,6,0
2021,East Suffolk 002E,E01030281,1038,704,353,351,1,1,192,87,105,141,124,17,0
2021,East Suffolk 014A,E01030283,596,374,249,125,14,14,152,85,67,56,49,7,0
2021,East Suffolk 013D,E01030285,1032,772,551,221,2,2,69,50,19,189,157,32,0
2021,East Suffolk 011B,E01030286,927,708,469,239,1,1,75,51,24,142,118,24,1
2021,East Suffolk 009D,E01030287,660,441,327,114,0,0,143,76,67,76,58,18,0
2021,East Suffolk 007E,E01030288,635,581,410,171,1,1,5,4,1,48,42,6,0
2021,East Suffolk 005D,E01030289,708,421,248,173,4,4,145,127,18,137,123,14,1
2021,East Suffolk 005E,E01030290,701,588,405,183,2,2,32,22,10,79,64,15,0
2021,East Suffolk 009E,E01030291,606,336,185,151,0,0,194,154,40,74,64,10,2
2021,East Suffolk 011C,E01030292,657,567,381,186,0,0,10,1,9,80,70,10,0
2021,East Suffolk 011D,E01030293,704,612,366,246,3,3,28,19,9,61,57,4,0
2021,East Suffolk 011E,E01030294,651,477,291,186,0,0,98,26,72,74,63,11,2
2021,East Suffolk 014B,E01030295,1049,705,484,221,9,9,133,111,22,200,171,29,2
2021,Elmbridge 015A,E01030296,670,620,326,294,1,1,5,2,3,43,32,11,1
2021,Elmbridge 015B,E01030297,833,702,381,321,2,2,8,1,7,121,105,16,0
2021,Elmbridge 015C,E01030298,671,440,233,207,10,10,157,17,140,64,49,15,0
2021,Elmbridge 015D,E01030299,633,489,222,267,4,4,74,19,55,66,64,2,0
2021,Elmbridge 017A,E01030300,771,405,190,215,1,1,178,33,145,186,174,12,1
2021,Elmbridge 017B,E01030301,620,464,265,199,1,1,63,11,52,92,84,8,0
2021,Elmbridge 017C,E01030302,822,551,334,217,8,8,31,3,28,232,193,39,0
2021,Elmbridge 018A,E01030303,693,571,313,258,9,9,15,0,15,98,84,14,0
2021,Elmbridge 017D,E01030304,693,336,144,192,0,0,246,61,185,111,102,9,0
2021,Elmbridge 017E,E01030305,497,411,209,202,0,0,0,0,0,86,86,0,0
2021,Elmbridge 017F,E01030306,498,410,204,206,0,0,10,2,8,78,67,11,0
2021,Elmbridge 013A,E01030307,725,564,299,265,6,6,11,1,10,144,136,8,0
2021,Elmbridge 013B,E01030308,668,511,269,242,1,1,28,2,26,128,120,8,0
2021,Elmbridge 013C,E01030309,649,514,298,216,8,8,25,5,20,102,79,23,0
2021,Elmbridge 013D,E01030310,750,409,157,252,9,9,206,33,173,126,105,21,0
2021,Elmbridge 014A,E01030311,654,390,160,230,1,1,173,42,131,90,86,4,0
2021,Elmbridge 014B,E01030312,580,378,141,237,7,7,120,30,90,75,66,9,0
2021,Elmbridge 010A,E01030313,859,531,156,375,38,38,158,23,135,131,117,14,1
2021,Elmbridge 010B,E01030314,734,487,212,275,39,39,108,5,103,100,94,6,0
2021,Elmbridge 014C,E01030315,625,508,209,299,1,1,58,10,48,58,52,6,0
2021,Elmbridge 014D,E01030316,637,535,274,261,9,9,4,1,3,89,84,5,0
2021,Elmbridge 014E,E01030317,865,598,281,317,21,21,99,19,80,147,133,14,0
2021,Elmbridge 014F,E01030318,661,334,183,151,3,3,256,9,247,67,49,18,1
2021,Elmbridge 009A,E01030319,671,583,238,345,10,10,22,3,19,56,48,8,0
2021,Elmbridge 009B,E01030320,699,534,258,276,1,1,51,2,49,113,102,11,0
2021,Elmbridge 009C,E01030321,566,524,256,268,1,1,6,0,6,35,29,6,0
2021,Elmbridge 006A,E01030322,771,500,202,298,7,7,112,11,101,152,141,11,0
2021,Elmbridge 006B,E01030323,521,420,213,207,0,0,40,6,34,60,53,7,1
2021,Elmbridge 006C,E01030324,642,530,216,314,0,0,49,10,39,62,54,8,1
2021,Elmbridge 006D,E01030325,589,481,216,265,0,0,71,15,56,37,30,7,0
2021,Elmbridge 002A,E01030326,819,503,260,243,26,26,32,5,27,256,233,23,2
2021,Elmbridge 002B,E01030327,802,582,278,304,16,16,31,1,30,173,159,14,0
2021,Elmbridge 002C,E01030328,629,556,260,296,6,6,4,1,3,63,57,6,0
2021,Elmbridge 002D,E01030329,682,568,282,286,7,7,16,2,14,91,80,11,0
2021,Elmbridge 001A,E01030330,655,547,276,271,5,5,10,1,9,93,85,8,0
2021,Elmbridge 001B,E01030331,685,574,280,294,3,3,31,1,30,77,70,7,0
2021,Elmbridge 001C,E01030332,610,404,189,215,22,22,127,25,102,57,52,5,0
2021,Elmbridge 001D,E01030333,584,466,258,208,3,3,30,2,28,85,81,4,0
2021,Elmbridge 003A,E01030334,587,431,214,217,5,5,54,11,43,97,90,7,0
2021,Elmbridge 003B,E01030335,760,541,244,297,10,10,124,28,96,83,75,8,2
2021,Elmbridge 003C,E01030336,797,537,204,333,5,5,150,26,124,103,95,8,2
2021,Elmbridge 003D,E01030337,765,380,164,216,7,7,262,47,215,116,104,12,0
2021,Elmbridge 011A,E01030338,636,529,276,253,0,0,9,2,7,98,90,8,0
2021,Elmbridge 011B,E01030339,761,512,271,241,0,0,60,10,50,186,171,15,3
2021,Elmbridge 011C,E01030340,652,468,237,231,2,2,60,7,53,122,117,5,0
2021,Elmbridge 011D,E01030341,756,612,309,303,1,1,8,1,7,135,126,9,0
2021,Elmbridge 018B,E01030342,678,562,333,229,7,7,5,0,5,104,83,21,0
2021,Elmbridge 018C,E01030343,685,543,283,260,0,0,52,8,44,90,69,21,0
2021,Elmbridge 018D,E01030344,532,460,244,216,0,0,6,1,5,66,60,6,0
2021,Elmbridge 018E,E01030345,639,490,223,267,9,9,62,9,53,78,65,13,0
2021,Elmbridge 016A,E01030346,513,379,205,174,0,0,2,1,1,132,109,23,0
2021,Elmbridge 016B,E01030347,706,423,144,279,23,23,93,12,81,167,159,8,0
2021,Elmbridge 016C,E01030348,688,501,254,247,0,0,2,0,2,185,173,12,0
2021,Elmbridge 016D,E01030349,714,530,275,255,0,0,7,0,7,177,163,14,0
2021,Elmbridge 005A,E01030350,712,540,243,297,3,3,21,1,20,145,138,7,3
2021,Elmbridge 005B,E01030351,621,502,205,297,1,1,30,2,28,88,79,9,0
2021,Elmbridge 005C,E01030352,609,445,192,253,4,4,82,8,74,77,72,5,1
2021,Elmbridge 005D,E01030353,545,459,189,270,1,1,5,0,5,80,74,6,0
2021,Elmbridge 008A,E01030354,660,245,82,163,19,19,284,55,229,111,104,7,1
2021,Elmbridge 008B,E01030355,536,443,191,252,0,0,36,7,29,57,51,6,0
2021,Elmbridge 008C,E01030356,516,419,176,243,0,0,45,13,32,52,45,7,0
2021,Elmbridge 007A,E01030357,736,575,310,265,13,13,14,1,13,134,117,17,0
2021,Elmbridge 007B,E01030358,692,556,300,256,2,2,9,2,7,125,117,8,0
2021,Elmbridge 007D,E01030360,725,500,264,236,5,5,12,2,10,208,201,7,0
2021,Elmbridge 004A,E01030361,926,720,300,420,19,19,78,19,59,109,98,11,0
2021,Elmbridge 004B,E01030362,578,292,147,145,37,37,176,47,129,73,68,5,0
2021,Elmbridge 004C,E01030363,812,462,191,271,14,14,185,35,150,151,128,23,0
2021,Elmbridge 004D,E01030364,751,307,93,214,14,14,258,58,200,169,161,8,3
2021,Elmbridge 008D,E01030365,607,480,223,257,1,1,10,1,9,116,107,9,0
2021,Elmbridge 010C,E01030366,901,489,225,264,12,12,66,6,60,334,317,17,0
2021,Elmbridge 010D,E01030367,629,507,288,219,2,2,12,1,11,108,97,11,0
2021,Elmbridge 008E,E01030368,614,519,230,289,3,3,15,4,11,77,72,5,0
2021,Elmbridge 009D,E01030369,776,678,301,377,0,0,19,3,16,78,71,7,1
2021,Elmbridge 009E,E01030370,622,527,219,308,1,1,8,0,8,86,79,7,0
2021,Elmbridge 012A,E01030371,726,369,173,196,8,8,170,22,148,179,164,15,0
2021,Elmbridge 012B,E01030372,588,392,162,230,1,1,65,11,54,130,123,7,0
2021,Elmbridge 012C,E01030373,672,481,205,276,13,13,65,9,56,113,98,15,0
2021,Elmbridge 012D,E01030374,805,498,261,237,0,0,57,16,41,250,231,19,0
2021,Elmbridge 012E,E01030375,856,508,218,290,6,6,36,1,35,306,289,17,0
2021,Elmbridge 012F,E01030376,542,376,176,200,2,2,7,1,6,157,143,14,0
2021,Epsom and Ewell 003A,E01030377,885,816,422,394,1,1,6,2,4,62,51,11,0
2021,Epsom and Ewell 003B,E01030378,642,530,254,276,1,1,11,1,10,100,88,12,0
2021,Epsom and Ewell 009A,E01030379,475,394,190,204,3,3,14,1,13,64,47,17,0
2021,Epsom and Ewell 009B,E01030380,518,459,226,233,0,0,5,0,5,54,48,6,0
2021,Epsom and Ewell 008A,E01030381,627,456,250,206,1,1,44,3,41,126,117,9,0
2021,Epsom and Ewell 010A,E01030382,604,398,226,172,2,2,28,1,27,176,142,34,0
2021,Epsom and Ewell 005B,E01030384,973,624,206,418,19,19,101,5,96,229,209,20,0
2021,Epsom and Ewell 007A,E01030385,704,270,114,156,28,28,328,18,310,78,70,8,0
2021,Epsom and Ewell 001A,E01030386,532,487,267,220,0,0,6,0,6,39,33,6,0
2021,Epsom and Ewell 001B,E01030387,615,509,230,279,1,1,5,0,5,100,88,12,0
2021,Epsom and Ewell 001C,E01030388,518,445,254,191,3,3,16,3,13,53,47,6,1
2021,Epsom and Ewell 001D,E01030389,647,407,206,201,1,1,99,8,91,140,126,14,0
2021,Epsom and Ewell 010B,E01030390,841,521,226,295,1,1,150,8,142,169,152,17,0
2021,Epsom and Ewell 007B,E01030391,841,583,306,277,6,6,47,1,46,205,192,13,0
2021,Epsom and Ewell 010C,E01030392,849,672,384,288,15,15,13,0,13,149,139,10,0
2021,Epsom and Ewell 001E,E01030393,815,657,395,262,2,2,52,4,48,104,89,15,0
2021,Epsom and Ewell 002A,E01030394,667,606,278,328,4,4,3,1,2,54,49,5,0
2021,Epsom and Ewell 004A,E01030395,732,672,415,257,1,1,5,1,4,54,45,9,0
2021,Epsom and Ewell 010D,E01030396,852,732,316,416,15,15,43,1,42,62,55,7,0
2021,Epsom and Ewell 010E,E01030398,621,595,335,260,0,0,4,2,2,22,17,5,0
2021,Epsom and Ewell 002B,E01030399,975,668,300,368,21,21,131,13,118,155,141,14,0
2021,Epsom and Ewell 002C,E01030400,584,254,90,164,5,5,274,17,257,51,49,2,0
2021,Epsom and Ewell 005C,E01030401,1009,856,408,448,1,1,29,4,25,123,108,15,0
2021,Epsom and Ewell 005D,E01030402,937,589,220,369,65,65,166,9,157,117,106,11,0
2021,Epsom and Ewell 007C,E01030403,617,486,257,229,3,3,49,4,45,79,70,9,0
2021,Epsom and Ewell 007D,E01030404,634,556,305,251,2,2,2,1,1,74,61,13,0
2021,Epsom and Ewell 009C,E01030405,694,579,237,342,1,1,46,2,44,67,57,10,1
2021,Epsom and Ewell 003C,E01030406,602,463,223,240,2,2,36,2,34,101,95,6,0
2021,Epsom and Ewell 003D,E01030407,538,494,270,224,1,1,0,0,0,43,37,6,0
2021,Epsom and Ewell 003E,E01030408,637,614,327,287,1,1,3,1,2,19,18,1,0
2021,Epsom and Ewell 007E,E01030409,556,377,206,171,0,0,6,2,4,173,165,8,0
2021,Epsom and Ewell 007F,E01030410,760,433,153,280,16,16,65,4,61,246,231,15,0
2021,Epsom and Ewell 008C,E01030412,956,531,290,241,5,5,56,6,50,364,344,20,0
2021,Epsom and Ewell 004B,E01030413,708,512,199,313,21,21,94,7,87,81,76,5,0
2021,Epsom and Ewell 002D,E01030414,512,396,172,224,6,6,62,3,59,48,40,8,0
2021,Epsom and Ewell 004C,E01030415,613,540,239,301,5,5,9,2,7,59,55,4,0
2021,Epsom and Ewell 004D,E01030416,523,458,241,217,1,1,4,0,4,60,49,11,0
2021,Epsom and Ewell 009D,E01030417,519,461,248,213,0,0,5,1,4,53,47,6,0
2021,Epsom and Ewell 009E,E01030418,581,522,265,257,0,0,6,1,5,53,44,9,0
2021,Epsom and Ewell 008D,E01030419,751,530,280,250,14,14,38,5,33,169,155,14,0
2021,Epsom and Ewell 009F,E01030420,527,355,170,185,3,3,87,4,83,82,65,17,0
2021,Guildford 014A,E01030421,731,639,326,313,18,18,33,6,27,40,36,4,1
2021,Guildford 014B,E01030422,775,547,222,325,16,16,119,86,33,93,88,5,0
2021,Guildford 014C,E01030423,732,523,262,261,14,14,139,118,21,53,51,2,3
2021,Guildford 010A,E01030424,659,397,184,213,2,2,197,81,116,63,54,9,0
2021,Guildford 014D,E01030425,781,662,278,384,14,14,35,12,23,70,59,11,0
2021,Guildford 004A,E01030426,620,400,148,252,7,7,128,85,43,85,80,5,0
2021,Guildford 004B,E01030427,601,540,268,272,1,1,6,3,3,54,45,9,0
2021,Guildford 004C,E01030428,536,413,216,197,1,1,28,7,21,93,63,30,1
2021,Guildford 004D,E01030429,710,458,230,228,10,10,21,13,8,221,203,18,0
2021,Guildford 004E,E01030430,610,523,303,220,3,3,7,5,2,77,63,14,0
2021,Guildford 010B,E01030431,615,540,319,221,2,2,25,24,1,48,36,12,0
2021,Guildford 010C,E01030432,631,384,168,216,1,1,180,67,113,66,59,7,0
2021,Guildford 010D,E01030433,698,390,154,236,8,8,224,135,89,74,65,9,2
2021,Guildford 008A,E01030434,719,475,213,262,4,4,10,6,4,230,216,14,0
2021,Guildford 008B,E01030435,706,579,278,301,7,7,56,44,12,62,50,12,2
2021,Guildford 011A,E01030436,963,681,356,325,23,23,19,6,13,240,222,18,0
2021,Guildford 011B,E01030437,914,664,356,308,7,7,56,7,49,187,176,11,0
2021,Guildford 013A,E01030438,812,501,309,192,7,7,70,27,43,234,219,15,0
2021,Guildford 011C,E01030439,652,556,306,250,3,3,2,2,0,91,82,9,0
2021,Guildford 001A,E01030440,640,470,259,211,5,5,100,62,38,65,49,16,0
2021,Guildford 003A,E01030441,530,441,242,199,2,2,37,28,9,50,38,12,0
2021,Guildford 003B,E01030442,552,529,314,215,0,0,6,4,2,17,16,1,0
2021,Guildford 003C,E01030443,539,496,283,213,2,2,9,5,4,32,27,5,0
2021,Guildford 003D,E01030444,589,523,261,262,0,0,26,25,1,40,34,6,0
2021,Guildford 003E,E01030445,622,435,270,165,7,7,80,67,13,100,91,9,0
2021,Guildford 003F,E01030446,526,449,252,197,4,4,13,7,6,60,49,11,0
2021,Guildford 003G,E01030447,541,434,249,185,11,11,47,12,35,49,39,10,0
2021,Guildford 016A,E01030448,623,510,289,221,1,1,4,2,2,108,101,7,0
2021,Guildford 016B,E01030449,705,350,215,135,4,4,110,78,32,239,217,22,2
2021,Guildford 013B,E01030450,1058,473,172,301,35,35,123,21,102,427,408,19,0
2021,Guildford 013C,E01030451,929,271,115,156,30,30,213,75,138,413,383,30,2
2021,Guildford 015A,E01030452,1131,400,149,251,76,76,168,81,87,486,456,30,1
2021,Guildford 013D,E01030453,766,353,182,171,8,8,39,16,23,366,344,22,0
2021,Guildford 016C,E01030454,735,484,234,250,2,2,62,40,22,187,181,6,0
2021,Guildford 013E,E01030455,958,400,218,182,17,17,78,34,44,463,432,31,0
2021,Guildford 016D,E01030456,555,507,282,225,0,0,5,2,3,43,34,9,0
2021,Guildford 013F,E01030457,833,292,122,170,6,6,111,74,37,421,400,21,3
2021,Guildford 001B,E01030458,534,405,239,166,4,4,14,4,10,111,80,31,0
2021,Guildford 001C,E01030459,579,339,206,133,18,18,136,74,62,85,72,13,1
2021,Guildford 011D,E01030460,624,497,281,216,2,2,30,29,1,95,87,8,0
2021,Guildford 011E,E01030461,661,574,316,258,4,4,10,4,6,73,66,7,0
2021,Guildford 008C,E01030462,720,438,241,197,7,7,122,20,102,153,136,17,0
2021,Guildford 008D,E01030463,621,478,253,225,4,4,19,16,3,119,113,6,1
2021,Guildford 008E,E01030464,627,305,123,182,8,8,238,230,8,74,66,8,2
2021,Guildford 002A,E01030465,600,459,257,202,1,1,88,73,15,52,42,10,0
2021,Guildford 002B,E01030466,739,664,461,203,4,4,28,14,14,43,34,9,0
2021,Guildford 015B,E01030467,633,550,274,276,2,2,5,4,1,76,70,6,0
2021,Guildford 015C,E01030468,474,141,92,49,2,2,99,88,11,230,219,11,2
2021,Guildford 015D,E01030469,519,318,167,151,0,0,120,116,4,80,76,4,1
2021,Guildford 012A,E01030470,494,263,149,114,7,7,19,14,5,205,185,20,0
2021,Guildford 017A,E01030471,483,409,233,176,2,2,7,5,2,65,48,17,0
2021,Guildford 017B,E01030472,507,348,173,175,1,1,63,51,12,95,69,26,0
2021,Guildford 002C,E01030473,676,507,244,263,12,12,39,26,13,118,46,72,0
2021,Guildford 002D,E01030474,429,49,15,34,3,3,60,16,44,317,94,223,0
2021,Guildford 001D,E01030475,540,493,261,232,1,1,9,8,1,37,34,3,0
2021,Guildford 001E,E01030476,467,444,266,178,1,1,2,2,0,20,14,6,0
2021,Guildford 001F,E01030477,716,491,247,244,2,2,131,102,29,89,72,17,3
2021,Guildford 017C,E01030478,672,484,255,229,6,6,77,61,16,105,79,26,0
2021,Guildford 017D,E01030479,814,503,211,292,37,37,175,151,24,97,84,13,2
2021,Guildford 017E,E01030480,814,680,391,289,3,3,38,32,6,93,79,14,0
2021,Guildford 007A,E01030481,635,347,157,190,13,13,178,158,20,95,83,12,2
2021,Guildford 007B,E01030482,529,316,136,180,5,5,119,101,18,88,72,16,1
2021,Guildford 007C,E01030483,607,207,100,107,4,4,317,270,47,70,60,10,9
2021,Guildford 007D,E01030484,679,301,125,176,12,12,222,187,35,142,123,19,2
2021,Guildford 006A,E01030485,764,449,182,267,9,9,90,84,6,216,202,14,0
2021,Guildford 009A,E01030486,612,480,239,241,35,35,21,19,2,76,67,9,0
2021,Guildford 006B,E01030487,654,430,213,217,2,2,15,7,8,207,190,17,0
2021,Guildford 006C,E01030488,760,483,221,262,48,48,129,72,57,99,88,11,1
2021,Guildford 006D,E01030489,949,665,278,387,40,40,89,14,75,155,136,19,0
2021,Guildford 018A,E01030490,699,536,335,201,4,4,36,22,14,121,90,31,2
2021,Guildford 018B,E01030491,817,479,290,189,8,8,138,80,58,191,165,26,1
2021,Guildford 018C,E01030492,806,710,431,279,1,1,22,22,0,71,54,17,2
2021,Guildford 009B,E01030493,509,187,71,116,2,2,218,213,5,100,94,6,2
2021,Guildford 012B,E01030494,652,255,156,99,6,6,240,229,11,151,138,13,0
2021,Guildford 009C,E01030495,662,343,196,147,7,7,55,44,11,257,245,12,0
2021,Guildford 012C,E01030496,622,163,85,78,3,3,315,302,13,141,133,8,0
2021,Guildford 012D,E01030497,601,111,48,63,10,10,361,308,53,115,107,8,4
2021,Guildford 009D,E01030498,508,406,186,220,1,1,6,5,1,95,88,7,0
2021,Guildford 005A,E01030499,647,565,345,220,3,3,14,14,0,65,43,22,0
2021,Guildford 005B,E01030500,615,450,256,194,3,3,29,15,14,133,117,16,0
2021,Guildford 005C,E01030501,654,508,242,266,7,7,47,26,21,92,78,14,0
2021,Guildford 005D,E01030502,494,396,240,156,1,1,47,38,9,50,38,12,0
2021,Guildford 005E,E01030503,552,212,96,116,17,17,231,119,112,91,82,9,1
2021,Guildford 005F,E01030504,490,451,277,174,1,1,7,6,1,31,23,8,0
2021,Mole Valley 002A,E01030505,633,470,243,227,2,2,98,16,82,63,57,6,0
2021,Mole Valley 001A,E01030506,482,461,233,228,0,0,3,0,3,18,14,4,0
2021,Mole Valley 002B,E01030507,499,414,216,198,1,1,3,0,3,81,72,9,0
2021,Mole Valley 001B,E01030508,516,462,274,188,0,0,21,0,21,33,22,11,0
2021,Mole Valley 001C,E01030509,572,371,209,162,9,9,101,2,99,91,80,11,0
2021,Mole Valley 004A,E01030510,730,599,341,258,13,13,60,1,59,58,49,9,0
2021,Mole Valley 002C,E01030511,571,517,277,240,7,7,7,1,6,40,32,8,0
2021,Mole Valley 002D,E01030512,671,534,310,224,1,1,43,3,40,93,85,8,0
2021,Mole Valley 001D,E01030513,522,411,209,202,2,2,83,14,69,26,20,6,0
2021,Mole Valley 001E,E01030514,649,499,304,195,0,0,63,9,54,87,76,11,0
2021,Mole Valley 013A,E01030515,916,661,398,263,8,8,144,17,127,103,86,17,0
2021,Mole Valley 006A,E01030516,662,353,218,135,9,9,183,23,160,117,103,14,0
2021,Mole Valley 006B,E01030517,708,609,366,243,6,6,7,3,4,86,69,17,0
2021,Mole Valley 006C,E01030518,550,525,351,174,0,0,3,0,3,22,18,4,0
2021,Mole Valley 006D,E01030519,667,471,276,195,17,17,123,20,103,56,46,10,0
2021,Mole Valley 007A,E01030520,640,433,268,165,3,3,168,33,135,36,33,3,0
2021,Mole Valley 007B,E01030521,678,513,300,213,1,1,60,7,53,104,85,19,0
2021,Mole Valley 007C,E01030522,565,520,321,199,0,0,5,1,4,40,36,4,0
2021,Mole Valley 007D,E01030523,536,447,275,172,0,0,32,5,27,57,51,6,0
2021,Mole Valley 008A,E01030524,980,825,643,182,14,14,38,10,28,102,80,22,1
2021,Mole Valley 008B,E01030525,650,573,336,237,1,1,32,2,30,44,31,13,0
2021,Mole Valley 008C,E01030526,536,405,215,190,2,2,90,5,85,39,37,2,0
2021,Mole Valley 008D,E01030527,667,473,272,201,0,0,60,4,56,134,112,22,0
2021,Mole Valley 013B,E01030528,604,464,288,176,7,7,56,5,51,77,62,15,0
2021,Mole Valley 012A,E01030529,702,491,260,231,8,8,120,18,102,83,69,14,0
2021,Mole Valley 013C,E01030530,491,391,223,168,0,0,45,11,34,55,44,11,0
2021,Mole Valley 013D,E01030531,946,725,359,366,12,12,82,6,76,127,97,30,0
2021,Mole Valley 009A,E01030532,694,523,236,287,5,5,23,2,21,143,126,17,0
2021,Mole Valley 009B,E01030533,595,487,258,229,1,1,31,4,27,76,67,9,0
2021,Mole Valley 009C,E01030534,747,421,227,194,1,1,115,11,104,209,179,30,1
2021,Mole Valley 010A,E01030535,802,549,301,248,6,6,74,15,59,172,146,26,1
2021,Mole Valley 010B,E01030536,814,601,345,256,2,2,102,5,97,109,101,8,0
2021,Mole Valley 010C,E01030537,743,525,324,201,12,12,118,10,108,88,74,14,0
2021,Mole Valley 010D,E01030538,839,447,213,234,19,19,114,11,103,259,239,20,0
2021,Mole Valley 005A,E01030539,701,512,250,262,0,0,115,15,100,74,67,7,0
2021,Mole Valley 005B,E01030540,855,813,513,300,0,0,2,0,2,40,29,11,0
2021,Mole Valley 005C,E01030541,504,474,271,203,0,0,4,2,2,26,20,6,0
2021,Mole Valley 005D,E01030542,483,435,224,211,1,1,13,1,12,34,26,8,0
2021,Mole Valley 005E,E01030543,637,556,278,278,11,11,17,1,16,53,42,11,0
2021,Mole Valley 011A,E01030544,650,528,258,270,2,2,39,6,33,81,72,9,0
2021,Mole Valley 011B,E01030545,685,523,253,270,12,12,42,5,37,108,98,10,0
2021,Mole Valley 011C,E01030546,662,395,192,203,38,38,192,24,168,37,30,7,0
2021,Mole Valley 011D,E01030547,713,223,114,109,9,9,431,67,364,50,42,8,0
2021,Mole Valley 003A,E01030548,892,508,197,311,72,72,128,21,107,184,168,16,0
2021,Mole Valley 003B,E01030549,855,468,194,274,21,21,120,32,88,244,227,17,2
2021,Mole Valley 003C,E01030550,969,448,222,226,2,2,225,27,198,294,268,26,0
2021,Mole Valley 003D,E01030551,731,330,114,216,8,8,287,47,240,106,93,13,0
2021,Mole Valley 004B,E01030552,740,426,217,209,6,6,25,4,21,283,247,36,0
2021,Mole Valley 004C,E01030553,823,608,368,240,8,8,103,9,94,104,90,14,0
2021,Mole Valley 004D,E01030554,454,413,245,168,0,0,8,6,2,33,27,6,0
2021,Mole Valley 012B,E01030555,668,449,246,203,2,2,42,4,38,175,153,22,0
2021,Mole Valley 009D,E01030556,802,632,365,267,5,5,36,7,29,129,99,30,0
2021,Mole Valley 012C,E01030557,782,580,318,262,8,8,51,6,45,143,116,27,0
2021,Mole Valley 012D,E01030558,938,691,403,288,8,8,136,18,118,103,91,12,0
2021,Reigate and Banstead 002A,E01030559,493,441,287,154,1,1,13,5,8,38,31,7,0
2021,Reigate and Banstead 002B,E01030560,762,539,356,183,5,5,30,7,23,188,176,12,0
2021,Reigate and Banstead 002C,E01030561,593,472,304,168,1,1,49,7,42,71,59,12,0
2021,Reigate and Banstead 002D,E01030562,577,380,167,213,17,17,84,24,60,96,87,9,0
2021,Reigate and Banstead 002E,E01030563,404,395,197,198,0,0,2,1,1,7,7,0,0
2021,Reigate and Banstead 002F,E01030564,519,437,232,205,3,3,52,1,51,27,23,4,0
2021,Reigate and Banstead 004A,E01030565,575,434,247,187,12,12,72,5,67,57,45,12,0
2021,Reigate and Banstead 004B,E01030566,545,492,205,287,0,0,19,6,13,34,31,3,0
2021,Reigate and Banstead 004C,E01030567,638,572,310,262,1,1,14,4,10,51,42,9,0
2021,Reigate and Banstead 004D,E01030568,594,520,278,242,3,3,12,0,12,59,50,9,0
2021,Reigate and Banstead 004E,E01030569,1011,737,241,496,36,36,125,17,108,112,96,16,1
2021,Reigate and Banstead 014A,E01030570,693,486,227,259,5,5,98,18,80,104,89,15,0
2021,Reigate and Banstead 014B,E01030571,610,528,239,289,6,6,25,7,18,51,40,11,0
2021,Reigate and Banstead 014C,E01030572,953,459,177,282,18,18,277,25,252,199,179,20,0
2021,Reigate and Banstead 014D,E01030573,739,592,269,323,1,1,52,13,39,94,86,8,0
2021,Reigate and Banstead 014E,E01030574,808,512,182,330,1,1,69,12,57,226,219,7,0
2021,Reigate and Banstead 018B,E01030576,679,480,217,263,8,8,33,4,29,158,151,7,0
2021,Reigate and Banstead 018C,E01030577,758,492,268,224,2,2,25,5,20,239,218,21,0
2021,Reigate and Banstead 018D,E01030578,610,313,151,162,0,0,236,39,197,61,55,6,0
2021,Reigate and Banstead 018E,E01030579,645,423,263,160,22,22,69,6,63,130,122,8,1
2021,Reigate and Banstead 017A,E01030580,894,624,238,386,27,27,67,5,62,176,159,17,0
2021,Reigate and Banstead 017B,E01030581,934,760,313,447,35,35,57,2,55,82,71,11,0
2021,Reigate and Banstead 017C,E01030582,566,360,150,210,9,9,7,1,6,190,183,7,0
2021,Reigate and Banstead 017D,E01030583,612,563,297,266,9,9,8,0,8,32,25,7,0
2021,Reigate and Banstead 016B,E01030585,623,516,294,222,5,5,28,8,20,74,71,3,0
2021,Reigate and Banstead 016C,E01030586,728,485,219,266,28,28,154,23,131,61,51,10,0
2021,Reigate and Banstead 016D,E01030587,621,437,222,215,1,1,101,23,78,82,70,12,0
2021,Reigate and Banstead 016E,E01030588,608,287,144,143,1,1,253,48,205,66,54,12,1
2021,Reigate and Banstead 007A,E01030589,677,611,328,283,0,0,6,1,5,60,54,6,0
2021,Reigate and Banstead 007B,E01030590,744,656,307,349,0,0,19,2,17,69,58,11,0
2021,Reigate and Banstead 007C,E01030591,666,557,321,236,8,8,44,9,35,57,45,12,0
2021,Reigate and Banstead 007D,E01030592,802,609,310,299,6,6,55,8,47,132,113,19,0
2021,Reigate and Banstead 012A,E01030593,621,433,191,242,3,3,73,4,69,112,106,6,0
2021,Reigate and Banstead 013A,E01030594,721,422,179,243,19,19,220,27,193,60,54,6,0
2021,Reigate and Banstead 013B,E01030595,646,489,217,272,4,4,68,9,59,85,77,8,0
2021,Reigate and Banstead 012B,E01030596,526,467,202,265,9,9,18,1,17,32,27,5,0
2021,Reigate and Banstead 012C,E01030597,652,531,196,335,3,3,9,1,8,109,95,14,0
2021,Reigate and Banstead 009A,E01030598,673,460,202,258,3,3,67,6,61,143,127,16,0
2021,Reigate and Banstead 008A,E01030599,704,258,78,180,40,40,366,80,286,40,36,4,0
2021,Reigate and Banstead 008B,E01030600,635,455,173,282,3,3,108,31,77,69,63,6,0
2021,Reigate and Banstead 008C,E01030601,602,376,135,241,4,4,167,33,134,55,42,13,0
2021,Reigate and Banstead 008D,E01030602,732,582,267,315,6,6,27,4,23,117,110,7,0
2021,Reigate and Banstead 001A,E01030603,568,529,286,243,0,0,10,1,9,29,24,5,0
2021,Reigate and Banstead 001B,E01030604,675,514,265,249,3,3,87,5,82,71,66,5,0
2021,Reigate and Banstead 001C,E01030605,581,493,192,301,1,1,32,5,27,55,47,8,0
2021,Reigate and Banstead 003A,E01030606,597,551,287,264,1,1,5,1,4,40,33,7,0
2021,Reigate and Banstead 001D,E01030607,741,675,343,332,4,4,17,5,12,45,42,3,0
2021,Reigate and Banstead 005A,E01030608,593,283,86,197,35,35,230,31,199,45,41,4,0
2021,Reigate and Banstead 005B,E01030609,876,497,132,365,55,55,244,34,210,79,75,4,1
2021,Reigate and Banstead 011A,E01030610,610,363,169,194,2,2,146,11,135,99,92,7,0
2021,Reigate and Banstead 011D,E01030613,910,435,145,290,8,8,68,12,56,399,384,15,0
2021,Reigate and Banstead 011E,E01030614,626,510,206,304,9,9,30,4,26,77,72,5,0
2021,Reigate and Banstead 010A,E01030615,844,202,87,115,40,40,262,76,186,339,321,18,1
2021,Reigate and Banstead 010B,E01030616,717,603,354,249,3,3,12,2,10,99,87,12,0
2021,Reigate and Banstead 010C,E01030617,727,514,283,231,3,3,49,12,37,161,150,11,0
2021,Reigate and Banstead 010D,E01030618,770,476,200,276,32,32,128,26,102,134,121,13,0
2021,Reigate and Banstead 010E,E01030619,622,258,145,113,17,17,288,36,252,59,53,6,0
2021,Reigate and Banstead 012D,E01030620,881,533,307,226,1,1,41,8,33,306,278,28,0
2021,Reigate and Banstead 012E,E01030621,647,354,172,182,14,14,191,11,180,88,79,9,0
2021,Reigate and Banstead 010F,E01030622,828,521,208,313,5,5,50,3,47,252,235,17,0
2021,Reigate and Banstead 009B,E01030623,911,761,370,391,5,5,15,0,15,130,106,24,0
2021,Reigate and Banstead 009C,E01030624,578,463,227,236,3,3,14,1,13,98,90,8,0
2021,Reigate and Banstead 009D,E01030625,460,401,198,203,3,3,8,1,7,48,33,15,0
2021,Reigate and Banstead 009E,E01030626,442,366,209,157,0,0,5,3,2,71,65,6,0
2021,Reigate and Banstead 009F,E01030627,955,570,283,287,6,6,27,0,27,352,330,22,0
2021,Reigate and Banstead 015A,E01030628,608,502,272,230,4,4,31,7,24,71,52,19,0
2021,Reigate and Banstead 015B,E01030629,564,478,251,227,2,2,14,2,12,70,57,13,0
2021,Reigate and Banstead 013C,E01030630,622,447,257,190,8,8,113,19,94,54,49,5,0
2021,Reigate and Banstead 013D,E01030631,663,410,177,233,4,4,198,31,167,51,41,10,0
2021,Reigate and Banstead 015C,E01030632,519,468,227,241,3,3,2,0,2,46,41,5,0
2021,Reigate and Banstead 015D,E01030633,582,358,168,190,1,1,147,26,121,76,64,12,0
2021,Reigate and Banstead 015E,E01030634,569,266,109,157,1,1,262,67,195,40,32,8,0
2021,Reigate and Banstead 006A,E01030635,671,540,290,250,2,2,38,6,32,91,77,14,0
2021,Reigate and Banstead 006B,E01030636,445,397,186,211,0,0,28,4,24,20,17,3,0
2021,Reigate and Banstead 006C,E01030637,463,426,242,184,0,0,6,3,3,31,27,4,0
2021,Reigate and Banstead 006D,E01030638,625,562,341,221,1,1,7,1,6,55,51,4,0
2021,Reigate and Banstead 006E,E01030639,696,571,370,201,1,1,19,3,16,105,92,13,0
2021,Reigate and Banstead 005C,E01030640,701,374,135,239,4,4,261,39,222,59,48,11,3
2021,Reigate and Banstead 003B,E01030641,631,516,293,223,0,0,55,8,47,60,55,5,0
2021,Reigate and Banstead 003C,E01030642,658,544,274,270,4,4,54,12,42,56,52,4,0
2021,Reigate and Banstead 005D,E01030643,643,470,240,230,28,28,89,5,84,56,41,15,0
2021,Reigate and Banstead 003D,E01030644,492,449,257,192,0,0,10,0,10,33,24,9,0
2021,Runnymede 009A,E01030645,960,424,222,202,11,11,355,273,82,167,150,17,3
2021,Runnymede 009B,E01030646,1028,693,337,356,16,16,51,19,32,268,246,22,0
2021,Runnymede 007A,E01030647,764,655,416,239,11,11,17,3,14,81,69,12,0
2021,Runnymede 007B,E01030648,660,501,204,297,8,8,37,10,27,113,94,19,1
2021,Runnymede 007C,E01030649,1189,717,285,432,42,42,120,42,78,308,285,23,2
2021,Runnymede 007D,E01030650,514,300,127,173,5,5,143,130,13,62,57,5,4
2021,Runnymede 007E,E01030651,566,422,192,230,6,6,42,6,36,96,87,9,0
2021,Runnymede 006A,E01030652,788,565,257,308,3,3,78,17,61,142,130,12,0
2021,Runnymede 006B,E01030653,799,472,138,334,10,10,146,104,42,171,160,11,0
2021,Runnymede 006C,E01030654,654,448,184,264,11,11,55,5,50,140,122,18,0
2021,Runnymede 007F,E01030655,771,580,267,313,5,5,80,9,71,106,93,13,0
2021,Runnymede 004A,E01030656,573,355,144,211,9,9,160,106,54,48,41,7,1
2021,Runnymede 006D,E01030657,639,213,75,138,20,20,304,238,66,99,91,8,3
2021,Runnymede 004B,E01030658,781,612,472,140,5,5,21,4,17,143,135,8,0
2021,Runnymede 006E,E01030659,913,607,285,322,5,5,87,68,19,213,190,23,1
2021,Runnymede 009C,E01030660,1036,708,300,408,86,86,146,39,107,94,75,19,2
2021,Runnymede 009D,E01030661,806,624,374,250,70,70,70,10,60,42,34,8,0
2021,Runnymede 007G,E01030662,650,501,220,281,6,6,82,79,3,61,53,8,0
2021,Runnymede 003A,E01030663,661,354,153,201,1,1,231,135,96,71,64,7,4
2021,Runnymede 003B,E01030664,758,352,137,215,8,8,283,233,50,114,98,16,1
2021,Runnymede 003C,E01030665,627,362,123,239,8,8,112,101,11,143,133,10,2
2021,Runnymede 003D,E01030666,744,546,242,304,4,4,31,24,7,163,150,13,0
2021,Runnymede 001A,E01030667,789,302,152,150,5,5,179,118,61,297,281,16,6
2021,Runnymede 001B,E01030668,872,497,265,232,12,12,44,14,30,319,300,19,0
2021,Runnymede 001C,E01030669,690,322,158,164,6,6,89,72,17,273,259,14,0
2021,Runnymede 001D,E01030670,494,306,164,142,2,2,27,4,23,159,159,0,0
2021,Runnymede 002A,E01030671,416,222,113,109,0,0,18,11,7,176,162,14,0
2021,Runnymede 002B,E01030672,804,588,298,290,0,0,11,8,3,205,185,20,0
2021,Runnymede 002C,E01030673,498,333,202,131,33,33,11,8,3,121,86,35,0
2021,Runnymede 002D,E01030674,647,214,103,111,5,5,282,120,162,146,135,11,0
2021,Runnymede 002E,E01030675,621,279,138,141,3,3,120,87,33,217,206,11,2
2021,Runnymede 002F,E01030676,506,98,45,53,2,2,235,171,64,169,165,4,2
2021,Runnymede 008A,E01030677,676,426,282,144,3,3,106,13,93,141,108,33,0
2021,Runnymede 008B,E01030678,604,343,118,225,7,7,144,34,110,110,100,10,0
2021,Runnymede 008C,E01030679,469,382,213,169,0,0,5,4,1,82,42,40,0
2021,Runnymede 008D,E01030680,626,532,314,218,2,2,7,4,3,85,73,12,0
2021,Runnymede 010A,E01030681,683,517,250,267,5,5,68,62,6,92,75,17,1
2021,Runnymede 010B,E01030682,520,431,205,226,1,1,24,20,4,64,54,10,0
2021,Runnymede 010C,E01030683,573,467,205,262,2,2,25,4,21,79,70,9,0
2021,Runnymede 009E,E01030684,658,423,175,248,3,3,117,95,22,115,103,12,0
2021,Runnymede 004C,E01030685,523,438,236,202,1,1,11,11,0,73,43,30,0
2021,Runnymede 004D,E01030686,568,487,271,216,5,5,6,4,2,70,60,10,0
2021,Runnymede 003E,E01030687,495,405,213,192,2,2,9,1,8,78,67,11,1
2021,Runnymede 003F,E01030688,604,510,226,284,5,5,39,34,5,50,46,4,0
2021,Runnymede 005A,E01030689,608,432,227,205,5,5,24,18,6,147,133,14,0
2021,Runnymede 005B,E01030690,707,464,254,210,23,23,39,30,9,181,166,15,0
2021,Runnymede 005C,E01030691,605,518,270,248,1,1,12,9,3,74,62,12,0
2021,Runnymede 005D,E01030692,569,421,224,197,11,11,33,8,25,104,62,42,0
2021,Runnymede 010D,E01030693,505,460,245,215,1,1,21,20,1,22,19,3,1
2021,Runnymede 010E,E01030694,528,377,171,206,9,9,95,92,3,45,39,6,2
2021,Runnymede 010F,E01030695,482,460,274,186,0,0,3,0,3,19,13,6,0
2021,Runnymede 010G,E01030696,628,485,266,219,2,2,46,41,5,95,78,17,0
2021,Spelthorne 006A,E01030697,695,539,276,263,34,34,39,5,34,83,70,13,0
2021,Spelthorne 006B,E01030698,643,532,251,281,2,2,23,0,23,86,77,9,0
2021,Spelthorne 006C,E01030699,616,485,266,219,2,2,80,7,73,49,42,7,0
2021,Spelthorne 006D,E01030700,822,544,247,297,2,2,88,6,82,187,161,26,1
2021,Spelthorne 005A,E01030701,617,481,239,242,3,3,60,9,51,73,66,7,0
2021,Spelthorne 005B,E01030702,549,243,106,137,3,3,213,30,183,90,80,10,0
2021,Spelthorne 005C,E01030703,621,505,273,232,5,5,27,12,15,84,72,12,0
2021,Spelthorne 005D,E01030704,687,518,281,237,3,3,46,8,38,120,105,15,0
2021,Spelthorne 005E,E01030705,650,546,275,271,5,5,13,1,12,86,76,10,0
2021,Spelthorne 005F,E01030706,556,468,208,260,0,0,5,0,5,83,77,6,0
2021,Spelthorne 003A,E01030707,849,492,220,272,3,3,58,7,51,296,272,24,0
2021,Spelthorne 003B,E01030708,620,462,224,238,3,3,57,7,50,98,91,7,0
2021,Spelthorne 002A,E01030709,636,405,139,266,8,8,116,21,95,104,93,11,3
2021,Spelthorne 002B,E01030710,734,425,138,287,20,20,163,35,128,125,114,11,1
2021,Spelthorne 002C,E01030711,715,322,147,175,45,45,225,26,199,123,103,20,0
2021,Spelthorne 003C,E01030712,747,442,189,253,13,13,67,30,37,224,204,20,1
2021,Spelthorne 003D,E01030713,528,426,187,239,4,4,13,5,8,85,79,6,0
2021,Spelthorne 003E,E01030714,485,411,195,216,4,4,15,3,12,55,48,7,0
2021,Spelthorne 003F,E01030715,623,507,268,239,5,5,11,3,8,100,91,9,0
2021,Spelthorne 003G,E01030716,585,490,257,233,3,3,27,3,24,65,60,5,0
2021,Spelthorne 011A,E01030717,736,540,316,224,5,5,62,11,51,129,109,20,0
2021,Spelthorne 011B,E01030718,517,418,204,214,2,2,58,9,49,39,34,5,0
2021,Spelthorne 011C,E01030719,637,456,245,211,2,2,120,15,105,59,51,8,0
2021,Spelthorne 011D,E01030720,739,581,301,280,11,11,90,7,83,56,48,8,1
2021,Spelthorne 012A,E01030721,607,462,246,216,9,9,80,7,73,54,43,11,2
2021,Spelthorne 012B,E01030722,658,554,294,260,9,9,14,3,11,81,75,6,0
2021,Spelthorne 012C,E01030723,625,550,292,258,1,1,31,4,27,42,32,10,1
2021,Spelthorne 012D,E01030724,646,412,182,230,6,6,175,20,155,52,42,10,1
2021,Spelthorne 006E,E01030725,931,472,154,318,26,26,92,14,78,340,325,15,1
2021,Spelthorne 009A,E01030726,656,592,301,291,0,0,19,2,17,45,41,4,0
2021,Spelthorne 009B,E01030727,853,600,315,285,4,4,57,8,49,192,186,6,0
2021,Spelthorne 009C,E01030728,736,647,371,276,2,2,8,1,7,79,68,11,0
2021,Spelthorne 007A,E01030729,610,457,244,213,4,4,100,16,84,49,44,5,0
2021,Spelthorne 013A,E01030730,806,706,456,250,3,3,13,8,5,83,66,17,1
2021,Spelthorne 013B,E01030731,764,619,322,297,12,12,50,4,46,83,67,16,0
2021,Spelthorne 013C,E01030732,730,620,389,231,2,2,15,4,11,93,72,21,0
2021,Spelthorne 013D,E01030733,840,558,337,221,3,3,35,3,32,244,229,15,0
2021,Spelthorne 004A,E01030734,573,414,211,203,7,7,59,7,52,93,90,3,0
2021,Spelthorne 004B,E01030735,679,435,227,208,11,11,45,5,40,188,174,14,0
2021,Spelthorne 004D,E01030737,694,384,168,216,3,3,130,17,113,175,160,15,2
2021,Spelthorne 004E,E01030738,714,351,157,194,5,5,162,16,146,196,182,14,0
2021,Spelthorne 007B,E01030739,691,390,168,222,10,10,228,22,206,63,55,8,0
2021,Spelthorne 007C,E01030740,757,434,204,230,16,16,231,45,186,74,63,11,2
2021,Spelthorne 007D,E01030741,651,461,204,257,2,2,95,11,84,93,81,12,0
2021,Spelthorne 009D,E01030742,816,630,330,300,10,10,64,4,60,112,103,9,0
2021,Spelthorne 001A,E01030743,682,426,197,229,4,4,126,17,109,126,121,5,0
2021,Spelthorne 001B,E01030744,846,285,115,170,29,29,307,52,255,224,200,24,1
2021,Spelthorne 001C,E01030745,619,254,101,153,39,39,233,32,201,93,85,8,0
2021,Spelthorne 002D,E01030746,681,370,154,216,4,4,175,28,147,132,124,8,0
2021,Spelthorne 001D,E01030747,565,394,171,223,1,1,34,6,28,136,128,8,0
2021,Spelthorne 008A,E01030748,656,475,220,255,1,1,65,6,59,112,102,10,3
2021,Spelthorne 008B,E01030749,591,330,131,199,5,5,205,39,166,51,48,3,0
2021,Spelthorne 008C,E01030750,599,353,157,196,13,13,141,24,117,92,82,10,0
2021,Spelthorne 008D,E01030751,762,436,191,245,5,5,90,7,83,231,217,14,0
2021,Spelthorne 008E,E01030752,649,265,89,176,40,40,234,26,208,108,102,6,2
2021,Spelthorne 010A,E01030753,807,596,330,266,5,5,47,6,41,159,137,22,0
2021,Spelthorne 010B,E01030754,864,693,359,334,19,19,57,8,49,93,81,12,2
2021,Spelthorne 010C,E01030755,829,533,236,297,18,18,129,28,101,149,134,15,0
2021,Spelthorne 010D,E01030756,663,565,318,247,7,7,5,2,3,84,73,11,2
2021,Surrey Heath 002A,E01030757,708,545,227,318,0,0,13,9,4,150,140,10,0
2021,Surrey Heath 002B,E01030758,453,356,163,193,3,3,19,0,19,75,58,17,0
2021,Surrey Heath 002C,E01030759,738,410,222,188,3,3,219,23,196,106,88,18,0
2021,Surrey Heath 002D,E01030760,687,533,269,264,24,24,65,10,55,65,56,9,0
2021,Surrey Heath 006A,E01030761,752,638,286,352,20,20,44,3,41,50,43,7,0
2021,Surrey Heath 006B,E01030762,754,629,298,331,5,5,15,2,13,105,99,6,0
2021,Surrey Heath 001A,E01030763,535,435,245,190,0,0,27,14,13,73,53,20,0
2021,Surrey Heath 001B,E01030764,561,484,289,195,1,1,3,0,3,73,57,16,0
2021,Surrey Heath 001C,E01030765,665,408,216,192,16,16,185,26,159,55,44,11,1
2021,Surrey Heath 010A,E01030766,740,450,203,247,3,3,90,11,79,196,175,21,1
2021,Surrey Heath 010B,E01030767,654,387,152,235,3,3,186,14,172,76,68,8,2
2021,Surrey Heath 010C,E01030768,549,374,207,167,1,1,111,14,97,62,43,19,1
2021,Surrey Heath 010D,E01030769,583,529,313,216,1,1,12,1,11,41,38,3,0
2021,Surrey Heath 011A,E01030770,603,496,262,234,24,24,3,0,3,80,69,11,0
2021,Surrey Heath 011B,E01030771,485,431,233,198,1,1,2,0,2,51,43,8,0
2021,Surrey Heath 011C,E01030772,624,426,220,206,8,8,111,7,104,79,72,7,0
2021,Surrey Heath 011D,E01030773,543,462,233,229,0,0,14,1,13,67,60,7,0
2021,Surrey Heath 007A,E01030774,619,478,209,269,16,16,20,5,15,105,98,7,0
2021,Surrey Heath 007B,E01030775,580,528,284,244,0,0,5,2,3,47,43,4,0
2021,Surrey Heath 007C,E01030776,616,556,285,271,2,2,4,1,3,54,51,3,0
2021,Surrey Heath 007D,E01030777,635,494,207,287,1,1,42,3,39,98,90,8,0
2021,Surrey Heath 003A,E01030778,737,632,369,263,1,1,3,0,3,101,87,14,0
2021,Surrey Heath 003B,E01030779,752,661,400,261,3,3,13,3,10,75,66,9,0
2021,Surrey Heath 003C,E01030780,652,565,301,264,0,0,2,0,2,85,76,9,0
2021,Surrey Heath 003D,E01030781,651,483,220,263,2,2,104,16,88,62,53,9,0
2021,Surrey Heath 012A,E01030782,668,501,257,244,3,3,99,19,80,65,52,13,0
2021,Surrey Heath 012B,E01030783,670,557,256,301,1,1,14,5,9,98,63,35,0
2021,Surrey Heath 012C,E01030784,903,532,171,361,14,14,81,11,70,276,142,134,0
2021,Surrey Heath 012D,E01030785,660,574,342,232,1,1,9,2,7,76,68,8,0
2021,Surrey Heath 004A,E01030786,789,306,137,169,33,33,362,59,303,87,76,11,1
2021,Surrey Heath 004B,E01030787,532,336,141,195,2,2,159,20,139,34,29,5,1
2021,Surrey Heath 004C,E01030788,487,208,85,123,1,1,241,36,205,37,36,1,0
2021,Surrey Heath 009A,E01030789,612,557,297,260,1,1,1,0,1,53,43,10,0
2021,Surrey Heath 009B,E01030790,681,524,228,296,4,4,68,7,61,84,77,7,1
2021,Surrey Heath 009C,E01030791,650,576,301,275,2,2,2,1,1,70,62,8,0
2021,Surrey Heath 009D,E01030792,494,457,240,217,0,0,2,1,1,35,30,5,0
2021,Surrey Heath 008A,E01030793,865,305,93,212,14,14,313,45,268,231,201,30,2
2021,Surrey Heath 008B,E01030794,643,460,197,263,1,1,46,8,38,136,119,17,0
2021,Surrey Heath 008C,E01030795,1099,634,304,330,59,59,55,5,50,350,322,28,1
2021,Surrey Heath 005A,E01030796,542,494,244,250,0,0,3,1,2,45,34,11,0
2021,Surrey Heath 005B,E01030797,530,465,205,260,0,0,4,0,4,61,50,11,0
2021,Surrey Heath 005C,E01030798,563,511,293,218,0,0,3,1,2,49,42,7,0
2021,Surrey Heath 005D,E01030799,516,467,245,222,0,0,2,0,2,47,39,8,0
2021,Surrey Heath 005E,E01030800,937,509,303,206,6,6,33,7,26,389,340,49,0
2021,Surrey Heath 004D,E01030801,720,318,123,195,0,0,106,23,83,296,189,107,0
2021,Surrey Heath 004E,E01030802,721,567,288,279,0,0,6,0,6,148,133,15,0
2021,Surrey Heath 008D,E01030803,700,419,171,248,2,2,97,17,80,181,160,21,1
2021,Surrey Heath 008E,E01030804,675,558,300,258,7,7,11,2,9,99,82,17,0
2021,Surrey Heath 008F,E01030805,614,303,127,176,0,0,233,25,208,77,64,13,1
2021,Surrey Heath 006C,E01030806,541,496,255,241,0,0,10,2,8,35,26,9,0
2021,Surrey Heath 006D,E01030807,896,630,245,385,72,72,107,11,96,87,65,22,0
2021,Surrey Heath 006E,E01030808,634,518,234,284,2,2,6,0,6,108,92,16,0
2021,Surrey Heath 001D,E01030809,665,485,248,237,0,0,65,5,60,115,100,15,0
2021,Surrey Heath 001E,E01030810,529,470,240,230,1,1,2,0,2,56,47,9,0
2021,Surrey Heath 001F,E01030811,601,527,276,251,2,2,0,0,0,72,60,12,0
2021,Tandridge 008A,E01030812,693,409,222,187,14,14,183,122,61,86,69,17,1
2021,Tandridge 008B,E01030813,657,527,256,271,4,4,40,24,16,86,75,11,0
2021,Tandridge 008C,E01030814,518,390,185,205,3,3,73,41,32,52,40,12,0
2021,Tandridge 008D,E01030815,625,456,230,226,1,1,85,84,1,83,62,21,0
2021,Tandridge 011A,E01030816,646,493,262,231,3,3,39,14,25,111,76,35,0
2021,Tandridge 011B,E01030817,579,504,279,225,2,2,25,12,13,48,38,10,0
2021,Tandridge 011C,E01030818,529,366,186,180,3,3,110,63,47,48,39,9,2
2021,Tandridge 011D,E01030819,664,508,273,235,2,2,21,5,16,133,104,29,0
2021,Tandridge 005A,E01030820,670,620,332,288,0,0,11,10,1,39,27,12,0
2021,Tandridge 010A,E01030821,756,570,294,276,2,2,91,81,10,93,79,14,0
2021,Tandridge 010B,E01030822,800,687,411,276,1,1,6,5,1,106,83,23,0
2021,Tandridge 011E,E01030823,923,765,427,338,12,12,73,8,65,73,50,23,0
2021,Tandridge 009A,E01030824,635,370,154,216,6,6,185,149,36,73,63,10,1
2021,Tandridge 009B,E01030825,619,480,256,224,2,2,61,48,13,76,62,14,0
2021,Tandridge 009C,E01030826,591,451,225,226,1,1,92,67,25,47,38,9,0
2021,Tandridge 009D,E01030827,692,489,236,253,1,1,112,69,43,90,57,33,0
2021,Tandridge 004A,E01030828,528,424,222,202,0,0,8,4,4,96,75,21,0
2021,Tandridge 004B,E01030829,773,487,239,248,3,3,49,37,12,234,217,17,0
2021,Tandridge 004C,E01030830,521,431,190,241,2,2,9,5,4,79,65,14,0
2021,Tandridge 006A,E01030831,895,751,427,324,6,6,14,11,3,124,102,22,0
2021,Tandridge 006B,E01030832,565,451,267,184,1,1,51,50,1,62,50,12,0
2021,Tandridge 010C,E01030833,635,394,207,187,4,4,133,82,51,104,82,22,0
2021,Tandridge 010D,E01030834,615,439,250,189,10,10,119,102,17,47,34,13,0
2021,Tandridge 010E,E01030835,605,492,238,254,0,0,63,21,42,50,37,13,0
2021,Tandridge 006C,E01030836,744,445,248,197,6,6,134,86,48,159,137,22,0
2021,Tandridge 006D,E01030837,544,426,198,228,2,2,40,27,13,76,64,12,0
2021,Tandridge 006E,E01030838,546,436,220,216,1,1,35,34,1,74,59,15,0
2021,Tandridge 006F,E01030839,586,517,305,212,3,3,15,13,2,51,42,9,0
2021,Tandridge 007A,E01030840,559,392,179,213,0,0,109,86,23,54,46,8,4
2021,Tandridge 007B,E01030841,509,464,256,208,0,0,12,0,12,33,29,4,0
2021,Tandridge 007C,E01030842,871,540,203,337,28,28,222,147,75,81,71,10,0
2021,Tandridge 007D,E01030843,613,356,190,166,1,1,178,128,50,78,70,8,0
2021,Tandridge 003A,E01030844,696,561,237,324,14,14,57,14,43,64,53,11,0
2021,Tandridge 003B,E01030845,520,394,154,240,14,14,74,20,54,36,26,10,2
2021,Tandridge 003C,E01030846,573,509,250,259,1,1,34,33,1,29,22,7,0
2021,Tandridge 005B,E01030847,713,546,306,240,3,3,89,57,32,75,64,11,0
2021,Tandridge 005C,E01030848,917,689,319,370,3,3,69,63,6,156,140,16,0
2021,Tandridge 004D,E01030850,1181,711,343,368,6,6,176,95,81,288,262,26,0
2021,Tandridge 004E,E01030851,808,587,223,364,26,26,113,82,31,82,72,10,0
2021,Tandridge 012A,E01030852,805,534,258,276,4,4,164,143,21,102,88,14,1
2021,Tandridge 012B,E01030853,757,613,350,263,0,0,69,48,21,74,65,9,1
2021,Tandridge 012C,E01030854,823,717,400,317,1,1,37,34,3,68,61,7,0
2021,Tandridge 002A,E01030855,844,758,439,319,1,1,9,4,5,76,65,11,0
2021,Tandridge 002B,E01030856,646,553,289,264,1,1,13,11,2,79,64,15,0
2021,Tandridge 003D,E01030857,882,523,195,328,19,19,240,81,159,100,87,13,0
2021,Tandridge 003E,E01030858,1089,750,313,437,22,22,98,36,62,219,197,22,0
2021,Tandridge 002C,E01030859,925,568,221,347,79,79,110,26,84,168,146,22,0
2021,Tandridge 004F,E01030861,761,670,360,310,2,2,13,12,1,76,52,24,0
2021,Waverley 015A,E01030862,931,690,481,209,18,18,112,42,70,111,86,25,0
2021,Waverley 008A,E01030863,749,632,378,254,0,0,46,39,7,71,59,12,0
2021,Waverley 012A,E01030864,682,489,241,248,23,23,39,13,26,131,85,46,0
2021,Waverley 008B,E01030865,680,382,207,175,11,11,179,170,9,106,83,23,2
2021,Waverley 008C,E01030866,633,563,279,284,6,6,11,7,4,53,45,8,0
2021,Waverley 015B,E01030867,649,470,250,220,14,14,84,49,35,81,53,28,0
2021,Waverley 015C,E01030868,497,413,220,193,2,2,41,34,7,38,33,5,3
2021,Waverley 015D,E01030869,490,328,164,164,8,8,88,75,13,65,55,10,1
2021,Waverley 013A,E01030870,652,598,385,213,1,1,6,3,3,47,37,10,0
2021,Waverley 013B,E01030871,782,638,331,307,15,15,92,57,35,37,26,11,0
2021,Waverley 013C,E01030872,847,411,242,169,28,28,316,216,100,91,71,20,1
2021,Waverley 013D,E01030873,624,471,303,168,9,9,81,75,6,63,57,6,0
2021,Waverley 013E,E01030874,502,393,244,149,2,2,21,19,2,86,44,42,0
2021,Waverley 013F,E01030875,822,452,253,199,50,50,112,42,70,208,181,27,0
2021,Waverley 013G,E01030876,684,555,365,190,30,30,36,9,27,63,48,15,0
2021,Waverley 011A,E01030877,527,316,194,122,4,4,129,128,1,76,60,16,2
2021,Waverley 011B,E01030878,710,593,369,224,20,20,36,10,26,61,55,6,0
2021,Waverley 012B,E01030879,470,385,225,160,0,0,12,7,5,73,47,26,0
2021,Waverley 015E,E01030880,875,692,434,258,7,7,71,64,7,102,61,41,3
2021,Waverley 004A,E01030881,549,509,267,242,1,1,1,1,0,38,29,9,0
2021,Waverley 006A,E01030882,539,484,249,235,1,1,2,2,0,52,46,6,0
2021,Waverley 004B,E01030883,547,446,240,206,1,1,35,31,4,64,52,12,1
2021,Waverley 003A,E01030884,769,390,238,152,19,19,191,132,59,167,151,16,2
2021,Waverley 003B,E01030885,939,469,362,107,9,9,129,81,48,330,300,30,2
2021,Waverley 003C,E01030886,543,416,228,188,12,12,47,39,8,68,58,10,0
2021,Waverley 006B,E01030887,534,456,226,230,3,3,24,13,11,51,46,5,0
2021,Waverley 004C,E01030888,663,456,235,221,6,6,35,24,11,166,160,6,0
2021,Waverley 006C,E01030889,643,365,174,191,2,2,171,150,21,105,95,10,0
2021,Waverley 001A,E01030890,656,455,216,239,1,1,112,77,35,87,77,10,1
2021,Waverley 002A,E01030891,672,613,318,295,3,3,4,2,2,52,44,8,0
2021,Waverley 002B,E01030892,525,425,188,237,3,3,7,7,0,90,78,12,0
2021,Waverley 003D,E01030893,821,483,225,258,30,30,147,109,38,157,144,13,4
2021,Waverley 004D,E01030894,639,566,324,242,0,0,18,16,2,55,45,10,0
2021,Waverley 003E,E01030895,663,291,130,161,2,2,158,102,56,212,202,10,0
2021,Waverley 006D,E01030896,549,280,129,151,16,16,182,149,33,70,59,11,1
2021,Waverley 006E,E01030897,522,429,198,231,7,7,46,46,0,39,38,1,1
2021,Waverley 009A,E01030898,623,550,280,270,7,7,10,10,0,56,43,13,0
2021,Waverley 002C,E01030899,682,607,332,275,0,0,9,5,4,66,58,8,0
2021,Waverley 002D,E01030900,510,423,246,177,0,0,45,37,8,42,36,6,0
2021,Waverley 002E,E01030901,497,188,79,109,1,1,222,50,172,86,82,4,0
2021,Waverley 001B,E01030902,537,462,259,203,0,0,16,14,2,59,47,12,0
2021,Waverley 001C,E01030903,845,608,269,339,34,34,78,48,30,125,111,14,0
2021,Waverley 001D,E01030904,652,463,269,194,2,2,126,81,45,59,49,10,2
2021,Waverley 009B,E01030905,677,413,195,218,14,14,148,115,33,102,93,9,0
2021,Waverley 009C,E01030906,805,620,304,316,16,16,61,4,57,108,96,12,0
2021,Waverley 009D,E01030907,499,437,269,168,9,9,12,4,8,41,32,9,0
2021,Waverley 018A,E01030908,609,484,254,230,4,4,16,5,11,105,62,43,0
2021,Waverley 018B,E01030909,536,414,227,187,0,0,54,45,9,68,49,19,0
2021,Waverley 018C,E01030910,498,366,221,145,1,1,88,61,27,42,31,11,1
2021,Waverley 005A,E01030911,615,458,241,217,4,4,87,82,5,62,47,15,4
2021,Waverley 005B,E01030912,555,316,149,167,6,6,191,190,1,42,33,9,0
2021,Waverley 005C,E01030913,573,269,123,146,9,9,241,110,131,54,50,4,0
2021,Waverley 010A,E01030914,577,286,139,147,1,1,194,141,53,96,89,7,0
2021,Waverley 010B,E01030915,616,439,195,244,6,6,111,107,4,59,50,9,1
2021,Waverley 007A,E01030916,1076,634,262,372,7,7,65,31,34,370,334,36,0
2021,Waverley 007B,E01030917,537,333,130,203,0,0,12,8,4,192,146,46,0
2021,Waverley 007C,E01030918,552,330,161,169,1,1,81,53,28,140,127,13,0
2021,Waverley 007D,E01030919,517,442,258,184,0,0,6,4,2,69,45,24,0
2021,Waverley 005D,E01030920,661,429,191,238,26,26,47,44,3,158,146,12,1
2021,Waverley 005E,E01030921,858,479,239,240,2,2,190,187,3,186,165,21,1
2021,Waverley 007E,E01030922,824,567,272,295,15,15,45,26,19,197,179,18,0
2021,Waverley 010C,E01030923,587,512,245,267,1,1,10,8,2,64,57,7,0
2021,Waverley 010D,E01030924,494,422,211,211,1,1,5,4,1,66,63,3,0
2021,Waverley 010E,E01030925,616,538,276,262,10,10,22,5,17,46,39,7,0
2021,Waverley 017A,E01030926,603,478,224,254,2,2,54,36,18,69,60,9,0
2021,Waverley 017B,E01030927,543,355,190,165,3,3,131,126,5,54,48,6,0
2021,Waverley 017C,E01030928,841,415,193,222,5,5,144,129,15,275,253,22,2
2021,Waverley 017D,E01030929,491,429,188,241,1,1,8,5,3,53,40,13,0
2021,Waverley 016A,E01030930,627,530,289,241,0,0,23,16,7,74,62,12,0
2021,Waverley 016B,E01030931,776,574,305,269,1,1,52,15,37,149,137,12,0
2021,Waverley 016C,E01030932,651,457,238,219,3,3,132,126,6,59,50,9,0
2021,Waverley 016D,E01030933,783,474,249,225,12,12,190,142,48,107,89,18,0
2021,Waverley 018D,E01030934,589,433,238,195,4,4,78,43,35,71,57,14,3
2021,Waverley 018E,E01030935,518,441,226,215,1,1,15,7,8,61,54,7,0
2021,Waverley 011C,E01030937,671,484,233,251,10,10,62,45,17,114,96,18,1
2021,Waverley 011D,E01030938,615,377,217,160,7,7,160,134,26,71,64,7,0
2021,Waverley 011E,E01030939,467,395,210,185,11,11,36,35,1,25,20,5,0
2021,Waverley 008D,E01030940,775,586,331,255,10,10,98,89,9,81,62,19,0
2021,Waverley 012C,E01030941,524,431,211,220,5,5,13,4,9,75,39,36,0
2021,Waverley 012D,E01030942,559,453,255,198,6,6,26,18,8,74,54,20,0
2021,Waverley 012E,E01030943,530,322,144,178,9,9,158,142,16,40,33,7,1
2021,Woking 012A,E01030944,492,405,190,215,8,8,3,2,1,76,64,12,0
2021,Woking 012B,E01030945,507,413,179,234,4,4,11,4,7,79,69,10,0
2021,Woking 001A,E01030946,627,319,137,182,4,4,217,189,28,85,76,9,2
2021,Woking 001B,E01030947,519,445,200,245,1,1,25,25,0,48,40,8,0
2021,Woking 001C,E01030948,670,553,254,299,6,6,14,10,4,97,82,15,0
2021,Woking 001D,E01030949,729,534,214,320,13,13,60,43,17,121,114,7,1
2021,Woking 001E,E01030950,706,537,302,235,2,2,59,31,28,108,95,13,0
2021,Woking 005A,E01030951,596,355,179,176,7,7,55,39,16,179,165,14,0
2021,Woking 005B,E01030952,611,153,49,104,11,11,357,336,21,86,83,3,4
2021,Woking 005C,E01030953,640,463,274,189,6,6,13,0,13,158,144,14,0
2021,Woking 008A,E01030954,1113,473,186,287,1,1,105,42,63,530,506,24,4
2021,Woking 010A,E01030955,568,434,243,191,1,1,7,5,2,126,117,9,0
2021,Woking 005D,E01030956,511,308,151,157,13,13,107,36,71,83,74,9,0
2021,Woking 005E,E01030957,478,243,96,147,14,14,130,105,25,91,87,4,0
2021,Woking 005F,E01030958,618,471,220,251,7,7,11,6,5,129,120,9,0
2021,Woking 005G,E01030959,474,322,173,149,5,5,51,47,4,95,86,9,1
2021,Woking 009A,E01030960,740,496,198,298,13,13,70,47,23,158,141,17,3
2021,Woking 009B,E01030961,716,639,337,302,2,2,23,21,2,52,46,6,0
2021,Woking 009C,E01030962,776,323,125,198,7,7,333,182,151,108,99,9,5
2021,Woking 003A,E01030963,535,488,288,200,0,0,2,1,1,45,38,7,0
2021,Woking 003B,E01030964,744,476,253,223,3,3,50,8,42,215,199,16,0
2021,Woking 003C,E01030965,570,501,264,237,1,1,8,7,1,60,53,7,0
2021,Woking 003D,E01030966,502,422,197,225,0,0,32,27,5,48,42,6,0
2021,Woking 003E,E01030967,633,553,320,233,0,0,22,11,11,58,50,8,0
2021,Woking 003F,E01030968,553,294,145,149,1,1,147,54,93,110,103,7,1
2021,Woking 008B,E01030969,563,483,223,260,1,1,11,9,2,68,56,12,0
2021,Woking 008C,E01030970,630,382,176,206,1,1,130,84,46,116,107,9,1
2021,Woking 011A,E01030971,891,573,223,350,3,3,202,174,28,113,97,16,0
2021,Woking 011B,E01030972,712,515,214,301,3,3,86,75,11,108,99,9,0
2021,Woking 007A,E01030974,629,378,156,222,24,24,121,113,8,106,94,12,0
2021,Woking 007B,E01030975,560,436,227,209,0,0,32,21,11,92,79,13,0
2021,Woking 007C,E01030976,632,479,244,235,5,5,22,11,11,125,114,11,1
2021,Woking 007D,E01030977,734,525,253,272,17,17,67,34,33,125,115,10,0
2021,Woking 012C,E01030978,808,606,194,412,34,34,99,34,65,69,66,3,0
2021,Woking 007E,E01030979,818,510,197,313,11,11,98,28,70,197,187,10,2
2021,Woking 004A,E01030980,580,243,91,152,4,4,70,49,21,260,232,28,3
2021,Woking 004B,E01030981,468,300,147,153,0,0,89,80,9,78,66,12,1
2021,Woking 004D,E01030983,798,287,118,169,14,14,174,109,65,320,294,26,3
2021,Woking 004E,E01030984,666,349,142,207,9,9,204,166,38,101,93,8,3
2021,Woking 012D,E01030986,454,424,255,169,0,0,2,2,0,28,23,5,0
2021,Woking 012E,E01030987,515,450,258,192,0,0,20,19,1,45,33,12,0
2021,Woking 006A,E01030988,826,454,229,225,2,2,18,3,15,352,328,24,0
2021,Woking 006B,E01030989,672,462,217,245,4,4,50,9,41,156,141,15,0
2021,Woking 006C,E01030990,584,479,259,220,3,3,40,6,34,62,49,13,0
2021,Woking 008D,E01030991,1009,515,276,239,5,5,46,27,19,443,421,22,0
2021,Woking 010B,E01030992,694,497,244,253,2,2,6,3,3,189,173,16,0
2021,Woking 011D,E01030994,780,553,196,357,15,15,104,61,43,107,98,9,1
2021,Woking 011E,E01030995,660,350,121,229,4,4,145,109,36,159,150,9,2
2021,Woking 002A,E01030996,568,542,308,234,0,0,4,3,1,22,20,2,0
2021,Woking 006D,E01030997,684,580,376,204,2,2,35,30,5,67,52,15,0
2021,Woking 002B,E01030998,728,673,402,271,1,1,10,5,5,43,40,3,1
2021,Woking 010C,E01030999,502,461,270,191,1,1,5,2,3,35,31,4,0
2021,Woking 009D,E01031000,667,518,280,238,1,1,22,7,15,126,114,12,0
2021,Woking 010D,E01031001,726,483,223,260,1,1,83,5,78,159,146,13,0
2021,Woking 002C,E01031002,681,605,329,276,0,0,5,3,2,71,63,8,0
2021,Woking 002D,E01031003,662,536,257,279,1,1,4,3,1,121,55,66,0
2021,Woking 002E,E01031004,1097,633,285,348,3,3,117,45,72,342,318,24,2
2021,North Warwickshire 005A,E01031005,682,427,198,229,6,6,149,86,63,100,88,12,0
2021,North Warwickshire 007A,E01031006,697,452,209,243,11,11,101,78,23,130,119,11,3
2021,North Warwickshire 007B,E01031007,538,457,258,199,4,4,38,9,29,38,29,9,1
2021,North Warwickshire 005B,E01031008,649,337,169,168,41,41,177,79,98,92,79,13,2
2021,North Warwickshire 003A,E01031009,998,610,337,273,2,2,116,89,27,270,252,18,0
2021,North Warwickshire 003B,E01031010,941,244,124,120,3,3,350,218,132,336,323,13,8
2021,North Warwickshire 003C,E01031011,970,718,422,296,13,13,60,23,37,179,166,13,0
2021,North Warwickshire 003D,E01031012,632,364,210,154,1,1,201,189,12,63,47,16,3
2021,North Warwickshire 003E,E01031013,493,419,281,138,1,1,6,4,2,67,53,14,0
2021,North Warwickshire 003F,E01031014,502,448,279,169,3,3,17,16,1,34,28,6,0
2021,North Warwickshire 003G,E01031015,699,259,135,124,14,14,365,192,173,58,47,11,3
2021,North Warwickshire 002A,E01031016,685,458,264,194,5,5,148,141,7,71,59,12,3
2021,North Warwickshire 005C,E01031017,667,545,276,269,17,17,37,30,7,68,54,14,0
2021,North Warwickshire 005D,E01031018,463,339,181,158,2,2,33,24,9,88,78,10,1
2021,North Warwickshire 006A,E01031019,680,525,231,294,14,14,46,17,29,94,77,17,1
2021,North Warwickshire 006B,E01031020,706,536,276,260,4,4,16,9,7,150,137,13,0
2021,North Warwickshire 006C,E01031021,857,514,290,224,0,0,179,86,93,162,142,20,2
2021,North Warwickshire 006D,E01031022,814,612,370,242,8,8,56,37,19,138,125,13,0
2021,North Warwickshire 004A,E01031023,658,569,351,218,4,4,20,11,9,65,53,12,0
2021,North Warwickshire 004B,E01031024,717,584,326,258,9,9,32,19,13,92,66,26,0
2021,North Warwickshire 002B,E01031025,721,456,247,209,0,0,126,91,35,136,126,10,3
2021,North Warwickshire 002C,E01031026,597,322,170,152,9,9,151,40,111,115,107,8,0
2021,North Warwickshire 007C,E01031027,642,538,289,249,1,1,23,22,1,80,62,18,0
2021,North Warwickshire 007D,E01031028,779,534,309,225,3,3,67,60,7,174,157,17,1
2021,North Warwickshire 005E,E01031029,611,508,256,252,2,2,27,15,12,74,64,10,0
2021,North Warwickshire 005F,E01031030,1030,683,381,302,2,2,179,130,49,163,142,21,3
2021,North Warwickshire 002D,E01031031,1034,720,340,380,23,23,191,142,49,100,82,18,0
2021,North Warwickshire 002E,E01031032,559,317,166,151,10,10,102,39,63,130,124,6,0
2021,North Warwickshire 004C,E01031033,788,551,341,210,11,11,145,90,55,79,60,19,2
2021,North Warwickshire 004D,E01031034,765,673,381,292,2,2,22,14,8,68,59,9,0
2021,North Warwickshire 001A,E01031035,801,632,334,298,6,6,84,71,13,78,67,11,1
2021,North Warwickshire 001B,E01031036,720,587,335,252,4,4,68,48,20,59,41,18,2
2021,North Warwickshire 001C,E01031037,835,560,246,314,10,10,165,156,9,98,81,17,2
2021,North Warwickshire 001D,E01031038,759,615,348,267,2,2,80,76,4,61,48,13,1
2021,North Warwickshire 001E,E01031039,647,572,313,259,1,1,7,4,3,67,55,12,0
2021,North Warwickshire 001F,E01031040,752,535,277,258,5,5,68,44,24,144,129,15,0
2021,North Warwickshire 006E,E01031041,715,570,299,271,4,4,19,13,6,122,107,15,0
2021,North Warwickshire 006F,E01031042,767,622,337,285,2,2,82,80,2,60,52,8,1
2021,Nuneaton and Bedworth 005A,E01031043,989,293,157,136,12,12,330,275,55,354,336,18,0
2021,Nuneaton and Bedworth 005B,E01031044,779,361,189,172,15,15,148,41,107,253,242,11,2
2021,Nuneaton and Bedworth 005C,E01031045,793,508,255,253,1,1,83,29,54,201,174,27,0
2021,Nuneaton and Bedworth 005D,E01031046,715,301,181,120,4,4,73,19,54,335,309,26,2
2021,Nuneaton and Bedworth 005E,E01031047,845,406,206,200,4,4,60,30,30,375,352,23,0
2021,Nuneaton and Bedworth 008A,E01031048,533,399,216,183,1,1,6,2,4,127,118,9,0
2021,Nuneaton and Bedworth 008B,E01031049,1118,756,319,437,29,29,124,65,59,207,191,16,2
2021,Nuneaton and Bedworth 008C,E01031050,792,493,218,275,6,6,86,8,78,206,184,22,1
2021,Nuneaton and Bedworth 008D,E01031051,583,497,296,201,2,2,20,3,17,64,55,9,0
2021,Nuneaton and Bedworth 010A,E01031052,648,356,162,194,1,1,33,14,19,258,237,21,0
2021,Nuneaton and Bedworth 010B,E01031053,743,333,193,140,1,1,257,213,44,149,129,20,3
2021,Nuneaton and Bedworth 010C,E01031054,698,453,231,222,10,10,134,79,55,101,86,15,0
2021,Nuneaton and Bedworth 010D,E01031055,680,501,198,303,1,1,48,14,34,130,122,8,0
2021,Nuneaton and Bedworth 010E,E01031056,615,420,212,208,2,2,115,23,92,78,63,15,0
2021,Nuneaton and Bedworth 006A,E01031057,649,195,78,117,1,1,372,335,37,79,67,12,2
2021,Nuneaton and Bedworth 006B,E01031058,647,424,237,187,1,1,116,93,23,106,94,12,0
2021,Nuneaton and Bedworth 006C,E01031059,692,437,196,241,8,8,58,46,12,189,167,22,0
2021,Nuneaton and Bedworth 006D,E01031060,618,443,275,168,0,0,83,77,6,91,74,17,1
2021,Nuneaton and Bedworth 006E,E01031061,610,420,188,232,0,0,84,3,81,106,88,18,0
2021,Nuneaton and Bedworth 013A,E01031062,500,425,273,152,1,1,45,11,34,29,24,5,0
2021,Nuneaton and Bedworth 013B,E01031063,624,314,189,125,2,2,243,121,122,62,57,5,3
2021,Nuneaton and Bedworth 013C,E01031064,616,335,206,129,8,8,165,80,85,105,92,13,3
2021,Nuneaton and Bedworth 013D,E01031065,647,412,209,203,2,2,120,116,4,113,96,17,0
2021,Nuneaton and Bedworth 013E,E01031066,666,312,131,181,6,6,266,234,32,80,66,14,2
2021,Nuneaton and Bedworth 014A,E01031067,711,419,267,152,0,0,190,136,54,101,92,9,1
2021,Nuneaton and Bedworth 014B,E01031068,761,644,416,228,4,4,33,30,3,80,66,14,0
2021,Nuneaton and Bedworth 014C,E01031069,677,624,429,195,0,0,11,8,3,42,24,18,0
2021,Nuneaton and Bedworth 014D,E01031070,650,597,409,188,0,0,7,5,2,45,35,10,1
2021,Nuneaton and Bedworth 002C,E01031073,883,615,321,294,11,11,119,64,55,138,125,13,0
2021,Nuneaton and Bedworth 002D,E01031074,730,393,195,198,1,1,133,86,47,198,183,15,5
2021,Nuneaton and Bedworth 002E,E01031075,920,467,179,288,2,2,278,234,44,173,163,10,0
2021,Nuneaton and Bedworth 018A,E01031077,705,445,145,300,7,7,162,57,105,91,76,15,0
2021,Nuneaton and Bedworth 018B,E01031078,847,681,346,335,6,6,18,11,7,142,122,20,0
2021,Nuneaton and Bedworth 018C,E01031079,685,452,273,179,18,18,136,114,22,79,66,13,0
2021,Nuneaton and Bedworth 018D,E01031080,674,413,220,193,0,0,111,96,15,149,134,15,1
2021,Nuneaton and Bedworth 004A,E01031081,667,419,185,234,5,5,115,61,54,128,116,12,0
2021,Nuneaton and Bedworth 004B,E01031082,556,501,202,299,6,6,12,3,9,37,32,5,0
2021,Nuneaton and Bedworth 004C,E01031083,753,615,286,329,8,8,47,16,31,82,68,14,1
2021,Nuneaton and Bedworth 004D,E01031084,889,687,273,414,20,20,17,7,10,165,154,11,0
2021,Nuneaton and Bedworth 004E,E01031085,544,486,253,233,2,2,27,3,24,29,27,2,0
2021,Nuneaton and Bedworth 016A,E01031086,810,614,309,305,4,4,72,5,67,120,98,22,0
2021,Nuneaton and Bedworth 016B,E01031087,885,574,255,319,1,1,174,157,17,134,117,17,2
2021,Nuneaton and Bedworth 016C,E01031088,782,564,257,307,9,9,100,53,47,109,102,7,0
2021,Nuneaton and Bedworth 016D,E01031089,639,579,374,205,6,6,6,4,2,48,41,7,0
2021,Nuneaton and Bedworth 007A,E01031090,670,249,101,148,0,0,315,281,34,103,94,9,3
2021,Nuneaton and Bedworth 007B,E01031091,693,544,314,230,0,0,36,12,24,113,102,11,0
2021,Nuneaton and Bedworth 007C,E01031092,617,311,141,170,0,0,131,114,17,175,155,20,0
2021,Nuneaton and Bedworth 007D,E01031093,550,438,259,179,2,2,46,43,3,64,59,5,0
2021,Nuneaton and Bedworth 007E,E01031094,503,316,134,182,1,1,33,19,14,153,136,17,0
2021,Nuneaton and Bedworth 015A,E01031095,507,277,139,138,3,3,105,82,23,122,110,12,0
2021,Nuneaton and Bedworth 015B,E01031096,598,383,199,184,8,8,37,14,23,170,154,16,0
2021,Nuneaton and Bedworth 015C,E01031097,762,373,161,212,4,4,285,243,42,94,80,14,6
2021,Nuneaton and Bedworth 015D,E01031098,550,396,214,182,3,3,9,3,6,142,130,12,0
2021,Nuneaton and Bedworth 015E,E01031099,947,699,284,415,10,10,17,15,2,220,206,14,1
2021,Nuneaton and Bedworth 003A,E01031100,509,456,242,214,2,2,7,6,1,43,40,3,1
2021,Nuneaton and Bedworth 003B,E01031101,520,485,267,218,0,0,4,3,1,31,29,2,0
2021,Nuneaton and Bedworth 003C,E01031102,578,411,212,199,2,2,24,7,17,141,131,10,0
2021,Nuneaton and Bedworth 003E,E01031104,632,590,420,170,0,0,9,3,6,32,22,10,1
2021,Nuneaton and Bedworth 012A,E01031105,695,473,260,213,26,26,80,9,71,116,97,19,0
2021,Nuneaton and Bedworth 012B,E01031106,643,499,316,183,0,0,69,63,6,72,59,13,3
2021,Nuneaton and Bedworth 012C,E01031107,467,377,203,174,1,1,8,6,2,81,75,6,0
2021,Nuneaton and Bedworth 012D,E01031108,556,487,261,226,6,6,11,0,11,52,48,4,0
2021,Nuneaton and Bedworth 012E,E01031109,713,429,223,206,12,12,174,159,15,97,86,11,1
2021,Nuneaton and Bedworth 001A,E01031110,711,634,379,255,1,1,3,0,3,73,58,15,0
2021,Nuneaton and Bedworth 001B,E01031111,404,380,244,136,0,0,3,2,1,21,15,6,0
2021,Nuneaton and Bedworth 001C,E01031112,655,568,302,266,1,1,15,12,3,71,59,12,0
2021,Nuneaton and Bedworth 001E,E01031114,763,452,253,199,4,4,225,214,11,79,71,8,3
2021,Nuneaton and Bedworth 009A,E01031115,728,390,223,167,2,2,95,80,15,241,225,16,0
2021,Nuneaton and Bedworth 009B,E01031116,683,266,123,143,0,0,338,277,61,77,63,14,2
2021,Nuneaton and Bedworth 009C,E01031117,587,352,149,203,9,9,166,134,32,58,44,14,2
2021,Nuneaton and Bedworth 009D,E01031118,473,302,159,143,0,0,132,116,16,37,32,5,2
2021,Nuneaton and Bedworth 009E,E01031119,727,351,214,137,2,2,186,137,49,182,170,12,6
2021,Nuneaton and Bedworth 011A,E01031120,584,498,313,185,5,5,12,6,6,69,61,8,0
2021,Nuneaton and Bedworth 011B,E01031121,452,435,267,168,0,0,1,0,1,16,11,5,0
2021,Nuneaton and Bedworth 011C,E01031122,626,561,365,196,3,3,7,3,4,55,44,11,0
2021,Nuneaton and Bedworth 011D,E01031123,513,483,307,176,3,3,4,0,4,23,17,6,0
2021,Nuneaton and Bedworth 011E,E01031124,635,605,380,225,1,1,5,4,1,24,17,7,0
2021,Rugby 007A,E01031125,659,530,294,236,4,4,9,6,3,116,102,14,0
2021,Rugby 007C,E01031127,670,291,164,127,4,4,273,28,245,101,91,10,1
2021,Rugby 014D,E01031129,530,415,246,169,3,3,51,12,39,61,53,8,0
2021,Rugby 005A,E01031130,799,391,148,243,9,9,38,13,25,361,345,16,0
2021,Rugby 005B,E01031131,723,310,172,138,3,3,33,9,24,377,360,17,0
2021,Rugby 005C,E01031132,873,399,179,220,5,5,72,53,19,397,387,10,0
2021,Rugby 005D,E01031133,577,351,166,185,8,8,68,51,17,150,141,9,0
2021,Rugby 011A,E01031134,736,657,432,225,2,2,13,7,6,64,55,9,0
2021,Rugby 011B,E01031135,758,647,460,187,1,1,50,47,3,59,50,9,1
2021,Rugby 011C,E01031136,801,592,334,258,3,3,65,24,41,141,128,13,0
2021,Rugby 002A,E01031137,563,341,159,182,28,28,64,54,10,130,117,13,0
2021,Rugby 002B,E01031138,463,371,176,195,2,2,44,4,40,46,43,3,0
2021,Rugby 002C,E01031139,685,600,283,317,0,0,4,1,3,81,77,4,0
2021,Rugby 002D,E01031140,533,439,248,191,2,2,43,24,19,49,42,7,0
2021,Rugby 002F,E01031142,690,250,78,172,9,9,316,181,135,114,99,15,1
2021,Rugby 009A,E01031143,654,556,376,180,1,1,10,9,1,87,66,21,0
2021,Rugby 009B,E01031144,662,356,172,184,3,3,56,40,16,247,211,36,0
2021,Rugby 009C,E01031145,502,168,99,69,2,2,144,90,54,184,130,54,4
2021,Rugby 009D,E01031146,628,373,201,172,2,2,184,72,112,69,62,7,0
2021,Rugby 012B,E01031148,817,536,317,219,8,8,147,124,23,126,100,26,0
2021,Rugby 012C,E01031149,661,533,326,207,1,1,45,40,5,82,65,17,0
2021,Rugby 012D,E01031150,503,419,267,152,1,1,44,40,4,39,31,8,0
2021,Rugby 004A,E01031151,616,543,338,205,13,13,7,4,3,53,42,11,0
2021,Rugby 004B,E01031152,480,401,259,142,1,1,12,10,2,66,55,11,0
2021,Rugby 004C,E01031153,674,465,227,238,2,2,141,84,57,65,52,13,1
2021,Rugby 004D,E01031154,773,642,360,282,1,1,19,16,3,110,89,21,1
2021,Rugby 008A,E01031155,551,496,269,227,2,2,6,2,4,47,40,7,0
2021,Rugby 008B,E01031156,641,532,267,265,14,14,4,3,1,91,87,4,0
2021,Rugby 008C,E01031157,934,718,310,408,11,11,42,7,35,163,157,6,0
2021,Rugby 008D,E01031158,473,437,260,177,1,1,6,3,3,29,24,5,0
2021,Rugby 013C,E01031159,683,583,333,250,1,1,41,37,4,58,45,13,0
2021,Rugby 013B,E01031160,920,689,397,292,4,4,100,91,9,126,105,21,1
2021,Rugby 010A,E01031161,886,707,391,316,4,4,63,42,21,109,96,13,3
2021,Rugby 010B,E01031162,876,673,310,363,16,16,84,76,8,102,87,15,1
2021,Rugby 010C,E01031163,785,400,238,162,11,11,302,257,45,69,52,17,3
2021,Rugby 007E,E01031165,686,419,225,194,3,3,198,180,18,63,56,7,3
2021,Rugby 012E,E01031166,839,701,451,250,3,3,41,32,9,94,70,24,0
2021,Rugby 006A,E01031167,580,435,244,191,0,0,47,7,40,97,88,9,1
2021,Rugby 006B,E01031168,1169,517,212,305,46,46,256,142,114,350,323,27,0
2021,Rugby 006C,E01031169,932,470,197,273,16,16,86,12,74,360,338,22,0
2021,Rugby 006D,E01031170,770,348,158,190,3,3,176,114,62,237,212,25,6
2021,Rugby 003A,E01031171,602,410,202,208,5,5,85,72,13,99,94,5,3
2021,Rugby 003B,E01031172,715,340,174,166,2,2,242,189,53,126,106,20,5
2021,Rugby 003C,E01031173,1001,274,151,123,17,17,275,164,111,427,402,25,8
2021,Rugby 003D,E01031174,967,330,166,164,10,10,241,68,173,383,355,28,3
2021,Rugby 011D,E01031175,582,526,362,164,0,0,11,8,3,45,39,6,0
2021,Rugby 011E,E01031176,598,298,122,176,8,8,198,177,21,90,79,11,4
2021,Rugby 011F,E01031177,609,298,114,184,6,6,225,176,49,78,69,9,2
2021,Rugby 011G,E01031178,631,481,298,183,1,1,87,82,5,60,53,7,2
2021,Rugby 010D,E01031179,794,664,295,369,10,10,30,3,27,90,81,9,0
2021,Rugby 010E,E01031180,859,632,315,317,1,1,97,63,34,127,108,19,2
2021,Rugby 004E,E01031181,782,583,300,283,30,30,100,76,24,66,47,19,3
2021,Rugby 013A,E01031182,852,591,379,212,1,1,48,34,14,211,71,140,1
2021,Stratford-on-Avon 006A,E01031183,821,545,340,205,6,6,45,3,42,224,189,35,1
2021,Stratford-on-Avon 006B,E01031184,658,507,321,186,5,5,41,4,37,105,85,20,0
2021,Stratford-on-Avon 006C,E01031185,619,292,167,125,3,3,237,49,188,85,80,5,2
2021,Stratford-on-Avon 006D,E01031186,705,417,280,137,4,4,230,23,207,54,47,7,0
2021,Stratford-on-Avon 007A,E01031187,832,670,458,212,4,4,62,12,50,96,79,17,0
2021,Stratford-on-Avon 007B,E01031188,1071,866,536,330,12,12,75,7,68,118,103,15,0
2021,Stratford-on-Avon 012A,E01031189,736,504,289,215,12,12,126,12,114,94,81,13,0
2021,Stratford-on-Avon 012B,E01031190,1007,658,275,383,18,18,239,35,204,92,77,15,0
2021,Stratford-on-Avon 012C,E01031191,881,694,404,290,34,34,101,13,88,52,46,6,0
2021,Stratford-on-Avon 012D,E01031192,1098,770,393,377,62,62,90,11,79,176,151,25,0
2021,Stratford-on-Avon 015A,E01031193,986,735,460,275,10,10,89,5,84,152,126,26,0
2021,Stratford-on-Avon 013A,E01031194,1019,705,355,350,3,3,81,9,72,230,132,98,0
2021,Stratford-on-Avon 002A,E01031195,940,769,467,302,9,9,108,10,98,54,43,11,0
2021,Stratford-on-Avon 014A,E01031196,1060,846,458,388,11,11,77,7,70,126,103,23,0
2021,Stratford-on-Avon 005A,E01031197,542,382,222,160,6,6,25,0,25,129,106,23,0
2021,Stratford-on-Avon 005B,E01031198,563,423,211,212,8,8,74,6,68,58,46,12,0
2021,Stratford-on-Avon 005C,E01031199,872,581,267,314,24,24,179,26,153,86,72,14,2
2021,Stratford-on-Avon 005D,E01031200,730,591,282,309,7,7,47,7,40,85,80,5,0
2021,Stratford-on-Avon 005E,E01031201,711,618,390,228,8,8,28,1,27,57,52,5,0
2021,Stratford-on-Avon 002B,E01031202,821,620,396,224,12,12,18,2,16,171,152,19,0
2021,Stratford-on-Avon 002C,E01031203,764,426,259,167,9,9,236,34,202,93,85,8,0
2021,Stratford-on-Avon 002D,E01031204,709,599,446,153,3,3,26,0,26,81,56,25,0
2021,Stratford-on-Avon 013B,E01031205,779,607,302,305,16,16,51,4,47,105,85,20,0
2021,Stratford-on-Avon 013C,E01031206,697,456,262,194,2,2,175,26,149,64,51,13,0
2021,Stratford-on-Avon 013D,E01031207,640,459,255,204,9,9,87,7,80,84,70,14,1
2021,Stratford-on-Avon 007C,E01031208,1065,851,569,282,21,21,72,5,67,121,106,15,0
2021,Stratford-on-Avon 015B,E01031209,1010,746,468,278,6,6,120,16,104,138,94,44,0
2021,Stratford-on-Avon 005F,E01031210,528,422,265,157,7,7,38,2,36,61,42,19,0
2021,Stratford-on-Avon 005G,E01031211,736,499,208,291,25,25,157,28,129,55,45,10,0
2021,Stratford-on-Avon 001A,E01031213,795,632,367,265,7,7,72,6,66,84,63,21,0
2021,Stratford-on-Avon 015C,E01031214,1046,827,466,361,41,41,108,13,95,70,62,8,0
2021,Stratford-on-Avon 015D,E01031215,908,553,338,215,18,18,156,18,138,181,155,26,0
2021,Stratford-on-Avon 015E,E01031216,747,434,271,163,11,11,205,16,189,97,86,11,0
2021,Stratford-on-Avon 008A,E01031217,537,443,262,181,7,7,56,2,54,31,24,7,0
2021,Stratford-on-Avon 008B,E01031218,488,358,212,146,11,11,40,6,34,79,62,17,0
2021,Stratford-on-Avon 004A,E01031219,993,666,290,376,49,49,217,24,193,61,51,10,0
2021,Stratford-on-Avon 004B,E01031220,613,489,289,200,2,2,77,9,68,45,38,7,0
2021,Stratford-on-Avon 004C,E01031221,884,508,239,269,44,44,253,32,221,78,66,12,1
2021,Stratford-on-Avon 004D,E01031222,1099,821,375,446,28,28,76,24,52,174,158,16,0
2021,Stratford-on-Avon 004E,E01031223,632,459,227,232,32,32,79,6,73,62,51,11,0
2021,Stratford-on-Avon 004F,E01031224,583,447,274,173,6,6,39,0,39,91,77,14,0
2021,Stratford-on-Avon 010A,E01031225,778,661,435,226,5,5,26,2,24,86,75,11,0
2021,Stratford-on-Avon 010C,E01031227,1010,759,468,291,23,23,105,5,100,123,100,23,0
2021,Stratford-on-Avon 009A,E01031228,723,609,427,182,1,1,15,3,12,98,85,13,0
2021,Stratford-on-Avon 009B,E01031229,1194,558,369,189,12,12,192,23,169,431,394,37,1
2021,Stratford-on-Avon 009D,E01031231,1142,449,230,219,25,25,324,47,277,343,319,24,1
2021,Stratford-on-Avon 011A,E01031232,957,717,459,258,16,16,64,4,60,160,149,11,0
2021,Stratford-on-Avon 011B,E01031233,749,513,297,216,7,7,110,12,98,119,105,14,0
2021,Stratford-on-Avon 011C,E01031234,953,502,364,138,16,16,135,12,123,300,263,37,0
2021,Stratford-on-Avon 011D,E01031235,938,650,462,188,1,1,65,1,64,222,198,24,0
2021,Stratford-on-Avon 009E,E01031236,648,431,241,190,9,9,100,10,90,108,98,10,0
2021,Stratford-on-Avon 011E,E01031237,636,483,289,194,0,0,90,9,81,63,58,5,0
2021,Stratford-on-Avon 009F,E01031238,603,275,153,122,2,2,235,32,203,91,79,12,0
2021,Stratford-on-Avon 003A,E01031239,773,561,308,253,20,20,16,3,13,176,145,31,0
2021,Stratford-on-Avon 003B,E01031240,596,386,235,151,1,1,143,18,125,66,57,9,0
2021,Stratford-on-Avon 003C,E01031241,616,508,297,211,2,2,51,6,45,55,41,14,0
2021,Stratford-on-Avon 003D,E01031242,658,428,238,190,5,5,151,19,132,74,63,11,0
2021,Stratford-on-Avon 001B,E01031243,808,742,452,290,3,3,16,4,12,47,39,8,0
2021,Stratford-on-Avon 001C,E01031244,774,607,376,231,7,7,54,5,49,106,79,27,0
2021,Stratford-on-Avon 014C,E01031245,579,423,285,138,17,17,68,9,59,71,46,25,0
2021,Stratford-on-Avon 014D,E01031246,570,445,266,179,7,7,61,9,52,57,51,6,0
2021,Stratford-on-Avon 013E,E01031247,1051,811,495,316,6,6,96,15,81,138,113,25,0
2021,Stratford-on-Avon 012E,E01031248,1055,849,519,330,14,14,83,4,79,109,84,25,0
2021,Stratford-on-Avon 008C,E01031249,527,323,174,149,0,0,163,19,144,41,32,9,0
2021,Stratford-on-Avon 008E,E01031251,502,468,319,149,1,1,2,1,1,31,23,8,0
2021,Stratford-on-Avon 008F,E01031252,536,362,186,176,1,1,80,10,70,93,61,32,0
2021,Stratford-on-Avon 008G,E01031253,635,419,221,198,1,1,133,17,116,82,70,12,0
2021,Warwick 001A,E01031254,724,591,344,247,9,9,32,14,18,91,72,19,1
2021,Warwick 001B,E01031255,624,539,333,206,1,1,9,3,6,75,67,8,0
2021,Warwick 001C,E01031256,785,599,398,201,4,4,28,7,21,154,138,16,0
2021,Warwick 001D,E01031257,670,407,191,216,1,1,95,91,4,167,152,15,0
2021,Warwick 001E,E01031258,871,530,350,180,2,2,77,56,21,262,246,16,0
2021,Warwick 014A,E01031259,1093,803,248,555,35,35,192,22,170,63,50,13,0
2021,Warwick 014B,E01031260,923,620,244,376,35,35,209,79,130,59,47,12,0
2021,Warwick 013A,E01031261,732,210,100,110,26,26,330,259,71,165,157,8,1
2021,Warwick 013B,E01031262,606,248,106,142,7,7,173,92,81,178,168,10,0
2021,Warwick 013C,E01031263,643,287,139,148,4,4,82,65,17,270,259,11,0
2021,Warwick 013D,E01031264,633,283,112,171,2,2,247,229,18,100,90,10,1
2021,Warwick 013E,E01031265,692,243,124,119,45,45,241,157,84,161,146,15,2
2021,Warwick 013F,E01031266,769,165,66,99,1,1,183,109,74,420,402,18,0
2021,Warwick 014C,E01031267,742,651,408,243,1,1,18,10,8,71,60,11,1
2021,Warwick 014D,E01031268,1090,828,374,454,19,19,95,25,70,148,136,12,0
2021,Warwick 014E,E01031269,883,624,320,304,28,28,106,59,47,125,104,21,0
2021,Warwick 010A,E01031271,911,451,256,195,8,8,240,139,101,211,194,17,1
2021,Warwick 007B,E01031272,770,442,231,211,7,7,53,40,13,268,255,13,0
2021,Warwick 006A,E01031273,607,187,84,103,2,2,362,345,17,52,49,3,4
2021,Warwick 006B,E01031274,617,328,160,168,2,2,197,177,20,90,76,14,0
2021,Warwick 006C,E01031275,522,446,285,161,0,0,38,16,22,37,31,6,1
2021,Warwick 006D,E01031276,622,332,142,190,1,1,224,207,17,62,58,4,3
2021,Warwick 005A,E01031277,639,546,290,256,3,3,24,21,3,66,60,6,0
2021,Warwick 005B,E01031278,654,553,314,239,6,6,21,3,18,74,68,6,0
2021,Warwick 005C,E01031279,613,480,299,181,2,2,75,70,5,56,41,15,0
2021,Warwick 005D,E01031280,524,433,242,191,1,1,45,38,7,45,28,17,0
2021,Warwick 004A,E01031281,657,549,313,236,1,1,26,21,5,81,61,20,0
2021,Warwick 004B,E01031282,737,542,304,238,4,4,100,54,46,91,72,19,0
2021,Warwick 004C,E01031283,536,443,248,195,2,2,15,8,7,76,68,8,0
2021,Warwick 004D,E01031284,517,448,271,177,3,3,19,15,4,47,35,12,0
2021,Warwick 007C,E01031285,1159,779,533,246,4,4,62,19,43,314,293,21,0
2021,Warwick 007D,E01031286,699,357,165,192,4,4,240,184,56,97,88,9,1
2021,Warwick 007E,E01031287,578,522,265,257,0,0,16,8,8,39,31,8,1
2021,Warwick 007F,E01031288,678,550,300,250,0,0,27,5,22,101,96,5,0
2021,Warwick 007G,E01031289,604,503,245,258,27,27,27,21,6,47,43,4,0
2021,Warwick 009A,E01031290,806,437,248,189,3,3,52,15,37,314,283,31,0
2021,Warwick 009B,E01031291,924,325,169,156,25,25,232,70,162,342,324,18,0
2021,Warwick 009C,E01031292,663,484,241,243,14,14,15,8,7,150,133,17,0
2021,Warwick 009D,E01031293,672,396,212,184,6,6,112,33,79,158,144,14,0
2021,Warwick 009E,E01031294,635,388,187,201,2,2,88,81,7,157,147,10,0
2021,Warwick 009F,E01031295,492,449,298,151,0,0,3,3,0,40,36,4,0
2021,Warwick 002A,E01031296,708,564,338,226,13,13,8,3,5,123,112,11,0
2021,Warwick 002B,E01031297,859,551,273,278,4,4,141,104,37,162,145,17,1
2021,Warwick 002C,E01031298,764,609,375,234,16,16,28,8,20,111,97,14,0
2021,Warwick 002D,E01031299,555,523,348,175,0,0,2,0,2,30,23,7,0
2021,Warwick 002E,E01031300,749,630,337,293,17,17,19,6,13,83,74,9,0
2021,Warwick 005E,E01031301,768,576,308,268,16,16,67,14,53,109,92,17,0
2021,Warwick 005F,E01031302,438,319,141,178,3,3,65,58,7,51,45,6,0
2021,Warwick 003A,E01031303,697,435,238,197,5,5,139,92,47,117,106,11,1
2021,Warwick 003B,E01031304,601,518,288,230,0,0,44,39,5,38,28,10,1
2021,Warwick 003C,E01031305,647,618,424,194,2,2,6,4,2,21,15,6,0
2021,Warwick 003D,E01031306,605,470,284,186,2,2,73,65,8,58,52,6,2
2021,Warwick 003E,E01031307,658,570,388,182,1,1,10,5,5,76,71,5,1
2021,Warwick 005G,E01031308,697,548,332,216,10,10,75,33,42,64,45,19,0
2021,Warwick 008A,E01031309,942,504,196,308,36,36,224,134,90,178,162,16,0
2021,Warwick 008B,E01031310,554,448,239,209,1,1,51,20,31,54,44,10,0
2021,Warwick 008C,E01031311,588,337,163,174,18,18,173,138,35,58,52,6,2
2021,Warwick 008D,E01031312,605,320,147,173,13,13,192,93,99,80,73,7,0
2021,Warwick 008E,E01031313,588,529,336,193,3,3,8,3,5,48,41,7,0
2021,Warwick 008F,E01031314,611,507,285,222,1,1,8,4,4,95,84,11,0
2021,Warwick 012A,E01031315,925,637,244,393,21,21,137,9,128,130,123,7,0
2021,Warwick 012B,E01031316,767,471,294,177,9,9,127,117,10,156,131,25,4
2021,Warwick 012C,E01031317,726,566,365,201,3,3,17,4,13,140,126,14,0
2021,Warwick 012E,E01031319,889,634,317,317,4,4,69,10,59,182,159,23,0
2021,Warwick 012F,E01031320,604,398,222,176,0,0,100,40,60,106,100,6,0
2021,Warwick 011A,E01031321,498,200,80,120,1,1,247,242,5,47,41,6,3
2021,Warwick 011B,E01031322,877,558,258,300,4,4,118,92,26,192,181,11,5
2021,Warwick 011C,E01031323,830,484,286,198,7,7,116,104,12,221,193,28,2
2021,Warwick 011D,E01031324,1236,561,304,257,33,33,199,93,106,440,407,33,3
2021,Warwick 011E,E01031325,614,345,167,178,1,1,194,183,11,73,70,3,1
2021,Warwick 015A,E01031327,624,364,186,178,2,2,166,122,44,89,77,12,3
2021,Warwick 015B,E01031328,1178,852,392,460,22,22,133,26,107,171,154,17,0
2021,Warwick 015C,E01031329,986,692,327,365,6,6,96,19,77,192,173,19,0
2021,Warwick 015D,E01031330,606,471,226,245,1,1,43,41,2,90,79,11,1
2021,Warwick 015E,E01031331,778,626,335,291,10,10,38,7,31,104,91,13,0
2021,Warwick 010B,E01031332,498,219,122,97,16,16,154,116,38,107,94,13,2
2021,Warwick 010C,E01031333,478,272,174,98,12,12,47,8,39,147,137,10,0
2021,Warwick 010D,E01031334,660,439,211,228,10,10,98,14,84,112,99,13,1
2021,Warwick 010E,E01031335,614,277,135,142,7,7,29,7,22,301,292,9,0
2021,Warwick 010F,E01031336,809,280,109,171,0,0,83,24,59,446,433,13,0
2021,Warwick 010G,E01031337,851,480,183,297,42,42,151,34,117,178,168,10,0
2021,Adur 002A,E01031338,517,439,245,194,1,1,4,3,1,73,61,12,0
2021,Adur 002B,E01031339,509,425,222,203,2,2,5,3,2,77,68,9,0
2021,Adur 002C,E01031340,637,593,372,221,3,3,6,4,2,35,23,12,0
2021,Adur 008A,E01031341,654,332,186,146,3,3,201,174,27,116,107,9,2
2021,Adur 008B,E01031342,782,605,402,203,1,1,29,16,13,147,132,15,0
2021,Adur 008C,E01031343,624,498,285,213,4,4,11,7,4,111,95,16,0
2021,Adur 006A,E01031344,614,388,208,180,1,1,149,141,8,74,60,14,2
2021,Adur 003A,E01031345,652,568,308,260,2,2,29,27,2,52,42,10,1
2021,Adur 006B,E01031346,632,529,287,242,5,5,7,3,4,91,71,20,0
2021,Adur 004A,E01031347,649,341,175,166,0,0,206,159,47,102,92,10,0
2021,Adur 004B,E01031348,675,293,118,175,14,14,260,222,38,107,92,15,1
2021,Adur 001A,E01031349,555,483,278,205,2,2,33,25,8,36,25,11,1
2021,Adur 001B,E01031350,493,303,120,183,1,1,137,130,7,52,43,9,0
2021,Adur 001C,E01031351,646,565,305,260,3,3,30,28,2,48,41,7,0
2021,Adur 001D,E01031352,648,525,308,217,3,3,68,64,4,51,43,8,1
2021,Adur 003B,E01031353,461,393,244,149,0,0,2,0,2,66,34,32,0
2021,Adur 003C,E01031354,560,483,283,200,1,1,17,13,4,59,50,9,0
2021,Adur 003D,E01031355,708,546,257,289,2,2,97,60,37,59,48,11,4
2021,Adur 005A,E01031356,1053,827,439,388,14,14,34,10,24,177,166,11,1
2021,Adur 005B,E01031357,1026,728,410,318,3,3,38,15,23,257,230,27,0
2021,Adur 007A,E01031358,640,303,140,163,3,3,246,154,92,84,77,7,4
2021,Adur 003E,E01031359,531,422,201,221,5,5,18,11,7,86,75,11,0
2021,Adur 007B,E01031360,658,419,244,175,0,0,148,39,109,91,80,11,0
2021,Adur 006C,E01031361,616,360,185,175,1,1,206,169,37,46,39,7,3
2021,Adur 006D,E01031362,513,421,199,222,2,2,17,4,13,73,56,17,0
2021,Adur 006E,E01031363,739,578,382,196,1,1,79,69,10,79,66,13,2
2021,Adur 005C,E01031364,1005,484,278,206,49,49,160,72,88,312,292,20,0
2021,Adur 002D,E01031365,810,600,323,277,12,12,92,36,56,106,93,13,0
2021,Adur 004C,E01031366,490,266,120,146,5,5,158,100,58,61,54,7,0
2021,Adur 002E,E01031367,547,503,313,190,1,1,8,6,2,35,32,3,0
2021,Adur 005D,E01031368,642,487,268,219,10,10,77,70,7,67,57,10,1
2021,Adur 005E,E01031369,632,508,343,165,2,2,9,2,7,113,98,15,0
2021,Adur 001E,E01031370,564,392,218,174,1,1,122,112,10,48,37,11,1
2021,Adur 004D,E01031371,612,294,133,161,1,1,242,173,69,74,66,8,1
2021,Adur 004E,E01031372,625,396,208,188,12,12,172,66,106,45,34,11,0
2021,Adur 004F,E01031373,625,420,221,199,0,0,88,77,11,117,102,15,0
2021,Adur 001F,E01031374,702,537,280,257,1,1,10,5,5,154,136,18,0
2021,Adur 004G,E01031375,686,475,262,213,1,1,61,56,5,149,128,21,0
2021,Adur 007C,E01031376,646,523,364,159,3,3,6,6,0,114,98,16,0
2021,Adur 008D,E01031377,875,505,262,243,3,3,119,76,43,246,228,18,2
2021,Adur 007D,E01031378,665,548,310,238,4,4,24,20,4,88,72,16,1
2021,Adur 008E,E01031379,755,627,394,233,0,0,12,7,5,116,99,17,0
2021,Arun 018A,E01031380,752,671,524,147,0,0,5,2,3,76,65,11,0
2021,Arun 018B,E01031381,774,633,478,155,0,0,14,7,7,127,116,11,0
2021,Arun 018C,E01031382,803,710,525,185,2,2,5,0,5,86,72,14,0
2021,Arun 018D,E01031383,743,676,526,150,1,1,15,3,12,51,43,8,0
2021,Arun 018E,E01031384,777,688,485,203,0,0,10,5,5,78,66,12,1
2021,Arun 019A,E01031385,747,485,303,182,4,4,177,20,157,81,76,5,0
2021,Arun 002A,E01031386,613,441,249,192,7,7,75,65,10,90,78,12,0
2021,Arun 002B,E01031387,709,552,324,228,2,2,61,45,16,94,78,16,0
2021,Arun 005B,E01031389,942,839,552,287,5,5,23,2,21,75,56,19,0
2021,Arun 001A,E01031390,596,402,258,144,0,0,117,89,28,76,59,17,1
2021,Arun 001B,E01031391,722,566,348,218,0,0,32,18,14,124,106,18,0
2021,Arun 001C,E01031392,755,496,340,156,3,3,41,10,31,215,164,51,0
2021,Arun 003A,E01031393,1009,835,477,358,12,12,54,7,47,107,94,13,1
2021,Arun 003B,E01031394,694,450,205,245,6,6,117,88,29,118,102,16,3
2021,Arun 003C,E01031395,686,572,329,243,5,5,15,11,4,94,83,11,0
2021,Arun 003D,E01031396,991,749,358,391,27,27,102,59,43,110,100,10,3
2021,Arun 003E,E01031397,732,607,372,235,2,2,18,15,3,105,86,19,0
2021,Arun 009A,E01031398,603,484,306,178,5,5,30,13,17,83,70,13,1
2021,Arun 009B,E01031399,753,651,507,144,0,0,44,4,40,58,51,7,0
2021,Arun 011A,E01031400,826,455,298,157,3,3,41,15,26,327,301,26,0
2021,Arun 012B,E01031402,739,590,360,230,7,7,20,11,9,122,102,20,0
2021,Arun 012C,E01031403,644,428,230,198,5,5,80,61,19,130,116,14,1
2021,Arun 014A,E01031404,476,162,73,89,5,5,228,148,80,80,68,12,1
2021,Arun 012D,E01031405,649,517,297,220,9,9,18,2,16,105,95,10,0
2021,Arun 012E,E01031406,509,386,204,182,4,4,24,2,22,95,91,4,0
2021,Arun 007A,E01031407,622,459,227,232,8,8,66,6,60,89,80,9,0
2021,Arun 007B,E01031408,870,611,289,322,13,13,45,3,42,201,185,16,0
2021,Arun 009C,E01031409,520,341,176,165,3,3,101,87,14,71,54,17,4
2021,Arun 007C,E01031410,614,422,236,186,9,9,55,33,22,127,118,9,1
2021,Arun 010A,E01031411,664,546,434,112,2,2,92,13,79,24,19,5,0
2021,Arun 008A,E01031412,640,600,440,160,0,0,9,1,8,31,24,7,0
2021,Arun 010B,E01031413,687,554,402,152,1,1,11,2,9,121,100,21,0
2021,Arun 005C,E01031414,629,516,305,211,10,10,68,57,11,34,26,8,1
2021,Arun 005D,E01031415,800,564,405,159,6,6,150,76,74,80,68,12,0
2021,Arun 015A,E01031416,648,595,422,173,0,0,8,1,7,45,34,11,0
2021,Arun 013A,E01031417,710,568,318,250,7,7,19,10,9,116,101,15,0
2021,Arun 015B,E01031418,893,745,491,254,3,3,72,36,36,73,62,11,0
2021,Arun 015C,E01031419,765,542,376,166,4,4,22,8,14,197,171,26,0
2021,Arun 015D,E01031420,799,701,500,201,2,2,9,6,3,87,78,9,0
2021,Arun 008B,E01031422,786,692,543,149,2,2,5,2,3,87,72,15,0
2021,Arun 008C,E01031423,882,738,494,244,7,7,42,24,18,95,81,14,0
2021,Arun 008D,E01031424,698,617,478,139,2,2,5,4,1,73,63,10,1
2021,Arun 002C,E01031425,630,561,395,166,2,2,5,2,3,62,50,12,0
2021,Arun 002D,E01031426,540,374,223,151,4,4,74,68,6,88,70,18,0
2021,Arun 004A,E01031427,698,289,158,131,10,10,263,200,63,133,120,13,3
2021,Arun 011B,E01031428,653,362,166,196,12,12,49,12,37,230,213,17,0
2021,Arun 004B,E01031429,574,178,87,91,14,14,300,225,75,82,77,5,0
2021,Arun 004C,E01031430,624,406,246,160,10,10,72,46,26,136,120,16,0
2021,Arun 017A,E01031431,461,239,183,56,9,9,56,14,42,157,141,16,0
2021,Arun 017B,E01031432,968,331,220,111,13,13,90,28,62,533,506,27,1
2021,Arun 014B,E01031433,623,399,262,137,9,9,128,11,117,87,78,9,0
2021,Arun 014C,E01031434,716,376,194,182,6,6,90,55,35,241,226,15,3
2021,Arun 017C,E01031435,784,478,286,192,9,9,16,5,11,281,265,16,0
2021,Arun 017D,E01031436,1062,277,179,98,6,6,124,73,51,651,617,34,4
2021,Arun 017E,E01031437,1010,457,268,189,7,7,26,14,12,520,487,33,0
2021,Arun 013B,E01031438,727,474,279,195,5,5,85,64,21,159,145,14,4
2021,Arun 013C,E01031439,936,805,612,193,3,3,36,23,13,91,77,14,1
2021,Arun 013D,E01031440,770,671,491,180,1,1,8,5,3,90,71,19,0
2021,Arun 014D,E01031441,748,425,200,225,2,2,176,145,31,144,129,15,1
2021,Arun 014E,E01031442,676,406,203,203,1,1,40,7,33,229,207,22,0
2021,Arun 016A,E01031443,524,342,167,175,3,3,104,70,34,74,65,9,1
2021,Arun 016B,E01031444,666,328,174,154,2,2,68,12,56,268,251,17,0
2021,Arun 019B,E01031445,824,673,530,143,5,5,48,25,23,98,82,16,0
2021,Arun 019C,E01031446,620,553,366,187,1,1,5,4,1,61,55,6,0
2021,Arun 019D,E01031447,758,701,482,219,0,0,4,3,1,53,44,9,0
2021,Arun 019E,E01031448,762,657,451,206,0,0,8,4,4,97,84,13,0
2021,Arun 019F,E01031449,714,543,302,241,6,6,82,29,53,82,69,13,1
2021,Arun 016C,E01031450,563,194,71,123,7,7,232,172,60,128,110,18,2
2021,Arun 016D,E01031451,721,367,163,204,23,23,236,140,96,91,78,13,4
2021,Arun 016E,E01031452,544,386,189,197,2,2,51,3,48,105,93,12,0
2021,Arun 017F,E01031453,759,372,245,127,5,5,93,41,52,288,271,17,1
2021,Arun 011C,E01031454,1182,422,272,150,18,18,145,36,109,595,556,39,2
2021,Arun 009D,E01031455,718,501,340,161,7,7,87,35,52,123,102,21,0
2021,Arun 011D,E01031456,966,382,247,135,3,3,80,29,51,501,475,26,0
2021,Arun 010C,E01031457,956,685,542,143,10,10,93,26,67,166,136,30,2
2021,Arun 010D,E01031458,920,871,714,157,1,1,9,2,7,39,36,3,0
2021,Arun 005E,E01031459,828,454,242,212,16,16,210,151,59,147,138,9,1
2021,Arun 010E,E01031460,960,763,610,153,10,10,29,13,16,158,137,21,0
2021,Arun 009E,E01031461,854,752,533,219,2,2,7,6,1,93,87,6,0
2021,Arun 007D,E01031462,652,470,230,240,8,8,53,38,15,121,101,20,0
2021,Arun 007E,E01031463,658,576,352,224,2,2,11,4,7,69,59,10,0
2021,Arun 007F,E01031464,831,630,452,178,3,3,33,20,13,165,143,22,0
2021,Arun 001D,E01031465,568,434,270,164,5,5,39,12,27,89,73,16,1
2021,Arun 003F,E01031466,623,509,332,177,0,0,40,35,5,74,63,11,0
2021,Arun 009F,E01031469,771,560,339,221,3,3,78,23,55,130,116,14,0
2021,Arun 006A,E01031470,649,559,385,174,5,5,33,1,32,52,40,12,0
2021,Arun 006B,E01031471,866,649,303,346,44,44,90,1,89,83,71,12,0
2021,Arun 006C,E01031472,687,540,314,226,2,2,60,24,36,85,72,13,0
2021,Arun 006D,E01031473,524,304,172,132,7,7,151,112,39,59,50,9,3
2021,Chichester 011A,E01031474,647,433,276,157,6,6,99,14,85,109,96,13,0
2021,Chichester 009A,E01031475,716,564,308,256,13,13,63,5,58,76,62,14,0
2021,Chichester 009B,E01031476,719,562,417,145,2,2,29,4,25,125,110,15,1
2021,Chichester 006A,E01031477,1032,562,365,197,7,7,195,15,180,267,212,55,1
2021,Chichester 005A,E01031478,466,341,241,100,1,1,22,3,19,102,65,37,0
2021,Chichester 005B,E01031479,448,327,214,113,0,0,47,9,38,73,53,20,1
2021,Chichester 010A,E01031480,604,284,161,123,2,2,115,15,100,202,193,9,1
2021,Chichester 010B,E01031481,741,362,239,123,7,7,138,17,121,234,225,9,0
2021,Chichester 008A,E01031482,698,227,132,95,11,11,285,30,255,174,162,12,1
2021,Chichester 008B,E01031483,1006,237,128,109,25,25,513,67,446,230,207,23,1
2021,Chichester 010C,E01031484,938,441,320,121,6,6,219,24,195,271,256,15,1
2021,Chichester 006B,E01031485,683,601,443,158,4,4,8,0,8,70,59,11,0
2021,Chichester 008C,E01031486,839,467,360,107,7,7,48,6,42,316,285,31,1
2021,Chichester 006C,E01031487,683,553,430,123,2,2,42,6,36,85,80,5,1
2021,Chichester 012A,E01031489,653,493,304,189,3,3,58,9,49,99,92,7,0
2021,Chichester 010D,E01031490,1103,628,508,120,4,4,94,14,80,377,327,50,0
2021,Chichester 010E,E01031491,957,525,321,204,32,32,146,12,134,253,225,28,1
2021,Chichester 012B,E01031492,720,239,143,96,9,9,348,57,291,122,116,6,2
2021,Chichester 011B,E01031493,785,558,391,167,6,6,93,28,65,128,114,14,0
2021,Chichester 008E,E01031494,747,249,145,104,2,2,423,75,348,71,57,14,2
2021,Chichester 008F,E01031495,725,478,343,135,4,4,65,12,53,175,161,14,3
2021,Chichester 011C,E01031496,1104,814,506,308,15,15,86,1,85,189,165,24,0
2021,Chichester 004A,E01031497,744,536,300,236,3,3,103,15,88,102,80,22,0
2021,Chichester 005C,E01031498,464,265,177,88,0,0,33,5,28,166,127,39,0
2021,Chichester 013A,E01031499,776,476,296,180,12,12,142,9,133,146,126,20,0
2021,Chichester 013B,E01031500,977,748,483,265,23,23,82,4,78,124,100,24,0
2021,Chichester 013C,E01031501,708,476,339,137,1,1,66,12,54,165,146,19,0
2021,Chichester 001A,E01031502,590,507,235,272,1,1,20,2,18,62,51,11,0
2021,Chichester 001B,E01031503,570,424,209,215,2,2,74,19,55,69,51,18,1
2021,Chichester 001C,E01031504,935,622,380,242,20,20,197,22,175,96,76,20,0
2021,Chichester 011D,E01031505,1100,810,483,327,17,17,103,5,98,170,142,28,0
2021,Chichester 007A,E01031506,552,442,296,146,1,1,44,10,34,65,48,17,0
2021,Chichester 007B,E01031507,589,395,290,105,3,3,20,3,17,171,140,31,0
2021,Chichester 003A,E01031508,875,621,376,245,2,2,124,27,97,128,100,28,0
2021,Chichester 004C,E01031511,750,570,372,198,2,2,41,3,38,137,111,26,0
2021,Chichester 004D,E01031512,900,423,244,179,19,19,344,50,294,113,102,11,1
2021,Chichester 005D,E01031514,772,460,310,150,6,6,64,8,56,242,187,55,0
2021,Chichester 005E,E01031515,729,336,208,128,4,4,260,40,220,129,110,19,0
2021,Chichester 005F,E01031516,676,481,307,174,1,1,69,10,59,125,96,29,0
2021,Chichester 002A,E01031517,801,659,361,298,4,4,73,7,66,65,51,14,0
2021,Chichester 002B,E01031518,649,555,309,246,2,2,22,3,19,70,52,18,0
2021,Chichester 001D,E01031519,557,367,210,157,1,1,109,20,89,80,55,25,0
2021,Chichester 003B,E01031520,559,392,233,159,2,2,99,12,87,66,49,17,0
2021,Chichester 003C,E01031521,455,364,211,153,2,2,20,1,19,69,46,23,0
2021,Chichester 014A,E01031522,927,549,332,217,5,5,240,19,221,133,115,18,0
2021,Chichester 014B,E01031523,756,601,434,167,5,5,21,2,19,129,107,22,0
2021,Chichester 014C,E01031524,842,687,533,154,22,22,37,5,32,96,67,29,0
2021,Chichester 014D,E01031525,620,495,343,152,5,5,37,4,33,83,71,12,0
2021,Chichester 014E,E01031526,551,439,334,105,0,0,70,5,65,42,34,8,0
2021,Chichester 014F,E01031527,657,552,414,138,0,0,20,2,18,85,72,13,0
2021,Chichester 014G,E01031528,723,508,358,150,1,1,19,1,18,195,179,16,0
2021,Chichester 013D,E01031529,514,404,263,141,0,0,37,5,32,73,44,29,0
2021,Chichester 012D,E01031530,555,350,190,160,4,4,143,19,124,57,47,10,1
2021,Chichester 007C,E01031531,526,477,287,190,1,1,13,0,13,35,28,7,0
2021,Chichester 009C,E01031532,483,233,154,79,3,3,21,3,18,226,45,181,0
2021,Chichester 007D,E01031533,618,379,196,183,18,18,170,35,135,51,44,7,0
2021,Chichester 009D,E01031534,922,615,457,158,18,18,105,6,99,183,163,20,1
2021,Chichester 009E,E01031535,888,654,408,246,29,29,112,8,104,93,72,21,0
2021,Chichester 003D,E01031536,538,374,228,146,0,0,71,8,63,93,70,23,0
2021,Chichester 012E,E01031538,645,349,192,157,22,22,187,21,166,87,76,11,0
2021,Chichester 012F,E01031539,739,427,165,262,29,29,133,7,126,150,141,9,0
2021,Chichester 013E,E01031540,640,473,361,112,4,4,65,8,57,98,75,23,0
2021,Chichester 013F,E01031541,697,536,421,115,3,3,51,2,49,107,86,21,0
2021,Chichester 013G,E01031542,902,697,471,226,17,17,71,11,60,117,95,22,0
2021,Chichester 007E,E01031543,1057,719,423,296,13,13,169,46,123,154,127,27,2
2021,Chichester 002C,E01031544,546,366,221,145,9,9,71,6,65,100,75,25,0
2021,Chichester 002D,E01031545,539,411,241,170,2,2,70,7,63,56,42,14,0
2021,Crawley 012A,E01031546,483,275,101,174,5,5,91,87,4,111,102,9,1
2021,Crawley 010A,E01031547,506,245,81,164,16,16,179,165,14,64,60,4,2
2021,Crawley 010B,E01031548,675,258,84,174,5,5,283,255,28,123,118,5,6
2021,Crawley 010C,E01031549,618,284,83,201,13,13,218,194,24,101,91,10,2
2021,Crawley 010D,E01031550,520,263,95,168,5,5,168,162,6,82,78,4,2
2021,Crawley 012B,E01031551,497,287,91,196,2,2,96,88,8,111,107,4,1
2021,Crawley 013A,E01031552,748,293,138,155,14,14,269,79,190,169,162,7,3
2021,Crawley 012C,E01031553,496,210,65,145,9,9,220,204,16,56,56,0,1
2021,Crawley 012D,E01031554,703,385,125,260,4,4,116,106,10,198,184,14,0
2021,Crawley 012E,E01031555,485,240,96,144,0,0,161,157,4,83,77,6,1
2021,Crawley 013B,E01031556,640,260,88,172,12,12,294,196,98,73,67,6,1
2021,Crawley 013C,E01031557,923,509,179,330,13,13,91,39,52,310,305,5,0
2021,Crawley 013D,E01031558,620,96,31,65,1,1,491,169,322,29,27,2,3
2021,Crawley 013E,E01031559,515,260,90,170,3,3,166,151,15,85,74,11,1
2021,Crawley 009A,E01031560,624,474,290,184,1,1,79,64,15,69,62,7,1
2021,Crawley 009B,E01031561,592,442,249,193,6,6,77,72,5,67,61,6,0
2021,Crawley 009C,E01031562,578,228,122,106,1,1,259,253,6,82,77,5,8
2021,Crawley 009D,E01031563,564,439,235,204,13,13,44,21,23,68,63,5,0
2021,Crawley 006A,E01031564,608,432,228,204,0,0,86,81,5,88,79,9,2
2021,Crawley 006B,E01031565,849,462,180,282,3,3,276,268,8,105,85,20,3
2021,Crawley 006C,E01031566,655,468,257,211,3,3,110,82,28,71,68,3,3
2021,Crawley 006D,E01031567,511,368,195,173,1,1,77,72,5,64,52,12,1
2021,Crawley 006E,E01031568,640,388,115,273,13,13,93,59,34,144,135,9,2
2021,Crawley 010E,E01031569,630,336,148,188,2,2,221,210,11,70,59,11,1
2021,Crawley 003A,E01031570,514,350,166,184,3,3,101,99,2,59,51,8,1
2021,Crawley 003B,E01031571,674,369,149,220,11,11,205,187,18,86,74,12,3
2021,Crawley 003C,E01031572,865,484,202,282,37,37,246,209,37,91,81,10,7
2021,Crawley 001A,E01031573,657,300,110,190,4,4,233,184,49,118,108,10,2
2021,Crawley 001B,E01031574,662,412,173,239,18,18,128,57,71,102,92,10,2
2021,Crawley 001C,E01031575,627,289,140,149,6,6,215,99,116,116,95,21,1
2021,Crawley 001D,E01031576,612,279,135,144,3,3,218,182,36,107,98,9,5
2021,Crawley 001E,E01031577,457,269,143,126,1,1,55,53,2,130,121,9,2
2021,Crawley 008A,E01031578,734,538,219,319,2,2,12,4,8,182,173,9,0
2021,Crawley 009E,E01031579,683,325,101,224,7,7,153,116,37,197,190,7,1
2021,Crawley 008B,E01031580,860,628,230,398,20,20,64,12,52,148,137,11,0
2021,Crawley 008C,E01031581,611,522,197,325,0,0,5,3,2,84,77,7,0
2021,Crawley 009F,E01031582,769,482,147,335,3,3,25,7,18,259,248,11,0
2021,Crawley 004A,E01031583,965,298,127,171,22,22,232,153,79,409,385,24,4
2021,Crawley 004B,E01031584,661,369,175,194,3,3,156,153,3,130,118,12,3
2021,Crawley 004C,E01031585,1133,326,162,164,6,6,247,190,57,550,515,35,4
2021,Crawley 002A,E01031586,704,421,177,244,4,4,139,128,11,138,123,15,2
2021,Crawley 002C,E01031588,593,471,224,247,1,1,31,2,29,90,85,5,0
2021,Crawley 005A,E01031589,703,555,291,264,0,0,18,9,9,130,120,10,0
2021,Crawley 002D,E01031590,641,533,266,267,9,9,7,4,3,92,87,5,0
2021,Crawley 005B,E01031591,747,350,146,204,17,17,158,150,8,219,210,9,3
2021,Crawley 008D,E01031592,771,621,347,274,17,17,35,11,24,97,90,7,1
2021,Crawley 002E,E01031593,621,468,237,231,1,1,17,14,3,134,120,14,1
2021,Crawley 005C,E01031594,555,318,145,173,3,3,169,149,20,62,57,5,3
2021,Crawley 011A,E01031595,645,329,154,175,6,6,193,190,3,114,101,13,3
2021,Crawley 007A,E01031596,751,325,123,202,4,4,245,214,31,177,163,14,0
2021,Crawley 007B,E01031597,633,506,303,203,3,3,15,12,3,109,98,11,0
2021,Crawley 007C,E01031598,820,330,160,170,11,11,287,84,203,192,180,12,0
2021,Crawley 007D,E01031599,937,442,210,232,9,9,187,75,112,299,277,22,0
2021,Crawley 005D,E01031600,685,340,159,181,26,26,142,100,42,173,163,10,4
2021,Crawley 004D,E01031601,525,317,164,153,5,5,118,113,5,84,75,9,1
2021,Crawley 005E,E01031603,610,369,163,206,2,2,93,44,49,145,140,5,1
2021,Crawley 011B,E01031604,654,348,147,201,5,5,207,164,43,91,73,18,3
2021,Crawley 011C,E01031605,598,353,151,202,0,0,175,171,4,69,58,11,1
2021,Crawley 011D,E01031606,617,379,179,200,4,4,160,156,4,71,63,8,3
2021,Crawley 011E,E01031607,568,347,173,174,4,4,148,144,4,65,61,4,4
2021,Crawley 007E,E01031608,1077,500,158,342,34,34,287,170,117,254,240,14,2
2021,Crawley 003D,E01031609,686,298,140,158,6,6,286,252,34,93,76,17,3
2021,Crawley 003E,E01031610,799,321,136,185,15,15,250,241,9,210,197,13,3
2021,Horsham 010A,E01031611,1152,764,387,377,62,62,99,7,92,227,190,37,0
2021,Horsham 010B,E01031612,889,686,347,339,6,6,98,24,74,99,86,13,0
2021,Horsham 010D,E01031614,1085,610,257,353,41,41,286,28,258,148,131,17,0
2021,Horsham 010E,E01031615,793,632,356,276,4,4,77,4,73,80,66,14,0
2021,Horsham 016A,E01031616,697,501,280,221,7,7,71,7,64,118,108,10,0
2021,Horsham 016B,E01031617,1013,854,549,305,2,2,38,8,30,119,92,27,0
2021,Horsham 014A,E01031618,561,457,260,197,2,2,26,2,24,76,63,13,0
2021,Horsham 003A,E01031620,867,549,237,312,35,35,182,22,160,101,90,11,0
2021,Horsham 012A,E01031621,812,783,601,182,0,0,6,1,5,23,21,2,0
2021,Horsham 015A,E01031622,658,515,270,245,3,3,13,0,13,127,108,19,0
2021,Horsham 012B,E01031623,767,644,424,220,10,10,56,8,48,55,44,11,2
2021,Horsham 015B,E01031624,672,530,310,220,8,8,70,7,63,64,53,11,0
2021,Horsham 015C,E01031625,759,618,318,300,40,40,37,0,37,64,55,9,0
2021,Horsham 013A,E01031626,711,536,337,199,10,10,66,7,59,99,71,28,0
2021,Horsham 012C,E01031627,836,753,499,254,4,4,21,2,19,58,53,5,0
2021,Horsham 015D,E01031628,689,447,218,229,28,28,126,25,101,88,69,19,0
2021,Horsham 015E,E01031629,652,552,343,209,0,0,34,7,27,66,48,18,0
2021,Horsham 013B,E01031630,863,642,454,188,4,4,86,8,78,129,110,19,2
2021,Horsham 013C,E01031631,843,418,261,157,5,5,325,41,284,94,81,13,1
2021,Horsham 011A,E01031632,666,531,312,219,2,2,14,0,14,119,90,29,0
2021,Horsham 011B,E01031633,512,439,277,162,0,0,28,0,28,45,34,11,0
2021,Horsham 011C,E01031634,530,371,178,193,2,2,82,6,76,75,58,17,0
2021,Horsham 011D,E01031635,549,449,235,214,4,4,32,6,26,64,57,7,0
2021,Horsham 007C,E01031638,771,598,301,297,4,4,35,3,32,134,126,8,0
2021,Horsham 008A,E01031639,880,656,374,282,6,6,56,9,47,161,149,12,1
2021,Horsham 008B,E01031640,716,669,407,262,3,3,5,0,5,39,33,6,0
2021,Horsham 014B,E01031641,756,611,437,174,4,4,27,1,26,113,102,11,1
2021,Horsham 014C,E01031642,1069,789,436,353,52,52,107,7,100,121,103,18,0
2021,Horsham 014D,E01031643,842,464,272,192,12,12,276,26,250,90,74,16,0
2021,Horsham 002A,E01031644,772,584,271,313,33,33,52,6,46,103,93,10,0
2021,Horsham 002B,E01031645,547,438,212,226,3,3,9,0,9,97,90,7,0
2021,Horsham 002C,E01031646,603,452,241,211,13,13,49,2,47,89,85,4,0
2021,Horsham 002D,E01031647,464,297,138,159,4,4,114,7,107,49,46,3,0
2021,Horsham 003B,E01031648,743,478,273,205,2,2,74,8,66,188,177,11,1
2021,Horsham 002E,E01031649,451,387,193,194,4,4,7,0,7,53,50,3,0
2021,Horsham 002F,E01031650,500,442,228,214,2,2,4,0,4,52,42,10,0
2021,Horsham 003C,E01031651,652,409,194,215,4,4,153,29,124,86,79,7,0
2021,Horsham 006B,E01031652,626,287,126,161,6,6,267,24,243,65,53,12,1
2021,Horsham 006C,E01031653,891,522,266,256,3,3,77,14,63,286,262,24,3
2021,Horsham 004A,E01031654,651,540,311,229,0,0,63,5,58,48,42,6,0
2021,Horsham 004B,E01031655,659,474,204,270,3,3,47,6,41,135,117,18,0
2021,Horsham 006D,E01031656,960,431,196,235,24,24,252,28,224,253,240,13,0
2021,Horsham 005A,E01031657,754,542,288,254,6,6,124,16,108,82,56,26,0
2021,Horsham 003D,E01031658,894,636,391,245,7,7,121,11,110,130,97,33,0
2021,Horsham 005B,E01031659,642,548,298,250,9,9,29,3,26,56,43,13,0
2021,Horsham 008C,E01031660,567,500,316,184,5,5,4,1,3,58,40,18,0
2021,Horsham 008D,E01031661,671,510,289,221,6,6,63,7,56,92,72,20,0
2021,Horsham 013D,E01031662,720,520,315,205,0,0,66,10,56,133,122,11,1
2021,Horsham 013E,E01031663,962,549,257,292,29,29,274,40,234,110,94,16,0
2021,Horsham 012D,E01031664,690,571,369,202,2,2,36,2,34,81,52,29,0
2021,Horsham 013F,E01031665,564,426,263,163,5,5,60,6,54,73,63,10,0
2021,Horsham 002G,E01031666,644,605,361,244,0,0,3,0,3,36,30,6,0
2021,Horsham 004C,E01031667,652,484,258,226,2,2,116,15,101,48,40,8,2
2021,Horsham 002H,E01031668,652,553,339,214,3,3,48,6,42,47,41,6,1
2021,Horsham 004D,E01031669,719,440,211,229,6,6,166,18,148,107,102,5,0
2021,Horsham 001A,E01031670,714,483,253,230,5,5,31,2,29,194,177,17,1
2021,Horsham 001B,E01031671,789,422,194,228,0,0,289,19,270,77,71,6,1
2021,Horsham 004E,E01031672,976,568,284,284,15,15,28,3,25,363,320,43,2
2021,Horsham 001C,E01031673,641,429,207,222,4,4,131,16,115,77,69,8,0
2021,Horsham 005C,E01031674,548,425,259,166,6,6,30,1,29,87,68,19,0
2021,Horsham 005D,E01031675,616,505,266,239,10,10,44,5,39,57,37,20,0
2021,Horsham 009A,E01031677,662,488,259,229,10,10,121,17,104,43,36,7,0
2021,Horsham 009B,E01031678,681,592,278,314,10,10,43,4,39,36,29,7,0
2021,Horsham 008E,E01031679,523,328,184,144,9,9,30,0,30,156,83,73,0
2021,Horsham 009C,E01031680,571,529,248,281,4,4,13,2,11,25,22,3,0
2021,Horsham 009D,E01031681,762,527,274,253,72,72,91,4,87,71,62,9,1
2021,Horsham 009E,E01031682,463,385,150,235,4,4,8,1,7,66,58,8,0
2021,Horsham 009F,E01031683,632,457,208,249,21,21,67,7,60,86,74,12,1
2021,Horsham 016C,E01031684,629,547,340,207,1,1,12,1,11,69,60,9,0
2021,Horsham 016D,E01031685,847,640,438,202,8,8,19,2,17,180,160,20,0
2021,Horsham 016E,E01031686,634,571,406,165,1,1,14,1,13,48,41,7,0
2021,Horsham 014E,E01031687,668,372,208,164,12,12,199,24,175,85,66,19,0
2021,Horsham 006E,E01031688,617,389,208,181,4,4,177,22,155,44,36,8,3
2021,Horsham 003E,E01031689,658,484,240,244,0,0,15,1,14,159,144,15,0
2021,Horsham 007D,E01031690,634,590,374,216,0,0,4,0,4,40,31,9,0
2021,Horsham 006F,E01031691,807,573,313,260,3,3,79,4,75,152,139,13,0
2021,Mid Sussex 007B,E01031693,761,469,240,229,2,2,88,3,85,202,154,48,0
2021,Mid Sussex 006A,E01031694,684,480,268,212,4,4,107,3,104,93,70,23,0
2021,Mid Sussex 003A,E01031695,556,480,264,216,3,3,2,0,2,71,60,11,0
2021,Mid Sussex 003B,E01031696,569,435,239,196,3,3,73,6,67,57,49,8,1
2021,Mid Sussex 007C,E01031697,472,356,193,163,1,1,42,1,41,73,52,21,0
2021,Mid Sussex 016A,E01031698,660,519,264,255,1,1,49,4,45,91,74,17,0
2021,Mid Sussex 012A,E01031699,675,529,246,283,9,9,9,0,9,128,123,5,0
2021,Mid Sussex 012B,E01031700,602,519,215,304,3,3,3,0,3,77,70,7,0
2021,Mid Sussex 012C,E01031701,775,543,224,319,14,14,116,6,110,102,94,8,0
2021,Mid Sussex 015A,E01031702,635,560,325,235,8,8,27,2,25,40,35,5,0
2021,Mid Sussex 015B,E01031703,677,599,384,215,11,11,19,4,15,48,37,11,0
2021,Mid Sussex 013A,E01031704,750,555,283,272,14,14,60,3,57,121,110,11,0
2021,Mid Sussex 014A,E01031705,663,352,137,215,14,14,205,13,192,92,78,14,0
2021,Mid Sussex 013B,E01031706,691,592,363,229,1,1,33,2,31,65,60,5,0
2021,Mid Sussex 014B,E01031707,673,553,330,223,3,3,85,7,78,32,23,9,0
2021,Mid Sussex 014C,E01031708,806,373,178,195,2,2,92,11,81,339,321,18,0
2021,Mid Sussex 014D,E01031709,897,543,331,212,2,2,180,17,163,172,150,22,0
2021,Mid Sussex 015C,E01031710,591,551,306,245,4,4,6,0,6,30,24,6,0
2021,Mid Sussex 013D,E01031712,644,427,186,241,7,7,143,6,137,67,56,11,0
2021,Mid Sussex 013E,E01031713,690,593,331,262,11,11,31,2,29,55,49,6,0
2021,Mid Sussex 012D,E01031714,727,520,215,305,25,25,101,4,97,81,74,7,0
2021,Mid Sussex 015D,E01031715,673,558,265,293,5,5,16,1,15,94,86,8,0
2021,Mid Sussex 014E,E01031716,457,251,118,133,5,5,159,4,155,42,33,9,0
2021,Mid Sussex 014F,E01031717,574,448,176,272,4,4,12,1,11,110,99,11,0
2021,Mid Sussex 002A,E01031718,718,613,303,310,2,2,11,0,11,92,83,9,0
2021,Mid Sussex 002B,E01031719,724,553,265,288,14,14,56,3,53,101,90,11,0
2021,Mid Sussex 002C,E01031720,536,480,272,208,0,0,5,0,5,51,43,8,0
2021,Mid Sussex 005A,E01031721,855,680,427,253,22,22,105,6,99,48,38,10,0
2021,Mid Sussex 002D,E01031722,496,295,126,169,7,7,72,4,68,122,81,41,0
2021,Mid Sussex 005B,E01031723,649,524,287,237,13,13,54,2,52,58,48,10,0
2021,Mid Sussex 005C,E01031724,506,463,240,223,7,7,4,1,3,32,25,7,0
2021,Mid Sussex 005D,E01031725,599,521,284,237,1,1,37,2,35,40,35,5,0
2021,Mid Sussex 011A,E01031726,677,444,200,244,9,9,131,5,126,93,88,5,0
2021,Mid Sussex 007D,E01031727,661,528,288,240,0,0,9,1,8,124,109,15,0
2021,Mid Sussex 003C,E01031729,856,743,406,337,14,14,45,3,42,54,47,7,0
2021,Mid Sussex 003D,E01031730,763,524,219,305,17,17,17,0,17,205,191,14,0
2021,Mid Sussex 001A,E01031731,824,421,196,225,7,7,326,26,300,70,59,11,0
2021,Mid Sussex 001B,E01031732,682,415,213,202,3,3,174,11,163,90,84,6,0
2021,Mid Sussex 001C,E01031733,759,533,237,296,4,4,83,8,75,139,126,13,0
2021,Mid Sussex 001D,E01031734,609,550,295,255,3,3,11,8,3,45,36,9,0
2021,Mid Sussex 003E,E01031735,669,582,335,247,6,6,6,0,6,75,67,8,0
2021,Mid Sussex 004A,E01031736,621,556,326,230,1,1,9,0,9,55,47,8,0
2021,Mid Sussex 004B,E01031737,601,471,210,261,3,3,71,8,63,56,50,6,0
2021,Mid Sussex 004C,E01031738,609,550,298,252,6,6,22,3,19,31,23,8,0
2021,Mid Sussex 004D,E01031739,833,655,372,283,5,5,34,3,31,139,127,12,0
2021,Mid Sussex 004E,E01031740,559,483,269,214,2,2,14,2,12,60,47,13,0
2021,Mid Sussex 001E,E01031741,1025,610,287,323,13,13,70,7,63,332,310,22,0
2021,Mid Sussex 001G,E01031743,831,372,175,197,16,16,222,24,198,221,210,11,0
2021,Mid Sussex 017A,E01031744,696,633,325,308,9,9,16,1,15,38,25,13,0
2021,Mid Sussex 017B,E01031745,857,707,411,296,10,10,65,1,64,75,65,10,0
2021,Mid Sussex 017C,E01031746,736,396,204,192,6,6,201,12,189,133,120,13,0
2021,Mid Sussex 017D,E01031747,704,611,373,238,4,4,24,1,23,65,55,10,0
2021,Mid Sussex 017E,E01031748,585,506,298,208,0,0,6,0,6,73,64,9,0
2021,Mid Sussex 011C,E01031749,619,503,253,250,9,9,18,5,13,89,79,10,0
2021,Mid Sussex 011D,E01031750,646,352,171,181,14,14,199,20,179,81,78,3,0
2021,Mid Sussex 009A,E01031751,1184,712,330,382,16,16,90,9,81,366,346,20,0
2021,Mid Sussex 010A,E01031752,725,268,105,163,13,13,361,30,331,83,75,8,0
2021,Mid Sussex 010B,E01031753,588,407,205,202,12,12,85,10,75,84,82,2,0
2021,Mid Sussex 010C,E01031754,683,483,225,258,11,11,65,6,59,124,112,12,0
2021,Mid Sussex 010D,E01031755,597,447,196,251,5,5,40,5,35,105,96,9,0
2021,Mid Sussex 010E,E01031757,689,346,164,182,8,8,252,7,245,83,75,8,0
2021,Mid Sussex 008A,E01031758,525,484,259,225,2,2,7,1,6,32,26,6,0
2021,Mid Sussex 009B,E01031759,781,520,266,254,2,2,62,1,61,197,184,13,0
2021,Mid Sussex 008B,E01031760,719,558,279,279,5,5,26,1,25,130,122,8,0
2021,Mid Sussex 011F,E01031763,807,683,358,325,20,20,23,2,21,81,74,7,0
2021,Mid Sussex 006B,E01031764,564,444,232,212,2,2,61,3,58,57,40,17,0
2021,Mid Sussex 006C,E01031765,647,491,266,225,1,1,57,1,56,98,77,21,0
2021,Mid Sussex 006D,E01031766,836,674,362,312,3,3,40,4,36,119,89,30,0
2021,Mid Sussex 016B,E01031767,761,600,280,320,22,22,68,7,61,71,42,29,0
2021,Mid Sussex 017F,E01031768,677,606,374,232,5,5,23,0,23,43,40,3,0
2021,Mid Sussex 016C,E01031769,705,496,219,277,7,7,125,4,121,77,65,12,0
2021,Mid Sussex 016D,E01031770,721,486,280,206,2,2,59,4,55,174,141,33,0
2021,Mid Sussex 016E,E01031771,614,341,162,179,9,9,211,11,200,53,44,9,0
2021,Mid Sussex 008C,E01031772,867,576,311,265,14,14,167,16,151,110,90,20,0
2021,Mid Sussex 008D,E01031773,814,709,417,292,1,1,13,1,12,91,81,10,0
2021,Mid Sussex 008E,E01031774,975,844,430,414,21,21,51,5,46,59,47,12,0
2021,Mid Sussex 008F,E01031775,756,628,364,264,1,1,24,1,23,103,90,13,0
2021,Worthing 005A,E01031776,669,508,217,291,11,11,12,2,10,138,126,12,0
2021,Worthing 005B,E01031777,792,510,238,272,12,12,38,9,29,232,222,10,0
2021,Worthing 004A,E01031778,652,518,254,264,0,0,6,2,4,128,117,11,0
2021,Worthing 009A,E01031779,518,239,116,123,0,0,210,67,143,68,59,9,1
2021,Worthing 005C,E01031780,547,486,224,262,2,2,6,1,5,53,44,9,0
2021,Worthing 005D,E01031781,616,498,226,272,2,2,45,5,40,71,61,10,0
2021,Worthing 007A,E01031782,787,661,436,225,1,1,64,21,43,60,47,13,1
2021,Worthing 006A,E01031783,615,293,138,155,1,1,268,84,184,53,44,9,0
2021,Worthing 006B,E01031785,643,465,241,224,2,2,51,3,48,125,114,11,0
2021,Worthing 006C,E01031786,633,411,198,213,4,4,106,36,70,111,95,16,1
2021,Worthing 011A,E01031787,1158,429,279,150,8,8,98,11,87,623,593,30,0
2021,Worthing 011B,E01031788,1024,535,261,274,12,12,116,22,94,361,333,28,0
2021,Worthing 010A,E01031790,995,362,206,156,7,7,216,47,169,409,389,20,1
2021,Worthing 008A,E01031791,1017,410,153,257,10,10,258,42,216,339,318,21,0
2021,Worthing 003A,E01031792,622,490,274,216,0,0,70,12,58,62,55,7,0
2021,Worthing 001A,E01031793,601,552,354,198,5,5,2,1,1,42,34,8,0
2021,Worthing 003B,E01031794,713,506,321,185,11,11,131,10,121,65,59,6,0
2021,Worthing 003C,E01031795,686,362,158,204,1,1,162,20,142,161,145,16,0
2021,Worthing 008B,E01031796,688,428,176,252,2,2,59,14,45,199,186,13,0
2021,Worthing 004B,E01031797,505,463,241,222,3,3,3,0,3,36,35,1,0
2021,Worthing 005E,E01031798,681,447,188,259,1,1,57,8,49,176,161,15,0
2021,Worthing 008C,E01031799,667,424,207,217,3,3,114,27,87,126,111,15,0
2021,Worthing 004C,E01031800,622,532,261,271,3,3,7,2,5,80,68,12,0
2021,Worthing 008D,E01031801,807,485,212,273,4,4,28,6,22,290,270,20,0
2021,Worthing 013A,E01031802,871,735,574,161,1,1,23,9,14,112,98,14,0
2021,Worthing 013B,E01031803,656,601,393,208,1,1,5,0,5,49,40,9,0
2021,Worthing 013C,E01031804,737,673,464,209,1,1,6,1,5,57,44,13,0
2021,Worthing 013D,E01031805,822,716,521,195,0,0,14,2,12,92,76,16,0
2021,Worthing 013E,E01031806,751,437,198,239,5,5,142,47,95,166,148,18,1
2021,Worthing 010B,E01031807,902,505,320,185,3,3,110,14,96,282,265,17,2
2021,Worthing 011D,E01031808,991,315,175,140,6,6,134,13,121,534,509,25,2
2021,Worthing 010C,E01031809,1065,630,422,208,8,8,36,8,28,391,368,23,0
2021,Worthing 010D,E01031810,868,421,210,211,7,7,50,18,32,390,372,18,0
2021,Worthing 010E,E01031811,697,334,171,163,0,0,77,10,67,285,268,17,1
2021,Worthing 012A,E01031812,815,589,393,196,5,5,28,7,21,193,174,19,0
2021,Worthing 012B,E01031813,799,516,278,238,1,1,61,16,45,221,198,23,0
2021,Worthing 012C,E01031814,833,667,410,257,11,11,7,1,6,148,132,16,0
2021,Worthing 012D,E01031815,784,603,415,188,2,2,16,3,13,163,134,29,0
2021,Worthing 012E,E01031816,658,544,232,312,1,1,8,2,6,105,98,7,0
2021,Worthing 006D,E01031817,713,451,177,274,10,10,130,18,112,121,111,10,1
2021,Worthing 003D,E01031818,772,517,259,258,0,0,128,26,102,127,113,14,0
2021,Worthing 001B,E01031820,798,748,525,223,0,0,8,2,6,42,32,10,0
2021,Worthing 001C,E01031821,776,640,357,283,1,1,49,18,31,86,79,7,0
2021,Worthing 002A,E01031822,654,575,330,245,1,1,7,2,5,71,60,11,0
2021,Worthing 004D,E01031823,577,540,265,275,0,0,5,0,5,32,31,1,0
2021,Worthing 004E,E01031824,503,453,247,206,1,1,6,0,6,43,39,4,0
2021,Worthing 002B,E01031825,783,629,410,219,2,2,78,9,69,74,61,13,0
2021,Worthing 002C,E01031826,613,461,230,231,1,1,61,21,40,90,76,14,0
2021,Worthing 002D,E01031827,656,464,269,195,0,0,96,16,80,96,84,12,0
2021,Worthing 001D,E01031828,554,530,338,192,0,0,0,0,0,24,21,3,0
2021,Worthing 001E,E01031829,635,596,382,214,2,2,3,0,3,34,30,4,0
2021,Worthing 003E,E01031830,660,424,231,193,3,3,162,62,100,71,61,10,0
2021,Worthing 009B,E01031831,667,452,220,232,3,3,23,4,19,189,177,12,0
2021,Worthing 009C,E01031832,806,540,323,217,5,5,119,31,88,142,128,14,0
2021,Worthing 009D,E01031833,674,365,160,205,2,2,86,29,57,221,197,24,0
2021,Worthing 009E,E01031834,637,434,207,227,4,4,99,28,71,99,83,16,1
2021,Worthing 011E,E01031835,995,470,235,235,1,1,51,6,45,473,447,26,0
2021,Worthing 007C,E01031836,729,417,183,234,3,3,192,52,140,117,106,11,0
2021,Worthing 008E,E01031837,779,561,230,331,0,0,5,0,5,213,197,16,0
2021,Worthing 007D,E01031838,667,521,289,232,2,2,19,4,15,125,110,15,0
2021,Worthing 002E,E01031839,725,505,239,266,4,4,87,8,79,129,123,6,0
2021,Worthing 007E,E01031840,756,619,322,297,0,0,20,4,16,117,107,10,0
2021,Wiltshire 012A,E01031841,797,576,341,235,2,2,112,22,90,107,85,22,0
2021,Wiltshire 038A,E01031842,810,618,385,233,4,4,86,16,70,102,89,13,0
2021,Wiltshire 029A,E01031843,797,510,312,198,10,10,134,16,118,143,117,26,0
2021,Wiltshire 028A,E01031845,729,563,362,201,5,5,68,10,58,93,68,25,0
2021,Wiltshire 028B,E01031846,704,455,237,218,7,7,157,16,141,82,65,17,3
2021,Wiltshire 029B,E01031847,795,573,314,259,21,21,98,10,88,103,85,18,0
2021,Wiltshire 028C,E01031848,731,573,347,226,4,4,90,8,82,64,38,26,0
2021,Wiltshire 029C,E01031849,689,485,254,231,7,7,85,12,73,112,78,34,0
2021,Wiltshire 025A,E01031850,990,564,337,227,40,40,229,59,170,157,131,26,0
2021,Wiltshire 025B,E01031851,647,311,169,142,4,4,246,30,216,86,74,12,0
2021,Wiltshire 025C,E01031852,856,662,360,302,4,4,61,12,49,129,87,42,0
2021,Wiltshire 026A,E01031853,717,425,288,137,5,5,221,37,184,65,53,12,1
2021,Wiltshire 026B,E01031854,1066,476,332,144,6,6,351,37,314,233,213,20,0
2021,Wiltshire 026C,E01031855,663,572,392,180,2,2,45,4,41,44,34,10,0
2021,Wiltshire 026D,E01031856,778,393,263,130,3,3,282,34,248,100,88,12,0
2021,Wiltshire 034B,E01031857,638,410,219,191,5,5,160,17,143,63,50,13,0
2021,Wiltshire 034C,E01031858,709,589,352,237,2,2,24,5,19,94,70,24,0
2021,Wiltshire 065B,E01031859,747,327,177,150,6,6,258,44,214,156,144,12,0
2021,Wiltshire 065A,E01031860,652,406,217,189,0,0,146,24,122,100,82,18,0
2021,Wiltshire 019A,E01031861,1166,802,507,295,22,22,209,40,169,132,113,19,1
2021,Wiltshire 019B,E01031862,704,300,177,123,1,1,307,49,258,96,83,13,0
2021,Wiltshire 019C,E01031863,577,317,237,80,2,2,64,6,58,194,151,43,0
2021,Wiltshire 019D,E01031864,517,429,279,150,1,1,16,3,13,71,47,24,0
2021,Wiltshire 019E,E01031865,713,451,327,124,16,16,126,20,106,119,90,29,1
2021,Wiltshire 024A,E01031866,699,496,303,193,7,7,57,7,50,139,96,43,0
2021,Wiltshire 038B,E01031867,798,530,292,238,4,4,143,12,131,121,83,38,0
2021,Wiltshire 012B,E01031868,721,451,268,183,9,9,72,7,65,189,137,52,0
2021,Wiltshire 024B,E01031869,894,463,280,183,13,13,331,53,278,85,61,24,2
2021,Wiltshire 024C,E01031870,899,680,454,226,2,2,35,9,26,181,156,25,1
2021,Wiltshire 024D,E01031871,724,515,303,212,1,1,76,8,68,132,100,32,0
2021,Wiltshire 028D,E01031872,670,457,282,175,5,5,151,15,136,57,46,11,0
2021,Wiltshire 012C,E01031873,768,492,286,206,7,7,114,5,109,155,102,53,0
2021,Wiltshire 012D,E01031874,667,459,293,166,3,3,123,9,114,81,61,20,1
2021,Wiltshire 028E,E01031876,668,511,325,186,3,3,75,10,65,79,55,24,0
2021,Wiltshire 029D,E01031877,815,561,331,230,10,10,78,12,66,166,100,66,0
2021,Wiltshire 066A,E01031879,540,88,18,70,0,0,95,23,72,356,59,297,1
2021,Wiltshire 038C,E01031882,834,521,332,189,2,2,106,15,91,205,78,127,0
2021,Wiltshire 034D,E01031883,863,664,429,235,10,10,107,13,94,82,60,22,0
2021,Wiltshire 012E,E01031884,670,466,300,166,3,3,68,7,61,132,92,40,1
2021,Wiltshire 002A,E01031885,709,505,281,224,7,7,65,6,59,132,107,25,0
2021,Wiltshire 004A,E01031886,582,498,309,189,2,2,30,4,26,52,32,20,0
2021,Wiltshire 001A,E01031887,744,613,374,239,10,10,62,8,54,59,52,7,0
2021,Wiltshire 017A,E01031888,590,479,272,207,3,3,30,4,26,78,63,15,0
2021,Wiltshire 017B,E01031889,1026,628,248,380,29,29,167,19,148,202,101,101,0
2021,Wiltshire 017C,E01031890,753,606,381,225,13,13,56,8,48,78,64,14,0
2021,Wiltshire 004B,E01031892,589,453,271,182,2,2,53,7,46,81,56,25,0
2021,Wiltshire 004C,E01031893,664,568,333,235,5,5,22,5,17,69,52,17,0
2021,Wiltshire 004D,E01031894,635,515,312,203,4,4,24,6,18,91,67,24,1
2021,Wiltshire 015A,E01031895,1032,654,283,371,33,33,256,30,226,89,71,18,0
2021,Wiltshire 015B,E01031896,684,269,116,153,20,20,306,43,263,89,81,8,0
2021,Wiltshire 015C,E01031897,844,626,297,329,4,4,74,12,62,140,120,20,0
2021,Wiltshire 015D,E01031898,644,421,213,208,8,8,89,11,78,126,112,14,0
2021,Wiltshire 016B,E01031901,659,368,197,171,15,15,165,17,148,111,95,16,0
2021,Wiltshire 016C,E01031902,760,541,207,334,29,29,113,11,102,77,66,11,0
2021,Wiltshire 016D,E01031903,1003,835,446,389,5,5,35,5,30,127,111,16,1
2021,Wiltshire 013B,E01031904,1044,761,400,361,25,25,102,15,87,156,129,27,0
2021,Wiltshire 010A,E01031905,501,473,247,226,0,0,5,0,5,22,17,5,1
2021,Wiltshire 010B,E01031906,645,437,191,246,2,2,11,5,6,195,181,14,0
2021,Wiltshire 009A,E01031907,937,753,348,405,3,3,7,3,4,174,158,16,0
2021,Wiltshire 010C,E01031908,737,404,190,214,25,25,182,25,157,126,109,17,0
2021,Wiltshire 010D,E01031909,527,440,279,161,2,2,50,11,39,35,29,6,0
2021,Wiltshire 009B,E01031910,646,447,200,247,6,6,88,3,85,105,86,19,0
2021,Wiltshire 011A,E01031911,563,241,95,146,11,11,235,26,209,75,62,13,1
2021,Wiltshire 011B,E01031912,904,355,236,119,6,6,219,21,198,324,299,25,0
2021,Wiltshire 011C,E01031913,653,521,277,244,6,6,28,3,25,98,85,13,0
2021,Wiltshire 009C,E01031914,508,191,103,88,3,3,262,31,231,52,42,10,0
2021,Wiltshire 009D,E01031915,702,543,277,266,3,3,45,2,43,110,98,12,1
2021,Wiltshire 014A,E01031916,554,367,186,181,5,5,122,13,109,60,46,14,0
2021,Wiltshire 011D,E01031917,706,301,142,159,13,13,199,13,186,192,176,16,1
2021,Wiltshire 011E,E01031918,1163,865,587,278,20,20,107,14,93,171,141,30,0
2021,Wiltshire 009E,E01031919,609,521,286,235,4,4,45,1,44,39,29,10,0
2021,Wiltshire 009F,E01031920,538,384,187,197,5,5,17,0,17,132,120,12,0
2021,Wiltshire 014B,E01031921,540,434,222,212,2,2,17,1,16,87,78,9,0
2021,Wiltshire 014C,E01031922,600,390,189,201,2,2,12,7,5,196,181,15,0
2021,Wiltshire 014D,E01031923,534,426,211,215,4,4,14,3,11,90,82,8,0
2021,Wiltshire 014E,E01031924,667,485,206,279,7,7,39,2,37,136,125,11,0
2021,Wiltshire 010E,E01031925,578,312,153,159,16,16,198,32,166,49,43,6,3
2021,Wiltshire 010F,E01031926,623,457,219,238,4,4,82,11,71,79,64,15,1
2021,Wiltshire 010G,E01031927,501,455,277,178,2,2,3,1,2,41,34,7,0
2021,Wiltshire 011F,E01031928,602,232,119,113,3,3,309,24,285,54,40,14,4
2021,Wiltshire 017D,E01031929,564,459,296,163,3,3,42,11,31,60,44,16,0
2021,Wiltshire 017E,E01031930,450,230,103,127,2,2,31,3,28,187,32,155,0
2021,Wiltshire 018A,E01031931,845,684,377,307,11,11,58,26,32,92,73,19,0
2021,Wiltshire 018B,E01031932,716,528,334,194,9,9,110,8,102,69,55,14,0
2021,Wiltshire 018C,E01031933,700,428,225,203,8,8,179,25,154,84,71,13,1
2021,Wiltshire 001B,E01031934,785,682,419,263,7,7,26,3,23,70,56,14,0
2021,Wiltshire 001C,E01031935,756,619,373,246,4,4,21,2,19,111,95,16,1
2021,Wiltshire 001D,E01031936,656,355,215,140,37,37,191,28,163,73,62,11,0
2021,Wiltshire 013C,E01031937,468,328,203,125,10,10,59,4,55,71,59,12,0
2021,Wiltshire 013D,E01031938,637,539,240,299,0,0,29,4,25,69,50,19,0
2021,Wiltshire 008A,E01031939,970,787,432,355,8,8,86,11,75,89,69,20,0
2021,Wiltshire 008B,E01031940,945,724,460,264,7,7,69,6,63,145,120,25,0
2021,Wiltshire 018D,E01031941,714,566,340,226,5,5,54,5,49,88,61,27,1
2021,Wiltshire 018E,E01031942,534,350,212,138,2,2,80,7,73,102,69,33,0
2021,Wiltshire 007B,E01031944,462,325,173,152,3,3,28,8,20,106,86,20,0
2021,Wiltshire 007D,E01031946,467,103,26,77,3,3,49,9,40,312,57,255,0
2021,Wiltshire 002B,E01031947,748,374,227,147,6,6,291,25,266,77,66,11,0
2021,Wiltshire 002C,E01031948,1034,710,349,361,22,22,94,6,88,208,186,22,0
2021,Wiltshire 002D,E01031949,866,570,341,229,1,1,45,6,39,250,227,23,0
2021,Wiltshire 008C,E01031950,567,457,254,203,1,1,17,3,14,92,57,35,0
2021,Wiltshire 008D,E01031951,470,328,193,135,3,3,52,6,46,87,40,47,0
2021,Wiltshire 018F,E01031952,1140,531,280,251,12,12,349,52,297,247,211,36,1
2021,Wiltshire 003B,E01031955,661,590,346,244,0,0,13,3,10,56,42,14,2
2021,Wiltshire 003C,E01031956,566,338,183,155,2,2,150,17,133,76,65,11,0
2021,Wiltshire 005A,E01031957,632,453,267,186,9,9,68,11,57,101,88,13,1
2021,Wiltshire 005B,E01031958,593,463,286,177,5,5,14,3,11,111,87,24,0
2021,Wiltshire 005C,E01031959,828,644,389,255,3,3,49,12,37,132,104,28,0
2021,Wiltshire 005D,E01031960,572,339,194,145,6,6,56,6,50,171,52,119,0
2021,Wiltshire 007E,E01031961,565,463,272,191,2,2,28,5,23,72,55,17,0
2021,Wiltshire 003D,E01031962,570,523,315,208,0,0,17,1,16,30,21,9,0
2021,Wiltshire 006A,E01031963,859,409,200,209,12,12,330,39,291,106,88,18,2
2021,Wiltshire 006B,E01031964,886,670,390,280,10,10,38,2,36,168,149,19,0
2021,Wiltshire 007F,E01031965,629,503,327,176,0,0,49,6,43,77,67,10,0
2021,Wiltshire 007G,E01031966,1121,841,378,463,33,33,122,12,110,125,108,17,0
2021,Wiltshire 006C,E01031967,1011,584,290,294,22,22,185,31,154,220,204,16,0
2021,Wiltshire 007H,E01031968,757,608,361,247,7,7,38,5,33,104,87,17,0
2021,Wiltshire 006D,E01031969,589,501,278,223,1,1,9,3,6,78,73,5,0
2021,Wiltshire 060A,E01031970,708,567,332,235,14,14,7,4,3,120,99,21,0
2021,Wiltshire 060B,E01031971,513,357,194,163,3,3,72,59,13,81,68,13,0
2021,Wiltshire 060C,E01031972,624,510,310,200,1,1,60,37,23,53,36,17,0
2021,Wiltshire 062A,E01031973,730,642,401,241,1,1,6,3,3,81,68,13,0
2021,Wiltshire 048A,E01031974,608,478,325,153,2,2,60,25,35,67,50,17,1
2021,Wiltshire 048B,E01031975,530,226,144,82,1,1,259,244,15,41,34,7,3
2021,Wiltshire 048C,E01031976,869,427,113,314,45,45,172,32,140,225,124,101,0
2021,Wiltshire 048E,E01031978,683,416,203,213,14,14,146,21,125,107,95,12,0
2021,Wiltshire 048F,E01031979,951,584,345,239,15,15,147,90,57,204,176,28,1
2021,Wiltshire 052A,E01031980,1029,602,174,428,70,70,252,126,126,105,93,12,0
2021,Wiltshire 052B,E01031981,609,252,128,124,4,4,293,258,35,59,41,18,1
2021,Wiltshire 052C,E01031982,575,375,213,162,4,4,141,115,26,54,42,12,1
2021,Wiltshire 052D,E01031983,786,277,122,155,7,7,423,283,140,78,67,11,1
2021,Wiltshire 051A,E01031984,1096,763,326,437,44,44,170,8,162,119,106,13,0
2021,Wiltshire 051B,E01031985,529,319,170,149,3,3,135,75,60,72,60,12,0
2021,Wiltshire 051C,E01031986,601,309,179,130,1,1,213,193,20,75,65,10,3
2021,Wiltshire 045B,E01031988,735,78,20,58,2,2,58,9,49,597,67,530,0
2021,Wiltshire 046A,E01031989,756,304,160,144,0,0,150,125,25,296,72,224,6
2021,Wiltshire 054A,E01031990,825,553,339,214,5,5,91,51,40,176,136,40,0
2021,Wiltshire 061A,E01031991,850,593,413,180,2,2,85,76,9,170,129,41,0
2021,Wiltshire 062B,E01031992,626,526,354,172,2,2,5,1,4,93,68,25,0
2021,Wiltshire 062C,E01031993,631,474,267,207,6,6,101,89,12,47,36,11,3
2021,Wiltshire 062D,E01031994,526,382,245,137,2,2,88,66,22,53,49,4,1
2021,Wiltshire 062E,E01031995,841,605,339,266,21,21,46,17,29,169,138,31,0
2021,Wiltshire 046B,E01031996,584,329,173,156,3,3,191,147,44,59,51,8,2
2021,Wiltshire 046C,E01031997,593,462,234,228,0,0,24,9,15,107,100,7,0
2021,Wiltshire 046D,E01031999,953,630,334,296,10,10,80,21,59,233,105,128,0
2021,Wiltshire 057A,E01032000,906,575,355,220,7,7,91,44,47,233,146,87,0
2021,Wiltshire 055A,E01032001,625,485,275,210,6,6,31,4,27,103,92,11,0
2021,Wiltshire 055B,E01032002,608,383,191,192,3,3,72,26,46,150,136,14,0
2021,Wiltshire 055C,E01032003,875,423,222,201,57,57,102,50,52,293,254,39,0
2021,Wiltshire 054B,E01032004,1029,663,433,230,8,8,134,97,37,222,180,42,2
2021,Wiltshire 059A,E01032005,532,419,262,157,1,1,41,7,34,71,60,11,0
2021,Wiltshire 059B,E01032006,494,391,240,151,1,1,6,0,6,96,68,28,0
2021,Wiltshire 059C,E01032007,701,364,166,198,41,41,160,33,127,136,127,9,0
2021,Wiltshire 058A,E01032008,666,387,228,159,0,0,222,193,29,53,38,15,4
2021,Wiltshire 058B,E01032009,860,686,460,226,4,4,67,7,60,103,87,16,0
2021,Wiltshire 050A,E01032010,939,674,454,220,1,1,95,70,25,168,125,43,1
2021,Wiltshire 057C,E01032012,764,703,487,216,2,2,9,5,4,50,29,21,0
2021,Wiltshire 049A,E01032013,845,504,319,185,0,0,136,114,22,204,158,46,1
2021,Wiltshire 056A,E01032014,1021,486,353,133,8,8,133,35,98,394,356,38,0
2021,Wiltshire 056B,E01032015,578,301,155,146,3,3,113,97,16,160,139,21,1
2021,Wiltshire 056C,E01032016,620,410,245,165,2,2,30,17,13,177,158,19,1
2021,Wiltshire 051D,E01032017,619,564,347,217,2,2,9,1,8,44,35,9,0
2021,Wiltshire 053A,E01032018,635,552,328,224,0,0,30,19,11,53,42,11,0
2021,Wiltshire 053B,E01032019,644,331,184,147,14,14,240,161,79,56,40,16,3
2021,Wiltshire 053C,E01032020,624,470,274,196,3,3,64,60,4,87,72,15,0
2021,Wiltshire 056D,E01032021,741,458,246,212,13,13,25,4,21,245,227,18,0
2021,Wiltshire 058C,E01032022,982,424,310,114,5,5,153,45,108,399,334,65,1
2021,Wiltshire 059D,E01032023,825,257,168,89,15,15,370,233,137,179,146,33,4
2021,Wiltshire 055D,E01032024,1145,606,286,320,12,12,135,29,106,392,365,27,0
2021,Wiltshire 053D,E01032025,647,457,282,175,5,5,86,75,11,99,80,19,0
2021,Wiltshire 045D,E01032026,703,549,323,226,6,6,45,33,12,102,75,27,1
2021,Wiltshire 054C,E01032027,626,457,290,167,5,5,50,41,9,110,83,27,4
2021,Wiltshire 061B,E01032029,615,469,322,147,3,3,38,29,9,105,90,15,0
2021,Wiltshire 061C,E01032030,807,445,305,140,17,17,219,135,84,124,108,16,2
2021,Wiltshire 061D,E01032031,513,386,260,126,1,1,55,52,3,70,52,18,1
2021,Wiltshire 049B,E01032032,679,587,370,217,5,5,18,16,2,69,46,23,0
2021,Wiltshire 049C,E01032033,586,464,255,209,3,3,50,40,10,68,51,17,1
2021,Wiltshire 049D,E01032034,602,454,278,176,1,1,53,43,10,93,41,52,1
2021,Wiltshire 050B,E01032035,752,621,424,197,14,14,26,17,9,91,69,22,0
2021,Wiltshire 050C,E01032036,647,402,282,120,3,3,99,55,44,143,111,32,0
2021,Wiltshire 050D,E01032037,737,402,266,136,7,7,196,150,46,129,116,13,3
2021,Wiltshire 054D,E01032038,644,429,283,146,6,6,83,48,35,126,75,51,0
2021,Wiltshire 054E,E01032039,1016,588,288,300,22,22,154,59,95,252,206,46,0
2021,Wiltshire 054F,E01032040,615,375,217,158,3,3,151,140,11,84,73,11,2
2021,Wiltshire 060D,E01032041,813,728,456,272,7,7,14,6,8,64,48,16,0
2021,Wiltshire 060E,E01032042,701,580,321,259,1,1,43,25,18,76,56,20,1
2021,Wiltshire 021A,E01032043,528,402,262,140,0,0,58,2,56,68,52,16,0
2021,Wiltshire 021B,E01032044,620,514,319,195,3,3,52,6,46,51,38,13,0
2021,Wiltshire 027A,E01032045,702,600,369,231,7,7,39,4,35,56,49,7,0
2021,Wiltshire 027B,E01032046,705,502,291,211,0,0,124,19,105,79,63,16,0
2021,Wiltshire 027C,E01032047,645,509,322,187,1,1,86,11,75,49,42,7,0
2021,Wiltshire 027D,E01032048,760,440,265,175,2,2,253,26,227,65,56,9,0
2021,Wiltshire 027E,E01032049,737,569,402,167,4,4,94,17,77,70,62,8,0
2021,Wiltshire 047A,E01032051,591,478,313,165,1,1,28,7,21,84,64,20,0
2021,Wiltshire 039A,E01032052,578,494,330,164,4,4,15,7,8,65,50,15,0
2021,Wiltshire 037A,E01032053,612,526,318,208,2,2,20,4,16,64,46,18,0
2021,Wiltshire 039B,E01032054,535,353,197,156,0,0,105,11,94,77,55,22,0
2021,Wiltshire 039C,E01032055,532,480,329,151,3,3,10,0,10,39,28,11,0
2021,Wiltshire 039D,E01032056,555,402,233,169,1,1,85,10,75,67,50,17,0
2021,Wiltshire 021C,E01032057,504,428,243,185,1,1,24,0,24,51,40,11,0
2021,Wiltshire 023A,E01032058,610,426,255,171,0,0,100,13,87,84,67,17,0
2021,Wiltshire 023B,E01032059,767,618,390,228,1,1,46,9,37,102,82,20,0
2021,Wiltshire 023C,E01032060,688,564,363,201,2,2,55,7,48,66,49,17,1
2021,Wiltshire 023D,E01032061,516,418,270,148,1,1,67,6,61,29,24,5,1
2021,Wiltshire 022A,E01032062,880,340,184,156,5,5,314,32,282,220,198,22,1
2021,Wiltshire 020A,E01032063,939,689,333,356,11,11,138,12,126,100,86,14,1
2021,Wiltshire 020B,E01032064,520,233,107,126,3,3,237,35,202,46,41,5,1
2021,Wiltshire 020C,E01032065,662,496,282,214,0,0,93,16,77,73,60,13,0
2021,Wiltshire 022B,E01032066,702,440,204,236,0,0,171,20,151,88,77,11,3
2021,Wiltshire 022C,E01032067,655,521,334,187,0,0,42,2,40,92,73,19,0
2021,Wiltshire 022D,E01032068,728,502,330,172,8,8,86,15,71,132,114,18,0
2021,Wiltshire 022E,E01032069,510,438,256,182,1,1,19,4,15,52,43,9,0
2021,Wiltshire 021D,E01032070,821,510,268,242,11,11,235,18,217,65,50,15,0
2021,Wiltshire 021F,E01032072,762,605,278,327,1,1,45,2,43,111,94,17,0
2021,Wiltshire 020D,E01032073,591,456,223,233,3,3,14,1,13,118,107,11,0
2021,Wiltshire 020E,E01032074,604,519,357,162,0,0,34,8,26,51,39,12,0
2021,Wiltshire 047B,E01032075,602,427,266,161,3,3,94,7,87,78,52,26,0
2021,Wiltshire 047C,E01032076,539,335,219,116,0,0,68,8,60,136,108,28,0
2021,Wiltshire 030A,E01032077,760,601,353,248,1,1,53,5,48,105,89,16,0
2021,Wiltshire 030B,E01032078,1192,752,340,412,2,2,222,40,182,216,192,24,0
2021,Wiltshire 030C,E01032079,644,508,291,217,2,2,74,8,66,60,52,8,0
2021,Wiltshire 030D,E01032080,710,583,253,330,3,3,34,4,30,90,77,13,0
2021,Wiltshire 047D,E01032081,549,319,227,92,2,2,23,2,21,205,168,37,0
2021,Wiltshire 047E,E01032082,530,415,263,152,3,3,33,3,30,79,61,18,0
2021,Wiltshire 037B,E01032083,1023,808,486,322,8,8,84,13,71,123,97,26,0
2021,Wiltshire 031A,E01032085,700,546,266,280,1,1,10,1,9,143,124,19,0
2021,Wiltshire 031C,E01032087,986,672,410,262,4,4,132,25,107,177,152,25,1
2021,Wiltshire 036A,E01032088,624,542,318,224,4,4,8,2,6,70,58,12,0
2021,Wiltshire 036B,E01032089,673,409,154,255,1,1,15,3,12,248,215,33,0
2021,Wiltshire 036C,E01032090,650,419,221,198,7,7,143,21,122,80,67,13,1
2021,Wiltshire 036D,E01032091,545,389,221,168,3,3,45,12,33,108,98,10,0
2021,Wiltshire 035A,E01032092,677,532,306,226,4,4,18,2,16,123,107,16,0
2021,Wiltshire 035B,E01032093,1002,526,230,296,13,13,365,84,281,96,74,22,2
2021,Wiltshire 035C,E01032094,1041,502,199,303,20,20,272,48,224,244,214,30,3
2021,Wiltshire 035D,E01032095,732,588,296,292,16,16,24,3,21,104,94,10,0
2021,Wiltshire 033A,E01032096,790,246,119,127,1,1,463,71,392,79,62,17,1
2021,Wiltshire 033B,E01032097,768,685,408,277,3,3,2,0,2,78,56,22,0
2021,Wiltshire 033C,E01032098,632,522,298,224,1,1,42,3,39,67,57,10,0
2021,Wiltshire 032B,E01032100,775,601,346,255,3,3,36,4,32,135,118,17,0
2021,Wiltshire 032C,E01032101,849,429,246,183,4,4,176,12,164,240,220,20,0
2021,Wiltshire 032D,E01032102,1023,822,433,389,10,10,93,15,78,98,85,13,0
2021,Wiltshire 044A,E01032103,928,494,320,174,6,6,108,12,96,319,293,26,1
2021,Wiltshire 042A,E01032104,561,215,125,90,0,0,306,35,271,40,33,7,0
2021,Wiltshire 042B,E01032105,672,583,397,186,2,2,9,2,7,78,62,16,0
2021,Wiltshire 044B,E01032106,638,558,370,188,5,5,19,6,13,56,40,16,0
2021,Wiltshire 042C,E01032107,427,46,15,31,2,2,36,7,29,343,70,273,0
2021,Wiltshire 042D,E01032108,625,460,317,143,3,3,32,3,29,130,89,41,0
2021,Wiltshire 044C,E01032109,688,439,242,197,2,2,148,17,131,99,85,14,0
2021,Wiltshire 043A,E01032110,1001,778,439,339,14,14,113,12,101,94,77,17,2
2021,Wiltshire 043B,E01032111,578,362,213,149,10,10,151,17,134,54,45,9,1
2021,Wiltshire 043C,E01032112,625,465,232,233,2,2,23,3,20,135,121,14,0
2021,Wiltshire 043D,E01032113,603,381,194,187,2,2,154,19,135,66,58,8,0
2021,Wiltshire 044D,E01032114,696,415,268,147,3,3,95,10,85,182,146,36,1
2021,Wiltshire 064A,E01032115,829,436,222,214,3,3,172,15,157,218,198,20,0
2021,Wiltshire 063D,E01032117,1078,763,341,422,7,7,171,17,154,137,114,23,0
2021,Wiltshire 063C,E01032118,618,280,115,165,11,11,284,32,252,43,36,7,0
2021,Wiltshire 064B,E01032119,971,571,291,280,0,0,60,5,55,340,313,27,0
2021,Wiltshire 039E,E01032121,865,710,347,363,11,11,33,3,30,110,89,21,1
2021,Bromsgrove 009A,E01032122,883,712,395,317,17,17,57,20,37,97,71,26,0
2021,Bromsgrove 009B,E01032123,664,591,385,206,2,2,13,4,9,58,40,18,0
2021,Bromsgrove 009C,E01032124,728,487,279,208,4,4,145,42,103,90,82,8,2
2021,Bromsgrove 009D,E01032125,606,526,301,225,1,1,50,18,32,29,28,1,0
2021,Bromsgrove 003A,E01032126,849,730,433,297,6,6,78,29,49,34,28,6,1
2021,Bromsgrove 007A,E01032127,767,586,309,277,10,10,63,18,45,108,92,16,0
2021,Bromsgrove 007B,E01032128,654,457,265,192,11,11,97,38,59,87,72,15,2
2021,Bromsgrove 007C,E01032129,537,328,140,188,10,10,161,48,113,38,29,9,0
2021,Bromsgrove 013B,E01032131,642,294,159,135,1,1,283,120,163,62,54,8,2
2021,Bromsgrove 013C,E01032132,930,462,244,218,8,8,368,148,220,92,84,8,0
2021,Bromsgrove 004A,E01032133,737,423,256,167,3,3,244,81,163,67,57,10,0
2021,Bromsgrove 005A,E01032134,631,558,342,216,5,5,6,3,3,62,43,19,0
2021,Bromsgrove 004B,E01032135,636,583,347,236,3,3,2,1,1,48,40,8,0
2021,Bromsgrove 002A,E01032136,526,468,288,180,2,2,5,2,3,51,44,7,0
2021,Bromsgrove 002B,E01032137,665,504,286,218,6,6,66,20,46,89,71,18,0
2021,Bromsgrove 001A,E01032138,632,573,322,251,0,0,15,1,14,44,40,4,0
2021,Bromsgrove 001B,E01032139,915,751,368,383,33,33,31,1,30,100,85,15,0
2021,Bromsgrove 001C,E01032140,729,604,327,277,1,1,34,13,21,90,85,5,0
2021,Bromsgrove 001D,E01032141,601,513,286,227,4,4,16,4,12,68,58,10,0
2021,Bromsgrove 006A,E01032142,931,820,342,478,22,22,35,7,28,54,47,7,0
2021,Bromsgrove 006B,E01032143,626,565,280,285,14,14,21,5,16,26,17,9,0
2021,Bromsgrove 006C,E01032144,860,722,428,294,6,6,26,5,21,106,86,20,0
2021,Bromsgrove 004C,E01032145,623,578,327,251,2,2,6,2,4,37,32,5,0
2021,Bromsgrove 005B,E01032146,668,608,365,243,0,0,21,12,9,39,35,4,0
2021,Bromsgrove 004D,E01032147,561,429,283,146,0,0,92,28,64,38,31,7,2
2021,Bromsgrove 008A,E01032148,457,400,235,165,2,2,7,5,2,48,41,7,0
2021,Bromsgrove 006D,E01032149,497,465,261,204,0,0,4,1,3,28,14,14,0
2021,Bromsgrove 008B,E01032150,617,566,333,233,2,2,5,2,3,44,34,10,0
2021,Bromsgrove 008C,E01032151,574,531,284,247,0,0,5,2,3,38,29,9,0
2021,Bromsgrove 007D,E01032152,628,368,204,164,15,15,174,44,130,70,56,14,1
2021,Bromsgrove 008D,E01032153,925,632,246,386,34,34,174,54,120,85,70,15,0
2021,Bromsgrove 010A,E01032154,678,578,265,313,1,1,6,0,6,93,83,10,0
2021,Bromsgrove 008E,E01032155,657,612,322,290,4,4,5,0,5,36,28,8,0
2021,Bromsgrove 011A,E01032156,882,443,259,184,16,16,159,45,114,264,234,30,0
2021,Bromsgrove 011B,E01032157,1043,521,395,126,6,6,329,113,216,185,159,26,2
2021,Bromsgrove 012A,E01032158,655,600,386,214,1,1,12,4,8,42,38,4,0
2021,Bromsgrove 010B,E01032159,864,553,306,247,24,24,196,62,134,91,78,13,0
2021,Bromsgrove 010C,E01032160,799,615,336,279,0,0,65,11,54,119,110,9,0
2021,Bromsgrove 010D,E01032161,817,363,171,192,42,42,331,140,191,81,68,13,0
2021,Bromsgrove 012B,E01032162,761,665,342,323,2,2,44,13,31,49,43,6,1
2021,Bromsgrove 002C,E01032168,475,381,234,147,2,2,67,21,46,25,21,4,0
2021,Bromsgrove 002D,E01032169,498,433,272,161,1,1,11,10,1,53,31,22,0
2021,Bromsgrove 003B,E01032170,558,443,210,233,14,14,28,2,26,73,67,6,0
2021,Bromsgrove 003C,E01032171,610,570,343,227,0,0,11,1,10,29,27,2,0
2021,Bromsgrove 003D,E01032172,674,493,275,218,1,1,55,17,38,124,114,10,1
2021,Bromsgrove 011C,E01032173,670,583,296,287,2,2,19,6,13,63,51,12,3
2021,Bromsgrove 013D,E01032174,672,450,224,226,1,1,136,53,83,85,76,9,0
2021,Bromsgrove 011D,E01032175,684,556,322,234,6,6,78,16,62,43,37,6,1
2021,Bromsgrove 002E,E01032176,921,785,488,297,0,0,38,13,25,98,69,29,0
2021,Bromsgrove 005C,E01032177,727,581,265,316,33,33,68,8,60,45,38,7,0
2021,Bromsgrove 005D,E01032178,550,518,354,164,4,4,5,2,3,23,14,9,0
2021,Malvern Hills 003A,E01032179,711,550,381,169,8,8,78,14,64,75,54,21,0
2021,Malvern Hills 003B,E01032180,880,694,415,279,11,11,88,14,74,87,76,11,0
2021,Malvern Hills 002A,E01032181,913,713,468,245,6,6,59,7,52,134,98,36,1
2021,Malvern Hills 003C,E01032182,967,811,466,345,17,17,55,7,48,84,62,22,0
2021,Malvern Hills 003D,E01032183,633,538,306,232,3,3,29,6,23,63,47,16,0
2021,Malvern Hills 009A,E01032184,773,602,453,149,4,4,70,11,59,97,74,23,0
2021,Malvern Hills 009B,E01032185,694,576,436,140,18,18,59,8,51,41,36,5,0
2021,Malvern Hills 009C,E01032186,556,358,232,126,5,5,47,6,41,146,136,10,0
2021,Malvern Hills 009D,E01032187,783,386,237,149,20,20,304,62,242,72,63,9,1
2021,Malvern Hills 006A,E01032188,801,505,276,229,12,12,180,18,162,104,92,12,0
2021,Malvern Hills 006B,E01032189,1174,841,449,392,45,45,163,23,140,125,103,22,0
2021,Malvern Hills 002B,E01032190,890,666,414,252,18,18,111,12,99,95,73,22,0
2021,Malvern Hills 008A,E01032191,1191,908,496,412,18,18,135,27,108,130,106,24,0
2021,Malvern Hills 008B,E01032192,915,690,386,304,6,6,160,24,136,59,49,10,0
2021,Malvern Hills 001A,E01032193,959,762,493,269,9,9,71,5,66,117,94,23,0
2021,Malvern Hills 004A,E01032194,731,378,260,118,28,28,257,37,220,68,55,13,0
2021,Malvern Hills 004B,E01032195,743,555,359,196,8,8,46,10,36,133,122,11,1
2021,Malvern Hills 004C,E01032196,797,532,362,170,2,2,119,14,105,143,123,20,1
2021,Malvern Hills 004D,E01032197,762,522,356,166,6,6,89,7,82,145,133,12,0
2021,Malvern Hills 011A,E01032198,869,691,470,221,2,2,39,3,36,137,112,25,0
2021,Malvern Hills 002C,E01032199,837,612,371,241,1,1,113,15,98,111,94,17,0
2021,Malvern Hills 011B,E01032200,1017,789,513,276,19,19,103,16,87,106,85,21,0
2021,Malvern Hills 007A,E01032201,689,398,264,134,51,51,197,37,160,42,37,5,1
2021,Malvern Hills 007B,E01032202,738,299,172,127,11,11,354,81,273,73,67,6,1
2021,Malvern Hills 007C,E01032203,695,410,243,167,16,16,208,21,187,61,53,8,0
2021,Malvern Hills 007D,E01032204,673,123,73,50,11,11,489,98,391,50,42,8,0
2021,Malvern Hills 005A,E01032205,463,333,239,94,4,4,45,3,42,80,64,16,1
2021,Malvern Hills 005B,E01032206,569,450,293,157,5,5,48,6,42,66,58,8,0
2021,Malvern Hills 005C,E01032207,771,628,308,320,5,5,79,14,65,59,48,11,0
2021,Malvern Hills 010A,E01032208,810,509,385,124,4,4,27,5,22,270,250,20,0
2021,Malvern Hills 010B,E01032209,647,419,340,79,3,3,13,0,13,212,181,31,0
2021,Malvern Hills 010C,E01032210,528,362,243,119,2,2,95,3,92,69,63,6,0
2021,Malvern Hills 008C,E01032211,839,710,465,245,2,2,52,7,45,74,53,21,1
2021,Malvern Hills 001B,E01032212,893,683,421,262,5,5,75,12,63,130,99,31,0
2021,Malvern Hills 001C,E01032213,748,585,403,182,10,10,56,7,49,97,71,26,0
2021,Malvern Hills 001D,E01032214,1053,580,415,165,5,5,238,17,221,230,204,26,0
2021,Malvern Hills 011C,E01032215,536,303,208,95,2,2,199,23,176,31,22,9,1
2021,Malvern Hills 011D,E01032216,811,518,337,181,5,5,94,16,78,194,165,29,0
2021,Malvern Hills 005D,E01032217,698,526,360,166,7,7,68,11,57,97,82,15,0
2021,Malvern Hills 010D,E01032218,660,524,334,190,6,6,47,6,41,83,73,10,0
2021,Malvern Hills 010E,E01032219,776,652,427,225,7,7,18,3,15,99,86,13,0
2021,Malvern Hills 006C,E01032220,659,499,300,199,7,7,39,5,34,114,98,16,0
2021,Malvern Hills 006D,E01032221,557,448,274,174,1,1,35,4,31,73,64,9,0
2021,Malvern Hills 006E,E01032222,604,400,208,192,8,8,102,23,79,93,73,20,1
2021,Malvern Hills 002D,E01032223,885,734,442,292,10,10,52,6,46,89,62,27,0
2021,Redditch 004A,E01032224,774,332,159,173,13,13,125,73,52,303,285,18,1
2021,Redditch 004B,E01032225,496,163,69,94,1,1,259,231,28,72,69,3,1
2021,Redditch 001A,E01032226,1129,787,359,428,50,50,160,21,139,132,115,17,0
2021,Redditch 001B,E01032227,464,446,280,166,0,0,7,6,1,11,10,1,0
2021,Redditch 013A,E01032228,546,458,265,193,6,6,22,15,7,60,53,7,0
2021,Redditch 013B,E01032229,625,384,192,192,0,0,124,78,46,117,104,13,0
2021,Redditch 013C,E01032230,602,509,260,249,0,0,51,32,19,42,37,5,0
2021,Redditch 013D,E01032231,817,598,312,286,4,4,66,49,17,149,130,19,0
2021,Redditch 003A,E01032232,750,239,110,129,3,3,437,294,143,71,60,11,0
2021,Redditch 003C,E01032234,772,320,129,191,0,0,336,270,66,111,101,10,5
2021,Redditch 003D,E01032235,719,323,152,171,0,0,321,314,7,67,51,16,8
2021,Redditch 006A,E01032236,822,352,162,190,4,4,209,143,66,255,236,19,2
2021,Redditch 006B,E01032237,607,494,258,236,1,1,33,26,7,77,69,8,2
2021,Redditch 006C,E01032238,562,381,196,185,2,2,24,10,14,155,143,12,0
2021,Redditch 004C,E01032239,682,261,97,164,1,1,132,39,93,285,270,15,3
2021,Redditch 002A,E01032240,550,251,107,144,1,1,197,157,40,98,86,12,3
2021,Redditch 002B,E01032241,498,218,78,140,3,3,196,180,16,81,73,8,0
2021,Redditch 002C,E01032242,590,362,140,222,1,1,126,118,8,98,82,16,3
2021,Redditch 001C,E01032243,571,533,344,189,1,1,10,4,6,27,23,4,0
2021,Redditch 001D,E01032244,629,386,194,192,17,17,152,92,60,74,69,5,0
2021,Redditch 002D,E01032245,682,182,69,113,2,2,389,277,112,105,94,11,4
2021,Redditch 012A,E01032246,560,496,262,234,5,5,14,8,6,43,30,13,2
2021,Redditch 012B,E01032247,634,406,194,212,0,0,129,120,9,96,84,12,3
2021,Redditch 012C,E01032248,533,508,265,243,0,0,14,3,11,11,11,0,0
2021,Redditch 012D,E01032249,690,497,224,273,3,3,35,30,5,154,141,13,1
2021,Redditch 010A,E01032250,508,202,85,117,0,0,198,170,28,107,99,8,1
2021,Redditch 010B,E01032251,705,352,142,210,14,14,200,134,66,138,131,7,1
2021,Redditch 010C,E01032252,545,165,64,101,1,1,274,248,26,102,100,2,3
2021,Redditch 009A,E01032253,643,531,226,305,26,26,45,20,25,41,30,11,0
2021,Redditch 010D,E01032254,845,567,218,349,10,10,168,115,53,100,89,11,0
2021,Redditch 007A,E01032255,548,445,211,234,0,0,40,22,18,61,53,8,2
2021,Redditch 011A,E01032256,627,395,212,183,1,1,147,106,41,80,71,9,4
2021,Redditch 011B,E01032257,571,516,265,251,1,1,27,3,24,27,24,3,0
2021,Redditch 011C,E01032258,703,477,250,227,2,2,89,71,18,133,123,10,2
2021,Redditch 008A,E01032259,612,490,279,211,0,0,40,18,22,80,70,10,2
2021,Redditch 011D,E01032260,699,206,88,118,0,0,380,196,184,112,103,9,1
2021,Redditch 012E,E01032261,579,523,296,227,1,1,11,9,2,44,40,4,0
2021,Redditch 004D,E01032262,840,334,133,201,2,2,314,249,65,182,168,14,8
2021,Redditch 007B,E01032263,716,534,287,247,7,7,87,56,31,85,80,5,3
2021,Redditch 006D,E01032264,645,436,197,239,0,0,97,88,9,112,100,12,0
2021,Redditch 009B,E01032265,639,314,129,185,0,0,231,214,17,92,83,9,2
2021,Redditch 007C,E01032266,716,540,293,247,2,2,71,20,51,103,90,13,0
2021,Redditch 009C,E01032267,667,364,157,207,22,22,180,153,27,99,85,14,2
2021,Redditch 009D,E01032268,485,434,246,188,2,2,18,13,5,31,24,7,0
2021,Redditch 008B,E01032269,759,517,282,235,0,0,107,78,29,135,127,8,0
2021,Redditch 008C,E01032270,572,511,258,253,1,1,11,8,3,49,39,10,0
2021,Redditch 008D,E01032271,795,641,249,392,27,27,86,11,75,41,36,5,0
2021,Redditch 008E,E01032272,530,393,219,174,2,2,84,76,8,51,47,4,0
2021,Redditch 005A,E01032273,570,537,319,218,1,1,4,1,3,28,25,3,0
2021,Redditch 007D,E01032274,516,475,244,231,0,0,3,2,1,38,35,3,0
2021,Redditch 005B,E01032275,605,395,180,215,0,0,146,108,38,63,54,9,1
2021,Redditch 009E,E01032276,598,524,262,262,0,0,12,9,3,62,49,13,0
2021,Redditch 005C,E01032277,498,259,105,154,0,0,166,154,12,72,65,7,1
2021,Redditch 005D,E01032278,724,234,96,138,0,0,380,301,79,107,98,9,3
2021,Worcester 004A,E01032279,533,376,195,181,6,6,72,28,44,79,71,8,0
2021,Worcester 007A,E01032280,904,558,341,217,7,7,75,16,59,264,246,18,0
2021,Worcester 007B,E01032281,671,422,185,237,0,0,28,3,25,221,192,29,0
2021,Worcester 007C,E01032282,930,318,147,171,5,5,117,8,109,490,452,38,0
2021,Worcester 013A,E01032283,701,505,276,229,2,2,78,31,47,115,98,17,1
2021,Worcester 013B,E01032284,832,718,427,291,2,2,14,6,8,98,82,16,0
2021,Worcester 011A,E01032285,724,472,242,230,1,1,71,8,63,180,168,12,0
2021,Worcester 012A,E01032286,1102,700,314,386,34,34,232,45,187,135,111,24,1
2021,Worcester 012B,E01032287,680,489,243,246,3,3,11,2,9,177,156,21,0
2021,Worcester 012C,E01032288,665,480,268,212,6,6,72,21,51,107,91,16,0
2021,Worcester 012D,E01032289,630,588,384,204,0,0,15,5,10,27,17,10,0
2021,Worcester 012E,E01032290,658,550,358,192,1,1,32,5,27,75,60,15,0
2021,Worcester 011B,E01032292,636,304,138,166,22,22,82,12,70,228,216,12,0
2021,Worcester 011D,E01032294,636,435,246,189,4,4,54,9,45,143,129,14,0
2021,Worcester 001A,E01032296,717,456,229,227,4,4,69,7,62,188,170,18,0
2021,Worcester 001B,E01032297,672,588,317,271,2,2,17,7,10,65,52,13,0
2021,Worcester 001C,E01032298,770,710,427,283,2,2,5,2,3,53,43,10,0
2021,Worcester 001D,E01032299,677,500,234,266,3,3,41,14,27,133,121,12,0
2021,Worcester 001E,E01032300,716,653,436,217,2,2,18,6,12,43,31,12,0
2021,Worcester 005A,E01032301,614,440,247,193,3,3,86,29,57,85,71,14,0
2021,Worcester 005B,E01032302,564,190,94,96,0,0,182,78,104,192,185,7,0
2021,Worcester 002A,E01032303,509,181,91,90,4,4,279,112,167,44,40,4,1
2021,Worcester 002B,E01032304,622,256,129,127,4,4,303,106,197,59,53,6,0
2021,Worcester 010A,E01032305,703,497,249,248,1,1,60,25,35,145,126,19,0
2021,Worcester 010B,E01032306,605,405,179,226,10,10,93,28,65,97,92,5,0
2021,Worcester 010C,E01032307,670,275,144,131,0,0,295,119,176,98,84,14,2
2021,Worcester 013D,E01032308,783,663,312,351,12,12,32,10,22,76,64,12,0
2021,Worcester 010D,E01032309,711,441,190,251,29,29,165,61,104,76,64,12,0
2021,Worcester 005C,E01032310,662,374,170,204,5,5,106,44,62,174,158,16,3
2021,Worcester 005D,E01032311,629,288,140,148,0,0,247,125,122,92,82,10,2
2021,Worcester 004B,E01032312,658,394,169,225,0,0,43,17,26,221,209,12,0
2021,Worcester 005E,E01032313,491,176,77,99,1,1,241,92,149,73,65,8,0
2021,Worcester 006A,E01032314,434,287,168,119,0,0,4,1,3,143,134,9,0
2021,Worcester 006B,E01032315,500,323,184,139,2,2,12,3,9,163,152,11,0
2021,Worcester 006C,E01032316,498,451,303,148,0,0,4,0,4,43,30,13,0
2021,Worcester 006D,E01032317,675,480,294,186,1,1,90,21,69,104,95,9,0
2021,Worcester 009A,E01032318,665,215,106,109,14,14,375,136,239,60,51,9,1
2021,Worcester 009B,E01032319,750,517,313,204,15,15,83,32,51,135,115,20,0
2021,Worcester 009C,E01032320,639,424,205,219,1,1,19,5,14,195,183,12,0
2021,Worcester 009D,E01032321,763,384,190,194,23,23,260,96,164,96,83,13,0
2021,Worcester 009E,E01032322,956,331,167,164,17,17,282,49,233,326,298,28,0
2021,Worcester 014A,E01032323,617,511,301,210,6,6,28,3,25,72,62,10,0
2021,Worcester 014B,E01032324,612,448,237,211,8,8,21,3,18,135,125,10,0
2021,Worcester 014C,E01032325,641,466,198,268,0,0,22,2,20,153,147,6,0
2021,Worcester 014D,E01032326,612,510,321,189,0,0,13,5,8,89,76,13,0
2021,Worcester 004C,E01032327,1025,674,327,347,12,12,112,22,90,227,206,21,0
2021,Worcester 004D,E01032328,646,395,241,154,14,14,163,27,136,73,61,12,1
2021,Worcester 004E,E01032329,860,729,396,333,2,2,41,6,35,88,74,14,0
2021,Worcester 003A,E01032330,591,360,167,193,0,0,69,9,60,162,145,17,0
2021,Worcester 002C,E01032331,652,236,122,114,7,7,331,123,208,75,63,12,3
2021,Worcester 002D,E01032332,641,129,60,69,11,11,452,187,265,42,40,2,7
2021,Worcester 005F,E01032333,767,226,108,118,72,72,407,104,303,60,57,3,2
2021,Worcester 003B,E01032334,1002,637,269,368,3,3,83,12,71,279,267,12,0
2021,Worcester 003C,E01032335,584,505,212,293,0,0,6,3,3,73,72,1,0
2021,Worcester 003D,E01032336,633,485,224,261,1,1,13,8,5,134,123,11,0
2021,Worcester 008A,E01032337,998,704,291,413,22,22,130,27,103,142,127,15,0
2021,Worcester 008B,E01032338,811,456,182,274,1,1,76,5,71,278,261,17,0
2021,Worcester 008C,E01032339,648,544,271,273,6,6,13,2,11,85,76,9,0
2021,Wychavon 013A,E01032340,798,520,278,242,17,17,184,29,155,77,62,15,0
2021,Wychavon 013B,E01032341,617,536,357,179,12,12,26,3,23,43,35,8,0
2021,Wychavon 016A,E01032342,1112,650,246,404,38,38,236,38,198,188,171,17,0
2021,Wychavon 016B,E01032344,950,703,409,294,25,25,108,15,93,114,97,17,0
2021,Wychavon 007A,E01032345,631,530,323,207,7,7,23,0,23,71,60,11,0
2021,Wychavon 007B,E01032346,609,509,287,222,7,7,47,7,40,46,37,9,0
2021,Wychavon 019A,E01032347,563,438,259,179,1,1,36,5,31,87,64,23,1
2021,Wychavon 019B,E01032348,571,498,303,195,4,4,26,1,25,43,38,5,0
2021,Wychavon 013C,E01032349,741,546,309,237,10,10,102,14,88,83,61,22,0
2021,Wychavon 013D,E01032350,523,343,204,139,14,14,106,12,94,60,49,11,0
2021,Wychavon 018A,E01032351,968,777,611,166,20,20,32,4,28,139,99,40,0
2021,Wychavon 018B,E01032352,665,518,333,185,2,2,74,11,63,70,64,6,1
2021,Wychavon 018C,E01032353,783,453,313,140,5,5,208,22,186,117,97,20,0
2021,Wychavon 009A,E01032355,641,454,274,180,11,11,109,20,89,67,47,20,0
2021,Wychavon 009B,E01032356,480,429,235,194,1,1,16,3,13,34,31,3,0
2021,Wychavon 004A,E01032357,506,331,179,152,1,1,109,25,84,65,52,13,0
2021,Wychavon 004B,E01032358,659,328,174,154,5,5,240,47,193,86,81,5,0
2021,Wychavon 003A,E01032359,1085,563,423,140,14,14,271,45,226,236,218,18,1
2021,Wychavon 003B,E01032360,832,522,283,239,1,1,220,36,184,89,75,14,0
2021,Wychavon 003C,E01032361,761,653,385,268,1,1,4,0,4,103,91,12,0
2021,Wychavon 005B,E01032363,645,578,320,258,1,1,27,5,22,39,35,4,0
2021,Wychavon 005C,E01032364,700,644,401,243,6,6,14,4,10,36,31,5,0
2021,Wychavon 004C,E01032365,784,418,228,190,14,14,286,61,225,65,55,10,1
2021,Wychavon 005D,E01032366,753,567,350,217,4,4,101,12,89,81,68,13,0
2021,Wychavon 004D,E01032367,653,537,357,180,1,1,46,10,36,69,54,15,0
2021,Wychavon 002A,E01032368,530,216,117,99,6,6,246,52,194,62,57,5,0
2021,Wychavon 002B,E01032369,617,223,107,116,3,3,279,62,217,112,97,15,0
2021,Wychavon 002C,E01032370,506,340,170,170,2,2,98,22,76,66,56,10,0
2021,Wychavon 002D,E01032371,594,327,171,156,1,1,181,23,158,85,74,11,0
2021,Wychavon 019C,E01032372,635,502,313,189,1,1,79,4,75,53,42,11,0
2021,Wychavon 019D,E01032373,592,507,345,162,5,5,28,2,26,52,38,14,0
2021,Wychavon 018D,E01032374,576,452,246,206,3,3,63,11,52,58,50,8,0
2021,Wychavon 010A,E01032375,521,408,291,117,2,2,72,10,62,39,29,10,0
2021,Wychavon 015A,E01032376,669,502,303,199,1,1,14,3,11,152,131,21,0
2021,Wychavon 014B,E01032377,957,304,148,156,7,7,350,61,289,296,275,21,0
2021,Wychavon 014C,E01032378,844,392,231,161,10,10,245,43,202,197,183,14,0
2021,Wychavon 016C,E01032379,725,584,286,298,2,2,57,8,49,82,76,6,0
2021,Wychavon 016D,E01032380,676,556,380,176,11,11,25,2,23,84,68,16,0
2021,Wychavon 017A,E01032381,827,420,209,211,8,8,260,40,220,139,121,18,0
2021,Wychavon 010B,E01032382,608,467,302,165,0,0,77,9,68,64,56,8,0
2021,Wychavon 010C,E01032383,642,511,339,172,2,2,31,4,27,98,75,23,0
2021,Wychavon 015B,E01032384,670,369,189,180,15,15,191,29,162,92,86,6,3
2021,Wychavon 015C,E01032385,1036,731,434,297,39,39,187,35,152,79,72,7,0
2021,Wychavon 001B,E01032386,601,472,279,193,2,2,26,8,18,101,72,29,0
2021,Wychavon 001C,E01032387,707,497,271,226,8,8,122,18,104,80,68,12,0
2021,Wychavon 013E,E01032388,588,490,304,186,0,0,49,8,41,49,40,9,0
2021,Wychavon 013F,E01032389,618,389,253,136,8,8,181,38,143,38,37,1,2
2021,Wychavon 011A,E01032390,691,508,280,228,8,8,91,18,73,84,64,20,0
2021,Wychavon 011B,E01032391,562,371,189,182,11,11,131,13,118,49,41,8,0
2021,Wychavon 008A,E01032392,704,597,385,212,4,4,23,1,22,80,55,25,0
2021,Wychavon 008B,E01032393,770,615,358,257,13,13,80,4,76,62,53,9,0
2021,Wychavon 008C,E01032394,528,445,263,182,1,1,21,0,21,61,47,14,0
2021,Wychavon 007C,E01032395,538,414,241,173,3,3,39,6,33,81,63,18,1
2021,Wychavon 015D,E01032396,732,555,234,321,4,4,27,6,21,146,130,16,0
2021,Wychavon 017B,E01032397,958,588,335,253,14,14,236,39,197,119,108,11,1
2021,Wychavon 017C,E01032398,679,392,158,234,0,0,87,12,75,199,184,15,1
2021,Wychavon 006A,E01032399,945,687,334,353,1,1,177,44,133,80,60,20,0
2021,Wychavon 006B,E01032400,1032,856,490,366,15,15,77,22,55,84,55,29,0
2021,Wychavon 001D,E01032401,1136,824,416,408,51,51,153,27,126,108,85,23,0
2021,Wychavon 009C,E01032402,619,495,183,312,12,12,33,0,33,79,76,3,0
2021,Wychavon 009D,E01032403,977,685,255,430,25,25,160,29,131,107,89,18,0
2021,Wychavon 006C,E01032404,1101,860,564,296,3,3,94,17,77,144,115,29,0
2021,Wychavon 012A,E01032405,821,593,398,195,25,25,130,22,108,73,55,18,0
2021,Wychavon 012B,E01032406,758,315,230,85,3,3,225,15,210,215,193,22,0
2021,Wychavon 012C,E01032407,657,466,329,137,17,17,107,15,92,67,54,13,0
2021,Wychavon 012D,E01032408,666,576,416,160,5,5,26,3,23,59,49,10,0
2021,Wychavon 012E,E01032409,1066,604,304,300,26,26,327,45,282,108,90,18,1
2021,Wychavon 010D,E01032410,614,496,324,172,4,4,49,6,43,64,44,20,1
2021,Wychavon 010E,E01032411,763,551,312,239,7,7,132,20,112,72,48,24,1
2021,Wychavon 019E,E01032412,570,342,229,113,1,1,76,8,68,151,126,25,0
2021,Wychavon 019F,E01032413,505,391,262,129,1,1,48,4,44,65,55,10,0
2021,Wychavon 011C,E01032414,674,504,316,188,6,6,128,18,110,36,30,6,0
2021,Wychavon 011D,E01032415,573,478,235,243,2,2,43,8,35,50,38,12,0
2021,Wychavon 008D,E01032416,469,413,264,149,3,3,17,1,16,36,23,13,0
2021,Wychavon 007D,E01032417,644,490,289,201,1,1,53,8,45,100,85,15,0
2021,Wyre Forest 010A,E01032418,617,441,275,166,10,10,29,12,17,137,117,20,0
2021,Wyre Forest 010B,E01032419,575,534,389,145,0,0,8,2,6,33,26,7,0
2021,Wyre Forest 010C,E01032420,518,430,226,204,11,11,27,9,18,50,40,10,0
2021,Wyre Forest 010D,E01032421,478,426,263,163,0,0,27,2,25,25,17,8,0
2021,Wyre Forest 010E,E01032422,660,266,107,159,4,4,205,47,158,184,175,9,1
2021,Wyre Forest 014A,E01032423,788,617,484,133,6,6,101,48,53,64,44,20,0
2021,Wyre Forest 014B,E01032424,626,292,162,130,4,4,276,151,125,52,43,9,2
2021,Wyre Forest 014C,E01032425,653,530,351,179,12,12,60,29,31,51,43,8,0
2021,Wyre Forest 014D,E01032426,658,504,320,184,5,5,76,44,32,73,62,11,0
2021,Wyre Forest 011A,E01032427,705,586,400,186,4,4,58,21,37,57,46,11,0
2021,Wyre Forest 011B,E01032428,864,568,409,159,2,2,30,5,25,264,227,37,0
2021,Wyre Forest 011C,E01032429,671,584,405,179,5,5,35,12,23,47,38,9,0
2021,Wyre Forest 005A,E01032430,805,627,426,201,8,8,74,25,49,96,75,21,0
2021,Wyre Forest 001A,E01032431,680,498,323,175,6,6,62,18,44,113,95,18,1
2021,Wyre Forest 001B,E01032432,571,383,212,171,4,4,118,55,63,65,55,10,1
2021,Wyre Forest 001C,E01032433,585,496,278,218,3,3,29,7,22,57,52,5,0
2021,Wyre Forest 004A,E01032434,944,353,121,232,13,13,399,210,189,179,160,19,0
2021,Wyre Forest 004B,E01032435,675,343,175,168,3,3,132,49,83,196,182,14,1
2021,Wyre Forest 003A,E01032436,679,570,301,269,4,4,7,3,4,98,85,13,0
2021,Wyre Forest 004C,E01032437,771,446,221,225,1,1,183,93,90,141,131,10,0
2021,Wyre Forest 003B,E01032438,665,580,314,266,1,1,12,5,7,72,63,9,0
2021,Wyre Forest 001D,E01032439,605,497,309,188,2,2,55,35,20,50,37,13,1
2021,Wyre Forest 001E,E01032440,544,343,214,129,7,7,121,71,50,72,63,9,1
2021,Wyre Forest 002A,E01032441,530,461,293,168,2,2,7,3,4,60,48,12,0
2021,Wyre Forest 002B,E01032442,679,541,269,272,14,14,17,8,9,107,97,10,0
2021,Wyre Forest 002C,E01032443,602,527,365,162,0,0,8,3,5,65,57,8,2
2021,Wyre Forest 002D,E01032444,538,366,196,170,0,0,48,8,40,123,111,12,1
2021,Wyre Forest 002E,E01032445,650,385,206,179,7,7,161,75,86,92,80,12,5
2021,Wyre Forest 003C,E01032446,603,479,281,198,2,2,32,7,25,90,83,7,0
2021,Wyre Forest 003D,E01032447,641,433,199,234,1,1,8,3,5,199,184,15,0
2021,Wyre Forest 003E,E01032448,478,431,229,202,0,0,6,3,3,41,32,9,0
2021,Wyre Forest 007A,E01032449,749,401,193,208,2,2,28,5,23,318,296,22,0
2021,Wyre Forest 006A,E01032451,660,586,371,215,2,2,17,9,8,55,51,4,0
2021,Wyre Forest 006B,E01032452,648,575,350,225,2,2,20,6,14,51,43,8,0
2021,Wyre Forest 006C,E01032453,777,297,140,157,28,28,381,171,210,68,60,8,3
2021,Wyre Forest 006D,E01032454,835,524,301,223,15,15,92,26,66,204,182,22,0
2021,Wyre Forest 012A,E01032455,627,554,332,222,3,3,10,5,5,60,48,12,0
2021,Wyre Forest 012B,E01032456,525,328,183,145,8,8,73,55,18,114,98,16,2
2021,Wyre Forest 012C,E01032457,591,428,209,219,17,17,106,32,74,40,28,12,0
2021,Wyre Forest 012D,E01032458,652,591,383,208,1,1,8,6,2,52,38,14,0
2021,Wyre Forest 012E,E01032459,624,516,283,233,4,4,35,22,13,69,61,8,0
2021,Wyre Forest 013A,E01032460,949,587,325,262,38,38,127,57,70,196,174,22,1
2021,Wyre Forest 013B,E01032461,1015,624,400,224,4,4,83,35,48,303,285,18,1
2021,Wyre Forest 013C,E01032462,934,713,382,331,20,20,64,21,43,137,122,15,0
2021,Wyre Forest 013D,E01032463,744,614,410,204,0,0,59,25,34,71,54,17,0
2021,Wyre Forest 007B,E01032464,746,315,179,136,24,24,343,170,173,57,52,5,7
2021,Wyre Forest 007C,E01032465,617,249,117,132,15,15,282,138,144,68,58,10,3
2021,Wyre Forest 007D,E01032466,660,510,345,165,1,1,9,4,5,140,124,16,0
2021,Wyre Forest 007E,E01032467,526,448,296,152,3,3,10,4,6,65,54,11,0
2021,Wyre Forest 007F,E01032468,499,444,308,136,2,2,15,10,5,38,27,11,0
2021,Wyre Forest 009A,E01032469,659,307,143,164,8,8,257,158,99,83,72,11,4
2021,Wyre Forest 009C,E01032471,634,149,81,68,4,4,434,249,185,43,36,7,4
2021,Wyre Forest 011D,E01032472,537,488,330,158,5,5,6,3,3,38,27,11,0
2021,Wyre Forest 011E,E01032473,593,485,332,153,6,6,54,13,41,48,38,10,0
2021,Wyre Forest 008A,E01032474,895,337,154,183,5,5,135,41,94,418,400,18,0
2021,Wyre Forest 008B,E01032475,757,500,216,284,9,9,37,10,27,211,184,27,0
2021,Wyre Forest 008C,E01032476,627,474,245,229,0,0,48,20,28,104,92,12,1
2021,Wyre Forest 008D,E01032477,519,480,333,147,1,1,4,3,1,34,27,7,0
2021,Wyre Forest 008E,E01032478,650,387,188,199,5,5,175,98,77,82,75,7,1
2021,Wyre Forest 001F,E01032479,1100,820,539,281,12,12,195,75,120,69,44,25,4
2021,Wyre Forest 005B,E01032480,789,641,427,214,3,3,37,15,22,108,89,19,0
2021,Wyre Forest 005C,E01032481,850,513,357,156,31,31,214,98,116,90,67,23,2
2021,Wyre Forest 005D,E01032482,659,528,348,180,2,2,12,3,9,116,103,13,1
2021,Sunderland 032F,E01032483,730,498,287,211,0,0,106,30,76,126,112,14,0
2021,Sunderland 032G,E01032484,582,419,222,197,0,0,66,28,38,97,78,19,0
2021,Blackburn with Darwen 018E,E01032485,774,657,330,327,1,1,6,1,5,110,95,15,0
2021,Blackburn with Darwen 018F,E01032486,609,512,316,196,2,2,31,0,31,64,56,8,0
2021,Leeds 097F,E01032487,455,249,121,128,3,3,168,159,9,35,31,4,0
2021,Leeds 097G,E01032488,760,641,354,287,7,7,62,24,38,50,38,12,0
2021,Leeds 102F,E01032489,985,561,218,343,7,7,76,54,22,339,317,22,2
2021,Leeds 102G,E01032490,577,452,203,249,0,0,28,17,11,97,89,8,0
2021,Leeds 102H,E01032491,490,427,194,233,0,0,13,9,4,49,43,6,1
2021,Leeds 102I,E01032492,1065,411,155,256,1,1,245,223,22,405,376,29,3
2021,Leeds 033F,E01032493,641,515,248,267,2,2,7,5,2,117,106,11,0
2021,Leeds 033G,E01032494,722,264,108,156,0,0,343,294,49,112,105,7,3
2021,Leeds 105F,E01032496,953,676,255,421,31,31,106,42,64,140,112,28,0
2021,Leeds 099E,E01032497,634,257,109,148,2,2,265,256,9,106,90,16,4
2021,Leeds 099F,E01032498,721,553,336,217,12,12,36,23,13,119,99,20,1
2021,Leeds 067G,E01032499,701,577,298,279,3,3,19,7,12,101,90,11,1
2021,Leeds 067H,E01032500,641,163,74,89,0,0,125,80,45,352,341,11,1
2021,Leeds 017E,E01032501,513,451,235,216,0,0,24,22,2,38,35,3,0
2021,Leeds 017F,E01032502,853,379,144,235,0,0,336,317,19,134,119,15,4
2021,Leeds 007E,E01032503,613,537,328,209,5,5,7,6,1,63,49,14,1
2021,Leeds 007F,E01032504,746,694,442,252,0,0,9,3,6,43,32,11,0
2021,Liverpool 050F,E01032505,565,337,182,155,8,8,121,7,114,99,91,8,0
2021,Liverpool 050G,E01032506,677,367,181,186,20,20,114,11,103,176,159,17,0
2021,Liverpool 050H,E01032507,646,428,196,232,2,2,31,4,27,185,169,16,0
2021,Liverpool 027G,E01032508,837,229,109,120,0,0,321,58,263,283,270,13,4
2021,Liverpool 027H,E01032509,614,271,136,135,0,0,116,13,103,227,219,8,0
2021,Liverpool 008F,E01032510,953,522,215,307,1,1,127,25,102,303,282,21,0
2021,Liverpool 008G,E01032511,608,371,233,138,2,2,144,34,110,91,78,13,0
2021,Westminster 010F,E01032512,893,106,60,46,24,24,584,398,186,163,143,20,16
2021,Westminster 010G,E01032513,532,100,47,53,4,4,338,268,70,82,78,4,8
2021,Bristol 053E,E01032514,877,199,96,103,21,21,584,516,68,67,59,8,6
2021,Bristol 053F,E01032515,841,360,181,179,8,8,293,207,86,174,161,13,6
2021,Bristol 001G,E01032516,859,578,333,245,7,7,139,92,47,132,119,13,3
2021,Bristol 001H,E01032517,725,356,157,199,0,0,248,235,13,115,101,14,6
2021,Bristol 018E,E01032518,778,327,134,193,3,3,337,262,75,108,97,11,3
2021,Bristol 018F,E01032519,530,390,196,194,1,1,32,28,4,107,98,9,0
2021,Nottingham 028E,E01032520,1031,500,279,221,2,2,23,5,18,506,481,25,0
2021,Nottingham 028F,E01032522,1042,478,238,240,6,6,26,7,19,531,499,32,1
2021,West Suffolk 003B,E01032523,692,222,81,141,17,17,92,13,79,361,293,68,0
2021,West Suffolk 003C,E01032524,510,311,150,161,12,12,43,9,34,144,137,7,0
2021,West Suffolk 003D,E01032526,829,550,327,223,3,3,63,14,49,213,189,24,0
2021,Coventry 035G,E01032527,665,411,200,211,3,3,160,57,103,90,77,13,1
2021,Coventry 035H,E01032528,702,377,230,147,3,3,224,61,163,96,84,12,2
2021,Coventry 038E,E01032529,648,351,232,119,1,1,20,7,13,275,258,17,1
2021,Coventry 038F,E01032530,793,578,280,298,1,1,49,6,43,165,147,18,0
2021,Coventry 036F,E01032532,665,505,269,236,1,1,32,12,20,125,108,17,2
2021,Coventry 036G,E01032533,617,506,270,236,2,2,45,17,28,64,52,12,0
2021,Coventry 037F,E01032534,718,424,216,208,1,1,165,53,112,128,118,10,0
2021,Coventry 037G,E01032535,472,372,180,192,2,2,8,2,6,90,80,10,0
2021,Coventry 001F,E01032536,953,530,233,297,45,45,148,27,121,229,204,25,1
2021,Coventry 001G,E01032537,821,538,329,209,0,0,92,22,70,189,172,17,2
2021,Coventry 001H,E01032538,976,437,218,219,5,5,173,18,155,361,339,22,0
2021,Hartlepool 003G,E01032540,453,249,119,130,29,29,116,40,76,59,48,11,0
2021,Hartlepool 003H,E01032541,979,470,264,206,3,3,360,165,195,142,120,22,4
2021,Stockton-on-Tees 009F,E01032542,704,298,43,255,6,6,235,95,140,165,159,6,0
2021,Stockton-on-Tees 009G,E01032543,874,256,133,123,1,1,447,315,132,169,156,13,1
2021,Stockton-on-Tees 009H,E01032544,797,491,144,347,6,6,190,111,79,110,101,9,0
2021,Darlington 002E,E01032545,684,398,185,213,21,21,140,55,85,125,110,15,0
2021,Darlington 002F,E01032546,709,662,372,290,0,0,6,5,1,41,31,10,0
2021,Redcar and Cleveland 019E,E01032548,724,676,474,202,1,1,13,5,8,34,22,12,0
2021,Redcar and Cleveland 019F,E01032549,1072,893,482,411,26,26,73,17,56,80,71,9,0
2021,Barnsley 010H,E01032551,1129,810,433,377,1,1,140,118,22,175,152,23,3
2021,Middlesbrough 018G,E01032552,667,416,165,251,1,1,190,89,101,60,53,7,0
2021,Oxford 002F,E01032554,988,635,434,201,6,6,64,19,45,283,258,25,0
2021,Oxford 002G,E01032555,772,302,156,146,7,7,279,225,54,183,156,27,1
2021,Oldham 026E,E01032556,671,497,236,261,5,5,56,6,50,113,101,12,0
2021,Oldham 026F,E01032557,765,183,79,104,2,2,482,269,213,95,84,11,3
2021,Oldham 007E,E01032558,655,170,74,96,13,13,408,213,195,63,52,11,1
2021,Oldham 007F,E01032559,1012,750,235,515,0,0,104,59,45,156,121,35,2
2021,Redcar and Cleveland 003E,E01032560,510,415,232,183,4,4,37,8,29,53,39,14,1
2021,Redcar and Cleveland 003F,E01032561,631,242,111,131,0,0,289,169,120,100,91,9,0
2021,Bromley 040D,E01032562,619,259,94,165,4,4,268,33,235,88,79,9,0
2021,Bromley 040E,E01032563,567,488,271,217,0,0,8,0,8,69,60,9,2
2021,Lewisham 037E,E01032564,493,187,66,121,3,3,199,73,126,102,94,8,2
2021,Lewisham 038E,E01032565,602,239,87,152,5,5,256,57,199,102,76,26,0
2021,Bexley 029D,E01032566,753,430,186,244,8,8,202,44,158,113,102,11,0
2021,Greenwich 033D,E01032567,600,417,191,226,3,3,97,34,63,83,71,12,0
2021,Bromley 041E,E01032568,641,329,135,194,11,11,195,13,182,106,94,12,0
2021,Croydon 045E,E01032569,682,219,91,128,3,3,397,324,73,62,54,8,1
2021,Bromley 042D,E01032570,733,599,362,237,0,0,62,4,58,72,61,11,0
2021,Tandridge 012D,E01032571,777,643,381,262,6,6,51,32,19,75,62,13,2
2021,Ealing 040D,E01032572,754,326,146,180,4,4,103,73,30,319,303,16,2
2021,Hounslow 029E,E01032573,902,364,220,144,7,7,79,63,16,451,423,28,1
2021,Enfield 037E,E01032574,694,316,169,147,3,3,139,75,64,235,220,15,1
2021,Haringey 037D,E01032575,659,104,41,63,38,38,380,153,227,135,127,8,2
2021,Harrow 032E,E01032576,517,405,177,228,4,4,7,4,3,101,92,9,0
2021,Hillingdon 033E,E01032577,609,463,198,265,2,2,61,49,12,83,74,9,0
2021,Lewisham 039E,E01032579,972,240,60,180,14,14,433,280,153,282,258,24,3
2021,Barking and Dagenham 023F,E01032580,488,173,71,102,11,11,139,67,72,164,153,11,1
2021,Redbridge 034G,E01032581,744,293,125,168,10,10,139,59,80,300,278,22,2
2021,Lambeth 036E,E01032582,1165,204,87,117,21,21,368,276,92,570,540,30,2
2021,Southwark 034D,E01032583,917,183,72,111,48,48,404,214,190,281,248,33,1
2021,Southwark 034E,E01032584,568,129,53,76,0,0,280,183,97,159,151,8,0
2021,Sheffield 072E,E01032585,652,582,401,181,2,2,5,3,2,63,49,14,0
2021,North East Derbyshire 014D,E01032586,751,422,268,154,2,2,220,188,32,104,86,18,3
2021,Coventry 043E,E01032587,640,372,159,213,6,6,128,47,81,134,118,16,0
2021,Nuneaton and Bedworth 018E,E01032588,579,512,294,218,1,1,2,1,1,64,48,16,0
2021,Birmingham 132E,E01032589,607,463,269,194,7,7,19,17,2,118,103,15,0
2021,Solihull 030D,E01032590,957,715,335,380,30,30,41,11,30,171,160,11,0
2021,Birmingham 133F,E01032591,472,415,247,168,0,0,1,0,1,56,43,13,0
2021,Sandwell 039F,E01032592,727,504,303,201,1,1,125,120,5,97,83,14,0
2021,Middlesbrough 020F,E01032593,948,873,423,450,1,1,25,4,21,49,40,9,0
2021,Redcar and Cleveland 021E,E01032594,673,549,349,200,3,3,61,26,35,60,47,13,0
2021,Kingston upon Hull 033E,E01032595,803,419,229,190,0,0,281,260,21,98,80,18,5
2021,East Riding of Yorkshire 043F,E01032596,616,472,257,215,4,4,12,8,4,127,115,12,1
2021,Leicester 037F,E01032597,670,253,97,156,2,2,339,301,38,70,69,1,6
2021,Leicester 038E,E01032599,578,465,248,217,0,0,13,6,7,100,86,14,0
2021,Oadby and Wigston 008D,E01032600,816,700,402,298,0,0,3,3,0,113,98,15,0
2021,Oadby and Wigston 008E,E01032601,573,501,300,201,2,2,3,1,2,67,60,7,0
2021,Leicester 039E,E01032602,602,263,115,148,1,1,268,240,28,68,61,7,2
2021,Blaby 013F,E01032603,660,572,390,182,1,1,6,2,4,81,64,17,0
2021,Portsmouth 026D,E01032604,604,500,256,244,0,0,26,16,10,78,68,10,0
2021,Havant 018F,E01032605,670,574,300,274,12,12,34,2,32,50,43,7,0
2021,Leeds 067I,E01032606,922,531,247,284,1,1,249,212,37,140,136,4,1
2021,Leeds 067J,E01032607,649,222,113,109,1,1,125,40,85,300,287,13,1
2021,Leeds 067K,E01032608,518,277,132,145,2,2,19,10,9,220,215,5,0
2021,Buckinghamshire 039F,E01032609,538,389,215,174,2,2,93,12,81,54,46,8,0
2021,Buckinghamshire 036F,E01032610,646,548,313,235,3,3,36,1,35,59,52,7,0
2021,East Cambridgeshire 011D,E01032611,739,588,353,235,19,19,10,1,9,122,71,51,0
2021,West Suffolk 015F,E01032612,1094,538,303,235,1,1,129,36,93,426,378,48,0
2021,Amber Valley 017E,E01032613,570,415,251,164,7,7,106,18,88,42,29,13,0
2021,Erewash 016E,E01032614,490,431,201,230,0,0,8,1,7,51,45,6,0
2021,East Hampshire 016D,E01032615,475,446,303,143,2,2,2,0,2,25,19,6,0
2021,East Hampshire 016E,E01032616,639,580,325,255,1,1,7,0,7,51,40,11,0
2021,Havant 020D,E01032617,672,619,374,245,0,0,5,3,2,48,43,5,0
2021,Havant 019D,E01032618,706,530,277,253,30,30,81,18,63,65,51,14,0
2021,Sevenoaks 016D,E01032619,638,521,298,223,4,4,23,11,12,90,78,12,0
2021,Tonbridge and Malling 014E,E01032620,966,805,473,332,3,3,42,7,35,116,82,34,0
2021,Nottingham 038E,E01032621,684,403,221,182,2,2,202,176,26,75,60,15,2
2021,Gedling 016D,E01032622,548,501,300,201,4,4,3,2,1,40,30,10,0
2021,Sutton 025E,E01032623,604,563,321,242,1,1,11,7,4,29,20,9,0
2021,Epsom and Ewell 010F,E01032624,667,637,323,314,0,0,2,0,2,28,24,4,0
2021,East Hampshire 017E,E01032625,559,487,308,179,13,13,30,11,19,29,21,8,0
2021,Waverley 018F,E01032626,684,500,281,219,14,14,46,32,14,124,108,16,0
2021,Mendip 011F,E01032627,1003,662,464,198,7,7,158,18,140,175,131,44,1
2021,East Devon 004G,E01032628,1076,817,493,324,22,22,76,42,34,161,120,41,0
2021,Sedgemoor 011E,E01032631,567,282,89,193,0,0,15,6,9,270,253,17,0
2021,Sedgemoor 011F,E01032632,600,493,263,230,3,3,21,14,7,83,76,7,0
2021,Sedgemoor 002G,E01032633,1044,824,576,248,4,4,37,24,13,179,149,30,0
2021,Sedgemoor 011G,E01032634,534,476,296,180,3,3,13,0,13,42,36,6,0
2021,Somerset West and Taunton 003E,E01032635,1030,628,434,194,8,8,310,35,275,84,68,16,0
2021,Somerset West and Taunton 001D,E01032636,978,645,458,187,5,5,66,12,54,262,231,31,0
2021,Southwark 035E,E01032637,565,163,73,90,7,7,8,6,2,387,370,17,0
2021,Southwark 035D,E01032638,597,227,110,117,3,3,11,3,8,356,322,34,0
2021,Southwark 014F,E01032639,781,194,59,135,38,38,195,144,51,353,330,23,1
2021,Southwark 035B,E01032640,610,216,96,120,2,2,12,8,4,380,351,29,0
2021,Dorset 031A,E01032643,763,496,307,189,9,9,70,3,67,188,165,23,0
2021,Dorset 031B,E01032644,733,329,240,89,0,0,166,14,152,238,212,26,0
2021,Dorset 031C,E01032645,831,421,322,99,17,17,222,15,207,171,151,20,0
2021,Southwark 036B,E01032646,806,258,111,147,7,7,150,95,55,391,361,30,0
2021,North Tyneside 011E,E01032647,1085,852,209,643,30,30,62,6,56,141,127,14,0
2021,North Tyneside 011F,E01032648,669,290,93,197,9,9,226,212,14,144,123,21,0
2021,North Tyneside 019F,E01032649,614,222,73,149,5,5,260,224,36,127,116,11,0
2021,North Tyneside 019G,E01032650,567,186,76,110,1,1,309,302,7,69,61,8,2
2021,Somerset West and Taunton 012D,E01032651,756,561,259,302,0,0,45,18,27,150,133,17,0
2021,Somerset West and Taunton 012E,E01032652,881,576,210,366,15,15,170,110,60,118,85,33,2
2021,Swale 004F,E01032653,676,473,261,212,3,3,38,6,32,162,145,17,0
2021,Swale 007G,E01032655,704,546,162,384,28,28,34,5,29,96,89,7,0
2021,Swale 007H,E01032656,925,711,237,474,35,35,97,13,84,82,64,18,0
2021,Plymouth 027F,E01032657,661,227,160,67,2,2,84,15,69,347,327,20,1
2021,Plymouth 027G,E01032658,856,141,94,47,14,14,309,104,205,390,359,31,2
2021,"Bournemouth, Christchurch and Poole 044C",E01032659,655,178,101,77,1,1,258,177,81,216,199,17,2
2021,"Bournemouth, Christchurch and Poole 044D",E01032660,745,305,155,150,53,53,132,12,120,255,234,21,0
2021,"Bournemouth, Christchurch and Poole 044E",E01032661,715,375,274,101,0,0,34,13,21,306,285,21,0
2021,"Bournemouth, Christchurch and Poole 044F",E01032662,611,161,109,52,2,2,267,218,49,174,163,11,7
2021,East Hampshire 012F,E01032664,677,366,267,99,5,5,77,9,68,229,207,22,0
2021,East Hampshire 012G,E01032665,678,330,184,146,2,2,96,10,86,250,228,22,0
2021,North Somerset 026B,E01032666,518,390,195,195,7,7,36,17,19,85,73,12,0
2021,North Somerset 026C,E01032667,444,328,121,207,6,6,39,3,36,71,67,4,0
2021,North Somerset 026D,E01032668,617,368,103,265,12,12,36,1,35,200,188,12,1
2021,North Somerset 027B,E01032669,574,296,46,250,1,1,11,5,6,266,254,12,0
2021,North Somerset 027C,E01032670,626,376,79,297,8,8,44,5,39,198,192,6,0
2021,North Somerset 027D,E01032671,488,295,79,216,1,1,32,0,32,160,152,8,0
2021,North Somerset 026E,E01032672,1084,804,196,608,19,19,49,7,42,212,190,22,0
2021,North Somerset 026F,E01032673,628,329,165,164,3,3,117,16,101,179,153,26,0
2021,North Somerset 001E,E01032675,793,476,240,236,17,17,39,3,36,261,236,25,0
2021,North Somerset 001F,E01032676,1096,614,364,250,20,20,58,14,44,404,369,35,0
2021,North Somerset 003D,E01032677,821,498,114,384,45,45,153,10,143,125,118,7,0
2021,North Somerset 003E,E01032678,552,468,151,317,0,0,7,0,7,77,71,6,0
2021,North Somerset 027E,E01032679,540,334,119,215,3,3,7,3,4,196,179,17,0
2021,North Somerset 006G,E01032680,842,741,496,245,2,2,18,7,11,81,63,18,0
2021,North Somerset 001G,E01032681,628,461,275,186,10,10,68,7,61,89,73,16,0
2021,North Somerset 003F,E01032682,424,327,159,168,0,0,34,2,32,63,54,9,0
2021,West Lindsey 001G,E01032683,1031,770,488,282,5,5,87,13,74,168,140,28,1
2021,Salford 034D,E01032684,632,177,59,118,2,2,208,71,137,243,230,13,2
2021,Wiltshire 025E,E01032688,536,357,161,196,12,12,76,11,65,91,81,10,0
2021,Wiltshire 025F,E01032689,549,397,241,156,11,11,73,8,65,68,56,12,0
2021,Wiltshire 015F,E01032690,702,424,155,269,28,28,115,13,102,135,121,14,0
2021,Wiltshire 015G,E01032691,601,380,147,233,3,3,117,23,94,101,91,10,0
2021,Wiltshire 025G,E01032692,506,312,132,180,15,15,70,6,64,109,101,8,0
2021,Wiltshire 025H,E01032693,749,459,210,249,27,27,165,11,154,98,86,12,0
2021,Wiltshire 064D,E01032694,700,423,136,287,3,3,137,19,118,137,123,14,0
2021,Wiltshire 064C,E01032695,629,539,312,227,7,7,18,3,15,65,54,11,0
2021,Wiltshire 045F,E01032696,876,495,274,221,4,4,141,109,32,236,115,121,0
2021,Wiltshire 066C,E01032697,624,86,30,56,13,13,185,32,153,340,205,135,0
2021,Wiltshire 007I,E01032699,989,686,445,241,2,2,73,16,57,228,105,123,0
2021,Swindon 026B,E01032700,586,454,99,355,5,5,9,2,7,118,107,11,0
2021,Swindon 027A,E01032701,526,296,64,232,2,2,19,4,15,209,203,6,0
2021,Swindon 027B,E01032702,560,398,130,268,26,26,14,2,12,122,115,7,0
2021,Swindon 026C,E01032703,584,402,107,295,7,7,42,4,38,133,127,6,0
2021,Swindon 027C,E01032704,723,402,77,325,1,1,97,10,87,223,186,37,0
2021,Swindon 026D,E01032705,575,386,83,303,18,18,49,4,45,122,114,8,0
2021,Swindon 021E,E01032706,695,291,53,238,59,59,71,4,67,274,257,17,0
2021,Swindon 021F,E01032707,789,693,317,376,2,2,7,0,7,87,78,9,0
2021,Swindon 012F,E01032708,729,320,71,249,1,1,20,6,14,388,376,12,0
2021,Swindon 026E,E01032709,551,295,58,237,46,46,49,8,41,160,150,10,1
2021,Swindon 028E,E01032710,549,430,158,272,1,1,6,2,4,112,98,14,0
2021,Swindon 027D,E01032711,666,353,73,280,1,1,22,1,21,290,276,14,0
2021,Swindon 027E,E01032712,941,552,96,456,29,29,77,6,71,282,265,17,1
2021,Swindon 026F,E01032713,690,540,122,418,6,6,11,0,11,133,127,6,0
2021,Swindon 019E,E01032714,821,171,75,96,18,18,100,28,72,530,513,17,2
2021,Swindon 019F,E01032715,637,226,101,125,1,1,45,3,42,365,345,20,0
2021,Swindon 012G,E01032716,668,402,144,258,3,3,40,7,33,223,208,15,0
2021,Southwark 014G,E01032719,801,146,47,99,68,68,299,291,8,288,269,19,0
2021,Bracknell Forest 006F,E01032724,769,283,67,216,32,32,226,51,175,227,212,15,1
2021,Bracknell Forest 009H,E01032726,629,327,112,215,48,48,189,75,114,64,58,6,1
2021,Bracknell Forest 006G,E01032728,862,394,129,265,52,52,217,34,183,199,186,13,0
2021,Slough 009F,E01032729,619,211,57,154,5,5,110,58,52,293,269,24,0
2021,Slough 009G,E01032730,753,156,40,116,15,15,128,32,96,450,440,10,4
2021,Slough 013E,E01032731,482,229,63,166,19,19,101,19,82,133,118,15,0
2021,Slough 013F,E01032732,642,299,113,186,3,3,159,131,28,178,172,6,3
2021,Windsor and Maidenhead 005G,E01032733,735,178,75,103,55,55,235,21,214,265,251,14,2
2021,Windsor and Maidenhead 005H,E01032734,802,258,104,154,14,14,166,10,156,363,347,16,1
2021,Swale 013F,E01032735,614,505,263,242,24,24,31,3,28,54,43,11,0
2021,Swale 013G,E01032737,613,412,174,238,32,32,105,6,99,64,54,10,0
2021,Southampton 022F,E01032738,891,130,52,78,4,4,86,12,74,670,652,18,1
2021,City of London 001F,E01032739,879,214,116,98,3,3,10,3,7,652,555,97,0
2021,City of London 001G,E01032740,875,246,126,120,2,2,35,6,29,592,521,71,0
2021,Havering 013E,E01032741,731,232,77,155,40,40,80,26,54,379,364,15,0
2021,Havering 013F,E01032742,832,421,198,223,17,17,85,12,73,309,289,20,0
2021,Ealing 010F,E01032743,821,196,40,156,77,77,234,25,209,310,294,16,4
2021,Ealing 010G,E01032744,521,223,93,130,3,3,98,74,24,195,182,13,2
2021,Southampton 033C,E01032745,714,115,18,97,46,46,256,67,189,297,280,17,0
2021,Southampton 034C,E01032746,724,142,40,102,20,20,42,15,27,520,504,16,0
2021,Southampton 034D,E01032748,1086,390,153,237,12,12,106,46,60,578,551,27,0
2021,Southampton 022G,E01032750,586,55,21,34,2,2,131,15,116,397,383,14,1
2021,Southampton 033D,E01032751,777,178,66,112,7,7,178,110,68,414,405,9,0
2021,Southampton 009F,E01032753,778,452,277,175,3,3,16,7,9,307,285,22,0
2021,Southampton 033A,E01032755,488,30,15,15,2,2,349,319,30,105,103,2,2
2021,Wokingham 012H,E01032759,735,596,212,384,14,14,32,12,20,93,83,10,0
2021,Tower Hamlets 004E,E01032764,1056,293,48,245,90,90,286,26,260,387,362,25,0
2021,Tower Hamlets 004F,E01032765,740,138,29,109,28,28,341,46,295,232,212,20,1
2021,Tower Hamlets 021F,E01032767,794,186,75,111,6,6,54,15,39,548,520,28,0
2021,Tower Hamlets 025E,E01032768,682,221,82,139,7,7,83,8,75,371,358,13,0
2021,Tower Hamlets 025F,E01032769,630,213,78,135,9,9,122,24,98,286,266,20,0
2021,Tower Hamlets 032B,E01032770,1081,241,77,164,30,30,199,30,169,611,580,31,0
2021,Tower Hamlets 033B,E01032771,781,191,74,117,24,24,114,20,94,451,438,13,1
2021,Tower Hamlets 032C,E01032772,1178,158,70,88,44,44,370,51,319,606,577,29,0
2021,Tower Hamlets 032E,E01032774,728,119,60,59,21,21,276,35,241,311,287,24,1
2021,Tower Hamlets 031F,E01032775,564,192,49,143,3,3,36,10,26,333,327,6,0
2021,Tower Hamlets 034D,E01032776,1051,234,89,145,38,38,139,9,130,639,612,27,1
2021,Tower Hamlets 035A,E01032777,576,130,34,96,33,33,168,12,156,245,219,26,0
2021,Tower Hamlets 035C,E01032779,655,157,54,103,17,17,117,9,108,364,350,14,0
2021,Tower Hamlets 035D,E01032780,1008,291,106,185,6,6,160,32,128,551,514,37,0
2021,Tower Hamlets 033C,E01032781,760,218,89,129,4,4,118,19,99,420,399,21,0
2021,Tower Hamlets 033D,E01032782,1138,200,70,130,44,44,240,45,195,653,625,28,1
2021,Tower Hamlets 031G,E01032783,581,107,28,79,14,14,176,14,162,283,269,14,1
2021,Tower Hamlets 004G,E01032784,742,204,48,156,13,13,183,91,92,342,325,17,0
2021,Tower Hamlets 010E,E01032785,1023,339,64,275,85,85,306,81,225,289,273,16,4
2021,Tower Hamlets 010F,E01032786,623,153,64,89,15,15,318,280,38,134,125,9,3
2021,Tower Hamlets 011F,E01032787,776,143,46,97,2,2,368,269,99,256,239,17,7
2021,Hammersmith and Fulham 023D,E01032788,713,178,75,103,42,42,193,56,137,299,269,30,1
2021,Hammersmith and Fulham 023E,E01032789,593,157,67,90,22,22,170,16,154,244,222,22,0
2021,Hammersmith and Fulham 023F,E01032790,487,133,74,59,0,0,145,22,123,209,193,16,0
2021,Cambridge 003F,E01032792,593,249,136,113,22,22,109,12,97,213,199,14,0
2021,Cambridge 014D,E01032794,592,327,226,101,2,2,108,12,96,155,129,26,0
2021,Gravesham 002F,E01032799,628,170,86,84,5,5,77,10,67,375,356,19,1
2021,Gravesham 002G,E01032800,703,234,125,109,9,9,104,36,68,356,340,16,0
2021,Cambridge 003G,E01032802,665,265,178,87,15,15,138,38,100,246,233,13,1
2021,Southwark 036C,E01032803,787,217,69,148,35,35,147,83,64,388,362,26,0
2021,Canterbury 020F,E01032807,763,306,180,126,2,2,61,35,26,394,363,31,0
2021,Canterbury 020G,E01032808,822,192,101,91,20,20,186,79,107,424,403,21,0
2021,Ashford 001F,E01032810,619,312,116,196,4,4,173,112,61,130,123,7,0
2021,Ashford 003D,E01032811,595,360,134,226,20,20,73,1,72,142,137,5,0
2021,Ashford 001G,E01032812,684,539,252,287,20,20,4,4,0,121,102,19,0
2021,Ashford 012E,E01032813,734,434,113,321,40,40,22,8,14,238,227,11,0
2021,Ashford 012F,E01032814,810,587,256,331,6,6,72,53,19,142,120,22,3
2021,Ashford 009F,E01032815,428,167,59,108,3,3,151,77,74,105,96,9,2
2021,Ashford 008E,E01032816,765,568,181,387,38,38,16,5,11,143,135,8,0
2021,Ashford 009G,E01032817,453,232,69,163,28,28,57,33,24,136,124,12,0
2021,Ashford 009H,E01032818,553,399,121,278,5,5,9,3,6,140,134,6,0
2021,Ashford 009I,E01032819,634,410,140,270,48,48,43,9,34,133,119,14,0
2021,Ashford 016B,E01032820,995,621,176,445,15,15,90,9,81,269,248,21,0
2021,Ashford 016A,E01032821,1105,804,232,572,32,32,61,14,47,208,195,13,0
2021,Ashford 003E,E01032822,569,421,207,214,2,2,91,91,0,55,42,13,0
2021,Ashford 008F,E01032823,608,404,187,217,7,7,80,28,52,117,103,14,0
2021,Ashford 009J,E01032824,594,414,173,241,1,1,56,31,25,123,104,19,0
2021,Tonbridge and Malling 007E,E01032825,1056,726,175,551,77,77,144,11,133,108,101,7,1
2021,Tonbridge and Malling 007F,E01032826,650,515,173,342,8,8,22,0,22,105,93,12,0
2021,Tonbridge and Malling 007G,E01032827,724,586,161,425,8,8,50,5,45,80,76,4,0
2021,Tonbridge and Malling 007H,E01032828,425,360,178,182,0,0,2,0,2,63,57,6,0
2021,Tonbridge and Malling 014F,E01032829,669,510,237,273,14,14,68,8,60,76,60,16,1
2021,Tonbridge and Malling 002G,E01032830,1011,491,205,286,10,10,387,62,325,123,104,19,0
2021,Eastbourne 014B,E01032831,751,596,393,203,2,2,4,2,2,149,141,8,0
2021,Eastbourne 014C,E01032832,660,331,229,102,23,23,199,6,193,107,96,11,0
2021,Eastbourne 014D,E01032833,672,391,265,126,2,2,17,10,7,262,248,14,0
2021,Southwark 035C,E01032834,620,226,124,102,3,3,23,11,12,367,336,31,1
2021,Crawley 004F,E01032835,844,288,106,182,47,47,154,27,127,354,346,8,1
2021,Crawley 004G,E01032836,910,434,219,215,25,25,224,195,29,223,208,15,4
2021,Mid Sussex 009E,E01032837,994,681,274,407,30,30,124,11,113,159,133,26,0
2021,Mid Sussex 009F,E01032838,615,354,82,272,27,27,83,5,78,151,146,5,0
2021,Mid Sussex 009G,E01032839,606,369,174,195,1,1,34,1,33,202,191,11,0
2021,Basingstoke and Deane 010G,E01032841,1110,664,142,522,38,38,197,6,191,211,201,10,0
2021,Basingstoke and Deane 011E,E01032842,723,154,34,120,35,35,107,6,101,427,413,14,0
2021,Basingstoke and Deane 007H,E01032843,770,423,80,343,38,38,155,6,149,154,144,10,0
2021,Basingstoke and Deane 007I,E01032844,1159,584,129,455,85,85,349,20,329,141,131,10,0
2021,Basingstoke and Deane 012E,E01032845,751,401,173,228,19,19,99,5,94,232,215,17,0
2021,Basingstoke and Deane 012F,E01032846,797,238,62,176,15,15,143,6,137,401,386,15,0
2021,Basingstoke and Deane 011F,E01032847,1103,308,169,139,20,20,226,16,210,549,525,24,0
2021,Basingstoke and Deane 021E,E01032848,632,404,85,319,18,18,104,5,99,106,101,5,0
2021,Basingstoke and Deane 021F,E01032849,576,387,87,300,0,0,100,2,98,89,86,3,0
2021,Basingstoke and Deane 021G,E01032850,599,464,169,295,3,3,21,0,21,111,105,6,0
2021,Hart 005E,E01032852,627,370,109,261,79,79,79,6,73,99,95,4,0
2021,Hart 005F,E01032853,662,489,129,360,10,10,16,0,16,147,135,12,0
2021,Hart 005G,E01032854,602,407,102,305,7,7,21,1,20,167,153,14,0
2021,Hart 011D,E01032855,420,290,165,125,0,0,52,4,48,78,56,22,0
2021,Hart 011E,E01032856,478,113,51,62,5,5,58,7,51,302,57,245,0
2021,Hart 005H,E01032857,455,315,131,184,1,1,2,1,1,137,123,14,0
2021,Rushmoor 009F,E01032858,1032,468,140,328,62,62,327,61,266,172,156,16,3
2021,Winchester 013F,E01032859,667,531,158,373,0,0,14,12,2,122,110,12,0
2021,Winchester 013G,E01032860,689,376,115,261,8,8,10,3,7,295,280,15,0
2021,Leicester 042B,E01032862,737,323,80,243,8,8,81,7,74,324,316,8,1
2021,Leicester 042C,E01032863,786,431,101,330,24,24,75,24,51,256,242,14,0
2021,Leicester 042A,E01032865,694,448,163,285,27,27,14,6,8,205,190,15,0
2021,Leicester 041B,E01032868,502,49,17,32,2,2,55,3,52,396,380,16,0
2021,Test Valley 005F,E01032870,736,591,300,291,17,17,23,1,22,105,87,18,0
2021,Test Valley 005G,E01032871,645,428,229,199,2,2,135,40,95,80,72,8,0
2021,Leicester 041C,E01032872,772,78,21,57,2,2,120,25,95,572,558,14,0
2021,Leicester 041D,E01032873,945,106,51,55,4,4,275,41,234,559,541,18,1
2021,Leeds 109G,E01032876,624,493,248,245,2,2,21,3,18,108,99,9,0
2021,Fareham 013F,E01032877,932,787,539,248,4,4,75,62,13,66,53,13,0
2021,Gosport 008F,E01032878,564,165,90,75,5,5,177,81,96,217,202,15,0
2021,Gosport 008G,E01032879,747,295,224,71,2,2,265,135,130,184,167,17,1
2021,Gosport 006F,E01032880,506,414,185,229,19,19,34,2,32,39,36,3,0
2021,Gosport 006G,E01032881,609,455,137,318,9,9,71,32,39,74,67,7,0
2021,Gosport 006H,E01032883,649,361,213,148,13,13,199,47,152,76,60,16,0
2021,Gosport 007F,E01032884,958,661,434,227,18,18,41,11,30,238,158,80,0
2021,Solihull 029F,E01032885,864,460,115,345,5,5,36,23,13,363,345,18,0
2021,Solihull 029G,E01032886,1094,777,277,500,50,50,87,17,70,180,162,18,0
2021,Walsall 018F,E01032888,1018,398,205,193,2,2,496,248,248,118,106,12,4
2021,Rugby 014C,E01032891,732,475,111,364,0,0,23,4,19,234,218,16,0
2021,Rugby 007F,E01032893,686,581,208,373,12,12,55,10,45,38,34,4,0
2021,Rugby 007G,E01032894,774,560,151,409,49,49,71,3,68,94,85,9,0
2021,Rugby 007H,E01032895,575,483,241,242,0,0,26,3,23,66,66,0,0
2021,East Staffordshire 011F,E01032896,700,169,61,108,14,14,160,44,116,357,335,22,0
2021,East Staffordshire 011G,E01032897,707,456,175,281,3,3,53,4,49,195,183,12,0
2021,East Staffordshire 011H,E01032898,598,132,63,69,5,5,193,35,158,268,253,15,0
2021,Lichfield 004F,E01032899,1050,581,396,185,19,19,263,18,245,187,168,19,0
2021,Lichfield 004G,E01032900,849,499,175,324,0,0,142,22,120,208,194,14,0
2021,Tamworth 010F,E01032901,706,407,120,287,41,41,105,7,98,153,142,11,0
2021,Tamworth 010G,E01032902,595,422,206,216,1,1,34,22,12,138,122,16,0
2021,St. Helens 025C,E01032904,708,619,293,326,0,0,8,1,7,81,71,10,0
2021,St. Helens 025D,E01032905,1134,878,223,655,41,41,108,8,100,106,89,17,1
2021,Salford 034E,E01032906,1139,234,60,174,5,5,288,112,176,610,597,13,2
2021,Salford 033F,E01032909,1041,171,40,131,7,7,37,12,25,826,804,22,0
2021,Salford 035B,E01032912,974,182,79,103,2,2,501,222,279,283,271,12,6
2021,Salford 035A,E01032914,1148,226,75,151,1,1,119,15,104,799,775,24,3
2021,Salford 036C,E01032915,946,152,61,91,3,3,343,185,158,442,433,9,6
2021,Oldham 011E,E01032920,1060,493,245,248,5,5,326,117,209,236,215,21,0
2021,Oldham 020E,E01032922,1070,823,525,298,0,0,143,66,77,104,91,13,0
2021,Calderdale 008F,E01032923,1118,508,245,263,7,7,294,100,194,308,278,30,1
2021,Barnsley 026F,E01032924,632,436,131,305,0,0,10,8,2,186,160,26,0
2021,Barnsley 026G,E01032925,650,346,186,160,11,11,141,89,52,147,135,12,5
2021,Rotherham 012E,E01032926,647,523,155,368,0,0,18,11,7,106,91,15,0
2021,Rotherham 012F,E01032927,626,463,210,253,0,0,42,36,6,121,106,15,0
2021,Cheshire West and Chester 033E,E01032930,1135,264,148,116,39,39,358,68,290,473,444,29,1
2021,Cheshire West and Chester 033F,E01032931,613,249,134,115,28,28,58,5,53,278,257,21,0
2021,Gloucester 004E,E01032932,986,416,249,167,48,48,201,54,147,320,297,23,1
2021,Gloucester 015E,E01032933,614,305,57,248,45,45,127,8,119,136,116,20,1
2021,Gloucester 015G,E01032935,573,360,75,285,26,26,74,4,70,113,109,4,0
2021,Gloucester 004F,E01032937,846,100,50,50,25,25,338,85,253,383,349,34,0
2021,Tewkesbury 001F,E01032938,932,567,213,354,64,64,112,19,93,189,145,44,0
2021,Tewkesbury 001G,E01032939,584,428,170,258,3,3,31,3,28,122,110,12,0
2021,Tewkesbury 001H,E01032940,582,391,106,285,12,12,30,4,26,149,119,30,0
2021,Cherwell 004G,E01032941,627,201,119,82,21,21,270,60,210,135,118,17,0
2021,Cherwell 004H,E01032942,731,187,71,116,30,30,143,21,122,371,350,21,0
2021,Cherwell 002E,E01032943,861,527,150,377,22,22,117,11,106,195,176,19,0
2021,Cherwell 002F,E01032944,617,368,173,195,4,4,46,10,36,199,188,11,0
2021,Leeds 110G,E01032946,828,190,92,98,2,2,102,5,97,534,506,28,0
2021,West Oxfordshire 008G,E01032947,718,367,108,259,41,41,111,7,104,199,188,11,0
2021,West Oxfordshire 008H,E01032948,739,555,254,301,9,9,41,5,36,134,122,12,0
2021,West Oxfordshire 013E,E01032949,560,324,82,242,20,20,62,3,59,154,145,9,0
2021,West Oxfordshire 013F,E01032950,663,387,91,296,22,22,51,5,46,203,178,25,0
2021,West Oxfordshire 013G,E01032951,745,314,117,197,22,22,121,14,107,288,81,207,0
2021,West Oxfordshire 008I,E01032952,629,446,260,186,25,25,39,6,33,119,105,14,0
2021,West Oxfordshire 013H,E01032953,900,385,204,181,13,13,87,6,81,415,77,338,0
2021,Buckinghamshire 015D,E01032955,789,323,168,155,71,71,167,30,137,228,208,20,0
2021,Buckinghamshire 016D,E01032956,679,511,141,370,3,3,4,1,3,161,144,17,0
2021,Buckinghamshire 016E,E01032957,590,352,107,245,3,3,9,1,8,226,213,13,0
2021,Buckinghamshire 009E,E01032958,647,514,268,246,2,2,49,9,40,82,60,22,0
2021,Buckinghamshire 015E,E01032961,784,255,106,149,10,10,130,19,111,389,366,23,0
2021,Buckinghamshire 016F,E01032962,650,456,165,291,6,6,14,1,13,174,164,10,0
2021,North Northamptonshire 008B,E01032963,623,435,169,266,1,1,10,2,8,177,166,11,0
2021,North Northamptonshire 008C,E01032964,646,442,111,331,7,7,27,6,21,170,162,8,0
2021,North Northamptonshire 008D,E01032965,630,459,99,360,5,5,23,4,19,143,133,10,0
2021,North Northamptonshire 008E,E01032966,893,654,118,536,3,3,18,2,16,218,209,9,0
2021,North Northamptonshire 008F,E01032967,833,588,96,492,0,0,11,6,5,234,220,14,0
2021,North Northamptonshire 013F,E01032969,595,404,99,305,24,24,65,3,62,102,93,9,0
2021,North Northamptonshire 013G,E01032970,793,567,212,355,26,26,95,45,50,105,92,13,0
2021,North Northamptonshire 013H,E01032971,559,310,138,172,5,5,42,22,20,201,187,14,1
2021,North Northamptonshire 020B,E01032972,653,542,289,253,15,15,38,27,11,57,51,6,1
2021,North Northamptonshire 020C,E01032973,593,431,130,301,36,36,46,6,40,80,74,6,0
2021,North Northamptonshire 020D,E01032974,590,458,203,255,1,1,44,14,30,87,79,8,0
2021,West Northamptonshire 035A,E01032976,779,378,135,243,81,81,158,19,139,161,146,15,1
2021,West Northamptonshire 032D,E01032978,839,94,25,69,46,46,463,285,178,222,211,11,14
2021,West Northamptonshire 032E,E01032979,776,70,23,47,13,13,408,245,163,279,257,22,6
2021,West Northamptonshire 037D,E01032980,801,150,51,99,16,16,136,17,119,498,475,23,1
2021,West Northamptonshire 037E,E01032981,729,283,118,165,3,3,48,10,38,394,374,20,1
2021,West Northamptonshire 046E,E01032982,554,338,124,214,8,8,45,8,37,163,146,17,0
2021,West Northamptonshire 046F,E01032983,532,395,107,288,0,0,19,2,17,118,109,9,0
2021,West Northamptonshire 046G,E01032984,551,401,90,311,20,20,1,0,1,129,122,7,0
2021,West Northamptonshire 046H,E01032985,926,756,273,483,16,16,66,14,52,88,71,17,0
2021,East Lindsey 004D,E01032986,595,294,192,102,1,1,74,14,60,226,218,8,0
2021,East Lindsey 004E,E01032987,704,390,212,178,22,22,92,19,73,200,184,16,0
2021,North Kesteven 013B,E01032988,797,457,160,297,18,18,175,90,85,145,134,11,2
2021,North Kesteven 013C,E01032989,813,554,86,468,16,16,69,11,58,174,164,10,0
2021,North Kesteven 014E,E01032991,939,740,297,443,9,9,51,33,18,139,118,21,0
2021,North Kesteven 014F,E01032992,683,490,287,203,8,8,63,49,14,122,110,12,0
2021,North Kesteven 013D,E01032993,1048,874,405,469,0,0,19,6,13,155,122,33,0
2021,North Kesteven 003H,E01032994,668,469,233,236,36,36,54,18,36,109,86,23,0
2021,South Holland 006F,E01032995,730,256,165,91,9,9,115,67,48,347,324,23,3
2021,South Holland 006G,E01032996,568,458,278,180,2,2,42,32,10,66,59,7,0
2021,South Kesteven 011E,E01032997,491,293,101,192,46,46,56,8,48,96,91,5,0
2021,South Kesteven 011F,E01032998,740,469,125,344,20,20,52,8,44,199,189,10,0
2021,South Kesteven 011G,E01032999,566,431,259,172,5,5,25,13,12,104,96,8,1
2021,Hounslow 025F,E01033000,624,102,42,60,5,5,438,318,120,78,63,15,1
2021,Leeds 055F,E01033002,1013,156,70,86,1,1,373,335,38,476,465,11,7
2021,Leeds 055G,E01033003,1179,116,56,60,3,3,583,541,42,463,441,22,14
2021,Leeds 111A,E01033008,594,109,39,70,1,1,33,12,21,451,426,25,0
2021,Leeds 111B,E01033010,765,102,30,72,2,2,137,11,126,524,502,22,0
2021,Leeds 111C,E01033011,744,135,41,94,4,4,48,6,42,557,540,17,0
2021,Leeds 082E,E01033013,720,104,43,61,3,3,191,170,21,416,408,8,6
2021,Leeds 111D,E01033015,933,240,76,164,9,9,31,6,25,653,620,33,0
2021,Leeds 111E,E01033016,705,143,49,94,5,5,85,34,51,470,448,22,2
2021,Leeds 075E,E01033021,1079,191,48,143,71,71,391,235,156,420,403,17,6
2021,Dacorum 018G,E01033022,687,273,93,180,7,7,153,58,95,254,236,18,0
2021,Dacorum 018H,E01033023,1026,494,122,372,4,4,209,139,70,317,306,11,2
2021,North Hertfordshire 017E,E01033024,530,479,156,323,0,0,6,3,3,45,44,1,0
2021,North Hertfordshire 017D,E01033025,519,380,101,279,4,4,40,3,37,95,90,5,0
2021,North Hertfordshire 017A,E01033026,593,392,130,262,19,19,42,7,35,140,133,7,0
2021,North Hertfordshire 017C,E01033027,591,341,63,278,40,40,97,12,85,113,103,10,0
2021,St Albans 018F,E01033028,522,365,167,198,28,28,64,20,44,65,58,7,0
2021,St Albans 018G,E01033029,634,445,152,293,12,12,84,26,58,93,88,5,0
2021,Hounslow 025G,E01033030,721,163,20,143,77,77,104,14,90,377,363,14,0
2021,Leeds 064E,E01033031,867,91,48,43,18,18,325,302,23,428,414,14,5
2021,Leeds 075F,E01033033,653,112,23,89,1,1,166,142,24,369,362,7,5
2021,Leeds 075G,E01033034,919,214,60,154,0,0,20,5,15,683,656,27,2
2021,Leeds 064F,E01033035,772,49,32,17,5,5,689,637,52,25,19,6,4
2021,King's Lynn and West Norfolk 017E,E01033036,652,502,281,221,1,1,56,3,53,93,82,11,0
2021,King's Lynn and West Norfolk 017F,E01033037,639,338,120,218,10,10,134,26,108,157,141,16,0
2021,King's Lynn and West Norfolk 017G,E01033038,987,443,221,222,7,7,183,37,146,354,321,33,0
2021,King's Lynn and West Norfolk 017H,E01033039,492,294,187,107,1,1,80,19,61,116,108,8,1
2021,Breckland 010F,E01033040,638,302,105,197,26,26,177,26,151,133,127,6,0
2021,Breckland 010G,E01033041,520,330,119,211,10,10,48,12,36,132,112,20,0
2021,Breckland 001F,E01033042,877,605,380,225,2,2,72,14,58,197,79,118,1
2021,West Suffolk 011D,E01033043,605,281,163,118,1,1,139,49,90,184,166,18,0
2021,West Suffolk 012D,E01033044,545,301,100,201,15,15,67,5,62,162,157,5,0
2021,West Suffolk 012E,E01033045,524,308,117,191,39,39,56,8,48,121,116,5,0
2021,West Suffolk 011E,E01033046,657,198,108,90,23,23,242,51,191,191,180,11,3
2021,West Suffolk 011F,E01033047,504,306,181,125,3,3,58,21,37,137,132,5,0
2021,West Suffolk 013E,E01033048,703,287,166,121,13,13,213,34,179,190,179,11,0
2021,West Suffolk 013F,E01033049,676,341,247,94,2,2,107,27,80,225,206,19,1
2021,West Suffolk 012F,E01033050,506,341,165,176,1,1,47,3,44,117,108,9,0
2021,Tendring 002F,E01033051,1146,672,390,282,9,9,194,47,147,271,255,16,0
2021,Uttlesford 008F,E01033052,662,421,205,216,2,2,134,102,32,105,81,24,0
2021,Uttlesford 008G,E01033053,762,570,124,446,30,30,71,11,60,91,83,8,0
2021,Uttlesford 007D,E01033054,532,286,127,159,27,27,159,59,100,58,49,9,2
2021,Uttlesford 007E,E01033055,862,715,336,379,11,11,33,9,24,103,89,14,0
2021,Uttlesford 007F,E01033056,641,411,218,193,8,8,154,117,37,66,54,12,2
2021,Coventry 042F,E01033058,843,389,284,105,7,7,145,53,92,301,277,24,1
2021,Bromsgrove 012D,E01033059,590,464,194,270,5,5,16,1,15,105,98,7,0
2021,Bromsgrove 014E,E01033060,471,398,234,164,1,1,10,3,7,62,47,15,0
2021,Bromsgrove 012E,E01033061,670,618,294,324,4,4,5,2,3,43,38,5,0
2021,Bromsgrove 014F,E01033062,910,817,424,393,5,5,30,12,18,58,49,9,0
2021,Brentwood 007F,E01033063,636,392,132,260,23,23,64,7,57,157,148,9,0
2021,Brentwood 007G,E01033064,685,361,160,201,1,1,157,77,80,164,152,12,2
2021,York 013F,E01033067,845,167,78,89,9,9,335,268,67,329,305,24,5
2021,York 013G,E01033068,659,195,128,67,3,3,84,46,38,375,353,22,2
2021,York 013H,E01033069,610,263,165,98,20,20,72,27,45,255,237,18,0
2021,York 013I,E01033070,968,239,147,92,10,10,159,47,112,560,529,31,0
2021,Lancaster 014E,E01033071,607,143,72,71,3,3,68,7,61,393,371,22,0
2021,Lancaster 016I,E01033072,1108,888,560,328,2,2,23,10,13,195,151,44,0
2021,Lancaster 014F,E01033073,687,299,189,110,2,2,90,16,74,294,273,21,2
2021,Sunderland 012F,E01033076,978,458,111,347,1,1,446,220,226,73,61,12,0
2021,Sunderland 027F,E01033077,995,568,224,344,24,24,349,130,219,53,45,8,1
2021,Bath and North East Somerset 010G,E01033078,688,544,340,204,4,4,21,6,15,119,91,28,0
2021,Bath and North East Somerset 010H,E01033079,485,378,224,154,0,0,47,10,37,60,47,13,0
2021,Bath and North East Somerset 009E,E01033080,1162,359,216,143,4,4,202,25,177,597,561,36,0
2021,Hounslow 031D,E01033081,779,265,118,147,34,34,188,87,101,288,274,14,4
2021,Hounslow 031C,E01033082,654,285,172,113,7,7,165,136,29,196,182,14,1
2021,Hounslow 018F,E01033083,789,165,46,119,39,39,60,15,45,525,507,18,0
2021,Hounslow 018G,E01033084,703,134,61,73,42,42,95,30,65,429,418,11,3
2021,Haringey 020F,E01033086,514,85,27,58,12,12,332,270,62,74,70,4,11
2021,Maidstone 006F,E01033087,876,279,89,190,38,38,206,35,171,353,336,17,0
2021,Maidstone 008F,E01033088,844,494,130,364,76,76,85,12,73,189,171,18,0
2021,Maidstone 008G,E01033089,668,319,121,198,14,14,199,34,165,136,117,19,0
2021,Maidstone 006G,E01033091,747,397,149,248,4,4,58,6,52,288,261,27,0
2021,Maidstone 004G,E01033092,759,233,87,146,3,3,204,51,153,319,304,15,0
2021,Sefton 004F,E01033094,684,181,125,56,27,27,71,5,66,405,380,25,0
2021,Sefton 033F,E01033095,1015,866,364,502,0,0,65,16,49,83,69,14,1
2021,Sefton 004G,E01033097,635,203,133,70,1,1,42,1,41,389,370,19,0
2021,Wandsworth 038C,E01033098,948,245,116,129,92,92,38,14,24,573,527,46,0
2021,Wandsworth 004E,E01033099,910,291,87,204,92,92,196,119,77,330,306,24,1
2021,Wandsworth 039B,E01033100,850,189,91,98,30,30,252,191,61,377,366,11,2
2021,North West Leicestershire 011E,E01033102,677,424,131,293,16,16,76,9,67,161,153,8,0
2021,North West Leicestershire 011F,E01033103,860,787,272,515,4,4,7,7,0,61,57,4,1
2021,Kingston upon Hull 029E,E01033104,1077,172,59,113,1,1,241,45,196,663,631,32,0
2021,Kingston upon Hull 035D,E01033105,595,487,148,339,0,0,7,2,5,101,93,8,0
2021,Kingston upon Hull 035E,E01033107,484,386,110,276,0,0,8,2,6,90,79,11,0
2021,Kingston upon Hull 029F,E01033109,879,143,73,70,0,0,256,156,100,478,458,20,2
2021,Fenland 003H,E01033111,759,456,302,154,3,3,104,22,82,195,177,18,1
2021,Fenland 003I,E01033112,690,160,87,73,0,0,141,19,122,389,373,16,0
2021,South Cambridgeshire 020A,E01033113,491,243,101,142,48,48,139,11,128,61,55,6,0
2021,South Cambridgeshire 020B,E01033114,550,322,106,216,36,36,51,8,43,140,136,4,1
2021,South Cambridgeshire 020C,E01033115,477,301,78,223,22,22,57,3,54,97,91,6,0
2021,South Cambridgeshire 021D,E01033116,1019,741,287,454,57,57,131,73,58,86,75,11,4
2021,South Cambridgeshire 020D,E01033117,482,253,69,184,43,43,83,7,76,103,92,11,0
2021,South Cambridgeshire 021E,E01033118,596,409,198,211,23,23,57,28,29,107,94,13,0
2021,South Cambridgeshire 006G,E01033120,552,179,86,93,18,18,213,15,198,141,135,6,1
2021,South Cambridgeshire 006H,E01033121,816,251,64,187,111,111,211,25,186,243,233,10,0
2021,Ipswich 012F,E01033122,1015,166,48,118,49,49,476,37,439,322,308,14,2
2021,Ipswich 011E,E01033123,787,352,176,176,7,7,126,52,74,302,288,14,0
2021,Ipswich 007F,E01033124,683,143,54,89,8,8,93,30,63,439,430,9,0
2021,Ipswich 007G,E01033125,818,136,51,85,5,5,179,39,140,497,472,25,1
2021,Ipswich 011F,E01033126,783,165,88,77,5,5,71,11,60,542,519,23,0
2021,Ipswich 014E,E01033127,657,334,90,244,13,13,170,16,154,140,124,16,0
2021,Ipswich 014F,E01033128,504,289,108,181,0,0,86,5,81,129,116,13,0
2021,Ipswich 007H,E01033129,839,154,66,88,4,4,313,118,195,363,335,28,5
2021,Ipswich 012G,E01033130,626,141,68,73,3,3,196,156,40,285,265,20,1
2021,Ipswich 014G,E01033131,664,243,107,136,2,2,356,303,53,61,53,8,2
2021,Wandsworth 038D,E01033132,1144,259,96,163,46,46,142,107,35,695,659,36,2
2021,Wandsworth 004G,E01033133,647,192,72,120,18,18,101,73,28,336,308,28,0
2021,Wandsworth 010G,E01033135,466,256,114,142,2,2,15,6,9,193,185,8,0
2021,Chelmsford 014F,E01033137,658,446,189,257,15,15,69,2,67,128,118,10,0
2021,Chelmsford 009F,E01033138,632,424,172,252,3,3,93,13,80,110,102,8,2
2021,Chelmsford 009G,E01033139,688,317,94,223,2,2,111,11,100,258,250,8,0
2021,Chelmsford 022D,E01033140,1140,439,203,236,18,18,118,14,104,565,527,38,0
2021,Chelmsford 005E,E01033142,737,569,187,382,21,21,90,2,88,57,52,5,0
2021,Chelmsford 005F,E01033144,626,430,148,282,4,4,120,2,118,72,62,10,0
2021,Chelmsford 014G,E01033145,629,445,245,200,3,3,127,30,97,54,38,16,0
2021,Enfield 025F,E01033146,554,128,39,89,22,22,228,44,184,176,169,7,0
2021,Enfield 003F,E01033148,675,250,72,178,1,1,243,51,192,181,167,14,0
2021,Enfield 003G,E01033150,650,200,30,170,1,1,171,56,115,275,264,11,3
2021,Enfield 025G,E01033151,503,135,78,57,3,3,267,217,50,93,89,4,5
2021,Dorset 002D,E01033156,660,452,203,249,21,21,44,3,41,143,131,12,0
2021,Dorset 002E,E01033158,592,476,301,175,7,7,26,6,20,83,59,24,0
2021,Barrow-in-Furness 009F,E01033160,1044,702,359,343,0,0,238,210,28,101,78,23,3
2021,County Durham 021D,E01033161,647,458,233,225,2,2,13,8,5,174,155,19,0
2021,County Durham 016F,E01033163,817,693,269,424,1,1,36,6,30,87,76,11,0
2021,Derby 018F,E01033166,673,186,54,132,10,10,248,154,94,226,208,18,3
2021,Derby 018G,E01033167,566,102,48,54,7,7,281,120,161,175,164,11,1
2021,Derby 030E,E01033168,485,397,182,215,1,1,28,3,25,59,56,3,0
2021,Derby 030F,E01033169,561,432,123,309,9,9,23,16,7,97,91,6,0
2021,Derby 030G,E01033170,579,433,231,202,5,5,19,11,8,122,109,13,0
2021,Derby 024E,E01033171,791,392,186,206,2,2,75,16,59,322,305,17,0
2021,Derby 024F,E01033172,703,223,96,127,5,5,133,36,97,341,320,21,1
2021,Peterborough 016F,E01033173,819,530,119,411,23,23,26,6,20,240,227,13,0
2021,Peterborough 022C,E01033174,1130,600,127,473,10,10,246,51,195,274,256,18,0
2021,Peterborough 023B,E01033175,547,332,109,223,16,16,62,6,56,137,132,5,0
2021,Peterborough 023D,E01033177,631,369,82,287,15,15,78,13,65,169,159,10,0
2021,Peterborough 022D,E01033179,1165,739,236,503,65,65,179,16,163,182,160,22,0
2021,Peterborough 023F,E01033180,609,291,56,235,4,4,144,46,98,169,162,7,1
2021,Peterborough 022E,E01033181,595,365,113,252,10,10,52,7,45,167,159,8,1
2021,Peterborough 016G,E01033182,673,269,109,160,3,3,162,52,110,235,228,7,4
2021,Richmondshire 004H,E01033184,509,218,65,153,0,0,28,11,17,262,141,121,1
2021,Richmondshire 006F,E01033185,698,445,329,116,5,5,77,62,15,168,132,36,3
2021,Richmondshire 006G,E01033186,713,531,401,130,7,7,66,15,51,108,85,23,1
2021,Central Bedfordshire 014E,E01033188,601,492,261,231,6,6,74,7,67,29,26,3,0
2021,Central Bedfordshire 014F,E01033189,1052,823,233,590,30,30,77,9,68,122,114,8,0
2021,Central Bedfordshire 014G,E01033190,632,443,155,288,17,17,49,3,46,123,111,12,0
2021,Central Bedfordshire 024E,E01033191,712,433,125,308,57,57,107,5,102,115,106,9,0
2021,Central Bedfordshire 024F,E01033192,616,386,61,325,36,36,71,10,61,123,115,8,0
2021,County Durham 030E,E01033195,407,222,149,73,0,0,39,12,27,146,137,9,0
2021,County Durham 030F,E01033197,446,130,88,42,1,1,71,32,39,244,233,11,0
2021,County Durham 021E,E01033198,636,354,186,168,1,1,79,30,49,202,182,20,0
2021,Dorset 047C,E01033200,1072,671,409,262,36,36,102,16,86,263,235,28,0
2021,County Durham 021F,E01033205,610,437,229,208,1,1,62,27,35,109,90,19,1
2021,County Durham 021G,E01033206,666,400,164,236,1,1,167,86,81,97,83,14,1
2021,Lambeth 004G,E01033208,954,260,156,104,68,68,187,22,165,439,387,52,0
2021,Dover 012E,E01033209,587,310,214,96,2,2,19,14,5,256,240,16,0
2021,Dover 010G,E01033210,1002,879,490,389,0,0,38,31,7,85,66,19,0
2021,Dover 012F,E01033211,762,235,169,66,2,2,160,134,26,363,337,26,2
2021,Folkestone and Hythe 014C,E01033212,843,169,99,70,4,4,87,15,72,582,560,22,1
2021,Folkestone and Hythe 002E,E01033213,716,507,174,333,9,9,59,7,52,141,126,15,0
2021,Folkestone and Hythe 002F,E01033214,779,670,313,357,14,14,6,1,5,89,81,8,0
2021,Folkestone and Hythe 014D,E01033215,778,295,231,64,15,15,55,13,42,413,388,25,0
2021,Bolton 016E,E01033217,646,66,34,32,1,1,353,193,160,218,204,14,8
2021,Bolton 028F,E01033218,628,447,136,311,10,10,30,3,27,141,133,8,0
2021,Bolton 028G,E01033219,598,518,270,248,6,6,14,3,11,60,51,9,0
2021,Bolton 016F,E01033220,741,126,86,40,0,0,419,158,261,189,170,19,7
2021,Preston 017F,E01033223,638,28,17,11,0,0,196,19,177,411,395,16,3
2021,Preston 017G,E01033224,552,106,66,40,9,9,210,48,162,226,208,18,1
2021,Preston 017H,E01033226,542,115,86,29,2,2,277,29,248,145,130,15,3
2021,Knowsley 008F,E01033228,1130,522,160,362,10,10,522,257,265,76,67,9,0
2021,Isle of Wight 003D,E01033229,874,682,441,241,9,9,48,6,42,135,124,11,0
2021,Exeter 011F,E01033232,595,281,121,160,16,16,95,8,87,203,196,7,0
2021,Exeter 011G,E01033234,851,592,265,327,24,24,82,12,70,153,142,11,0
2021,Exeter 015E,E01033235,701,459,336,123,8,8,66,40,26,167,151,16,1
2021,Exeter 015F,E01033236,540,386,291,95,1,1,38,34,4,115,100,15,0
2021,Isle of Wight 003E,E01033237,776,322,156,166,11,11,306,30,276,137,123,14,0
2021,Isle of Wight 012H,E01033239,1187,1025,825,200,4,4,28,2,26,130,96,34,0
2021,"Bournemouth, Christchurch and Poole 037D",E01033241,631,251,122,129,0,0,17,3,14,363,350,13,0
2021,"Bournemouth, Christchurch and Poole 038C",E01033242,598,186,110,76,2,2,35,5,30,375,354,21,0
2021,Bromsgrove 014G,E01033243,727,530,244,286,19,19,47,0,47,131,111,20,0
2021,North Northamptonshire 035D,E01033244,1053,881,358,523,13,13,17,2,15,142,132,10,0
2021,North Northamptonshire 035E,E01033245,489,342,167,175,4,4,25,4,21,118,104,14,0
2021,Worcester 007E,E01033246,731,349,214,135,0,0,144,24,120,238,225,13,0
2021,Worcester 007F,E01033247,611,77,38,39,3,3,116,13,103,415,390,25,0
2021,Worcester 011E,E01033248,711,118,69,49,4,4,265,54,211,322,293,29,2
2021,Worcester 011F,E01033249,748,211,110,101,2,2,205,62,143,330,300,30,0
2021,Stratford-on-Avon 010D,E01033250,551,384,152,232,0,0,28,1,27,139,131,8,0
2021,Stratford-on-Avon 010E,E01033251,717,429,228,201,38,38,132,9,123,118,109,9,0
2021,Stratford-on-Avon 010F,E01033252,599,526,345,181,8,8,32,6,26,33,25,8,0
2021,Warwick 007H,E01033253,740,218,106,112,4,4,65,22,43,453,434,19,0
2021,Warwick 011G,E01033254,560,362,93,269,38,38,26,5,21,134,123,11,0
2021,Warwick 011H,E01033255,985,650,222,428,35,35,197,117,80,103,91,12,0
2021,Warwick 007I,E01033256,674,216,108,108,0,0,110,67,43,348,339,9,0
2021,Newcastle-under-Lyme 015H,E01033257,1108,952,527,425,2,2,38,11,27,116,101,15,0
2021,Doncaster 014E,E01033259,663,414,139,275,2,2,18,16,2,227,206,21,2
2021,Doncaster 014F,E01033260,645,366,127,239,3,3,49,45,4,226,210,16,1
2021,Sheffield 073A,E01033261,565,62,24,38,0,0,108,27,81,394,382,12,1
2021,Sheffield 073B,E01033262,934,223,66,157,1,1,64,46,18,646,630,16,0
2021,Sheffield 073C,E01033263,1057,181,51,130,2,2,190,87,103,679,657,22,5
2021,Sheffield 073D,E01033264,909,181,73,108,2,2,59,5,54,667,639,28,0
2021,Sheffield 074C,E01033265,660,83,41,42,3,3,115,7,108,459,441,18,0
2021,Sheffield 075G,E01033268,1050,257,120,137,7,7,465,132,333,321,291,30,0
2021,Sheffield 022G,E01033269,666,114,78,36,4,4,403,309,94,142,129,13,3
2021,Sheffield 022H,E01033270,915,134,60,74,16,16,239,199,40,523,509,14,3
2021,Sheffield 040E,E01033271,819,37,24,13,2,2,486,454,32,288,281,7,6
2021,Sheffield 040F,E01033272,852,103,60,43,1,1,217,144,73,529,508,21,2
2021,Sheffield 042F,E01033273,570,89,46,43,0,0,107,75,32,373,359,14,1
2021,Sheffield 042G,E01033274,431,41,18,23,1,1,35,3,32,354,345,9,0
2021,Sheffield 008F,E01033275,666,466,198,268,10,10,92,6,86,98,85,13,0
2021,Sheffield 073E,E01033276,592,12,4,8,1,1,90,5,85,489,471,18,0
2021,Sheffield 011E,E01033277,1176,442,153,289,15,15,599,483,116,120,107,13,0
2021,Sheffield 076F,E01033279,997,421,202,219,32,32,434,345,89,108,82,26,2
2021,Sheffield 008G,E01033280,605,561,278,283,0,0,2,1,1,42,34,8,0
2021,Rossendale 004G,E01033281,1174,760,391,369,1,1,153,39,114,260,221,39,0
2021,"Bournemouth, Christchurch and Poole 037E",E01033283,692,329,197,132,10,10,25,6,19,327,297,30,1
2021,"Bournemouth, Christchurch and Poole 038D",E01033285,708,145,63,82,5,5,95,68,27,461,442,19,2
2021,"Bournemouth, Christchurch and Poole 040C",E01033286,609,303,154,149,0,0,28,24,4,277,268,9,1
2021,"Bournemouth, Christchurch and Poole 040D",E01033288,643,375,185,190,5,5,41,1,40,222,203,19,0
2021,Cornwall 007E,E01033289,947,597,438,159,14,14,126,73,53,208,148,60,2
2021,Cornwall 004D,E01033291,763,571,399,172,1,1,62,8,54,129,99,30,0
2021,Cornwall 004E,E01033292,674,297,171,126,14,14,234,133,101,127,113,14,2
2021,Cornwall 034E,E01033294,1012,746,432,314,7,7,61,55,6,198,172,26,0
2021,North Lincolnshire 018F,E01033296,593,492,259,233,5,5,20,7,13,76,64,12,0
2021,North Lincolnshire 018G,E01033297,687,428,93,335,5,5,14,8,6,240,226,14,0
2021,Warrington 017F,E01033299,1111,353,97,256,8,8,259,31,228,490,470,20,1
2021,Warrington 018F,E01033300,991,132,67,65,2,2,213,50,163,643,626,17,1
2021,Warrington 018G,E01033302,781,281,116,165,15,15,210,100,110,273,255,18,2
2021,Warrington 017G,E01033303,592,243,124,119,2,2,62,19,43,285,260,25,0
2021,Vale of White Horse 006G,E01033305,667,269,131,138,21,21,99,15,84,278,254,24,0
2021,Vale of White Horse 006H,E01033306,951,424,242,182,3,3,153,16,137,371,347,24,0
2021,Welwyn Hatfield 010E,E01033308,765,116,28,88,40,40,211,20,191,398,386,12,0
2021,Welwyn Hatfield 002E,E01033310,650,413,150,263,4,4,83,7,76,150,143,7,0
2021,Welwyn Hatfield 010F,E01033311,584,322,148,174,1,1,171,160,11,87,80,7,3
2021,Welwyn Hatfield 002F,E01033313,546,405,161,244,3,3,64,16,48,74,63,11,0
2021,Welwyn Hatfield 010G,E01033314,696,195,47,148,18,18,191,17,174,292,276,16,0
2021,Mid Suffolk 010F,E01033316,793,520,143,377,40,40,67,27,40,166,158,8,0
2021,Mid Suffolk 010G,E01033317,790,439,175,264,9,9,61,13,48,281,255,26,0
2021,Mid Suffolk 010H,E01033319,1056,798,259,539,4,4,40,12,28,213,205,8,1
2021,Lewisham 017E,E01033320,638,320,121,199,5,5,110,32,78,203,194,9,0
2021,Lewisham 017F,E01033322,571,220,53,167,16,16,122,18,104,213,206,7,0
2021,Lewisham 008E,E01033324,629,253,111,142,3,3,273,195,78,99,88,11,1
2021,Lewisham 008F,E01033325,718,189,36,153,23,23,40,13,27,466,443,23,0
2021,Lewisham 041B,E01033327,1003,372,100,272,23,23,114,23,91,494,464,30,0
2021,Brighton and Hove 027F,E01033328,681,267,146,121,7,7,121,30,91,285,275,10,1
2021,Brighton and Hove 027G,E01033329,849,224,99,125,101,101,124,32,92,400,380,20,0
2021,Salford 033E,E01033330,827,129,79,50,8,8,579,241,338,106,90,16,5
2021,South Gloucestershire 021F,E01033334,604,286,84,202,3,3,8,0,8,307,203,104,0
2021,South Gloucestershire 021G,E01033336,600,511,195,316,0,0,26,1,25,63,61,2,0
2021,South Gloucestershire 019F,E01033338,641,466,188,278,16,16,43,3,40,116,110,6,0
2021,South Gloucestershire 019G,E01033339,622,339,138,201,17,17,156,25,131,109,99,10,1
2021,Lewisham 041C,E01033341,567,164,66,98,8,8,178,88,90,214,208,6,3
2021,Bristol 025E,E01033342,597,101,36,65,6,6,107,83,24,378,350,28,5
2021,Bristol 060D,E01033344,630,170,80,90,15,15,111,28,83,334,317,17,0
2021,Bristol 059D,E01033347,1034,236,62,174,30,30,214,12,202,553,527,26,1
2021,Bristol 059C,E01033348,527,72,29,43,46,46,173,51,122,236,223,13,0
2021,Bristol 061D,E01033350,705,336,180,156,3,3,72,46,26,291,267,24,3
2021,Bristol 054A,E01033352,916,240,65,175,23,23,158,93,65,493,466,27,2
2021,Bristol 054B,E01033353,864,152,39,113,40,40,211,101,110,457,438,19,4
2021,Bristol 056C,E01033356,693,132,51,81,4,4,390,299,91,165,153,12,2
2021,Bristol 054D,E01033358,845,92,30,62,11,11,451,338,113,285,269,16,6
2021,Bristol 039E,E01033359,911,249,45,204,10,10,209,27,182,443,418,25,0
2021,Bristol 039F,E01033361,783,209,86,123,4,4,276,246,30,290,274,16,4
2021,Bristol 039G,E01033362,734,284,107,177,17,17,75,17,58,358,338,20,0
2021,Bristol 039H,E01033364,819,429,139,290,4,4,99,86,13,287,265,22,0
2021,Bristol 059B,E01033366,577,72,26,46,29,29,359,275,84,111,104,7,6
2021,Bristol 025F,E01033367,673,137,54,83,3,3,229,176,53,301,290,11,3
2021,Bristol 056D,E01033369,589,141,71,70,2,2,377,312,65,66,62,4,3
2021,Bristol 054E,E01033370,664,50,27,23,3,3,380,365,15,224,212,12,7
2021,Cheshire East 050E,E01033372,593,377,202,175,11,11,32,5,27,173,156,17,0
2021,Cheshire East 050F,E01033373,737,365,234,131,14,14,210,31,179,148,136,12,0
2021,Cheshire East 053B,E01033375,724,574,182,392,21,21,27,5,22,102,93,9,0
2021,Cheshire East 053A,E01033376,444,291,85,206,0,0,3,1,2,150,144,6,0
2021,Cheshire East 053E,E01033378,584,509,257,252,2,2,19,3,16,53,43,10,1
2021,Portsmouth 024E,E01033380,698,291,194,97,11,11,63,25,38,332,299,33,1
2021,Portsmouth 027D,E01033381,756,134,48,86,38,38,228,109,119,355,344,11,1
2021,Portsmouth 027B,E01033383,590,108,65,43,4,4,319,252,67,153,139,14,6
2021,Portsmouth 024F,E01033384,768,462,308,154,1,1,79,17,62,226,192,34,0
2021,Charnwood 001E,E01033386,908,634,417,217,8,8,140,39,101,125,114,11,1
2021,Chesterfield 010F,E01033387,659,223,83,140,3,3,36,13,23,397,366,31,0
2021,Chesterfield 010G,E01033388,788,411,203,208,10,10,151,111,40,215,200,15,1
2021,Mansfield 013G,E01033389,620,388,130,258,0,0,10,10,0,222,208,14,0
2021,Mansfield 013H,E01033390,660,482,129,353,0,0,13,10,3,164,153,11,1
2021,Mansfield 013I,E01033391,523,471,280,191,0,0,13,7,6,38,28,10,1
2021,Mansfield 006G,E01033392,1143,713,357,356,5,5,176,153,23,242,222,20,7
2021,Newark and Sherwood 012G,E01033394,629,522,290,232,10,10,36,24,12,60,51,9,1
2021,Nottingham 026G,E01033395,433,35,19,16,3,3,102,33,69,292,272,20,1
2021,Nottingham 026H,E01033396,516,70,33,37,0,0,267,162,105,177,169,8,2
2021,Nottingham 006F,E01033397,739,317,85,232,3,3,209,170,39,209,195,14,1
2021,Nottingham 006G,E01033398,626,154,51,103,3,3,218,206,12,247,236,11,4
2021,Nottingham 023E,E01033399,456,89,56,33,0,0,232,137,95,130,114,16,5
2021,Nottingham 039B,E01033400,977,199,83,116,0,0,157,111,46,621,594,27,0
2021,Nottingham 039C,E01033402,657,72,24,48,16,16,141,12,129,427,407,20,1
2021,Nottingham 039F,E01033407,647,88,44,44,1,1,48,32,16,508,498,10,2
2021,Nottingham 023H,E01033409,486,18,14,4,0,0,399,358,41,65,63,2,4
2021,Nottingham 031I,E01033410,816,175,115,60,2,2,51,12,39,585,559,26,3
2021,Nottingham 023I,E01033411,574,127,71,56,1,1,357,279,78,83,74,9,6
2021,Broxtowe 016F,E01033412,1012,903,545,358,2,2,39,36,3,68,58,10,0
2021,Broxtowe 016G,E01033413,984,776,390,386,2,2,49,46,3,155,137,18,2
2021,North East Lincolnshire 009E,E01033414,1200,812,408,404,64,64,134,47,87,190,167,23,0
2021,Reading 019B,E01033415,1091,179,57,122,30,30,108,43,65,773,747,26,1
2021,Reading 010F,E01033417,623,167,59,108,4,4,86,52,34,364,352,12,2
2021,Reading 019A,E01033418,717,179,47,132,16,16,79,5,74,443,431,12,0
2021,Reading 020B,E01033420,690,148,73,75,10,10,93,7,86,438,423,15,1
2021,Reading 010G,E01033421,1068,219,54,165,28,28,398,230,168,419,401,18,4
2021,Reading 019D,E01033422,689,116,46,70,31,31,102,25,77,440,428,12,0
2021,Reading 020A,E01033423,793,156,50,106,2,2,50,3,47,584,568,16,1
2021,East Cambridgeshire 004F,E01033425,706,532,173,359,13,13,42,2,40,119,109,10,0
2021,East Cambridgeshire 003F,E01033426,564,430,147,283,7,7,43,2,41,83,72,11,1
2021,East Cambridgeshire 006G,E01033427,506,289,83,206,35,35,77,8,69,104,98,6,1
2021,East Cambridgeshire 006H,E01033429,893,599,309,290,18,18,55,7,48,221,199,22,0
2021,East Cambridgeshire 003G,E01033430,586,276,158,118,4,4,235,38,197,70,64,6,1
2021,Bedford 004F,E01033431,587,378,120,258,36,36,121,26,95,52,48,4,0
2021,Norwich 011G,E01033434,667,258,142,116,12,12,66,59,7,331,309,22,0
2021,Norwich 005G,E01033435,763,206,61,145,9,9,125,42,83,422,400,22,1
2021,Norwich 005H,E01033436,825,186,91,95,0,0,472,292,180,166,148,18,1
2021,Norwich 011H,E01033437,792,156,89,67,17,17,470,421,49,145,133,12,4
2021,Norwich 014A,E01033438,1183,393,264,129,1,1,235,52,183,554,497,57,0
2021,Norwich 014C,E01033440,923,216,97,119,19,19,329,136,193,359,340,19,0
2021,Norwich 014D,E01033441,844,286,148,138,5,5,93,48,45,459,437,22,1
2021,East Suffolk 025F,E01033442,555,384,114,270,1,1,24,4,20,146,132,14,0
2021,East Suffolk 023B,E01033443,517,307,185,122,0,0,32,5,27,178,44,134,0
2021,East Suffolk 025G,E01033444,523,364,80,284,0,0,27,8,19,132,125,7,0
2021,East Suffolk 023C,E01033445,669,487,174,313,2,2,58,7,51,122,105,17,0
2021,East Suffolk 023D,E01033446,976,722,487,235,3,3,83,9,74,168,137,31,0
2021,East Suffolk 025H,E01033447,592,532,311,221,2,2,15,3,12,43,39,4,0
2021,East Suffolk 023E,E01033448,556,379,266,113,0,0,62,6,56,114,92,22,1
2021,East Suffolk 023F,E01033449,769,516,245,271,1,1,49,4,45,203,184,19,0
2021,East Suffolk 028E,E01033450,1121,934,696,238,2,2,90,13,77,95,79,16,0
2021,West Suffolk 007C,E01033452,738,392,177,215,1,1,89,15,74,256,240,16,0
2021,West Suffolk 007D,E01033454,753,454,140,314,19,19,51,12,39,229,210,19,0
2021,Brent 031G,E01033455,498,82,52,30,3,3,136,56,80,277,266,11,0
2021,Brent 027F,E01033456,874,97,36,61,23,23,622,235,387,126,115,11,6
2021,Brent 035A,E01033457,579,212,121,91,3,3,11,5,6,352,327,25,1
2021,Braintree 009E,E01033458,826,259,108,151,0,0,131,16,115,436,417,19,0
2021,Braintree 009F,E01033459,823,412,225,187,7,7,62,14,48,342,318,24,0
2021,Braintree 017F,E01033460,865,580,183,397,20,20,123,21,102,142,128,14,0
2021,Braintree 017G,E01033461,559,385,82,303,11,11,63,6,57,100,91,9,0
2021,Braintree 017H,E01033462,492,269,100,169,11,11,55,7,48,157,148,9,0
2021,Brent 003G,E01033463,910,593,388,205,4,4,41,34,7,272,242,30,0
2021,Hartlepool 001F,E01033465,739,583,207,376,0,0,33,14,19,123,106,17,0
2021,Hartlepool 003I,E01033466,980,332,166,166,15,15,437,226,211,191,173,18,5
2021,Hartlepool 001G,E01033467,1020,625,164,461,45,45,241,57,184,109,92,17,0
2021,Middlesbrough 006E,E01033469,903,309,167,142,0,0,469,248,221,125,111,14,0
2021,Redcar and Cleveland 022G,E01033470,828,313,188,125,9,9,335,149,186,171,154,17,0
2021,Redcar and Cleveland 009F,E01033471,840,276,145,131,1,1,407,232,175,152,144,8,4
2021,Redcar and Cleveland 019G,E01033472,1056,760,413,347,0,0,104,58,46,191,175,16,1
2021,Redcar and Cleveland 013E,E01033473,912,395,236,159,20,20,334,162,172,161,145,16,2
2021,Stockton-on-Tees 027C,E01033474,999,753,130,623,0,0,11,4,7,235,214,21,0
2021,Stockton-on-Tees 028A,E01033475,584,503,109,394,2,2,9,6,3,70,64,6,0
2021,Stockton-on-Tees 005F,E01033476,731,666,288,378,0,0,5,4,1,60,53,7,0
2021,Stockton-on-Tees 027A,E01033479,621,528,165,363,0,0,11,5,6,82,73,9,0
2021,Stockton-on-Tees 005G,E01033480,1146,1019,415,604,5,5,34,8,26,87,71,16,1
2021,Darlington 001E,E01033481,751,505,152,353,5,5,44,10,34,197,173,24,0
2021,Darlington 001F,E01033482,707,537,218,319,0,0,8,6,2,161,145,16,1
2021,Brent 031H,E01033485,709,168,72,96,4,4,247,111,136,287,271,16,3
2021,Islington 011E,E01033486,421,91,38,53,6,6,210,141,69,114,106,8,0
2021,Islington 011F,E01033487,593,141,37,104,37,37,114,16,98,301,286,15,0
2021,Islington 011G,E01033488,619,121,39,82,1,1,321,123,198,175,168,7,1
2021,Islington 022G,E01033489,680,253,106,147,11,11,84,23,61,332,315,17,0
2021,Islington 022H,E01033490,556,114,52,62,4,4,200,143,57,237,216,21,1
2021,Islington 011H,E01033491,966,241,89,152,18,18,240,143,97,465,442,23,2
2021,Islington 006F,E01033493,687,233,81,152,16,16,40,23,17,398,354,44,0
2021,Islington 006G,E01033494,651,316,129,187,11,11,129,81,48,194,185,9,1
2021,East Riding of Yorkshire 032G,E01033495,615,373,99,274,10,10,18,12,6,214,205,9,0
2021,East Riding of Yorkshire 032H,E01033496,641,591,304,287,1,1,6,4,2,43,37,6,0
2021,Milton Keynes 023E,E01033497,765,350,177,173,14,14,153,54,99,247,222,25,1
2021,Milton Keynes 023F,E01033498,836,271,119,152,69,69,345,194,151,149,136,13,2
2021,Milton Keynes 014E,E01033499,1060,144,75,69,11,11,281,152,129,620,595,25,4
2021,Milton Keynes 014F,E01033500,842,133,31,102,80,80,119,23,96,510,498,12,0
2021,Milton Keynes 016E,E01033501,743,335,89,246,77,77,157,5,152,174,167,7,0
2021,Milton Keynes 033A,E01033503,904,562,189,373,98,98,95,14,81,149,142,7,0
2021,Milton Keynes 016F,E01033506,723,473,159,314,25,25,95,4,91,130,118,12,0
2021,Milton Keynes 034C,E01033508,920,519,100,419,88,88,128,21,107,185,178,7,0
2021,Milton Keynes 033B,E01033511,686,223,37,186,125,125,117,12,105,221,211,10,0
2021,Milton Keynes 025E,E01033514,584,348,64,284,52,52,81,22,59,103,94,9,0
2021,Milton Keynes 025F,E01033515,661,462,131,331,10,10,99,10,89,90,85,5,0
2021,Milton Keynes 025G,E01033517,550,385,85,300,30,30,6,4,2,129,125,4,0
2021,Milton Keynes 028E,E01033519,1020,576,121,455,143,143,142,8,134,159,150,9,0
2021,Milton Keynes 028F,E01033520,661,488,158,330,33,33,38,3,35,102,92,10,0
2021,Milton Keynes 036E,E01033522,680,281,42,239,133,133,131,21,110,135,129,6,0
2021,Milton Keynes 036D,E01033523,545,219,31,188,87,87,82,10,72,157,151,6,0
2021,Shropshire 038H,E01033526,633,272,218,54,1,1,166,14,152,194,166,28,0
2021,Shropshire 038I,E01033527,694,486,414,72,8,8,62,7,55,138,122,16,0
2021,Shropshire 006H,E01033528,1039,760,390,370,14,14,78,6,72,186,168,18,1
2021,Shropshire 030E,E01033530,829,529,370,159,5,5,75,9,66,220,185,35,0
2021,South Derbyshire 002F,E01033532,620,483,167,316,2,2,12,3,9,123,114,9,0
2021,South Derbyshire 002G,E01033533,594,483,183,300,1,1,33,1,32,77,65,12,0
2021,South Derbyshire 002H,E01033534,491,292,70,222,0,0,8,3,5,191,183,8,0
2021,South Derbyshire 013D,E01033535,548,471,166,305,0,0,9,8,1,68,62,6,0
2021,South Derbyshire 012D,E01033536,768,463,194,269,7,7,102,12,90,196,177,19,0
2021,South Derbyshire 012E,E01033537,710,486,257,229,4,4,46,34,12,173,154,19,1
2021,South Norfolk 015G,E01033539,910,520,238,282,17,17,100,18,82,273,257,16,0
2021,South Norfolk 016E,E01033540,671,486,276,210,5,5,113,25,88,65,51,14,2
2021,South Norfolk 015H,E01033541,694,401,267,134,14,14,95,18,77,184,173,11,0
2021,Newcastle upon Tyne 036C,E01033543,836,83,38,45,2,2,147,7,140,604,584,20,0
2021,Newcastle upon Tyne 036D,E01033545,957,172,93,79,6,6,176,11,165,602,582,20,1
2021,Newcastle upon Tyne 025E,E01033547,1167,401,142,259,6,6,602,446,156,152,126,26,6
2021,Newcastle upon Tyne 037C,E01033548,661,187,88,99,7,7,238,189,49,229,206,23,0
2021,Newcastle upon Tyne 002F,E01033550,702,621,251,370,0,0,8,4,4,73,67,6,0
2021,Newcastle upon Tyne 002G,E01033551,771,665,374,291,3,3,17,8,9,86,76,10,0
2021,Newcastle upon Tyne 037B,E01033553,638,68,28,40,0,0,200,144,56,369,332,37,1
2021,Newcastle upon Tyne 022H,E01033556,880,225,119,106,6,6,178,114,64,470,445,25,1
2021,Birmingham 134B,E01033557,988,190,72,118,4,4,43,5,38,751,725,26,0
2021,Birmingham 049E,E01033559,911,190,53,137,0,0,145,16,129,576,554,22,0
2021,Birmingham 050E,E01033561,413,37,20,17,0,0,278,189,89,92,79,13,6
2021,Birmingham 087F,E01033562,1009,349,220,129,9,9,242,217,25,405,384,21,4
2021,Birmingham 136C,E01033564,722,117,32,85,0,0,70,35,35,535,516,19,0
2021,Birmingham 137B,E01033565,876,163,26,137,18,18,62,7,55,632,618,14,1
2021,Birmingham 135B,E01033567,638,80,23,57,8,8,41,6,35,509,493,16,0
2021,Kingston upon Thames 004G,E01033569,803,343,148,195,7,7,64,20,44,389,373,16,0
2021,Richmond upon Thames 004G,E01033570,832,381,144,237,38,38,125,10,115,288,266,22,0
2021,Richmond upon Thames 004H,E01033571,608,372,190,182,0,0,158,37,121,78,71,7,0
2021,Newham 040C,E01033579,896,243,46,197,54,54,109,47,62,490,464,26,0
2021,Newham 042A,E01033580,587,220,62,158,9,9,31,9,22,326,309,17,1
2021,Newham 041A,E01033581,747,172,64,108,21,21,329,237,92,223,215,8,2
2021,Newham 041B,E01033582,600,169,33,136,8,8,30,14,16,393,380,13,0
2021,Newham 034I,E01033584,562,87,25,62,12,12,350,187,163,110,97,13,3
2021,Newham 040D,E01033586,904,194,60,134,26,26,278,159,119,403,384,19,3
2021,Barking and Dagenham 021E,E01033587,1039,195,31,164,16,16,451,321,130,377,360,17,0
2021,Redbridge 039B,E01033589,666,104,45,59,26,26,60,21,39,475,461,14,1
2021,Redbridge 037C,E01033590,418,134,34,100,16,16,91,25,66,176,168,8,1
2021,Redbridge 039A,E01033591,1014,235,101,134,5,5,104,53,51,668,645,23,2
2021,Redbridge 037D,E01033592,626,390,174,216,20,20,68,18,50,147,130,17,1
2021,Westminster 015F,E01033593,872,110,70,40,38,38,302,75,227,422,387,35,0
2021,Westminster 015G,E01033594,701,145,87,58,6,6,201,24,177,347,295,52,2
2021,Westminster 023F,E01033597,584,106,56,50,10,10,288,85,203,177,163,14,3
2021,Westminster 009F,E01033598,546,53,30,23,6,6,344,253,91,130,123,7,13
2021,Westminster 023G,E01033599,525,39,18,21,39,39,355,48,307,90,81,9,2
2021,Westminster 009G,E01033601,608,96,62,34,3,3,409,269,140,93,86,7,7
2021,Westminster 009H,E01033602,633,77,45,32,3,3,409,275,134,137,128,9,7
2021,Westminster 009I,E01033603,592,117,74,43,2,2,226,107,119,245,231,14,2
2021,Westminster 009J,E01033604,543,35,18,17,2,2,177,29,148,327,311,16,2
2021,Westminster 009K,E01033605,699,134,73,61,13,13,366,291,75,176,163,13,10
2021,East Hertfordshire 010E,E01033609,1083,719,365,354,18,18,181,20,161,164,143,21,1
2021,Thurrock 019B,E01033610,553,404,61,343,1,1,5,2,3,143,130,13,0
2021,Thurrock 019C,E01033611,631,319,57,262,1,1,10,3,7,301,288,13,0
2021,Thurrock 020D,E01033612,594,417,111,306,3,3,22,6,16,152,144,8,0
2021,Thurrock 019D,E01033613,575,373,100,273,2,2,3,1,2,197,183,14,0
2021,Thurrock 020E,E01033614,611,493,118,375,4,4,3,2,1,110,96,14,1
2021,Birmingham 135C,E01033615,483,82,21,61,7,7,30,5,25,364,341,23,0
2021,Birmingham 135D,E01033616,757,93,36,57,7,7,412,54,358,243,223,20,2
2021,Birmingham 050F,E01033617,851,28,9,19,0,0,102,17,85,719,677,42,2
2021,Birmingham 137C,E01033618,757,174,61,113,1,1,34,16,18,548,536,12,0
2021,Birmingham 138A,E01033620,739,124,34,90,6,6,96,14,82,510,488,22,3
2021,Birmingham 138B,E01033622,1162,216,64,152,9,9,127,60,67,808,786,22,2
2021,Birmingham 138C,E01033623,1066,181,47,134,2,2,328,27,301,555,535,20,0
2021,Birmingham 134C,E01033624,771,194,53,141,6,6,186,17,169,385,369,16,0
2021,Birmingham 138D,E01033625,1100,190,80,110,3,3,57,14,43,850,822,28,0
2021,Birmingham 134D,E01033626,595,106,26,80,3,3,204,16,188,279,269,10,3
2021,Birmingham 137E,E01033627,503,123,54,69,0,0,220,188,32,159,152,7,1
2021,Birmingham 106F,E01033629,1051,420,209,211,3,3,450,402,48,166,141,25,12
2021,Birmingham 031H,E01033630,596,135,28,107,10,10,149,9,140,302,293,9,0
2021,Birmingham 049F,E01033638,667,133,73,60,3,3,462,317,145,61,51,10,8
2021,Birmingham 134E,E01033640,899,128,41,87,2,2,333,169,164,433,416,17,3
2021,Birmingham 063F,E01033642,836,478,269,209,0,0,106,74,32,248,215,33,4
2021,Birmingham 082F,E01033643,822,409,258,151,1,1,160,26,134,247,216,31,5
2021,Birmingham 031I,E01033646,851,171,88,83,12,12,294,91,203,370,354,16,4
2021,Birmingham 084F,E01033648,827,345,258,87,2,2,314,31,283,165,141,24,1
2021,Birmingham 058F,E01033649,493,256,118,138,2,2,81,60,21,152,139,13,2
2021,Birmingham 077F,E01033650,724,385,262,123,4,4,177,53,124,156,119,37,2
2021,Manchester 054B,E01033651,957,144,35,109,2,2,70,37,33,741,720,21,0
2021,Manchester 055B,E01033653,1145,238,84,154,8,8,182,6,176,717,680,37,0
2021,Manchester 055C,E01033654,563,137,58,79,1,1,20,0,20,405,386,19,0
2021,Manchester 056B,E01033655,745,131,25,106,0,0,4,0,4,610,599,11,0
2021,Manchester 057B,E01033656,483,95,26,69,3,3,7,2,5,378,370,8,0
2021,Manchester 054C,E01033658,711,166,64,102,8,8,42,1,41,495,477,18,0
2021,Manchester 059B,E01033660,861,243,44,199,2,2,5,2,3,611,593,18,0
2021,Manchester 055E,E01033661,1202,248,88,160,2,2,173,98,75,777,754,23,2
2021,Manchester 057C,E01033662,966,160,50,110,4,4,127,16,111,674,649,25,1
2021,Manchester 054D,E01033664,1076,146,34,112,2,2,152,47,105,776,755,21,0
2021,Manchester 056C,E01033665,916,206,82,124,11,11,142,90,52,555,532,23,2
2021,Manchester 054E,E01033667,880,185,65,120,22,22,95,38,57,578,556,22,0
2021,Manchester 015F,E01033668,593,112,34,78,8,8,137,46,91,336,323,13,0
2021,Manchester 015G,E01033669,647,145,71,74,1,1,353,135,218,147,140,7,1
2021,Manchester 039E,E01033670,781,378,97,281,4,4,4,3,1,395,376,19,0
2021,Manchester 039F,E01033671,827,446,124,322,5,5,12,3,9,364,348,16,0
2021,Manchester 059C,E01033672,922,188,100,88,3,3,378,145,233,351,344,7,2
2021,Manchester 059D,E01033673,857,195,45,150,2,2,4,0,4,656,644,12,0
2021,Manchester 058C,E01033674,666,139,43,96,4,4,105,9,96,417,400,17,1
2021,Manchester 058D,E01033675,772,234,96,138,5,5,215,18,197,318,297,21,0
2021,Manchester 056D,E01033676,732,191,86,105,6,6,437,258,179,92,79,13,6
2021,Manchester 060A,E01033677,609,169,70,99,4,4,8,1,7,428,396,32,0
2021,Manchester 009F,E01033678,660,145,52,93,2,2,393,226,167,115,107,8,5
2021,Manchester 009G,E01033679,581,83,37,46,0,0,415,279,136,79,63,16,4
2021,Manchester 028E,E01033680,674,151,62,89,3,3,165,37,128,353,343,10,2
2021,Manchester 060B,E01033681,850,265,96,169,6,6,7,1,6,572,543,29,0
2021,Manchester 060C,E01033682,753,286,112,174,3,3,11,6,5,452,422,30,1
2021,Manchester 062D,E01033684,1018,183,24,159,1,1,28,2,26,805,782,23,1
2021,Manchester 003F,E01033685,632,333,103,230,4,4,110,82,28,183,175,8,2
2021,Manchester 028F,E01033686,646,224,90,134,2,2,198,15,183,221,211,10,1
2021,Manchester 003G,E01033687,763,177,91,86,2,2,465,335,130,111,108,3,8
2021,Manchester 062B,E01033688,701,150,80,70,6,6,462,170,292,83,72,11,0
2021,Bradford 020E,E01033689,844,131,60,71,2,2,214,99,115,497,475,22,0
2021,Bradford 065C,E01033690,1050,29,15,14,0,0,44,11,33,977,958,19,0
2021,Bradford 065B,E01033691,1010,143,81,62,4,4,324,105,219,538,520,18,1
2021,Bradford 064D,E01033692,610,40,20,20,11,11,192,68,124,365,352,13,2
2021,Bradford 064A,E01033693,939,254,167,87,6,6,247,20,227,432,399,33,0
2021,Bradford 020F,E01033694,568,307,152,155,10,10,23,7,16,228,215,13,0
2021,Bradford 049H,E01033695,736,476,156,320,1,1,101,8,93,157,145,12,1
2021,Bradford 049I,E01033696,694,459,207,252,0,0,56,17,39,179,165,14,0
2021,Bradford 049J,E01033697,791,509,291,218,1,1,26,13,13,254,208,46,1
2021,Hackney 030A,E01033699,713,139,41,98,21,21,149,12,137,403,385,18,1
2021,Hackney 030B,E01033700,1132,268,79,189,23,23,199,86,113,641,613,28,1
2021,Hackney 028C,E01033702,559,141,33,108,53,53,183,40,143,178,171,7,4
2021,Hackney 010F,E01033703,559,117,35,82,5,5,202,64,138,234,222,12,1
2021,Hackney 023F,E01033704,1104,285,61,224,122,122,176,33,143,519,498,21,2
2021,Hackney 028D,E01033705,551,126,43,83,5,5,279,98,181,141,129,12,0
2021,Hackney 033B,E01033706,733,143,55,88,8,8,108,101,7,466,441,25,8
2021,Hackney 033C,E01033708,936,172,70,102,18,18,89,27,62,656,629,27,1
2021,Hackney 032B,E01033709,872,114,47,67,28,28,418,206,212,311,292,19,1
2021,Hackney 028E,E01033710,515,120,37,83,16,16,109,35,74,270,262,8,0
2021,Hackney 032C,E01033711,881,203,84,119,29,29,104,39,65,545,517,28,0
2021,Hackney 023G,E01033712,694,136,45,91,25,25,302,186,116,229,217,12,2
2021,Hackney 010G,E01033713,610,233,52,181,16,16,163,41,122,198,183,15,0
2021,Northumberland 033F,E01033714,1180,1038,627,411,2,2,36,6,30,104,81,23,0
2021,Northumberland 005D,E01033715,665,263,184,79,1,1,245,61,184,156,136,20,0
2021,Northumberland 013F,E01033716,1057,552,340,212,2,2,322,180,142,181,159,22,0
2021,Northumberland 005E,E01033717,734,560,349,211,4,4,86,52,34,84,76,8,0
2021,Northumberland 016F,E01033718,980,541,302,239,1,1,318,85,233,119,92,27,1
2021,Colchester 008G,E01033719,728,85,28,57,5,5,109,11,98,529,510,19,0
2021,Colchester 002F,E01033720,771,412,127,285,12,12,120,20,100,227,220,7,0
2021,Colchester 002G,E01033721,656,494,136,358,3,3,22,2,20,137,128,9,0
2021,Colchester 008H,E01033722,551,136,91,45,0,0,190,20,170,225,218,7,0
2021,Greenwich 035B,E01033727,965,235,46,189,50,50,369,223,146,310,292,18,1
2021,Greenwich 035C,E01033728,864,323,104,219,19,19,96,20,76,426,408,18,0
2021,Greenwich 030E,E01033729,760,259,118,141,9,9,398,389,9,90,85,5,4
2021,Greenwich 041E,E01033732,453,114,30,84,25,25,107,15,92,207,202,5,0
2021,Greenwich 039B,E01033734,631,169,29,140,55,55,137,7,130,270,258,12,0
2021,Greenwich 042D,E01033735,592,63,19,44,0,0,166,143,23,360,356,4,3
2021,Greenwich 039A,E01033736,1167,360,53,307,19,19,52,21,31,736,712,24,0
2021,Greenwich 042B,E01033737,813,193,46,147,34,34,340,228,112,243,232,11,3
2021,Greenwich 037D,E01033738,742,329,110,219,3,3,115,24,91,295,277,18,0
2021,Greenwich 002E,E01033739,650,147,24,123,26,26,142,16,126,333,316,17,2
2021,Greenwich 002F,E01033740,546,194,51,143,21,21,104,19,85,227,213,14,0
2021,Greenwich 002G,E01033741,638,244,36,208,39,39,111,12,99,244,230,14,0
2021,Greenwich 007F,E01033742,566,153,35,118,50,50,53,16,37,306,274,32,4
2021,Greenwich 002H,E01033743,663,222,37,185,15,15,180,34,146,246,235,11,0
2021,Greenwich 007G,E01033744,661,190,57,133,13,13,252,34,218,205,184,21,1
2021,Greenwich 002I,E01033745,589,248,50,198,28,28,127,27,100,180,167,13,6
2021,Greenwich 038E,E01033746,704,328,139,189,4,4,223,123,100,147,137,10,2
2021,Liverpool 018F,E01033747,808,301,73,228,6,6,381,26,355,120,103,17,0
2021,Liverpool 050I,E01033748,732,251,96,155,0,0,12,4,8,469,450,19,0
2021,Liverpool 061A,E01033750,1136,249,106,143,8,8,44,8,36,835,802,33,0
2021,Liverpool 062A,E01033751,856,195,91,104,2,2,171,30,141,488,464,24,0
2021,Liverpool 061C,E01033756,574,155,79,76,15,15,65,30,35,334,312,22,5
2021,Liverpool 037E,E01033757,522,49,15,34,0,0,254,13,241,219,209,10,0
2021,Liverpool 060B,E01033758,494,21,11,10,3,3,149,33,116,321,303,18,0
2021,Liverpool 060C,E01033760,441,53,25,28,7,7,29,0,29,352,328,24,0
2021,Liverpool 060D,E01033761,1072,112,43,69,31,31,83,12,71,846,832,14,0
2021,Liverpool 060E,E01033762,602,59,31,28,6,6,104,8,96,433,417,16,0
2021,Liverpool 031G,E01033763,1030,329,114,215,9,9,443,56,387,245,221,24,4
2021,Liverpool 061D,E01033765,720,199,99,100,1,1,338,99,239,177,168,9,5
2021,Liverpool 050J,E01033767,515,197,117,80,0,0,166,27,139,152,141,11,0
2021,Liverpool 037F,E01033768,738,63,28,35,10,10,491,36,455,172,167,5,2
2021,Bassetlaw 014F,E01033769,855,460,258,202,1,1,129,69,60,263,211,52,2
2021,Newark and Sherwood 001G,E01033770,610,371,126,245,9,9,68,20,48,162,147,15,0
2021,Newark and Sherwood 001H,E01033771,622,535,404,131,1,1,9,7,2,77,55,22,0
2021,Newark and Sherwood 002F,E01033772,553,408,70,338,4,4,27,1,26,114,111,3,0
2021,Newark and Sherwood 002G,E01033773,548,490,90,400,1,1,10,6,4,47,40,7,0
2021,Newark and Sherwood 002H,E01033774,553,357,161,196,5,5,70,13,57,121,107,14,0
2021,Mansfield 007G,E01033775,611,509,157,352,9,9,34,5,29,59,51,8,0
2021,Mansfield 007H,E01033776,612,526,241,285,1,1,4,4,0,81,69,12,0
2021,Newark and Sherwood 012H,E01033777,597,358,85,273,28,28,30,5,25,181,172,9,0
2021,Ashfield 013F,E01033778,473,308,85,223,4,4,78,9,69,83,53,30,0
2021,Ashfield 013G,E01033779,501,407,125,282,12,12,34,2,32,48,44,4,0
2021,Newark and Sherwood 012I,E01033780,613,468,145,323,11,11,14,6,8,120,110,10,0
2021,Ashfield 013H,E01033781,599,259,115,144,2,2,205,144,61,132,132,0,1
2021,Ashfield 013I,E01033782,610,408,225,183,4,4,135,118,17,62,53,9,1
2021,Ashfield 013J,E01033783,593,452,184,268,4,4,35,8,27,102,87,15,0
2021,Havering 007F,E01033784,679,460,212,248,7,7,54,11,43,157,152,5,1
2021,Havering 007G,E01033785,634,378,47,331,32,32,56,23,33,168,154,14,0
2021,Havering 017G,E01033786,558,161,27,134,3,3,123,8,115,269,261,8,2
2021,Havering 017H,E01033787,571,123,14,109,30,30,224,17,207,194,182,12,0
2021,Havering 017I,E01033788,515,341,153,188,26,26,76,16,60,72,65,7,0
2021,Bexley 008H,E01033789,605,413,72,341,32,32,77,15,62,83,82,1,0
2021,Bexley 008I,E01033790,491,266,96,170,4,4,159,40,119,62,60,2,0
2021,Bexley 019G,E01033791,630,173,69,104,67,67,184,27,157,205,183,22,1
2021,Bexley 019H,E01033792,571,440,188,252,1,1,40,7,33,89,76,13,1
2021,St. Helens 013D,E01033793,534,372,90,282,15,15,44,18,26,103,100,3,0
2021,St. Helens 013E,E01033794,787,337,138,199,16,16,359,140,219,75,65,10,0
2021,St. Helens 022G,E01033795,567,470,129,341,5,5,22,7,15,70,61,9,0
2021,St. Helens 022H,E01033796,715,433,177,256,7,7,41,8,33,234,210,24,0
2021,Sefton 004H,E01033797,642,247,197,50,4,4,75,5,70,316,300,16,0
2021,Sefton 004I,E01033798,632,99,66,33,2,2,55,2,53,476,464,12,0
2021,Sefton 018G,E01033799,590,449,178,271,7,7,92,24,68,42,32,10,0
2021,Sefton 018H,E01033800,623,534,344,190,0,0,45,4,41,44,34,10,0
2021,Luton 022C,E01033801,779,129,63,66,5,5,238,209,29,404,344,60,3
2021,Luton 022D,E01033802,724,72,29,43,3,3,191,63,128,456,440,16,2
2021,Luton 023A,E01033803,743,71,45,26,2,2,168,96,72,500,483,17,2
2021,Luton 023B,E01033804,593,37,13,24,3,3,96,52,44,456,434,22,1
2021,Luton 023C,E01033805,644,60,9,51,4,4,41,30,11,538,525,13,1
2021,Luton 021G,E01033806,636,30,6,24,18,18,356,199,157,229,222,7,3
2021,Luton 021H,E01033807,710,104,42,62,5,5,206,131,75,392,372,20,3
2021,Central Bedfordshire 006E,E01033808,525,455,94,361,9,9,14,2,12,47,41,6,0
2021,Central Bedfordshire 006F,E01033809,557,380,88,292,42,42,65,1,64,70,61,9,0
2021,Central Bedfordshire 006G,E01033810,590,418,244,174,15,15,89,12,77,68,60,8,0
2021,Central Bedfordshire 006H,E01033811,572,396,134,262,15,15,89,10,79,72,66,6,0
2021,Central Bedfordshire 006I,E01033812,511,407,48,359,28,28,40,2,38,36,32,4,0
2021,Central Bedfordshire 006J,E01033813,490,258,112,146,1,1,176,22,154,55,48,7,0
2021,Central Bedfordshire 007H,E01033814,447,275,155,120,8,8,57,13,44,107,51,56,0
2021,Central Bedfordshire 007I,E01033815,506,339,88,251,47,47,83,4,79,37,29,8,0
2021,Central Bedfordshire 007J,E01033816,506,383,91,292,67,67,32,1,31,24,20,4,0
2021,Central Bedfordshire 008F,E01033817,619,420,203,217,13,13,109,8,101,75,58,17,2
2021,Central Bedfordshire 008G,E01033818,603,475,139,336,47,47,54,7,47,27,25,2,0
2021,Central Bedfordshire 009F,E01033819,608,469,119,350,47,47,53,3,50,39,30,9,0
2021,Central Bedfordshire 009G,E01033820,659,498,210,288,11,11,82,9,73,68,60,8,0
2021,Central Bedfordshire 009H,E01033821,500,388,138,250,17,17,63,3,60,31,27,4,1
2021,Central Bedfordshire 009I,E01033822,485,369,84,285,29,29,54,1,53,33,30,3,0
2021,Central Bedfordshire 009J,E01033823,418,306,97,209,17,17,25,2,23,70,67,3,0
2021,Central Bedfordshire 017F,E01033824,636,413,126,287,63,63,86,6,80,74,64,10,0
2021,Central Bedfordshire 017G,E01033825,693,570,312,258,4,4,72,6,66,47,43,4,0
2021,Central Bedfordshire 019F,E01033826,438,364,74,290,51,51,9,1,8,14,10,4,0
2021,Central Bedfordshire 019G,E01033827,806,654,386,268,0,0,76,71,5,75,59,16,1
2021,Central Bedfordshire 024H,E01033828,546,455,93,362,1,1,17,8,9,73,62,11,0
2021,Central Bedfordshire 024I,E01033829,508,300,95,205,3,3,74,16,58,131,122,9,0
2021,Central Bedfordshire 024J,E01033830,491,297,128,169,8,8,86,16,70,100,94,6,0
2021,Central Bedfordshire 024K,E01033831,417,346,148,198,5,5,7,1,6,59,38,21,0
2021,Central Bedfordshire 024L,E01033832,495,307,37,270,42,42,102,8,94,44,39,5,0
2021,Central Bedfordshire 024M,E01033833,539,376,77,299,16,16,95,5,90,52,48,4,0
2021,Central Bedfordshire 028G,E01033834,644,404,134,270,2,2,90,41,49,147,140,7,1
2021,Central Bedfordshire 028H,E01033835,575,317,74,243,29,29,131,61,70,98,92,6,0
2021,Central Bedfordshire 029F,E01033836,725,477,85,392,45,45,76,62,14,126,116,10,1
2021,Central Bedfordshire 029G,E01033837,707,378,159,219,20,20,107,73,34,201,195,6,1
2021,Reading 020C,E01033838,554,145,37,108,0,0,68,41,27,341,321,20,0
2021,Reading 020D,E01033839,630,114,41,73,24,24,89,24,65,403,386,17,0
2021,Swindon 008E,E01033840,590,376,47,329,62,62,98,1,97,54,50,4,0
2021,Swindon 008F,E01033841,568,328,60,268,65,65,142,23,119,31,26,5,2
2021,Swindon 008G,E01033842,557,398,34,364,63,63,66,5,61,30,27,3,0
2021,Swindon 008H,E01033843,554,419,245,174,2,2,75,63,12,56,50,6,2
2021,Swindon 008I,E01033844,567,404,58,346,69,69,75,2,73,19,17,2,0
2021,Swindon 015E,E01033845,764,108,24,84,0,0,157,81,76,497,475,22,2
2021,Swindon 015F,E01033846,741,163,58,105,1,1,265,244,21,307,296,11,5
2021,Swindon 024E,E01033847,675,620,341,279,6,6,7,0,7,42,33,9,0
2021,Swindon 024F,E01033848,768,449,92,357,38,38,148,5,143,133,124,9,0
2021,Swindon 025G,E01033849,805,613,89,524,20,20,103,7,96,69,59,10,0
2021,Swindon 025H,E01033850,820,578,267,311,12,12,96,19,77,134,92,42,0
2021,West Berkshire 007F,E01033851,981,764,416,348,5,5,28,4,24,184,73,111,0
2021,West Berkshire 019E,E01033852,654,393,189,204,18,18,148,13,135,95,83,12,0
2021,West Berkshire 019F,E01033853,686,510,225,285,49,49,65,3,62,62,52,10,0
2021,West Berkshire 019G,E01033854,796,381,95,286,111,111,116,15,101,188,177,11,0
2021,West Berkshire 019H,E01033855,711,243,157,86,15,15,156,11,145,297,276,21,0
2021,West Berkshire 019I,E01033856,613,186,102,84,23,23,94,11,83,310,288,22,0
2021,Reading 017G,E01033857,711,254,89,165,10,10,311,153,158,134,124,10,2
2021,Reading 017H,E01033858,713,286,43,243,56,56,114,18,96,256,248,8,1
2021,Reading 017I,E01033859,703,163,36,127,23,23,29,6,23,488,471,17,0
2021,Swindon 028F,E01033860,709,435,132,303,3,3,117,1,116,154,142,12,0
2021,Swindon 028G,E01033861,674,589,164,425,1,1,8,2,6,76,69,7,0
2021,Lambeth 003F,E01033862,747,165,80,85,80,80,120,33,87,382,348,34,0
2021,Lambeth 003G,E01033863,603,95,37,58,7,7,393,388,5,107,96,11,1
2021,Lambeth 004H,E01033864,493,77,32,45,4,4,335,63,272,75,68,7,2
2021,Lambeth 004I,E01033865,595,144,52,92,22,22,107,53,54,321,305,16,1
2021,Lambeth 004J,E01033866,624,131,55,76,48,48,65,8,57,380,359,21,0
2021,Southwark 002F,E01033867,605,118,44,74,9,9,241,151,90,235,209,26,2
2021,Southwark 002G,E01033868,600,144,50,94,80,80,69,32,37,306,294,12,1
2021,Southwark 004F,E01033869,644,97,30,67,91,91,347,215,132,109,95,14,0
2021,Southwark 004G,E01033870,863,264,56,208,78,78,222,98,124,299,274,25,0
2021,Southwark 004H,E01033871,688,149,64,85,30,30,308,127,181,201,184,17,0
2021,Southwark 004I,E01033872,659,147,50,97,23,23,265,78,187,224,209,15,0
2021,Southwark 009G,E01033873,675,84,28,56,57,57,339,291,48,189,170,19,6
2021,Southwark 009H,E01033874,626,49,24,25,15,15,92,9,83,470,462,8,0
2021,Southwark 012G,E01033875,639,79,18,61,90,90,291,43,248,179,168,11,0
2021,Southwark 012H,E01033876,650,162,55,107,45,45,71,19,52,371,355,16,1
2021,Southwark 012I,E01033877,684,195,35,160,3,3,252,119,133,234,223,11,0
2021,Southwark 015F,E01033878,421,99,32,67,2,2,226,169,57,94,84,10,0
2021,Southwark 015G,E01033879,844,71,24,47,2,2,636,599,37,135,128,7,0
2021,Southwark 015H,E01033880,534,110,41,69,47,47,143,56,87,233,218,15,1
2021,Southwark 016F,E01033881,712,121,50,71,3,3,461,395,66,123,111,12,4
2021,Southwark 022G,E01033882,583,165,69,96,12,12,229,162,67,174,164,10,3
2021,Southwark 022H,E01033883,647,160,18,142,101,101,308,245,63,76,67,9,2
2021,Southwark 035A,E01033884,593,110,56,54,7,7,151,122,29,325,309,16,0
2021,Southwark 036A,E01033885,629,103,34,69,0,0,307,268,39,215,201,14,4
2021,Sandwell 014F,E01033886,574,273,63,210,1,1,224,155,69,72,64,8,4
2021,Sandwell 014G,E01033887,615,344,147,197,0,0,132,116,16,139,131,8,0
2021,Sandwell 018F,E01033888,541,243,156,87,1,1,178,150,28,116,106,10,3
2021,Sandwell 018G,E01033889,659,309,112,197,0,0,239,178,61,109,104,5,2
2021,Sandwell 040B,E01033890,435,127,36,91,1,1,202,147,55,93,91,2,12
2021,Sandwell 040C,E01033891,559,52,15,37,3,3,441,419,22,46,42,4,17
2021,Sandwell 041A,E01033892,613,197,80,117,1,1,183,131,52,227,209,18,5
2021,Sandwell 041C,E01033893,499,228,62,166,2,2,67,10,57,201,189,12,1
2021,Walsall 013F,E01033894,606,229,93,136,1,1,289,143,146,86,80,6,1
2021,Walsall 013G,E01033895,556,257,61,196,1,1,232,99,133,66,59,7,0
2021,Walsall 030F,E01033896,663,91,49,42,6,6,291,46,245,270,249,21,5
2021,Walsall 030G,E01033897,488,92,42,50,4,4,205,17,188,186,173,13,1
2021,Bradford 030E,E01033898,455,254,77,177,4,4,113,45,68,84,71,13,0
2021,Bradford 030F,E01033899,476,114,28,86,0,0,278,95,183,83,69,14,1
2021,Bradford 044G,E01033900,405,240,155,85,0,0,27,3,24,137,119,18,1
2021,Bradford 044H,E01033901,406,246,177,69,1,1,3,1,2,156,139,17,0
2021,Bristol 054F,E01033902,789,174,80,94,23,23,112,13,99,480,458,22,0
2021,Bristol 054G,E01033903,478,72,32,40,0,0,45,8,37,361,346,15,0
2021,Bristol 060B,E01033904,529,136,66,70,2,2,69,7,62,322,303,19,0
2021,Bristol 060C,E01033905,525,62,28,34,3,3,25,4,21,435,421,14,0
2021,Bristol 060E,E01033906,642,133,67,66,28,28,82,13,69,398,386,12,1
2021,Bristol 061A,E01033907,548,88,35,53,3,3,62,6,56,395,370,25,0
2021,Bristol 061B,E01033908,455,90,27,63,3,3,49,5,44,313,302,11,0
2021,Bristol 061C,E01033909,484,163,82,81,12,12,41,6,35,267,245,22,1
2021,Bristol 061E,E01033910,628,266,119,147,32,32,165,157,8,161,140,21,4
2021,Barnet 017E,E01033911,651,500,237,263,7,7,41,17,24,103,93,10,0
2021,Barnet 017F,E01033912,638,382,92,290,19,19,100,15,85,137,127,10,0
2021,Barnet 024G,E01033913,538,105,34,71,10,10,205,47,158,217,199,18,1
2021,Barnet 024H,E01033914,598,201,77,124,4,4,211,129,82,182,177,5,0
2021,Barnet 042A,E01033915,582,111,37,74,2,2,273,21,252,188,182,6,8
2021,Barnet 042B,E01033916,651,161,78,83,3,3,56,9,47,431,409,22,0
2021,Barnet 042C,E01033917,700,140,51,89,37,37,91,6,85,432,413,19,0
2021,Barnet 042D,E01033918,631,229,41,188,42,42,116,15,101,244,226,18,0
2021,Barnet 042E,E01033919,648,136,41,95,22,22,34,4,30,455,431,24,1
2021,Barnet 042F,E01033920,640,321,73,248,44,44,21,9,12,254,246,8,0
2021,Barnet 043A,E01033921,695,174,44,130,38,38,143,8,135,340,323,17,0
2021,Barnet 043B,E01033922,686,227,43,184,1,1,70,10,60,388,376,12,0
2021,Barnet 043C,E01033923,587,165,78,87,76,76,197,16,181,149,139,10,0
2021,Barnet 043D,E01033924,580,133,65,68,1,1,250,137,113,193,178,15,3
2021,Barnet 043E,E01033925,619,242,132,110,37,37,101,8,93,237,220,17,2
2021,Enfield 014E,E01033926,977,320,97,223,33,33,370,257,113,246,220,26,8
2021,Enfield 020F,E01033927,680,189,100,89,2,2,42,16,26,447,425,22,0
2021,Enfield 020G,E01033928,575,182,98,84,2,2,15,4,11,376,362,14,0
2021,Brent 002F,E01033929,552,228,27,201,88,88,135,8,127,101,94,7,0
2021,Brent 002G,E01033930,590,279,171,108,5,5,208,13,195,97,86,11,1
2021,Brent 009F,E01033931,500,53,20,33,26,26,237,82,155,184,175,9,0
2021,Brent 009G,E01033932,522,96,42,54,7,7,299,61,238,117,104,13,3
2021,Brent 010G,E01033933,417,201,155,46,6,6,48,23,25,161,142,19,1
2021,Brent 010H,E01033934,444,215,152,63,3,3,52,24,28,172,158,14,2
2021,Brent 020F,E01033935,568,158,71,87,39,39,136,45,91,235,227,8,0
2021,Brent 020G,E01033936,548,91,57,34,4,4,89,22,67,362,332,30,2
2021,Brent 027G,E01033937,482,45,22,23,33,33,304,111,193,100,92,8,0
2021,Brent 027H,E01033938,448,50,15,35,28,28,298,83,215,69,63,6,3
2021,Brent 027I,E01033939,795,235,45,190,52,52,112,17,95,396,378,18,0
2021,Brent 035B,E01033940,709,132,25,107,38,38,122,13,109,416,395,21,1
2021,Brent 035C,E01033941,730,118,25,93,81,81,225,62,163,306,285,21,0
2021,Brent 035D,E01033942,692,47,16,31,11,11,148,22,126,486,465,21,0
2021,Haringey 015E,E01033943,726,290,119,171,3,3,59,33,26,373,342,31,1
2021,Haringey 015F,E01033944,693,122,47,75,100,100,354,61,293,114,103,11,3
2021,Haringey 020G,E01033945,672,192,44,148,44,44,183,66,117,252,242,10,1
2021,Haringey 020H,E01033946,675,136,29,107,82,82,88,21,67,366,353,13,3
2021,Stockport 014E,E01033947,856,139,49,90,54,54,335,133,202,326,316,10,2
2021,Stockport 014F,E01033948,861,50,32,18,42,42,528,406,122,241,234,7,0
2021,Tameside 013F,E01033949,591,33,16,17,0,0,512,56,456,45,37,8,1
2021,Tameside 013G,E01033950,682,71,32,39,0,0,482,46,436,129,125,4,0
2021,Buckinghamshire 001C,E01033951,414,287,152,135,4,4,41,12,29,82,60,22,0
2021,Buckinghamshire 001D,E01033952,546,421,246,175,6,6,41,12,29,78,61,17,0
2021,Buckinghamshire 001E,E01033953,592,338,71,267,84,84,108,12,96,62,58,4,0
2021,Buckinghamshire 001F,E01033954,656,539,280,259,5,5,4,0,4,108,101,7,0
2021,Buckinghamshire 007E,E01033955,552,473,175,298,22,22,30,7,23,27,22,5,0
2021,Buckinghamshire 007F,E01033956,616,490,196,294,6,6,86,27,59,34,29,5,0
2021,Buckinghamshire 007G,E01033957,401,344,56,288,0,0,37,5,32,20,15,5,0
2021,Buckinghamshire 009F,E01033958,527,330,70,260,33,33,100,8,92,64,61,3,0
2021,Buckinghamshire 009G,E01033959,548,263,57,206,41,41,183,13,170,60,55,5,1
2021,Buckinghamshire 011D,E01033960,597,481,29,452,26,26,51,5,46,39,36,3,0
2021,Buckinghamshire 011E,E01033961,589,421,43,378,46,46,71,5,66,51,50,1,0
2021,Buckinghamshire 011F,E01033962,566,245,43,202,105,105,167,16,151,49,47,2,0
2021,Buckinghamshire 011G,E01033963,560,355,35,320,22,22,111,11,100,72,69,3,0
2021,Buckinghamshire 011H,E01033964,567,329,52,277,31,31,128,10,118,79,75,4,0
2021,Buckinghamshire 021F,E01033965,610,484,253,231,25,25,63,3,60,37,29,8,1
2021,Buckinghamshire 021G,E01033966,597,466,164,302,28,28,61,6,55,41,34,7,1
2021,Buckinghamshire 011I,E01033967,585,468,184,284,9,9,30,6,24,77,73,4,1
2021,Buckinghamshire 024E,E01033968,476,186,90,96,1,1,31,9,22,258,47,211,0
2021,Buckinghamshire 024F,E01033969,588,316,80,236,15,15,98,3,95,159,100,59,0
2021,Buckinghamshire 040D,E01033970,599,490,284,206,2,2,33,4,29,74,58,16,0
2021,Buckinghamshire 040E,E01033971,563,370,190,180,6,6,51,10,41,135,70,65,1
2021,Buckinghamshire 051C,E01033972,722,345,112,233,58,58,130,9,121,189,168,21,0
2021,Buckinghamshire 051D,E01033973,564,260,78,182,8,8,161,24,137,135,128,7,0
2021,Buckinghamshire 051E,E01033974,604,448,171,277,3,3,15,1,14,138,131,7,0
2021,Buckinghamshire 051F,E01033975,642,311,110,201,4,4,203,41,162,124,116,8,0
2021,Salford 003D,E01033976,808,585,147,438,2,2,29,13,16,191,183,8,1
2021,Salford 003E,E01033977,538,254,131,123,0,0,170,91,79,113,104,9,1
2021,Salford 008E,E01033978,406,274,94,180,1,1,24,9,15,107,97,10,0
2021,Salford 008F,E01033979,468,307,111,196,22,22,57,17,40,80,71,9,2
2021,Salford 017G,E01033980,426,149,42,107,2,2,77,34,43,195,184,11,3
2021,Salford 017H,E01033981,737,159,100,59,4,4,209,107,102,360,342,18,5
2021,Salford 021H,E01033982,760,264,135,129,34,34,268,81,187,190,177,13,4
2021,Salford 021I,E01033983,640,73,36,37,10,10,152,29,123,404,395,9,1
2021,Salford 024E,E01033984,996,190,81,109,4,4,552,309,243,242,231,11,8
2021,Salford 032A,E01033985,672,97,30,67,2,2,371,107,264,199,188,11,3
2021,Salford 032B,E01033986,660,197,30,167,3,3,217,25,192,242,232,10,1
2021,Salford 033A,E01033987,582,110,21,89,1,1,49,7,42,422,412,10,0
2021,Salford 033B,E01033988,843,103,36,67,1,1,24,6,18,715,702,13,0
2021,Salford 033C,E01033989,678,165,63,102,0,0,88,34,54,425,412,13,0
2021,Salford 033D,E01033990,664,65,23,42,0,0,47,9,38,552,536,16,0
2021,Salford 034A,E01033991,790,173,59,114,3,3,288,95,193,325,309,16,1
2021,Salford 034B,E01033992,755,185,23,162,0,0,46,9,37,524,520,4,0
2021,Salford 036A,E01033993,892,154,66,88,2,2,140,78,62,596,587,9,0
2021,Salford 036B,E01033994,638,78,18,60,1,1,23,7,16,536,532,4,0
2021,Salford 037A,E01033995,713,94,33,61,0,0,26,7,19,593,577,16,0
2021,Salford 037B,E01033996,706,142,59,83,2,2,44,18,26,518,502,16,0
2021,Salford 037C,E01033997,626,107,35,72,1,1,28,5,23,490,483,7,0
2021,Salford 037D,E01033998,748,118,62,56,1,1,31,5,26,598,573,25,0
2021,Salford 037E,E01033999,667,119,19,100,0,0,23,5,18,525,505,20,0
2021,Trafford 001G,E01034000,751,65,21,44,0,0,185,44,141,500,493,7,1
2021,Trafford 001H,E01034001,781,228,115,113,22,22,325,104,221,206,196,10,0
2021,Charnwood 009G,E01034002,596,280,121,159,3,3,240,215,25,72,65,7,1
2021,Charnwood 009H,E01034003,592,455,109,346,33,33,44,2,42,60,60,0,0
2021,Charnwood 010G,E01034004,691,525,117,408,2,2,33,3,30,131,120,11,0
2021,Charnwood 010H,E01034005,585,463,252,211,11,11,33,1,32,78,72,6,0
2021,Charnwood 019E,E01034006,869,559,116,443,13,13,100,9,91,197,185,12,0
2021,Charnwood 019F,E01034007,712,638,363,275,2,2,12,2,10,60,51,9,0
2021,Leicester 006F,E01034008,484,281,106,175,4,4,71,3,68,128,118,10,0
2021,Leicester 006G,E01034009,547,145,93,52,6,6,234,19,215,162,148,14,0
2021,Leicester 008F,E01034010,612,408,243,165,3,3,60,8,52,141,131,10,0
2021,Leicester 008G,E01034011,664,157,45,112,3,3,88,13,75,416,400,16,0
2021,Leicester 008H,E01034012,614,20,8,12,5,5,201,89,112,387,372,15,1
2021,Leicester 023H,E01034013,465,100,57,43,6,6,161,148,13,195,175,20,3
2021,Leicester 023I,E01034014,434,28,15,13,2,2,113,12,101,291,277,14,0
2021,Leicester 029E,E01034015,452,105,30,75,7,7,40,6,34,300,285,15,0
2021,Leicester 029F,E01034016,733,184,85,99,9,9,55,31,24,484,461,23,1
2021,Leicester 037G,E01034017,528,386,95,291,8,8,83,44,39,50,38,12,1
2021,Leicester 037H,E01034018,500,210,84,126,13,13,215,177,38,62,57,5,0
2021,Leicester 040E,E01034019,703,96,58,38,2,2,126,55,71,476,454,22,3
2021,Leicester 040F,E01034020,978,53,30,23,2,2,616,106,510,306,291,15,1
2021,Leicester 040G,E01034021,406,65,36,29,1,1,94,23,71,246,231,15,0
2021,Leicester 041E,E01034022,735,39,17,22,2,2,126,11,115,568,544,24,0
2021,Leicester 041F,E01034023,724,62,21,41,3,3,71,21,50,588,567,21,0
2021,Leicester 043A,E01034024,638,295,118,177,8,8,148,22,126,187,169,18,0
2021,Leicester 043B,E01034025,663,463,215,248,12,12,93,20,73,95,83,12,0
2021,Ealing 015F,E01034026,628,60,22,38,64,64,64,18,46,440,398,42,0
2021,Ealing 015G,E01034027,894,231,117,114,30,30,184,73,111,447,408,39,2
2021,Ealing 019F,E01034028,639,122,41,81,30,30,141,26,115,345,331,14,1
2021,Ealing 019G,E01034029,698,219,85,134,21,21,87,46,41,371,360,11,0
2021,Ealing 042A,E01034030,876,204,93,111,15,15,117,63,54,538,517,21,2
2021,Ealing 042B,E01034031,636,124,62,62,52,52,70,7,63,389,375,14,1
2021,Hounslow 006G,E01034032,755,265,126,139,9,9,237,172,65,243,231,12,1
2021,Hounslow 006H,E01034033,841,396,108,288,88,88,55,41,14,302,290,12,0
2021,Hounslow 014F,E01034034,621,269,88,181,44,44,97,12,85,211,205,6,0
2021,Hounslow 014G,E01034035,657,454,185,269,3,3,53,20,33,147,132,15,0
2021,Hounslow 015F,E01034036,678,86,36,50,36,36,168,48,120,388,377,11,0
2021,Hounslow 015G,E01034037,654,267,77,190,36,36,149,55,94,198,185,13,4
2021,Hounslow 017F,E01034038,547,119,41,78,70,70,168,17,151,190,181,9,0
2021,Hounslow 017G,E01034039,537,144,52,92,15,15,139,45,94,237,230,7,2
2021,Hounslow 018H,E01034040,554,137,75,62,13,13,81,25,56,322,308,14,1
2021,Hounslow 018I,E01034041,443,185,91,94,5,5,48,6,42,205,186,19,0
2021,Hounslow 030A,E01034042,597,98,24,74,29,29,284,149,135,183,174,9,3
2021,Hounslow 030B,E01034043,639,137,55,82,2,2,274,247,27,225,216,9,1
2021,Hounslow 030C,E01034044,576,207,100,107,52,52,95,13,82,222,205,17,0
2021,Hounslow 031A,E01034045,838,260,63,197,67,67,151,12,139,360,343,17,0
2021,Hounslow 031B,E01034046,730,130,58,72,11,11,481,430,51,100,92,8,8
2021,Stafford 010F,E01034047,739,184,94,90,2,2,170,31,139,383,363,20,0
2021,Stafford 010G,E01034048,606,249,157,92,8,8,105,16,89,244,221,23,0
2021,Stafford 011F,E01034049,601,423,121,302,15,15,118,10,108,45,38,7,0
2021,Stafford 011G,E01034050,581,419,200,219,14,14,21,5,16,127,84,43,0
2021,Stafford 014I,E01034051,1105,988,611,377,5,5,29,3,26,83,63,20,0
2021,Stoke-on-Trent 009F,E01034052,523,145,49,96,10,10,190,10,180,177,142,35,1
2021,Stoke-on-Trent 009G,E01034053,694,169,80,89,10,10,269,111,158,243,207,36,3
2021,Stoke-on-Trent 016H,E01034054,505,316,47,269,3,3,58,32,26,128,115,13,0
2021,Stoke-on-Trent 016I,E01034055,696,144,69,75,6,6,399,225,174,143,134,9,4
2021,Stoke-on-Trent 016J,E01034056,728,436,250,186,9,9,105,50,55,177,163,14,1
2021,Stoke-on-Trent 016K,E01034057,671,230,112,118,12,12,124,77,47,301,279,22,4
2021,Stoke-on-Trent 032E,E01034058,766,247,109,138,0,0,411,334,77,99,87,12,9
2021,Stoke-on-Trent 032F,E01034059,771,661,139,522,0,0,17,14,3,93,85,8,0
2021,Gosport 004H,E01034060,849,381,98,283,39,39,268,11,257,161,148,13,0
2021,Gosport 004I,E01034061,439,150,30,120,33,33,208,10,198,48,43,5,0
2021,Gosport 005F,E01034062,636,391,178,213,2,2,47,8,39,196,174,22,0
2021,Gosport 005G,E01034063,575,301,144,157,45,45,88,5,83,141,130,11,0
2021,Gosport 008H,E01034064,646,325,153,172,9,9,68,9,59,244,224,20,0
2021,Gosport 008I,E01034065,583,253,123,130,38,38,129,10,119,163,143,20,0
2021,Havant 014G,E01034066,470,270,135,135,10,10,100,10,90,89,81,8,1
2021,Havant 014H,E01034067,776,354,222,132,7,7,167,13,154,248,235,13,0
2021,Allerdale 012F,E01034068,939,611,405,206,4,4,183,38,145,141,108,33,0
2021,Barrow-in-Furness 007G,E01034069,926,520,251,269,1,1,248,167,81,151,129,22,6
2021,Carlisle 013F,E01034070,471,372,172,200,0,0,9,0,9,90,84,6,0
2021,Carlisle 013G,E01034071,628,548,179,369,9,9,20,4,16,51,44,7,0
2021,Carlisle 013H,E01034072,517,433,177,256,1,1,46,10,36,37,37,0,0
2021,Carlisle 013I,E01034073,660,531,388,143,0,0,53,8,45,76,60,16,0
2021,Carlisle 013J,E01034074,754,615,271,344,24,24,45,8,37,70,47,23,0
2021,Copeland 001E,E01034075,1039,870,516,354,1,1,76,12,64,92,76,16,0
2021,Copeland 004J,E01034076,927,624,409,215,0,0,203,44,159,98,69,29,2
2021,South Lakeland 002F,E01034077,912,530,297,233,8,8,236,144,92,134,119,15,4
2021,South Lakeland 006H,E01034078,583,291,151,140,17,17,129,59,70,145,135,10,1
2021,South Lakeland 006I,E01034079,772,612,352,260,26,26,31,3,28,103,78,25,0
2021,South Lakeland 011F,E01034080,1250,1049,789,260,3,3,89,17,72,109,83,26,0
2021,Chelmsford 001E,E01034081,706,447,223,224,22,22,174,32,142,62,50,12,1
2021,Chelmsford 001F,E01034082,603,362,78,284,54,54,142,14,128,43,40,3,2
2021,Chelmsford 004G,E01034083,583,384,62,322,71,71,86,9,77,42,33,9,0
2021,Chelmsford 004H,E01034084,680,591,264,327,2,2,11,3,8,76,71,5,0
2021,Chelmsford 018F,E01034085,568,480,372,108,8,8,23,2,21,57,36,21,0
2021,Chelmsford 018G,E01034086,695,600,389,211,3,3,18,1,17,74,63,11,0
2021,Chelmsford 021D,E01034087,659,559,440,119,4,4,9,1,8,87,61,26,0
2021,Chelmsford 021E,E01034088,602,391,122,269,37,37,133,18,115,41,38,3,0
2021,Chelmsford 022A,E01034089,914,383,92,291,36,36,93,10,83,402,379,23,0
2021,Chelmsford 022C,E01034090,726,335,187,148,15,15,73,10,63,302,278,24,1
2021,Chelmsford 023A,E01034091,718,229,74,155,13,13,90,8,82,386,365,21,0
2021,Chelmsford 023B,E01034092,689,35,10,25,116,116,166,10,156,371,355,16,1
2021,Maldon 008H,E01034093,674,556,283,273,36,36,56,5,51,26,18,8,0
2021,Maldon 008I,E01034094,660,460,255,205,5,5,147,7,140,48,36,12,0
2021,Southend-on-Sea 010G,E01034095,907,147,30,117,69,69,230,21,209,460,449,11,1
2021,Southend-on-Sea 010H,E01034096,783,141,73,68,1,1,322,274,48,318,302,16,1
2021,Cannock Chase 005E,E01034097,466,357,117,240,4,4,67,42,25,37,34,3,1
2021,Cannock Chase 005F,E01034098,954,719,233,486,21,21,100,14,86,113,106,7,1
2021,Lichfield 001E,E01034099,655,435,71,364,34,34,74,5,69,112,89,23,0
2021,Lichfield 001F,E01034100,773,566,376,190,3,3,112,15,97,91,79,12,1
2021,Lichfield 002E,E01034101,765,566,291,275,13,13,109,16,93,77,69,8,0
2021,Lichfield 002F,E01034102,650,493,100,393,24,24,70,5,65,63,56,7,0
2021,Lichfield 006F,E01034103,585,334,114,220,11,11,105,23,82,135,119,16,0
2021,Lichfield 006G,E01034104,753,612,285,327,17,17,74,8,66,50,41,9,0
2021,Lichfield 008E,E01034105,665,446,56,390,64,64,92,9,83,63,58,5,0
2021,Lichfield 008F,E01034106,703,446,216,230,1,1,71,5,66,185,82,103,0
2021,Manchester 002F,E01034107,596,305,110,195,28,28,57,35,22,206,189,17,0
2021,Manchester 002G,E01034108,789,446,161,285,7,7,116,49,67,219,201,18,1
2021,Manchester 008G,E01034109,424,226,127,99,4,4,23,16,7,171,151,20,0
2021,Manchester 008H,E01034110,484,178,80,98,31,31,50,21,29,224,204,20,1
2021,Manchester 017G,E01034111,555,94,48,46,0,0,363,55,308,95,88,7,3
2021,Manchester 017H,E01034112,735,286,120,166,13,13,213,53,160,222,199,23,1
2021,Manchester 017I,E01034113,565,168,81,87,29,29,237,30,207,130,121,9,1
2021,Manchester 017J,E01034114,730,463,153,310,4,4,99,22,77,163,138,25,1
2021,Manchester 018F,E01034115,422,115,40,75,1,1,166,101,65,139,131,8,1
2021,Manchester 018G,E01034116,415,126,43,83,1,1,103,62,41,184,172,12,1
2021,Manchester 019E,E01034117,474,37,27,10,2,2,127,19,108,308,291,17,0
2021,Manchester 019F,E01034118,456,43,27,16,1,1,359,105,254,51,46,5,2
2021,Manchester 022H,E01034119,765,88,47,41,2,2,287,94,193,386,376,10,2
2021,Manchester 023F,E01034120,595,141,37,104,5,5,369,146,223,78,69,9,2
2021,Manchester 023G,E01034121,450,171,26,145,7,7,106,46,60,166,161,5,0
2021,Manchester 024E,E01034122,627,134,54,80,5,5,221,56,165,267,258,9,0
2021,Manchester 024F,E01034123,638,168,77,91,14,14,303,52,251,151,143,8,2
2021,Manchester 025F,E01034124,558,72,29,43,16,16,296,48,248,174,157,17,0
2021,Manchester 025G,E01034125,548,75,32,43,0,0,193,35,158,278,263,15,2
2021,Manchester 025H,E01034126,606,295,72,223,9,9,96,16,80,205,195,10,1
2021,Manchester 025I,E01034127,588,267,121,146,0,0,97,35,62,224,204,20,0
2021,Manchester 032F,E01034128,889,371,173,198,1,1,101,31,70,413,396,17,3
2021,Manchester 055F,E01034129,637,159,37,122,5,5,23,3,20,449,432,17,1
2021,Manchester 055G,E01034130,782,158,37,121,25,25,18,2,16,580,564,16,1
2021,Manchester 060E,E01034131,648,128,51,77,1,1,6,2,4,513,466,47,0
2021,Manchester 060F,E01034132,957,139,54,85,2,2,33,1,32,783,754,29,0
2021,Manchester 061C,E01034133,882,215,66,149,4,4,338,186,152,323,314,9,2
2021,Manchester 061D,E01034134,670,168,14,154,0,0,27,2,25,475,467,8,0
2021,Manchester 062A,E01034135,641,287,47,240,0,0,78,17,61,276,262,14,0
2021,Manchester 062C,E01034136,606,194,38,156,10,10,30,1,29,371,349,22,1
2021,Manchester 063C,E01034137,492,191,87,104,2,2,39,15,24,259,236,23,1
2021,Manchester 064B,E01034138,453,89,44,45,0,0,116,29,87,244,236,8,4
2021,Croydon 015F,E01034139,659,196,80,116,22,22,144,51,93,296,264,32,1
2021,Croydon 015G,E01034140,523,141,41,100,49,49,106,16,90,227,208,19,0
2021,Croydon 020F,E01034141,588,119,41,78,16,16,47,17,30,406,399,7,0
2021,Croydon 020G,E01034142,643,146,47,99,7,7,156,18,138,333,320,13,1
2021,Croydon 020H,E01034143,670,54,15,39,19,19,78,21,57,518,506,12,1
2021,Croydon 024F,E01034144,589,248,63,185,21,21,140,87,53,180,173,7,0
2021,Croydon 024G,E01034145,559,129,41,88,5,5,203,111,92,217,202,15,5
2021,Croydon 024H,E01034146,595,211,21,190,28,28,148,15,133,208,194,14,0
2021,Croydon 046A,E01034147,640,63,17,46,1,1,25,7,18,551,539,12,0
2021,Croydon 046B,E01034148,837,93,14,79,22,22,80,33,47,642,632,10,0
2021,Croydon 046C,E01034149,1091,293,134,159,41,41,168,59,109,587,533,54,2
2021,Croydon 046D,E01034150,668,143,14,129,38,38,139,36,103,346,331,15,2
2021,Croydon 046E,E01034151,642,224,18,206,56,56,99,11,88,263,243,20,0
2021,Croydon 047B,E01034152,730,234,66,168,7,7,151,93,58,337,324,13,1
2021,Sutton 004F,E01034153,583,312,117,195,14,14,51,7,44,206,198,8,0
2021,Sutton 004G,E01034154,635,419,34,385,96,96,53,9,44,67,60,7,0
2021,Sutton 012F,E01034155,862,220,81,139,25,25,306,218,88,310,299,11,1
2021,Sutton 012G,E01034156,684,158,24,134,96,96,158,53,105,270,251,19,2
2021,Plymouth 031G,E01034157,710,538,95,443,36,36,47,13,34,89,66,23,0
2021,Plymouth 031H,E01034158,471,351,179,172,3,3,54,25,29,63,51,12,0
2021,Plymouth 034B,E01034159,650,188,91,97,24,24,174,22,152,263,246,17,1
2021,Plymouth 034C,E01034160,878,388,267,121,11,11,117,19,98,361,335,26,1
2021,Plymouth 034D,E01034161,747,251,147,104,4,4,97,12,85,395,374,21,0
2021,Plymouth 034E,E01034162,597,247,154,93,4,4,108,28,80,238,221,17,0
2021,Teignbridge 005E,E01034165,733,563,401,162,4,4,36,3,33,130,109,21,0
2021,Teignbridge 005F,E01034166,754,497,267,230,43,43,90,23,67,124,115,9,0
2021,Teignbridge 013E,E01034167,717,548,268,280,16,16,56,8,48,97,88,9,0
2021,Teignbridge 013F,E01034168,679,434,51,383,58,58,88,8,80,98,90,8,1
2021,Torbay 003G,E01034169,625,338,146,192,13,13,32,0,32,242,222,20,0
2021,Torbay 003H,E01034170,614,307,156,151,15,15,118,10,108,174,163,11,0
2021,Torbay 013H,E01034171,502,305,165,140,6,6,126,12,114,65,50,15,0
2021,Torbay 013I,E01034172,717,466,156,310,48,48,73,10,63,130,115,15,0
2021,Greenwich 005F,E01034173,641,121,49,72,3,3,424,203,221,87,77,10,6
2021,Greenwich 034F,E01034174,600,239,85,154,30,30,147,23,124,182,175,7,2
2021,Greenwich 034G,E01034175,657,197,41,156,121,121,17,8,9,322,314,8,0
2021,Greenwich 034H,E01034176,606,283,107,176,22,22,246,182,64,55,51,4,0
2021,Greenwich 034I,E01034177,650,117,27,90,5,5,304,18,286,224,215,9,0
2021,Greenwich 035E,E01034178,860,152,51,101,53,53,256,22,234,398,385,13,1
2021,Greenwich 035F,E01034179,555,139,40,99,34,34,226,162,64,156,140,16,0
2021,Greenwich 035G,E01034180,538,70,22,48,8,8,393,325,68,66,63,3,1
2021,Greenwich 035H,E01034181,748,129,31,98,63,63,143,18,125,413,407,6,0
2021,Greenwich 035I,E01034182,725,242,35,207,23,23,228,53,175,232,221,11,0
2021,Greenwich 037E,E01034183,693,346,52,294,23,23,167,41,126,157,147,10,0
2021,Greenwich 037F,E01034184,574,218,32,186,86,86,143,16,127,127,125,2,0
2021,Greenwich 037G,E01034185,560,278,70,208,28,28,83,37,46,171,162,9,0
2021,Greenwich 039C,E01034186,736,192,60,132,3,3,39,8,31,502,487,15,0
2021,Greenwich 039D,E01034187,698,93,19,74,194,194,246,20,226,163,157,6,2
2021,Greenwich 040A,E01034188,668,211,39,172,39,39,114,22,92,304,293,11,0
2021,Greenwich 040B,E01034189,564,407,16,391,16,16,66,16,50,75,65,10,0
2021,Greenwich 040C,E01034190,721,152,57,95,4,4,421,369,52,141,134,7,3
2021,Greenwich 040D,E01034191,757,374,70,304,33,33,174,15,159,176,165,11,0
2021,Greenwich 040E,E01034192,1062,354,125,229,55,55,407,126,281,246,233,13,0
2021,Greenwich 041A,E01034193,735,131,33,98,78,78,218,28,190,308,303,5,0
2021,Greenwich 041B,E01034194,603,118,30,88,38,38,102,17,85,345,325,20,0
2021,Greenwich 041C,E01034195,509,125,30,95,75,75,183,22,161,126,117,9,0
2021,Greenwich 041D,E01034196,577,186,41,145,24,24,80,4,76,287,271,16,0
2021,Greenwich 042C,E01034198,967,256,82,174,6,6,324,245,79,380,364,16,1
2021,Newham 012E,E01034199,696,99,34,65,32,32,355,263,92,205,188,17,5
2021,Newham 012F,E01034200,721,166,59,107,19,19,92,63,29,443,423,20,1
2021,Newham 022E,E01034201,427,114,51,63,23,23,145,30,115,145,137,8,0
2021,Newham 022F,E01034202,498,181,74,107,26,26,102,48,54,189,181,8,0
2021,Newham 025E,E01034203,481,156,20,136,46,46,129,91,38,149,143,6,1
2021,Newham 025F,E01034204,554,217,91,126,3,3,70,46,24,264,236,28,0
2021,Newham 033E,E01034205,562,155,38,117,15,15,150,21,129,240,229,11,2
2021,Newham 033F,E01034206,677,73,9,64,46,46,280,42,238,278,275,3,0
2021,Newham 033G,E01034207,713,294,39,255,68,68,76,4,72,275,267,8,0
2021,Newham 034J,E01034208,666,104,45,59,12,12,405,303,102,140,129,11,5
2021,Newham 034K,E01034209,685,124,27,97,61,61,90,14,76,410,396,14,0
2021,Newham 034L,E01034210,709,170,41,129,66,66,141,71,70,332,321,11,0
2021,Newham 034M,E01034211,744,199,34,165,4,4,16,6,10,525,513,12,0
2021,Newham 034N,E01034212,1006,189,35,154,29,29,101,38,63,687,665,22,0
2021,Newham 038A,E01034213,647,237,37,200,55,55,176,30,146,178,170,8,1
2021,Newham 038B,E01034214,647,43,10,33,20,20,137,17,120,446,438,8,1
2021,Newham 038C,E01034215,642,30,1,29,64,64,171,18,153,375,365,10,2
2021,Newham 038D,E01034216,634,22,2,20,33,33,222,14,208,357,352,5,0
2021,Newham 038E,E01034217,665,99,23,76,43,43,139,19,120,384,364,20,0
2021,Newham 039B,E01034218,616,169,67,102,36,36,182,99,83,229,219,10,0
2021,Newham 039C,E01034219,669,196,25,171,98,98,144,21,123,231,210,21,0
2021,Newham 039D,E01034220,618,140,37,103,38,38,22,7,15,418,389,29,0
2021,Newham 039E,E01034221,643,156,46,110,46,46,199,106,93,239,231,8,3
2021,Newham 040A,E01034222,718,69,12,57,13,13,266,42,224,370,360,10,0
2021,Newham 040B,E01034223,711,94,27,67,107,107,207,100,107,299,286,13,4
2021,Newham 041D,E01034224,612,122,42,80,13,13,252,136,116,223,208,15,2
2021,Newham 042B,E01034225,638,140,28,112,7,7,290,91,199,201,189,12,0
2021,Newham 042C,E01034226,610,158,29,129,42,42,100,8,92,310,300,10,0
2021,Newham 042D,E01034227,634,28,6,22,68,68,379,32,347,158,149,9,1
2021,Newham 042E,E01034228,635,179,28,151,43,43,32,10,22,381,370,11,0
2021,Newham 042F,E01034229,618,118,29,89,30,30,175,24,151,295,283,12,0
2021,Newham 042G,E01034230,677,188,32,156,7,7,53,6,47,429,416,13,0
2021,Newham 042H,E01034231,651,187,30,157,8,8,22,12,10,434,421,13,0
2021,Oldham 036A,E01034232,433,159,80,79,4,4,175,60,115,91,83,8,4
2021,Oldham 036B,E01034233,431,198,129,69,2,2,141,52,89,89,70,19,1
2021,Rochdale 008H,E01034234,456,287,145,142,0,0,41,14,27,128,119,9,0
2021,Rochdale 008I,E01034235,472,208,106,102,0,0,114,17,97,150,142,8,0
2021,Doncaster 019G,E01034236,626,98,64,34,4,4,62,16,46,457,441,16,5
2021,Doncaster 019H,E01034237,602,134,79,55,5,5,59,9,50,403,386,17,1
2021,Doncaster 022G,E01034238,633,123,56,67,0,0,45,18,27,465,450,15,0
2021,Doncaster 022H,E01034239,600,220,155,65,2,2,31,11,20,347,330,17,0
2021,Doncaster 027E,E01034240,672,434,183,251,4,4,31,20,11,203,186,17,0
2021,Doncaster 027F,E01034241,568,428,214,214,0,0,24,10,14,116,107,9,0
2021,Doncaster 028E,E01034242,665,439,72,367,18,18,65,9,56,143,135,8,0
2021,Doncaster 028F,E01034243,756,629,265,364,1,1,11,9,2,115,104,11,0
2021,Doncaster 038D,E01034244,453,264,66,198,9,9,9,2,7,171,162,9,0
2021,Doncaster 038E,E01034245,695,545,100,445,0,0,109,10,99,40,34,6,1
2021,Rotherham 001F,E01034246,778,421,187,234,7,7,212,159,53,135,115,20,3
2021,Rotherham 001G,E01034247,752,576,88,488,12,12,58,7,51,106,92,14,0
2021,Rotherham 027F,E01034248,589,475,56,419,27,27,49,17,32,38,34,4,0
2021,Rotherham 027G,E01034249,604,529,179,350,16,16,15,11,4,44,37,7,0
2021,Rotherham 027H,E01034250,409,312,131,181,0,0,60,53,7,37,29,8,0
2021,Rotherham 028E,E01034251,491,401,258,143,1,1,24,20,4,65,52,13,0
2021,Rotherham 028F,E01034252,876,598,170,428,6,6,97,26,71,174,159,15,1
2021,Rotherham 034G,E01034253,1053,773,414,359,0,0,158,130,28,120,98,22,2
2021,Amber Valley 016E,E01034254,1156,907,587,320,5,5,50,9,41,194,165,29,0
2021,Amber Valley 016F,E01034255,507,400,58,342,0,0,47,13,34,60,56,4,0
2021,Derby 013G,E01034256,706,46,19,27,2,2,266,69,197,391,365,26,1
2021,Derby 013H,E01034257,836,88,47,41,7,7,239,123,116,501,478,23,1
2021,Barnsley 010I,E01034258,640,427,187,240,0,0,133,129,4,80,60,20,0
2021,Barnsley 010J,E01034259,630,364,188,176,2,2,148,89,59,113,91,22,3
2021,Wakefield 002F,E01034260,629,499,120,379,1,1,15,8,7,114,103,11,0
2021,Wakefield 002G,E01034261,592,335,182,153,1,1,40,12,28,215,194,21,1
2021,Wakefield 005E,E01034262,627,336,155,181,3,3,46,35,11,242,233,9,0
2021,Wakefield 005F,E01034263,641,479,142,337,17,17,47,12,35,98,91,7,0
2021,Wakefield 017E,E01034264,712,106,63,43,6,6,245,152,93,355,328,27,0
2021,Wakefield 017F,E01034265,758,61,41,20,1,1,414,222,192,282,269,13,0
2021,Wakefield 024G,E01034266,627,524,97,427,4,4,16,3,13,83,76,7,0
2021,Wakefield 024H,E01034267,595,455,110,345,26,26,71,19,52,42,35,7,1
2021,Wakefield 024I,E01034268,532,358,187,171,1,1,134,104,30,38,32,6,1
2021,Wakefield 034G,E01034269,660,479,204,275,29,29,76,15,61,76,69,7,0
2021,Wakefield 034H,E01034270,715,526,111,415,17,17,33,8,25,139,124,15,0
2021,"Bournemouth, Christchurch and Poole 038E",E01034271,426,122,73,49,0,0,91,64,27,210,201,9,3
2021,"Bournemouth, Christchurch and Poole 038F",E01034272,530,249,114,135,2,2,23,17,6,256,234,22,0
2021,"Bournemouth, Christchurch and Poole 038G",E01034273,621,141,47,94,1,1,25,1,24,454,432,22,0
2021,"Bournemouth, Christchurch and Poole 038H",E01034274,778,120,72,48,3,3,71,5,66,584,564,20,0
2021,"Bournemouth, Christchurch and Poole 037F",E01034275,651,101,43,58,14,14,68,8,60,468,454,14,0
2021,"Bournemouth, Christchurch and Poole 037G",E01034276,620,93,33,60,0,0,43,9,34,484,475,9,0
2021,"Bournemouth, Christchurch and Poole 041E",E01034277,680,170,85,85,7,7,49,5,44,454,436,18,0
2021,"Bournemouth, Christchurch and Poole 041F",E01034278,587,199,130,69,0,0,12,3,9,376,358,18,0
2021,"Bournemouth, Christchurch and Poole 031E",E01034279,741,322,187,135,1,1,185,8,177,233,220,13,0
2021,"Bournemouth, Christchurch and Poole 031F",E01034280,531,303,176,127,2,2,153,8,145,73,64,9,0
2021,"Bournemouth, Christchurch and Poole 044G",E01034281,666,407,331,76,2,2,77,2,75,180,161,19,0
2021,"Bournemouth, Christchurch and Poole 044H",E01034282,628,170,96,74,79,79,130,11,119,249,239,10,0
2021,"Bournemouth, Christchurch and Poole 046D",E01034283,677,415,218,197,8,8,125,79,46,127,113,14,2
2021,"Bournemouth, Christchurch and Poole 046E",E01034284,562,218,101,117,27,27,132,8,124,182,161,21,3
2021,Elmbridge 007E,E01034285,602,138,57,81,41,41,160,25,135,262,249,13,1
2021,Elmbridge 007F,E01034286,637,388,166,222,9,9,74,16,58,166,155,11,0
2021,Epsom and Ewell 005E,E01034287,589,283,74,209,60,60,131,6,125,114,106,8,1
2021,Epsom and Ewell 005F,E01034288,509,244,105,139,7,7,207,15,192,51,45,6,0
2021,Epsom and Ewell 008E,E01034289,766,248,130,118,14,14,169,9,160,334,320,14,1
2021,Epsom and Ewell 008F,E01034290,597,250,131,119,5,5,77,10,67,265,251,14,0
2021,Spelthorne 004F,E01034291,699,306,117,189,2,2,5,1,4,386,372,14,0
2021,Spelthorne 004G,E01034292,652,200,71,129,7,7,62,5,57,382,358,24,1
2021,Woking 004G,E01034293,976,441,181,260,8,8,261,214,47,262,244,18,4
2021,Woking 008F,E01034294,885,194,61,133,19,19,64,8,56,608,588,20,0
2021,Woking 008G,E01034295,841,368,188,180,5,5,68,16,52,400,381,19,0
2021,Woking 011F,E01034296,508,396,204,192,0,0,42,24,18,70,60,10,0
2021,Woking 011G,E01034297,599,231,51,180,1,1,322,99,223,45,42,3,0
2021,Eastbourne 012F,E01034298,1162,839,664,175,3,3,16,11,5,304,269,35,0
2021,Wealden 018G,E01034299,656,564,370,194,5,5,20,4,16,67,49,18,0
2021,Wealden 018H,E01034300,571,366,107,259,31,31,119,6,113,55,50,5,0
2021,Wealden 018I,E01034301,456,293,94,199,31,31,100,5,95,32,27,5,0
2021,Wealden 018J,E01034302,711,519,223,296,18,18,95,6,89,79,72,7,0
2021,Wealden 018K,E01034303,416,337,186,151,1,1,21,0,21,57,37,20,0
2021,Wealden 019F,E01034304,655,557,379,178,17,17,16,2,14,65,54,11,0
2021,Wealden 019G,E01034305,738,515,168,347,16,16,117,19,98,90,72,18,0
2021,Dudley 006H,E01034306,565,130,52,78,5,5,393,331,62,36,32,4,1
2021,Dudley 006I,E01034307,638,244,63,181,1,1,323,190,133,66,63,3,4
2021,Dudley 011E,E01034308,665,167,85,82,1,1,255,113,142,238,220,18,4
2021,Dudley 011F,E01034309,705,97,51,46,0,0,308,237,71,298,281,17,2
2021,Wolverhampton 006E,E01034310,409,157,43,114,4,4,217,145,72,29,26,3,2
2021,Wolverhampton 006F,E01034311,848,634,106,528,8,8,40,14,26,165,151,14,1
2021,Wolverhampton 020G,E01034312,578,107,50,57,18,18,179,120,59,274,252,22,0
2021,Wolverhampton 020H,E01034313,593,84,19,65,0,0,84,25,59,425,409,16,0
2021,Wolverhampton 035I,E01034314,641,225,86,139,1,1,218,169,49,197,186,11,0
2021,Wolverhampton 035J,E01034315,438,197,68,129,1,1,137,122,15,102,92,10,1
2021,Bromsgrove 013E,E01034316,627,365,117,248,22,22,40,11,29,200,185,15,0
2021,Bromsgrove 013F,E01034317,579,353,143,210,1,1,137,57,80,87,79,8,1
2021,Bromsgrove 014H,E01034318,649,491,288,203,8,8,37,7,30,113,100,13,0
2021,Bromsgrove 014I,E01034319,558,389,161,228,11,11,121,43,78,36,29,7,1
2021,Redditch 003E,E01034320,561,389,52,337,48,48,88,4,84,36,30,6,0
2021,Redditch 003F,E01034321,481,393,162,231,0,0,25,6,19,63,58,5,0
2021,Redditch 003G,E01034322,571,468,175,293,0,0,30,22,8,73,68,5,0
2021,Worcester 013E,E01034323,873,414,201,213,31,31,140,22,118,288,264,24,0
2021,Worcester 013F,E01034324,768,473,236,237,14,14,58,5,53,223,201,22,0
2021,Wychavon 001E,E01034325,608,449,202,247,14,14,78,17,61,66,51,15,1
2021,Wychavon 001F,E01034326,595,400,176,224,1,1,135,23,112,59,49,10,0
2021,Wychavon 005E,E01034327,676,555,279,276,19,19,82,27,55,20,17,3,0
2021,Wychavon 005F,E01034328,670,474,130,344,31,31,133,31,102,32,26,6,0
2021,Wychavon 014D,E01034329,664,208,117,91,11,11,182,29,153,262,246,16,1
2021,Wychavon 014E,E01034330,595,276,164,112,4,4,32,6,26,283,259,24,0
2021,Wyre Forest 004E,E01034331,681,165,108,57,5,5,181,72,109,330,313,17,0
2021,Wyre Forest 004F,E01034332,743,338,139,199,9,9,150,77,73,246,232,14,0
2021,Wyre Forest 009D,E01034333,615,377,135,242,12,12,125,52,73,101,88,13,0
2021,Wyre Forest 009E,E01034334,621,340,179,161,25,25,183,96,87,72,65,7,1
2021,Hyndburn 006I,E01034335,453,299,198,101,1,1,28,8,20,125,96,29,0
2021,Hyndburn 006J,E01034336,633,319,149,170,1,1,159,11,148,154,118,36,0
2021,Chorley 004E,E01034337,722,566,219,347,3,3,84,22,62,69,63,6,0
2021,Chorley 004F,E01034338,590,352,68,284,7,7,43,5,38,187,173,14,1
2021,Chorley 006G,E01034339,976,635,349,286,9,9,222,48,174,109,100,9,1
2021,Chorley 008E,E01034340,708,435,94,341,0,0,105,8,97,168,152,16,0
2021,Chorley 008F,E01034341,696,455,72,383,0,0,62,5,57,179,169,10,0
2021,Chorley 008G,E01034342,616,490,92,398,6,6,30,7,23,90,85,5,0
2021,Chorley 008H,E01034343,564,204,87,117,2,2,319,23,296,39,35,4,0
2021,Chorley 012E,E01034344,658,421,143,278,5,5,78,10,68,154,144,10,0
2021,Chorley 012F,E01034345,574,297,155,142,7,7,145,33,112,125,115,10,0
2021,Preston 002E,E01034346,433,369,224,145,0,0,7,2,5,57,41,16,0
2021,Preston 002F,E01034347,996,823,213,610,69,69,41,5,36,63,51,12,0
2021,South Ribble 005E,E01034348,851,609,328,281,36,36,138,12,126,67,53,14,1
2021,South Ribble 012E,E01034349,698,622,354,268,2,2,36,3,33,38,34,4,0
2021,South Ribble 012F,E01034350,882,738,160,578,48,48,50,5,45,46,36,10,0
2021,South Ribble 016F,E01034351,1288,1024,581,443,3,3,96,8,88,165,142,23,0
2021,South Ribble 016G,E01034352,580,434,105,329,7,7,69,6,63,70,60,10,0
2021,South Ribble 016H,E01034353,628,347,97,250,9,9,44,6,38,228,217,11,0
2021,Basildon 014F,E01034354,718,567,101,466,14,14,75,29,46,62,56,6,0
2021,Basildon 014G,E01034355,748,256,77,179,20,20,393,281,112,76,72,4,3
2021,Basildon 020F,E01034356,788,126,28,98,2,2,42,12,30,618,603,15,0
2021,Basildon 020G,E01034357,698,365,176,189,1,1,200,171,29,131,121,10,1
2021,Brentwood 007H,E01034358,662,214,64,150,10,10,118,22,96,320,284,36,0
2021,Brentwood 007I,E01034359,647,328,126,202,0,0,104,93,11,212,200,12,3
2021,Brentwood 007J,E01034360,721,467,248,219,6,6,21,5,16,225,211,14,2
2021,Brentwood 007K,E01034361,592,248,52,196,32,32,125,35,90,187,181,6,0
2021,Harlow 001E,E01034362,588,397,90,307,48,48,104,77,27,38,33,5,1
2021,Harlow 001F,E01034363,573,388,162,226,1,1,138,23,115,46,39,7,0
2021,Harlow 001G,E01034364,596,431,67,364,56,56,63,7,56,46,39,7,0
2021,Harlow 001H,E01034365,595,340,89,251,58,58,49,6,43,148,140,8,0
2021,Harlow 007F,E01034366,609,24,9,15,11,11,236,47,189,332,321,11,6
2021,Harlow 007G,E01034367,661,195,77,118,0,0,287,238,49,178,168,10,1
2021,Thurrock 006G,E01034368,696,520,54,466,8,8,102,58,44,65,60,5,1
2021,Thurrock 006H,E01034369,619,303,97,206,10,10,225,123,102,81,76,5,0
2021,Thurrock 022C,E01034370,721,427,37,390,48,48,51,35,16,195,188,7,0
2021,Thurrock 022D,E01034371,725,326,74,252,21,21,236,165,71,142,130,12,0
2021,Dorset 024E,E01034372,613,511,304,207,2,2,36,1,35,64,52,12,0
2021,Dorset 024F,E01034373,602,480,231,249,24,24,46,6,40,52,40,12,0
2021,Dorset 003D,E01034374,817,366,110,256,77,77,224,15,209,150,132,18,0
2021,Dorset 003E,E01034375,691,545,326,219,2,2,53,4,49,91,79,12,0
2021,Dorset 005E,E01034376,554,341,204,137,8,8,146,19,127,59,46,13,0
2021,Dorset 005F,E01034377,671,322,224,98,5,5,178,21,157,166,142,24,0
2021,Dorset 009D,E01034378,753,340,223,117,2,2,73,9,64,338,82,256,0
2021,Dorset 004F,E01034379,643,432,234,198,20,20,96,9,87,95,74,21,0
2021,Dorset 004G,E01034380,717,517,381,136,7,7,105,10,95,88,71,17,0
2021,Dorset 031D,E01034381,709,401,287,114,59,59,185,8,177,64,57,7,0
2021,Dorset 032D,E01034382,752,400,292,108,36,36,156,7,149,160,147,13,0
2021,Bromley 005F,E01034383,630,171,45,126,5,5,148,26,122,306,295,11,0
2021,Bromley 005G,E01034384,622,298,33,265,33,33,136,8,128,155,145,10,0
2021,Bromley 018F,E01034385,580,401,212,189,0,0,21,0,21,158,140,18,0
2021,Bromley 018G,E01034386,648,181,36,145,47,47,60,8,52,360,342,18,0
2021,Lewisham 001F,E01034387,846,381,60,321,12,12,108,23,85,345,323,22,0
2021,Lewisham 001G,E01034388,615,174,43,131,34,34,111,78,33,296,283,13,0
2021,Lewisham 001H,E01034389,731,152,22,130,75,75,351,266,85,152,146,6,1
2021,Lewisham 020F,E01034390,694,302,30,272,55,55,172,35,137,164,151,13,1
2021,Lewisham 020G,E01034391,636,376,130,246,2,2,55,25,30,203,186,17,0
2021,Lewisham 040A,E01034392,675,164,59,105,88,88,179,36,143,243,218,25,1
2021,Lewisham 040B,E01034393,613,142,28,114,2,2,13,9,4,456,443,13,0
2021,Lewisham 040C,E01034394,669,205,29,176,4,4,29,13,16,431,412,19,0
2021,Lewisham 040D,E01034395,701,67,24,43,54,54,407,54,353,173,165,8,0
2021,Liverpool 010G,E01034396,715,376,96,280,1,1,266,68,198,72,67,5,0
2021,Liverpool 010H,E01034397,678,339,52,287,2,2,197,36,161,138,132,6,2
2021,Liverpool 022F,E01034398,482,217,63,154,12,12,215,46,169,38,36,2,0
2021,Liverpool 022G,E01034399,587,95,48,47,7,7,316,58,258,167,159,8,2
2021,Liverpool 022H,E01034400,547,94,65,29,1,1,272,55,217,180,177,3,0
2021,Liverpool 035G,E01034401,1525,504,281,223,13,13,397,72,325,607,573,34,4
2021,Liverpool 037G,E01034402,584,38,15,23,15,15,116,5,111,415,405,10,0
2021,Liverpool 037H,E01034403,637,62,30,32,4,4,295,39,256,271,259,12,5
2021,Liverpool 042H,E01034404,429,294,116,178,0,0,32,1,31,103,95,8,0
2021,Liverpool 060F,E01034405,408,46,10,36,1,1,69,9,60,292,279,13,0
2021,Liverpool 060G,E01034406,426,73,32,41,22,22,35,0,35,295,279,16,1
2021,Liverpool 061E,E01034407,705,27,5,22,1,1,37,9,28,639,627,12,1
2021,Liverpool 061F,E01034408,740,168,79,89,1,1,165,29,136,405,393,12,1
2021,Liverpool 062E,E01034409,1214,266,84,182,6,6,29,6,23,912,874,38,1
2021,Liverpool 062F,E01034410,594,138,55,83,1,1,9,3,6,446,424,22,0
2021,Liverpool 062G,E01034411,742,111,64,47,1,1,21,5,16,609,587,22,0
2021,Bedford 004H,E01034412,832,640,353,287,22,22,91,13,78,79,66,13,0
2021,Bedford 004I,E01034413,430,279,91,188,20,20,58,5,53,73,64,9,0
2021,Bedford 008F,E01034414,591,495,248,247,11,11,47,5,42,38,30,8,0
2021,Bedford 008G,E01034415,540,269,60,209,26,26,127,8,119,117,109,8,1
2021,Bedford 008H,E01034416,609,471,69,402,21,21,51,4,47,66,60,6,0
2021,Bedford 008I,E01034417,505,343,40,303,52,52,52,7,45,58,54,4,0
2021,Bedford 012G,E01034418,654,179,90,89,5,5,142,20,122,328,323,5,0
2021,Bedford 012H,E01034419,653,186,79,107,20,20,79,10,69,367,346,21,1
2021,Bedford 015G,E01034420,756,223,78,145,9,9,150,13,137,374,351,23,0
2021,Bedford 015H,E01034421,655,247,60,187,24,24,87,17,70,297,281,16,0
2021,Bedford 018F,E01034422,582,398,121,277,35,35,82,7,75,67,63,4,0
2021,Bedford 018G,E01034423,407,326,198,128,3,3,21,1,20,57,53,4,0
2021,Bedford 018H,E01034424,606,387,57,330,49,49,72,5,67,98,89,9,0
2021,Bedford 020E,E01034425,727,556,257,299,21,21,83,10,73,66,55,11,1
2021,Bedford 020F,E01034426,816,573,61,512,66,66,153,24,129,24,21,3,0
2021,Bedford 021A,E01034427,570,348,46,302,60,60,101,19,82,61,59,2,0
2021,Bedford 021C,E01034428,514,427,61,366,15,15,34,2,32,38,34,4,0
2021,Bedford 021D,E01034429,483,286,145,141,7,7,86,8,78,104,91,13,0
2021,Bedford 021E,E01034430,433,318,190,128,8,8,69,8,61,38,33,5,0
2021,Bedford 022A,E01034431,673,404,133,271,11,11,142,16,126,113,104,9,3
2021,Bedford 022B,E01034432,580,413,236,177,48,48,62,2,60,56,49,7,1
2021,Bedford 022C,E01034433,819,595,95,500,60,60,100,18,82,64,57,7,0
2021,Bedford 022D,E01034434,700,483,72,411,71,71,122,18,104,24,20,4,0
2021,Huntingdonshire 010H,E01034435,684,570,187,383,4,4,54,16,38,56,48,8,0
2021,Huntingdonshire 010I,E01034436,734,454,245,209,25,25,96,16,80,158,80,78,1
2021,Huntingdonshire 012F,E01034437,581,207,124,83,34,34,69,9,60,271,262,9,0
2021,Huntingdonshire 012G,E01034438,732,271,171,100,3,3,75,9,66,383,335,48,0
2021,Huntingdonshire 014E,E01034439,702,419,279,140,3,3,83,27,56,197,185,12,0
2021,Huntingdonshire 014F,E01034440,647,358,76,282,42,42,165,18,147,82,71,11,0
2021,Huntingdonshire 018E,E01034441,665,546,255,291,5,5,59,7,52,55,48,7,0
2021,Huntingdonshire 018F,E01034442,639,245,47,198,88,88,204,21,183,102,95,7,0
2021,Huntingdonshire 018G,E01034443,630,363,70,293,27,27,121,19,102,119,104,15,0
2021,Huntingdonshire 021G,E01034444,717,530,242,288,4,4,14,0,14,169,156,13,0
2021,Huntingdonshire 021H,E01034445,711,433,125,308,31,31,103,13,90,144,129,15,0
2021,Milton Keynes 002G,E01034446,637,390,104,286,36,36,113,11,102,98,90,8,0
2021,Milton Keynes 002H,E01034447,525,453,215,238,3,3,31,22,9,38,35,3,0
2021,Milton Keynes 002I,E01034448,580,342,77,265,63,63,103,4,99,72,67,5,0
2021,Milton Keynes 010E,E01034449,832,589,299,290,46,46,52,6,46,145,122,23,0
2021,Milton Keynes 010F,E01034450,683,344,77,267,120,120,73,8,65,145,134,11,1
2021,Milton Keynes 024E,E01034451,784,579,114,465,62,62,69,16,53,74,61,13,0
2021,Milton Keynes 024F,E01034452,948,606,249,357,50,50,85,27,58,207,189,18,0
2021,Milton Keynes 032E,E01034453,728,442,37,405,91,91,83,13,70,112,105,7,0
2021,Milton Keynes 032F,E01034454,659,195,91,104,33,33,302,255,47,124,116,8,5
2021,Milton Keynes 032G,E01034455,688,463,56,407,70,70,84,8,76,71,65,6,0
2021,Milton Keynes 033C,E01034456,604,412,164,248,45,45,45,3,42,102,98,4,0
2021,Milton Keynes 033D,E01034457,805,314,57,257,41,41,210,17,193,240,231,9,0
2021,Milton Keynes 034A,E01034458,642,443,27,416,80,80,52,9,43,67,63,4,0
2021,Milton Keynes 034B,E01034459,654,294,36,258,82,82,139,3,136,139,128,11,0
2021,Milton Keynes 034D,E01034460,628,378,20,358,112,112,59,5,54,79,76,3,0
2021,Milton Keynes 034E,E01034461,646,230,31,199,48,48,125,18,107,243,235,8,0
2021,Milton Keynes 036A,E01034462,656,525,335,190,5,5,49,41,8,77,66,11,0
2021,Milton Keynes 036B,E01034463,621,403,21,382,147,147,39,7,32,32,29,3,0
2021,Milton Keynes 036C,E01034464,602,403,63,340,62,62,40,12,28,97,87,10,0
2021,Milton Keynes 036F,E01034465,635,334,48,286,57,57,111,12,99,133,127,6,0
2021,Milton Keynes 037A,E01034466,858,629,31,598,134,134,44,8,36,51,44,7,0
2021,Milton Keynes 037B,E01034467,713,422,101,321,39,39,152,6,146,100,97,3,0
2021,Milton Keynes 037E,E01034468,462,251,166,85,72,72,71,23,48,68,62,6,0
2021,Barking and Dagenham 004F,E01034469,542,329,55,274,29,29,120,20,100,63,55,8,1
2021,Barking and Dagenham 004G,E01034470,465,279,102,177,2,2,67,52,15,116,106,10,1
2021,Barking and Dagenham 008G,E01034471,772,217,60,157,28,28,299,140,159,227,218,9,1
2021,Barking and Dagenham 008H,E01034472,667,163,27,136,12,12,234,52,182,258,244,14,0
2021,Barking and Dagenham 015E,E01034473,427,118,56,62,1,1,59,48,11,248,229,19,1
2021,Barking and Dagenham 015F,E01034474,863,128,24,104,25,25,269,162,107,440,426,14,1
2021,Barking and Dagenham 019F,E01034475,585,257,90,167,6,6,203,151,52,118,106,12,1
2021,Barking and Dagenham 019G,E01034476,510,176,32,144,12,12,228,47,181,93,89,4,1
2021,Barking and Dagenham 019H,E01034477,552,149,11,138,14,14,249,44,205,139,130,9,1
2021,Barking and Dagenham 019I,E01034478,473,295,5,290,66,66,49,14,35,63,61,2,0
2021,Barking and Dagenham 021G,E01034479,750,146,29,117,26,26,378,302,76,198,170,28,2
2021,Redbridge 023E,E01034480,410,109,37,72,10,10,121,27,94,170,164,6,0
2021,Redbridge 023F,E01034481,466,139,61,78,6,6,138,25,113,182,169,13,1
2021,Redbridge 032F,E01034482,427,38,8,30,83,83,73,9,64,233,225,8,0
2021,Redbridge 032G,E01034483,542,29,9,20,71,71,225,33,192,216,209,7,1
2021,Redbridge 032H,E01034484,535,211,107,104,4,4,35,21,14,285,266,19,0
2021,Waltham Forest 014F,E01034485,765,433,196,237,6,6,35,21,14,291,268,23,0
2021,Waltham Forest 014G,E01034486,739,267,9,258,61,61,63,8,55,348,340,8,0
2021,Waltham Forest 020H,E01034487,456,67,17,50,55,55,250,52,198,81,76,5,3
2021,Waltham Forest 020I,E01034488,664,125,40,85,3,3,446,107,339,89,80,9,1
2021,County Durham 014F,E01034489,529,319,108,211,1,1,105,31,74,104,86,18,0
2021,County Durham 014G,E01034490,631,528,105,423,3,3,53,5,48,47,38,9,0
2021,County Durham 014H,E01034491,540,254,103,151,1,1,184,95,89,100,89,11,1
2021,County Durham 016H,E01034492,992,638,330,308,2,2,220,140,80,130,106,24,2
2021,County Durham 030H,E01034493,788,194,144,50,1,1,134,49,85,459,426,33,0
2021,County Durham 031D,E01034494,696,435,158,277,7,7,99,32,67,151,138,13,4
2021,County Durham 031E,E01034495,659,335,184,151,2,2,212,90,122,100,85,15,10
2021,County Durham 033F,E01034496,533,398,223,175,2,2,14,2,12,119,108,11,0
2021,County Durham 033G,E01034497,683,500,253,247,4,4,78,8,70,101,88,13,0
2021,County Durham 033H,E01034498,483,438,196,242,0,0,8,3,5,37,31,6,0
2021,County Durham 033I,E01034499,791,433,155,278,26,26,100,17,83,232,220,12,0
2021,County Durham 039F,E01034500,1081,733,479,254,2,2,215,134,81,130,105,25,1
2021,County Durham 049E,E01034501,887,379,206,173,0,0,328,180,148,173,158,15,7
2021,County Durham 049F,E01034502,540,481,90,391,0,0,11,4,7,47,41,6,1
2021,County Durham 052F,E01034503,727,419,130,289,3,3,180,57,123,125,115,10,0
2021,County Durham 052G,E01034504,625,371,134,237,0,0,197,72,125,56,50,6,1
2021,County Durham 053F,E01034505,730,443,241,202,0,0,141,62,79,146,129,17,0
2021,County Durham 053G,E01034506,581,263,173,90,1,1,81,14,67,236,221,15,0
2021,County Durham 053H,E01034507,585,420,182,238,1,1,62,35,27,102,91,11,0
2021,County Durham 053I,E01034508,680,532,239,293,10,10,55,14,41,83,74,9,0
2021,County Durham 057F,E01034509,715,501,185,316,0,0,37,21,16,177,156,21,0
2021,County Durham 057G,E01034510,513,169,64,105,0,0,261,135,126,83,74,9,0
2021,County Durham 067A,E01034511,1069,677,488,189,4,4,91,16,75,297,241,56,0
2021,South Tyneside 013F,E01034512,640,361,189,172,2,2,220,171,49,57,38,19,0
2021,South Tyneside 013G,E01034513,596,372,113,259,7,7,159,37,122,58,48,10,0
2021,Sunderland 005H,E01034514,1547,591,372,219,32,32,575,187,388,348,313,35,1
2021,Sunderland 017F,E01034515,603,509,228,281,6,6,24,6,18,64,52,12,0
2021,Sunderland 017G,E01034516,589,512,93,419,3,3,19,1,18,55,45,10,0
2021,Sunderland 021G,E01034517,974,337,182,155,2,2,527,270,257,107,90,17,1
2021,Sunderland 030F,E01034518,731,627,346,281,0,0,53,18,35,51,38,13,0
2021,Sunderland 030G,E01034519,605,553,133,420,3,3,20,6,14,29,27,2,0
2021,Wiltshire 003E,E01034520,667,541,280,261,12,12,45,6,39,69,59,10,0
2021,Wiltshire 003F,E01034521,763,523,60,463,47,47,114,6,108,79,65,14,0
2021,Wiltshire 013E,E01034522,578,465,278,187,2,2,37,7,30,74,58,16,0
2021,Wiltshire 013F,E01034523,630,468,211,257,32,32,29,3,26,101,83,18,0
2021,Wiltshire 016E,E01034524,637,439,304,135,10,10,113,16,97,75,60,15,0
2021,Wiltshire 016F,E01034525,572,465,237,228,6,6,42,3,39,59,54,5,0
2021,Wiltshire 018H,E01034526,598,436,279,157,20,20,76,6,70,66,53,13,0
2021,Wiltshire 018I,E01034527,606,431,165,266,9,9,58,7,51,108,99,9,0
2021,Wiltshire 021G,E01034528,573,471,212,259,12,12,40,12,28,50,33,17,0
2021,Wiltshire 021H,E01034529,549,372,111,261,3,3,117,9,108,57,46,11,0
2021,Wiltshire 021I,E01034530,643,568,249,319,3,3,19,1,18,53,41,12,0
2021,Wiltshire 027G,E01034531,626,400,260,140,13,13,75,9,66,138,116,22,0
2021,Wiltshire 027H,E01034532,596,454,307,147,3,3,18,1,17,121,104,17,0
2021,Wiltshire 031D,E01034533,958,393,183,210,14,14,275,43,232,272,255,17,4
2021,Wiltshire 031E,E01034534,578,141,88,53,2,2,184,39,145,251,240,11,0
2021,Wiltshire 032E,E01034535,536,444,247,197,4,4,30,6,24,58,50,8,0
2021,Wiltshire 032F,E01034536,531,301,117,184,4,4,90,14,76,136,119,17,0
2021,Wiltshire 032G,E01034537,527,396,95,301,0,0,84,11,73,47,41,6,0
2021,Wiltshire 034E,E01034538,570,389,228,161,3,3,119,8,111,59,44,15,0
2021,Wiltshire 034F,E01034539,670,411,162,249,71,71,108,14,94,80,69,11,0
2021,Wiltshire 037D,E01034540,660,568,374,194,0,0,8,3,5,84,62,22,0
2021,Wiltshire 037E,E01034541,625,447,220,227,0,0,98,14,84,80,76,4,0
2021,Wiltshire 045G,E01034542,415,34,8,26,2,2,46,18,28,333,48,285,0
2021,Wiltshire 045H,E01034543,407,63,18,45,1,1,34,8,26,309,40,269,0
2021,Wiltshire 048G,E01034544,669,518,310,208,9,9,37,2,35,105,93,12,0
2021,Wiltshire 048H,E01034545,490,253,59,194,26,26,110,45,65,101,80,21,0
2021,Wiltshire 048I,E01034546,539,334,31,303,58,58,109,11,98,38,31,7,0
2021,Wiltshire 057D,E01034547,529,246,36,210,105,105,134,5,129,44,33,11,0
2021,Wiltshire 057E,E01034548,566,380,158,222,17,17,66,3,63,103,50,53,0
2021,Wiltshire 057F,E01034549,545,193,43,150,47,47,202,14,188,103,72,31,0
2021,Wiltshire 057G,E01034550,488,290,161,129,9,9,97,61,36,89,77,12,3
2021,Wiltshire 063A,E01034551,724,530,230,300,15,15,72,13,59,107,92,15,0
2021,Wiltshire 063B,E01034552,698,512,240,272,0,0,93,12,81,93,77,16,0
2021,Wiltshire 065C,E01034553,539,183,73,110,19,19,120,8,112,216,34,182,1
2021,Wiltshire 065D,E01034554,607,274,50,224,29,29,147,30,117,157,47,110,0
2021,Wiltshire 065E,E01034555,594,335,117,218,17,17,48,8,40,194,45,149,0
2021,Wiltshire 066B,E01034556,605,257,89,168,14,14,151,25,126,183,88,95,0
2021,Wiltshire 066D,E01034557,460,164,72,92,5,5,40,10,30,251,55,196,0
2021,Wiltshire 066E,E01034558,463,38,4,34,0,0,29,10,19,396,56,340,0
2021,Babergh 004G,E01034559,593,308,163,145,10,10,73,13,60,202,85,117,0
2021,Babergh 004H,E01034560,588,429,294,135,5,5,73,36,37,79,71,8,2
2021,West Suffolk 001C,E01034561,768,391,195,196,7,7,95,32,63,274,261,13,1
2021,West Suffolk 001D,E01034562,529,34,7,27,0,0,86,9,77,409,63,346,0
2021,West Suffolk 001E,E01034563,526,216,23,193,0,0,39,3,36,271,185,86,0
2021,West Suffolk 003E,E01034564,600,290,152,138,0,0,14,6,8,296,183,113,0
2021,West Suffolk 003F,E01034565,605,247,157,90,93,93,104,18,86,161,154,7,0
2021,West Suffolk 007E,E01034566,782,343,51,292,34,34,119,29,90,286,279,7,0
2021,West Suffolk 007F,E01034567,475,216,29,187,63,63,104,22,82,92,87,5,0
2021,West Suffolk 008E,E01034568,610,292,184,108,14,14,94,19,75,209,148,61,1
2021,West Suffolk 008F,E01034569,650,145,49,96,59,59,379,95,284,66,54,12,1
2021,Mid Suffolk 003D,E01034570,775,595,416,179,4,4,89,64,25,84,54,30,3
2021,Mid Suffolk 003E,E01034571,464,323,212,111,1,1,82,69,13,58,44,14,0
2021,West Suffolk 016C,E01034572,759,531,389,142,20,20,48,11,37,159,151,8,1
2021,West Suffolk 016D,E01034573,679,390,131,259,44,44,149,36,113,96,86,10,0
2021,West Suffolk 018C,E01034574,469,392,215,177,2,2,23,15,8,51,36,15,1
2021,West Suffolk 018D,E01034575,494,376,250,126,4,4,58,11,47,56,41,15,0
2021,Kingston upon Thames 004H,E01034576,588,230,100,130,30,30,27,7,20,301,277,24,0
2021,Kingston upon Thames 004I,E01034577,634,127,46,81,49,49,148,20,128,309,297,12,1
2021,Merton 001F,E01034578,448,212,104,108,1,1,105,62,43,129,118,11,1
2021,Merton 001G,E01034579,894,294,92,202,58,58,162,17,145,380,366,14,0
2021,Merton 005F,E01034580,593,188,90,98,49,49,69,14,55,287,272,15,0
2021,Merton 005G,E01034581,684,227,81,146,90,90,49,9,40,318,298,20,0
2021,Calderdale 008G,E01034582,826,88,62,26,4,4,252,73,179,480,453,27,2
2021,Calderdale 008H,E01034583,553,182,109,73,2,2,72,5,67,296,284,12,1
2021,Kirklees 017F,E01034584,617,378,200,178,0,0,81,65,16,155,141,14,3
2021,Kirklees 017G,E01034585,410,298,162,136,0,0,6,4,2,106,91,15,0
2021,Kirklees 030E,E01034586,635,557,333,224,0,0,20,6,14,58,49,9,0
2021,Kirklees 030F,E01034587,577,473,74,399,16,16,54,4,50,34,30,4,0
2021,Kirklees 053G,E01034588,1128,680,363,317,5,5,229,182,47,211,186,25,3
2021,Harrow 002F,E01034589,617,419,232,187,29,29,51,6,45,118,103,15,0
2021,Harrow 002G,E01034590,615,228,82,146,54,54,61,4,57,272,250,22,0
2021,Harrow 013F,E01034591,520,194,67,127,15,15,106,17,89,205,199,6,0
2021,Harrow 013G,E01034592,401,142,77,65,9,9,117,70,47,129,118,11,4
2021,Harrow 015E,E01034593,530,323,149,174,1,1,75,25,50,131,115,16,0
2021,Harrow 015F,E01034594,472,387,79,308,7,7,10,5,5,68,60,8,0
2021,Harrow 023E,E01034595,515,180,94,86,13,13,50,7,43,271,263,8,1
2021,Harrow 023F,E01034596,580,227,33,194,10,10,70,25,45,270,262,8,3
2021,Harrow 023G,E01034597,605,298,111,187,2,2,95,65,30,207,198,9,3
2021,Harrow 023H,E01034598,600,173,20,153,18,18,54,15,39,355,346,9,0
2021,Harrow 027E,E01034599,573,248,137,111,13,13,98,14,84,214,206,8,0
2021,Harrow 027F,E01034600,816,278,81,197,31,31,97,14,83,410,401,9,0
2021,Hillingdon 015G,E01034601,593,273,100,173,2,2,151,41,110,166,128,38,1
2021,Hillingdon 015H,E01034602,627,157,60,97,45,45,121,39,82,304,286,18,0
2021,Hillingdon 015I,E01034603,515,376,39,337,12,12,22,1,21,105,52,53,0
2021,Hillingdon 015J,E01034604,609,233,116,117,4,4,171,139,32,201,194,7,0
2021,Hillingdon 015K,E01034605,578,273,77,196,26,26,104,60,44,175,105,70,0
2021,Hillingdon 016G,E01034606,486,272,153,119,1,1,42,31,11,169,154,15,2
2021,Hillingdon 016H,E01034607,576,260,134,126,1,1,146,111,35,167,153,14,2
2021,Hillingdon 022G,E01034608,943,363,110,253,50,50,172,17,155,355,339,16,3
2021,Hillingdon 022H,E01034609,851,172,56,116,11,11,177,50,127,491,477,14,0
2021,Hillingdon 027G,E01034610,566,259,99,160,51,51,136,48,88,118,109,9,2
2021,Hillingdon 027H,E01034611,429,186,63,123,4,4,62,21,41,176,159,17,1
2021,Hillingdon 027I,E01034612,620,317,152,165,5,5,97,29,68,200,184,16,1
2021,Hillingdon 027J,E01034613,443,37,7,30,9,9,92,7,85,305,304,1,0
2021,Hillingdon 028F,E01034614,756,192,44,148,27,27,204,31,173,331,326,5,2
2021,Hillingdon 028G,E01034615,699,338,91,247,43,43,172,66,106,146,141,5,0
2021,Hillingdon 030F,E01034616,697,91,22,69,45,45,111,27,84,444,431,13,6
2021,Hillingdon 030G,E01034617,732,296,127,169,29,29,110,14,96,297,278,19,0
2021,East Devon 005F,E01034618,753,393,206,187,9,9,276,186,90,75,67,8,0
2021,East Devon 005G,E01034619,688,492,331,161,50,50,65,11,54,80,58,22,1
2021,East Devon 021C,E01034620,716,502,232,270,1,1,112,74,38,100,75,25,1
2021,East Devon 021D,E01034621,684,452,124,328,46,46,138,15,123,48,42,6,0
2021,East Devon 021E,E01034622,682,486,96,390,41,41,111,13,98,44,34,10,0
2021,East Devon 021F,E01034623,651,460,251,209,10,10,78,46,32,103,83,20,0
2021,East Devon 022A,E01034624,713,489,38,451,115,115,63,3,60,46,44,2,0
2021,East Devon 022B,E01034625,603,366,49,317,47,47,120,12,108,70,62,8,0
2021,East Devon 022C,E01034626,508,252,60,192,50,50,96,12,84,110,76,34,0
2021,East Devon 022D,E01034627,442,246,46,200,41,41,99,12,87,56,47,9,0
2021,Exeter 001G,E01034628,500,444,298,146,0,0,11,2,9,45,36,9,0
2021,Exeter 001H,E01034629,477,301,198,103,15,15,65,4,61,96,76,20,0
2021,Exeter 008F,E01034630,596,163,97,66,2,2,120,59,61,310,281,29,1
2021,Exeter 008G,E01034631,652,88,50,38,1,1,303,137,166,257,247,10,3
2021,Exeter 011H,E01034632,487,379,237,142,13,13,52,30,22,43,32,11,0
2021,Exeter 011I,E01034633,804,499,182,317,33,33,101,14,87,170,160,10,1
2021,Exeter 015G,E01034634,699,460,213,247,23,23,138,36,102,78,75,3,0
2021,Exeter 015H,E01034635,636,507,347,160,15,15,49,33,16,65,44,21,0
2021,Mid Devon 002E,E01034636,626,517,275,242,2,2,9,5,4,98,85,13,0
2021,Mid Devon 002F,E01034637,650,308,142,166,9,9,32,3,29,301,290,11,0
2021,North Devon 012F,E01034638,660,501,252,249,27,27,81,12,69,51,40,11,0
2021,North Devon 012G,E01034639,593,434,230,204,39,39,41,8,33,79,66,13,0
2021,Torridge 002D,E01034640,606,385,293,92,2,2,24,3,21,195,180,15,0
2021,Torridge 002E,E01034641,649,466,323,143,14,14,37,6,31,132,122,10,0
2021,West Devon 001E,E01034642,609,492,350,142,3,3,22,10,12,92,66,26,0
2021,West Devon 001F,E01034643,688,404,173,231,41,41,122,5,117,121,112,9,0
2021,Bolsover 001F,E01034644,598,408,223,185,1,1,123,84,39,64,52,12,2
2021,Bolsover 001G,E01034645,618,492,227,265,1,1,19,9,10,105,91,14,1
2021,Bolsover 006E,E01034646,659,472,247,225,0,0,103,100,3,82,68,14,2
2021,Bolsover 006F,E01034647,646,502,168,334,1,1,7,7,0,136,126,10,0
2021,North East Derbyshire 012E,E01034648,607,386,152,234,0,0,143,131,12,76,64,12,2
2021,North East Derbyshire 012F,E01034649,638,230,149,81,1,1,210,139,71,196,181,15,1
2021,South Derbyshire 003F,E01034650,941,698,87,611,50,50,114,14,100,79,75,4,0
2021,South Derbyshire 003G,E01034651,565,512,318,194,0,0,6,4,2,47,40,7,0
2021,South Derbyshire 004E,E01034652,554,493,179,314,6,6,3,2,1,52,47,5,0
2021,South Derbyshire 004F,E01034653,608,479,103,376,13,13,90,12,78,26,21,5,0
2021,South Derbyshire 012F,E01034654,732,613,115,498,2,2,18,1,17,99,92,7,0
2021,South Derbyshire 012G,E01034655,684,472,102,370,9,9,27,10,17,176,168,8,0
2021,South Derbyshire 013E,E01034656,745,377,157,220,2,2,140,70,70,224,209,15,2
2021,South Derbyshire 013F,E01034657,670,518,123,395,10,10,28,2,26,114,104,10,0
2021,Cheshire East 003F,E01034658,1061,961,610,351,0,0,28,10,18,72,61,11,0
2021,Cheshire East 016F,E01034659,653,466,269,197,3,3,70,17,53,113,106,7,1
2021,Cheshire East 016G,E01034660,582,285,154,131,10,10,173,19,154,114,105,9,0
2021,Cheshire East 020E,E01034661,429,373,224,149,8,8,16,0,16,32,24,8,0
2021,Cheshire East 020F,E01034662,823,583,308,275,17,17,85,15,70,138,112,26,0
2021,Cheshire East 022D,E01034663,879,634,257,377,59,59,89,17,72,97,82,15,0
2021,Cheshire East 022E,E01034664,591,466,280,186,1,1,29,3,26,95,78,17,0
2021,Cheshire East 031E,E01034665,552,464,247,217,0,0,28,8,20,60,52,8,0
2021,Cheshire East 031F,E01034666,660,475,191,284,38,38,88,7,81,59,51,8,0
2021,Cheshire East 033H,E01034667,546,471,231,240,9,9,29,5,24,37,29,8,0
2021,Cheshire East 033I,E01034668,715,584,238,346,25,25,39,9,30,67,54,13,0
2021,Cheshire East 036F,E01034669,605,176,92,84,2,2,122,36,86,305,285,20,0
2021,Cheshire East 036G,E01034670,639,207,61,146,6,6,128,22,106,298,289,9,0
2021,Cheshire East 041F,E01034671,506,365,165,200,13,13,49,11,38,79,62,17,0
2021,Cheshire East 041G,E01034672,495,386,257,129,6,6,40,10,30,63,49,14,0
2021,Cheshire East 041H,E01034673,482,379,136,243,0,0,6,0,6,97,91,6,0
2021,Cheshire East 052A,E01034674,594,488,127,361,23,23,20,7,13,63,46,17,0
2021,Cheshire East 052B,E01034675,627,504,316,188,5,5,29,4,25,89,62,27,0
2021,Cheshire East 052C,E01034676,473,327,125,202,23,23,51,12,39,72,65,7,0
2021,Cheshire East 052D,E01034677,586,510,294,216,3,3,15,4,11,58,44,14,0
2021,Cheshire East 052E,E01034678,520,334,110,224,43,43,78,8,70,65,57,8,0
2021,Boston 002F,E01034679,550,290,143,147,2,2,56,28,28,202,188,14,0
2021,Boston 002G,E01034680,565,145,60,85,0,0,277,153,124,142,130,12,1
2021,Boston 003E,E01034681,600,143,81,62,9,9,143,39,104,305,295,10,0
2021,Boston 003F,E01034682,656,201,84,117,5,5,99,39,60,350,318,32,1
2021,Boston 009E,E01034683,580,419,216,203,7,7,27,8,19,127,112,15,0
2021,Boston 009F,E01034684,561,365,139,226,12,12,52,15,37,132,122,10,0
2021,East Lindsey 012E,E01034685,641,549,462,87,4,4,14,2,12,74,66,8,0
2021,East Lindsey 012F,E01034686,745,417,216,201,13,13,37,7,30,277,260,17,1
2021,Lincoln 005E,E01034687,459,177,92,85,1,1,22,5,17,259,252,7,0
2021,Lincoln 005F,E01034688,433,147,82,65,0,0,28,11,17,258,244,14,0
2021,Lincoln 007E,E01034689,519,301,114,187,13,13,46,29,17,159,143,16,0
2021,Lincoln 007F,E01034690,691,486,251,235,3,3,62,49,13,140,128,12,0
2021,Lincoln 008E,E01034691,462,150,74,76,5,5,167,26,141,140,131,9,0
2021,Lincoln 008F,E01034692,640,243,132,111,19,19,33,13,20,345,328,17,0
2021,North Kesteven 003I,E01034693,673,563,87,476,7,7,21,10,11,82,67,15,0
2021,North Kesteven 003J,E01034694,710,507,108,399,2,2,16,13,3,185,173,12,0
2021,North Kesteven 011F,E01034695,747,469,122,347,59,59,44,19,25,174,105,69,1
2021,North Kesteven 011G,E01034696,623,574,318,256,0,0,1,0,1,48,35,13,0
2021,South Holland 006H,E01034697,650,470,206,264,34,34,41,17,24,105,97,8,0
2021,South Holland 006I,E01034698,631,471,136,335,18,18,46,6,40,96,91,5,0
2021,South Holland 009F,E01034699,549,256,115,141,26,26,58,13,45,209,200,9,0
2021,South Holland 009G,E01034700,668,488,326,162,10,10,35,7,28,135,129,6,0
2021,South Kesteven 004F,E01034701,602,485,70,415,24,24,48,10,38,45,41,4,0
2021,South Kesteven 004G,E01034702,649,567,304,263,0,0,8,0,8,74,66,8,0
2021,South Kesteven 010E,E01034703,574,477,324,153,1,1,17,5,12,79,69,10,0
2021,South Kesteven 010F,E01034704,547,369,57,312,30,30,38,5,33,110,103,7,0
2021,South Kesteven 010G,E01034705,547,403,88,315,22,22,23,4,19,99,89,10,0
2021,West Lindsey 009E,E01034706,644,516,237,279,16,16,37,6,31,75,60,15,0
2021,West Lindsey 009F,E01034707,610,455,294,161,1,1,6,0,6,148,124,24,0
2021,Basingstoke and Deane 005F,E01034708,516,397,149,248,37,37,51,6,45,31,25,6,0
2021,Basingstoke and Deane 005G,E01034709,526,310,70,240,54,54,129,7,122,33,20,13,0
2021,Basingstoke and Deane 005H,E01034710,507,335,53,282,46,46,97,10,87,29,23,6,0
2021,Basingstoke and Deane 006E,E01034711,689,445,124,321,40,40,82,2,80,122,117,5,0
2021,Basingstoke and Deane 006F,E01034712,722,609,207,402,1,1,44,2,42,68,62,6,0
2021,Basingstoke and Deane 007K,E01034713,624,327,92,235,54,54,158,9,149,85,80,5,0
2021,Basingstoke and Deane 007L,E01034714,712,202,102,100,43,43,375,26,349,90,85,5,2
2021,Basingstoke and Deane 009E,E01034715,654,334,131,203,18,18,208,9,199,94,81,13,0
2021,Basingstoke and Deane 009F,E01034716,625,330,56,274,47,47,147,10,137,101,92,9,0
2021,Basingstoke and Deane 010H,E01034717,473,169,19,150,41,41,153,5,148,110,89,21,0
2021,Basingstoke and Deane 010I,E01034718,790,401,45,356,24,24,201,8,193,164,156,8,0
2021,East Hampshire 003G,E01034719,716,572,345,227,26,26,67,3,64,50,44,6,1
2021,East Hampshire 003H,E01034720,685,424,223,201,16,16,196,31,165,49,39,10,0
2021,East Hampshire 008F,E01034721,481,391,185,206,4,4,34,3,31,52,40,12,0
2021,East Hampshire 008G,E01034722,727,508,234,274,9,9,128,24,104,81,42,39,1
2021,Hart 008F,E01034723,551,433,241,192,0,0,94,10,84,24,23,1,0
2021,Hart 008G,E01034724,645,464,133,331,67,67,69,4,65,45,42,3,0
2021,Hart 010F,E01034725,725,465,110,355,63,63,96,9,87,101,66,35,0
2021,Hart 010G,E01034726,760,427,100,327,52,52,90,13,77,190,83,107,1
2021,Rushmoor 008E,E01034727,798,303,25,278,54,54,153,23,130,288,140,148,0
2021,Rushmoor 008F,E01034728,529,210,14,196,62,62,115,12,103,142,23,119,0
2021,Rushmoor 008G,E01034729,561,148,36,112,6,6,109,25,84,297,122,175,1
2021,Rushmoor 008H,E01034730,698,100,30,70,56,56,161,34,127,379,360,19,2
2021,Winchester 013H,E01034731,670,341,90,251,48,48,109,18,91,172,164,8,0
2021,Winchester 013I,E01034732,598,435,278,157,1,1,47,18,29,115,93,22,0
2021,Winchester 014F,E01034733,694,353,257,96,5,5,65,34,31,271,171,100,0
2021,Winchester 014G,E01034734,637,306,48,258,68,68,128,21,107,135,123,12,0
2021,Coventry 015G,E01034735,614,297,38,259,6,6,114,16,98,196,176,20,1
2021,Coventry 015H,E01034736,568,143,76,67,1,1,168,34,134,256,235,21,0
2021,Coventry 020F,E01034737,592,236,85,151,8,8,71,6,65,274,253,21,3
2021,Coventry 020G,E01034738,543,161,93,68,3,3,58,11,47,321,285,36,0
2021,Coventry 025E,E01034739,708,346,71,275,40,40,89,17,72,233,215,18,0
2021,Coventry 025F,E01034740,734,331,113,218,2,2,320,29,291,80,76,4,1
2021,Coventry 028E,E01034741,424,45,26,19,0,0,55,15,40,322,312,10,2
2021,Coventry 028F,E01034742,444,75,48,27,1,1,93,13,80,275,261,14,0
2021,Coventry 031E,E01034743,420,38,22,16,0,0,222,37,185,160,151,9,0
2021,Coventry 031F,E01034744,480,43,30,13,2,2,146,12,134,289,276,13,0
2021,Coventry 035I,E01034745,461,225,45,180,2,2,161,43,118,72,68,4,1
2021,Coventry 035J,E01034746,553,95,42,53,1,1,394,152,242,62,57,5,1
2021,Coventry 036H,E01034747,697,228,107,121,9,9,354,80,274,105,90,15,1
2021,Coventry 036I,E01034748,538,98,62,36,9,9,328,100,228,99,89,10,4
2021,Coventry 038G,E01034749,764,262,126,136,2,2,124,25,99,375,352,23,1
2021,Coventry 038H,E01034750,1059,520,99,421,5,5,44,13,31,490,474,16,0
2021,West Oxfordshire 004I,E01034751,645,406,212,194,3,3,129,15,114,107,83,24,0
2021,East Riding of Yorkshire 001G,E01034752,633,369,240,129,4,4,180,132,48,80,70,10,0
2021,East Riding of Yorkshire 001H,E01034753,618,467,351,116,2,2,3,2,1,146,130,16,0
2021,East Riding of Yorkshire 011H,E01034754,547,436,255,181,4,4,44,21,23,63,45,18,0
2021,East Riding of Yorkshire 011I,E01034755,667,502,222,280,14,14,102,4,98,49,37,12,0
2021,East Riding of Yorkshire 024F,E01034756,1062,898,533,365,2,2,42,30,12,120,97,23,0
2021,East Riding of Yorkshire 032I,E01034757,601,437,235,202,1,1,3,2,1,160,147,13,0
2021,East Riding of Yorkshire 032J,E01034758,604,473,106,367,0,0,3,1,2,128,120,8,0
2021,East Riding of Yorkshire 044E,E01034759,657,515,240,275,15,15,26,2,24,101,92,9,0
2021,East Riding of Yorkshire 044F,E01034760,619,443,268,175,5,5,38,13,25,133,126,7,0
2021,York 023D,E01034761,679,566,292,274,0,0,49,13,36,64,54,10,0
2021,York 023E,E01034762,587,331,193,138,4,4,102,76,26,149,133,16,1
2021,Lancaster 015E,E01034763,838,338,188,150,3,3,31,10,21,462,444,18,4
2021,Ribble Valley 008H,E01034764,898,819,462,357,0,0,13,2,11,66,46,20,0
2021,Broadland 013F,E01034765,675,473,95,378,32,32,109,13,96,60,50,10,1
2021,Broadland 013G,E01034766,754,609,397,212,13,13,42,4,38,90,74,16,0
2021,Great Yarmouth 013E,E01034767,1073,673,403,270,3,3,278,167,111,115,91,24,4
2021,King's Lynn and West Norfolk 011G,E01034768,659,272,202,70,1,1,108,26,82,274,256,18,4
2021,King's Lynn and West Norfolk 011H,E01034769,576,101,70,31,1,1,159,41,118,312,290,22,3
2021,King's Lynn and West Norfolk 017I,E01034770,596,482,378,104,0,0,6,0,6,108,86,22,0
2021,King's Lynn and West Norfolk 017J,E01034771,620,410,256,154,2,2,29,0,29,179,165,14,0
2021,King's Lynn and West Norfolk 017K,E01034772,637,541,450,91,7,7,18,2,16,71,54,17,0
2021,King's Lynn and West Norfolk 017L,E01034773,669,505,382,123,1,1,92,9,83,71,62,9,0
2021,North Norfolk 005D,E01034774,595,493,403,90,3,3,17,3,14,82,64,18,0
2021,North Norfolk 005E,E01034775,634,466,333,133,2,2,68,6,62,98,79,19,0
2021,North Norfolk 006E,E01034776,1052,757,595,162,11,11,95,8,87,188,157,31,1
2021,Cheltenham 007G,E01034777,660,301,126,175,6,6,37,9,28,316,300,16,0
2021,Cheltenham 007H,E01034778,585,271,117,154,3,3,35,10,25,275,262,13,1
2021,Cheltenham 012H,E01034779,668,438,90,348,15,15,72,9,63,143,136,7,0
2021,Cheltenham 012I,E01034780,620,525,282,243,4,4,17,6,11,74,69,5,0
2021,Cotswold 002F,E01034781,718,375,136,239,66,66,203,15,188,74,67,7,0
2021,Cotswold 002G,E01034782,615,469,300,169,2,2,52,7,45,92,79,13,0
2021,Cotswold 003E,E01034783,570,324,142,182,45,45,147,7,140,54,44,10,0
2021,Cotswold 003F,E01034784,635,350,243,107,6,6,163,21,142,116,98,18,0
2021,Cotswold 003G,E01034785,617,445,265,180,13,13,57,0,57,102,72,30,0
2021,Cotswold 003H,E01034786,594,440,137,303,27,27,34,3,31,93,88,5,0
2021,Cotswold 010D,E01034787,712,492,276,216,45,45,75,5,70,100,81,19,0
2021,Cotswold 010E,E01034788,513,348,203,145,15,15,97,8,89,53,45,8,0
2021,Cotswold 011G,E01034789,584,353,135,218,42,42,64,8,56,125,93,32,0
2021,Cotswold 011H,E01034790,631,418,274,144,1,1,49,13,36,163,113,50,0
2021,Gloucester 004G,E01034791,729,341,169,172,25,25,124,18,106,239,222,17,0
2021,Gloucester 004H,E01034792,691,181,81,100,2,2,77,9,68,430,413,17,1
2021,Gloucester 004I,E01034793,752,225,75,150,15,15,128,21,107,383,359,24,1
2021,Gloucester 004J,E01034794,793,578,259,319,6,6,61,5,56,148,131,17,0
2021,Gloucester 015I,E01034795,727,378,59,319,38,38,150,9,141,161,143,18,0
2021,Gloucester 015J,E01034796,757,383,45,338,48,48,192,14,178,134,115,19,0
2021,Gloucester 015K,E01034797,587,453,229,224,10,10,15,2,13,109,98,11,0
2021,Gloucester 015L,E01034798,714,473,54,419,51,51,134,8,126,56,46,10,0
2021,Stroud 001E,E01034799,659,393,63,330,27,27,124,26,98,115,111,4,0
2021,Stroud 001F,E01034800,735,562,302,260,31,31,51,9,42,90,74,16,1
2021,Stroud 001G,E01034801,834,711,454,257,1,1,40,35,5,82,63,19,0
2021,Stroud 001H,E01034802,704,533,86,447,33,33,82,20,62,56,48,8,0
2021,Stroud 006F,E01034803,521,326,147,179,21,21,60,18,42,114,101,13,0
2021,Stroud 006G,E01034804,724,390,266,124,4,4,30,6,24,299,268,31,1
2021,Tewkesbury 008D,E01034805,802,621,390,231,26,26,57,4,53,98,76,22,0
2021,Tewkesbury 008E,E01034806,462,351,217,134,11,11,56,13,43,44,34,10,0
2021,Tewkesbury 009F,E01034807,678,532,290,242,2,2,36,3,33,108,103,5,0
2021,Tewkesbury 009G,E01034808,690,408,65,343,36,36,123,16,107,123,112,11,0
2021,Tewkesbury 009H,E01034809,509,343,53,290,17,17,82,11,71,67,61,6,0
2021,Tewkesbury 009I,E01034810,847,676,292,384,35,35,64,9,55,72,61,11,0
2021,Tewkesbury 010A,E01034811,646,415,162,253,69,69,81,7,74,81,74,7,0
2021,Tewkesbury 010B,E01034812,450,264,61,203,75,75,72,8,64,39,38,1,0
2021,Tewkesbury 011A,E01034813,511,285,147,138,26,26,145,24,121,53,43,10,2
2021,Tewkesbury 011B,E01034814,615,471,339,132,1,1,45,5,40,98,86,12,0
2021,Tewkesbury 011D,E01034815,603,364,194,170,10,10,192,19,173,36,25,11,1
2021,Arun 004F,E01034816,776,423,89,334,86,86,157,21,136,110,105,5,0
2021,Arun 004G,E01034817,790,560,208,352,37,37,80,4,76,113,101,12,0
2021,Arun 004H,E01034818,623,480,232,248,7,7,36,17,19,99,88,11,1
2021,Arun 004I,E01034819,705,514,255,259,31,31,89,4,85,70,61,9,1
2021,Arun 005F,E01034820,795,599,242,357,14,14,81,6,75,101,93,8,0
2021,Arun 005G,E01034821,713,536,244,292,40,40,46,5,41,91,78,13,0
2021,Arun 012F,E01034822,760,462,147,315,53,53,134,9,125,111,99,12,0
2021,Arun 012G,E01034823,752,587,312,275,29,29,29,2,27,107,95,12,0
2021,Arun 015F,E01034824,687,434,153,281,2,2,150,7,143,101,96,5,0
2021,Arun 015G,E01034825,719,632,395,237,15,15,8,1,7,64,58,6,0
2021,Worthing 006F,E01034826,649,276,63,213,43,43,271,56,215,57,51,6,2
2021,Worthing 006G,E01034827,657,448,76,372,41,41,124,7,117,44,35,9,0
2021,Worthing 007F,E01034828,737,581,311,270,1,1,51,10,41,104,96,8,0
2021,Worthing 007G,E01034829,571,306,68,238,29,29,65,13,52,171,160,11,0
2021,Worthing 011F,E01034830,617,393,249,144,1,1,46,18,28,177,164,13,0
2021,Worthing 011G,E01034831,659,213,98,115,1,1,9,2,7,436,420,16,0
2021,Knowsley 006E,E01034832,467,216,112,104,31,31,168,32,136,51,37,14,1
2021,Knowsley 006F,E01034833,833,594,134,460,7,7,114,57,57,117,105,12,1
2021,Knowsley 007F,E01034834,708,207,104,103,18,18,217,90,127,265,242,23,1
2021,Knowsley 007G,E01034835,534,271,63,208,0,0,110,48,62,150,141,9,3
2021,Wirral 010G,E01034836,520,219,77,142,1,1,201,74,127,99,87,12,0
2021,Wirral 010H,E01034837,754,396,212,184,1,1,117,18,99,236,224,12,4
2021,Wirral 016F,E01034838,580,109,54,55,20,20,295,61,234,156,150,6,0
2021,Wirral 016G,E01034839,740,115,56,59,1,1,387,21,366,237,228,9,0
2021,Wirral 036F,E01034840,648,454,207,247,0,0,46,11,35,148,133,15,0
2021,Wirral 036G,E01034841,564,450,68,382,33,33,24,3,21,55,48,7,2
2021,Sheffield 022I,E01034842,929,451,292,159,1,1,70,33,37,407,374,33,0
2021,Sheffield 036F,E01034843,914,408,231,177,9,9,61,14,47,435,407,28,1
2021,Sheffield 074F,E01034844,725,93,52,41,1,1,105,30,75,526,499,27,0
2021,Sheffield 076G,E01034845,600,310,139,171,0,0,222,213,9,68,60,8,0
2021,Sheffield 076H,E01034846,603,195,96,99,30,30,335,189,146,43,42,1,0
2021,Cornwall 005F,E01034847,723,512,180,332,27,27,41,13,28,143,133,10,0
2021,Cornwall 005G,E01034848,839,410,198,212,2,2,201,102,99,226,196,30,0
2021,Cornwall 016E,E01034849,639,381,198,183,22,22,114,37,77,121,114,7,1
2021,Cornwall 016F,E01034850,622,381,218,163,5,5,36,19,17,199,187,12,1
2021,Cornwall 016G,E01034851,560,341,213,128,11,11,151,79,72,56,43,13,1
2021,Cornwall 016H,E01034852,677,500,302,198,8,8,76,35,41,93,65,28,0
2021,Cornwall 018E,E01034853,586,410,192,218,3,3,44,8,36,129,113,16,0
2021,Cornwall 018F,E01034854,566,335,118,217,46,46,57,9,48,128,78,50,0
2021,Cornwall 018G,E01034855,612,370,91,279,43,43,102,19,83,97,81,16,0
2021,Cornwall 036F,E01034856,746,636,464,172,5,5,12,3,9,92,67,25,1
2021,Cornwall 036G,E01034857,586,409,257,152,18,18,50,7,43,109,98,11,0
2021,Cornwall 037E,E01034858,1130,859,622,237,8,8,30,6,24,233,189,44,0
2021,Cornwall 040E,E01034859,623,471,303,168,31,31,48,3,45,73,49,24,0
2021,Cornwall 040F,E01034860,628,501,295,206,2,2,24,7,17,101,78,23,0
2021,Cornwall 043G,E01034862,460,220,98,122,7,7,80,9,71,153,145,8,0
2021,Cornwall 043H,E01034863,924,577,301,276,26,26,110,14,96,211,195,16,0
2021,Cornwall 044E,E01034864,661,273,207,66,1,1,192,131,61,189,171,18,6
2021,Cornwall 044F,E01034865,598,192,98,94,26,26,129,45,84,251,231,20,0
2021,Cornwall 052E,E01034866,673,355,206,149,3,3,170,39,131,145,132,13,0
2021,Cornwall 052F,E01034867,572,266,83,183,19,19,129,36,93,158,149,9,0
2021,Cornwall 057F,E01034868,574,296,113,183,49,49,192,31,161,36,35,1,1
2021,Cornwall 057G,E01034869,709,253,135,118,10,10,308,59,249,138,126,12,0
2021,Birmingham 014F,E01034913,431,188,59,129,19,19,150,34,116,74,65,9,0
2021,Birmingham 014G,E01034914,703,286,99,187,8,8,333,167,166,73,68,5,3
2021,Birmingham 023G,E01034915,630,136,27,109,2,2,422,398,24,50,43,7,20
2021,Birmingham 023H,E01034916,656,386,217,169,3,3,100,24,76,165,151,14,2
2021,Birmingham 035H,E01034917,505,203,114,89,10,10,189,49,140,103,91,12,0
2021,Birmingham 035I,E01034918,547,219,152,67,1,1,186,106,80,133,122,11,8
2021,Birmingham 037G,E01034919,481,208,128,80,7,7,118,35,83,148,128,20,0
2021,Birmingham 037H,E01034920,409,246,157,89,0,0,51,9,42,111,98,13,1
2021,Birmingham 039I,E01034921,436,185,107,78,1,1,47,9,38,196,153,43,7
2021,Birmingham 039J,E01034922,524,217,132,85,6,6,126,33,93,173,140,33,2
2021,Birmingham 041H,E01034923,531,183,106,77,2,2,260,79,181,82,63,19,4
2021,Birmingham 041I,E01034924,440,174,115,59,0,0,188,59,129,77,63,14,1
2021,Birmingham 041J,E01034925,536,207,73,134,3,3,246,206,40,78,67,11,2
2021,Birmingham 041K,E01034926,530,178,90,88,2,2,281,219,62,63,54,9,6
2021,Birmingham 043D,E01034927,639,47,22,25,11,11,528,333,195,45,41,4,8
2021,Birmingham 043E,E01034928,504,30,19,11,0,0,452,424,28,20,19,1,2
2021,Birmingham 050G,E01034929,521,57,33,24,5,5,395,374,21,53,43,10,11
2021,Birmingham 050H,E01034930,508,72,27,45,2,2,159,135,24,274,266,8,1
2021,Birmingham 051F,E01034931,429,246,144,102,4,4,53,13,40,126,116,10,0
2021,Birmingham 051G,E01034932,437,158,91,67,1,1,207,21,186,71,59,12,0
2021,Birmingham 052G,E01034933,407,221,142,79,3,3,71,33,38,110,95,15,2
2021,Birmingham 052H,E01034934,436,152,102,50,0,0,196,43,153,87,76,11,1
2021,Birmingham 058G,E01034935,831,416,218,198,5,5,148,79,69,262,231,31,0
2021,Birmingham 079G,E01034936,407,291,183,108,4,4,12,2,10,100,88,12,0
2021,Birmingham 079H,E01034937,449,221,108,113,0,0,17,4,13,211,176,35,0
2021,Birmingham 088F,E01034938,519,251,169,82,2,2,138,14,124,128,115,13,0
2021,Birmingham 088G,E01034939,439,227,148,79,0,0,97,12,85,115,102,13,0
2021,Birmingham 096H,E01034940,437,40,18,22,4,4,102,69,33,290,282,8,1
2021,Birmingham 096I,E01034941,427,26,15,11,0,0,55,18,37,346,341,5,0
2021,Birmingham 125H,E01034942,667,360,66,294,14,14,185,118,67,106,63,43,2
2021,Birmingham 125I,E01034943,731,282,150,132,4,4,369,363,6,72,65,7,4
2021,Birmingham 129E,E01034944,662,311,152,159,126,126,169,31,138,55,52,3,1
2021,Birmingham 129F,E01034945,637,324,123,201,23,23,237,127,110,50,45,5,3
2021,Birmingham 135E,E01034946,587,78,24,54,25,25,163,9,154,321,304,17,0
2021,Birmingham 135F,E01034947,700,137,77,60,0,0,203,139,64,359,337,22,1
2021,Birmingham 136E,E01034948,908,110,60,50,1,1,249,151,98,542,525,17,6
2021,Birmingham 136F,E01034949,742,86,37,49,7,7,178,128,50,464,454,10,7
2021,Birmingham 137F,E01034950,703,77,26,51,1,1,13,1,12,611,603,8,1
2021,Birmingham 137G,E01034951,598,206,44,162,14,14,74,56,18,304,290,14,0
2021,Birmingham 142B,E01034952,407,185,89,96,0,0,57,42,15,165,154,11,0
2021,Birmingham 142C,E01034953,405,242,154,88,1,1,43,9,34,119,108,11,0
2021,Birmingham 143A,E01034954,510,264,121,143,3,3,29,4,25,213,196,17,1
2021,Birmingham 143B,E01034955,567,370,184,186,2,2,26,17,9,168,154,14,1
2021,Craven 006E,E01034956,595,332,175,157,6,6,92,12,80,165,142,23,0
2021,Craven 006F,E01034957,714,365,255,110,4,4,54,1,53,291,265,26,0
2021,Hambleton 007F,E01034958,931,508,309,199,2,2,66,10,56,355,103,252,0
2021,Hambleton 009E,E01034959,779,510,206,304,69,69,150,17,133,50,37,13,0
2021,Hambleton 009F,E01034960,708,530,373,157,1,1,79,9,70,98,74,24,0
2021,Hambleton 012A,E01034961,692,572,382,190,11,11,41,6,35,68,58,10,0
2021,Hambleton 012B,E01034962,543,346,204,142,2,2,71,6,65,124,105,19,0
2021,Harrogate 008E,E01034963,567,447,263,184,17,17,47,13,34,55,48,7,1
2021,Harrogate 008F,E01034964,585,357,202,155,17,17,78,26,52,133,52,81,0
2021,Richmondshire 004I,E01034965,845,199,116,83,0,0,144,60,84,502,71,431,0
2021,Richmondshire 004J,E01034966,745,491,211,280,16,16,86,51,35,152,129,23,0
2021,Richmondshire 004K,E01034967,649,335,64,271,2,2,114,13,101,198,164,34,0
2021,Ryedale 009B,E01034968,653,468,136,332,28,28,86,9,77,71,68,3,0
2021,Ryedale 009C,E01034969,666,398,143,255,16,16,156,20,136,95,85,10,1
2021,Ryedale 009D,E01034970,699,267,179,88,2,2,190,16,174,240,217,23,0
2021,Ryedale 009E,E01034971,627,283,142,141,2,2,244,30,214,98,83,15,0
2021,Scarborough 001F,E01034972,1184,557,421,136,4,4,160,19,141,463,404,59,0
2021,Scarborough 004G,E01034973,883,677,488,189,13,13,73,12,61,120,87,33,0
2021,Scarborough 006F,E01034974,1218,820,461,359,6,6,46,8,38,346,311,35,0
2021,Selby 004F,E01034975,612,455,114,341,47,47,79,5,74,31,28,3,0
2021,Selby 004G,E01034976,703,535,197,338,21,21,90,11,79,57,48,9,0
2021,Selby 004H,E01034977,625,478,255,223,0,0,66,62,4,81,74,7,0
2021,Selby 004I,E01034978,586,423,150,273,16,16,55,7,48,92,82,10,0
2021,Selby 005G,E01034979,619,446,221,225,10,10,49,6,43,113,105,8,1
2021,Selby 005H,E01034980,582,245,81,164,9,9,155,26,129,172,166,6,1
2021,Selby 005I,E01034981,571,330,123,207,10,10,173,139,34,58,51,7,0
2021,Selby 005J,E01034982,539,270,77,193,19,19,149,120,29,98,88,10,3
2021,Selby 005K,E01034983,555,400,62,338,26,26,73,4,69,56,46,10,0
2021,Selby 006F,E01034984,1073,856,545,311,9,9,54,34,20,153,132,21,1
2021,Ashford 005F,E01034985,603,235,119,116,21,21,67,23,44,277,255,22,3
2021,Ashford 005G,E01034986,691,101,50,51,6,6,124,61,63,457,432,25,3
2021,Ashford 010E,E01034987,607,374,49,325,81,81,77,4,73,75,68,7,0
2021,Ashford 010F,E01034988,637,514,220,294,11,11,30,16,14,82,58,24,0
2021,Ashford 010G,E01034989,657,505,200,305,19,19,33,14,19,100,84,16,0
2021,Maidstone 001F,E01034990,919,823,335,488,9,9,5,1,4,82,79,3,0
2021,Maidstone 004H,E01034991,641,66,22,44,19,19,107,32,75,449,420,29,0
2021,Maidstone 004I,E01034992,590,242,174,68,7,7,145,23,122,196,176,20,0
2021,Maidstone 011E,E01034993,651,528,359,169,15,15,52,9,43,56,45,11,0
2021,Maidstone 011F,E01034994,731,526,240,286,37,37,92,10,82,76,66,10,0
2021,Maidstone 013H,E01034995,565,227,65,162,28,28,239,47,192,71,62,9,0
2021,Maidstone 013I,E01034996,558,79,37,42,6,6,433,118,315,40,37,3,0
2021,Maidstone 015F,E01034997,551,330,120,210,48,48,90,8,82,82,72,10,1
2021,Maidstone 015G,E01034998,552,377,130,247,10,10,113,27,86,52,48,4,0
2021,Maidstone 015H,E01034999,557,364,41,323,59,59,87,12,75,47,40,7,0
2021,Sevenoaks 008F,E01035000,655,370,126,244,75,75,84,10,74,126,111,15,0
2021,Sevenoaks 008G,E01035001,605,372,134,238,45,45,64,7,57,124,113,11,0
2021,Tonbridge and Malling 001G,E01035002,548,411,157,254,18,18,30,2,28,89,77,12,0
2021,Tonbridge and Malling 001H,E01035003,542,384,54,330,61,61,70,11,59,27,24,3,0
2021,Tonbridge and Malling 001I,E01035004,563,459,180,279,4,4,20,3,17,80,72,8,0
2021,Tonbridge and Malling 002H,E01035005,576,422,208,214,9,9,29,4,25,116,107,9,0
2021,Tonbridge and Malling 002I,E01035006,576,264,82,182,30,30,202,20,182,80,70,10,0
2021,Tonbridge and Malling 002J,E01035007,574,369,90,279,6,6,90,12,78,109,102,7,0
2021,Tonbridge and Malling 012G,E01035008,801,301,119,182,90,90,160,23,137,250,236,14,0
2021,Tonbridge and Malling 012H,E01035009,751,451,179,272,11,11,125,15,110,164,157,7,0
2021,Tonbridge and Malling 014G,E01035010,595,414,45,369,53,53,75,13,62,53,47,6,0
2021,Tonbridge and Malling 014H,E01035011,638,561,284,277,2,2,24,1,23,51,42,9,0
2021,Tunbridge Wells 008E,E01035012,590,193,95,98,21,21,71,7,64,304,285,19,1
2021,Tunbridge Wells 008F,E01035013,930,363,185,178,2,2,47,6,41,518,496,22,0
2021,Nuneaton and Bedworth 001F,E01035014,786,573,54,519,52,52,128,12,116,32,30,2,1
2021,Nuneaton and Bedworth 001G,E01035015,703,616,340,276,11,11,17,2,15,59,48,11,0
2021,Nuneaton and Bedworth 002G,E01035016,668,228,77,151,11,11,306,207,99,122,107,15,1
2021,Nuneaton and Bedworth 002H,E01035017,782,511,90,421,14,14,136,29,107,119,101,18,2
2021,Nuneaton and Bedworth 003F,E01035018,619,541,200,341,15,15,51,4,47,12,11,1,0
2021,Nuneaton and Bedworth 003G,E01035019,616,471,143,328,19,19,79,7,72,47,35,12,0
2021,Rugby 002G,E01035020,690,389,44,345,23,23,65,12,53,213,201,12,0
2021,Rugby 002H,E01035021,745,361,133,228,6,6,145,45,100,232,221,11,1
2021,Rugby 007I,E01035022,612,354,89,265,43,43,163,23,140,52,44,8,0
2021,Rugby 007J,E01035023,682,555,232,323,17,17,14,8,6,96,84,12,0
2021,Rugby 012F,E01035024,743,416,60,356,73,73,213,49,164,41,37,4,0
2021,Rugby 012G,E01035025,659,614,421,193,2,2,12,7,5,31,26,5,0
2021,Rugby 013D,E01035026,576,458,177,281,7,7,50,34,16,61,45,16,0
2021,Rugby 014A,E01035027,551,425,63,362,22,22,38,12,26,66,61,5,0
2021,Rugby 014B,E01035028,599,408,94,314,44,44,100,24,76,47,43,4,0
2021,Rugby 014E,E01035029,642,514,58,456,52,52,47,5,42,29,19,10,0
2021,Stratford-on-Avon 008H,E01035030,681,499,284,215,5,5,80,10,70,97,81,16,0
2021,Stratford-on-Avon 008I,E01035031,640,403,123,280,43,43,125,23,102,69,49,20,0
2021,Stratford-on-Avon 009G,E01035032,656,441,206,235,18,18,138,15,123,59,45,14,0
2021,Stratford-on-Avon 009H,E01035033,738,389,145,244,46,46,115,14,101,188,178,10,0
2021,Stratford-on-Avon 014E,E01035034,612,446,253,193,5,5,39,5,34,122,106,16,0
2021,Stratford-on-Avon 014F,E01035035,674,373,58,315,43,43,210,37,173,48,38,10,0
2021,Stratford-on-Avon 014G,E01035036,643,401,181,220,33,33,111,18,93,98,88,10,0
2021,Warwick 012G,E01035037,573,321,77,244,80,80,131,11,120,41,35,6,0
2021,Warwick 012H,E01035038,577,460,164,296,0,0,4,2,2,113,105,8,0
2021,Warwick 012I,E01035039,520,322,107,215,24,24,154,17,137,20,17,3,0
2021,Leeds 044G,E01035040,536,75,36,39,5,5,62,21,41,394,391,3,0
2021,Leeds 044H,E01035041,449,127,67,60,7,7,43,6,37,272,268,4,0
2021,Leeds 055I,E01035042,464,65,37,28,2,2,201,73,128,193,181,12,3
2021,Leeds 055J,E01035043,432,41,25,16,0,0,151,41,110,240,236,4,0
2021,Leeds 063F,E01035044,650,36,20,16,2,2,125,29,96,485,445,40,2
2021,Leeds 063G,E01035045,622,37,17,20,1,1,71,22,49,513,487,26,0
2021,Leeds 082G,E01035046,763,60,10,50,3,3,56,20,36,643,631,12,1
2021,Leeds 082H,E01035047,634,90,47,43,0,0,254,233,21,287,280,7,3
2021,Leeds 099G,E01035048,781,499,133,366,18,18,107,77,30,156,144,12,1
2021,Leeds 099H,E01035049,695,501,134,367,0,0,12,3,9,182,167,15,0
2021,Leeds 105G,E01035050,612,398,100,298,3,3,123,107,16,88,82,6,0
2021,Leeds 105H,E01035051,606,494,122,372,2,2,8,2,6,102,96,6,0
2021,Leeds 105I,E01035052,593,370,73,297,2,2,97,62,35,122,117,5,2
2021,Leeds 105J,E01035053,659,451,104,347,13,13,78,40,38,115,109,6,2
2021,Leeds 112F,E01035054,1376,282,77,205,4,4,29,4,25,1060,1022,38,1
2021,Herefordshire 011E,E01035055,635,515,259,256,22,22,23,3,20,75,45,30,0
2021,Herefordshire 011F,E01035056,595,423,182,241,29,29,60,6,54,83,68,15,0
2021,Shropshire 009E,E01035057,401,338,208,130,0,0,12,5,7,51,41,10,0
2021,Shropshire 009F,E01035058,401,229,133,96,2,2,40,8,32,130,54,76,0
2021,Shropshire 016E,E01035059,684,450,134,316,23,23,58,19,39,153,115,38,0
2021,Shropshire 016F,E01035060,557,463,223,240,1,1,4,2,2,88,63,25,1
2021,Shropshire 019E,E01035061,622,218,159,59,9,9,14,0,14,381,366,15,0
2021,Shropshire 019F,E01035062,677,386,236,150,24,24,94,13,81,173,160,13,0
2021,Shropshire 019G,E01035063,623,250,186,64,1,1,49,9,40,323,283,40,0
2021,Shropshire 019H,E01035064,638,287,212,75,2,2,101,7,94,248,231,17,0
2021,Shropshire 020F,E01035065,645,371,214,157,5,5,134,14,120,135,125,10,0
2021,Shropshire 020G,E01035066,750,479,193,286,21,21,86,10,76,164,145,19,0
2021,Shropshire 024E,E01035067,703,495,317,178,6,6,46,8,38,156,119,37,0
2021,Shropshire 024F,E01035068,685,430,162,268,12,12,129,24,105,114,96,18,0
2021,Shropshire 025F,E01035069,567,421,154,267,9,9,54,18,36,82,62,20,1
2021,Shropshire 025G,E01035070,754,498,169,329,42,42,133,74,59,81,70,11,0
2021,Shropshire 030F,E01035071,960,760,562,198,3,3,46,3,43,151,111,40,0
2021,Shropshire 036F,E01035072,1044,677,526,151,1,1,33,4,29,332,253,79,1
2021,Telford and Wrekin 009F,E01035073,607,237,78,159,5,5,161,46,115,204,195,9,0
2021,Telford and Wrekin 009G,E01035074,725,435,120,315,3,3,113,51,62,170,162,8,4
2021,Telford and Wrekin 009H,E01035075,459,279,25,254,22,22,85,10,75,73,66,7,0
2021,Telford and Wrekin 024A,E01035076,728,569,68,501,17,17,59,19,40,83,79,4,0
2021,Telford and Wrekin 024B,E01035077,547,214,90,124,1,1,158,79,79,174,168,6,0
2021,Telford and Wrekin 024D,E01035078,634,434,85,349,37,37,43,12,31,120,117,3,0
2021,Telford and Wrekin 025A,E01035079,536,381,83,298,23,23,47,17,30,85,76,9,0
2021,Telford and Wrekin 025B,E01035080,551,431,82,349,18,18,39,7,32,63,58,5,0
2021,Telford and Wrekin 025C,E01035081,579,437,144,293,14,14,50,10,40,78,74,4,0
2021,Telford and Wrekin 025D,E01035082,761,433,193,240,13,13,195,17,178,119,110,9,1
2021,Telford and Wrekin 025E,E01035083,842,585,112,473,21,21,182,31,151,54,51,3,0
2021,Harborough 003G,E01035084,729,512,226,286,26,26,99,12,87,92,80,12,0
2021,Harborough 003H,E01035085,666,505,218,287,38,38,43,4,39,80,66,14,0
2021,Harborough 005G,E01035086,645,495,251,244,11,11,42,5,37,97,82,15,0
2021,Harborough 005H,E01035087,593,454,238,216,7,7,46,8,38,86,69,17,0
2021,Harborough 007G,E01035088,713,604,334,270,9,9,39,5,34,61,50,11,0
2021,Harborough 007H,E01035089,585,436,146,290,19,19,31,4,27,99,92,7,0
2021,Harborough 010E,E01035090,641,502,221,281,41,41,36,1,35,62,56,6,0
2021,Harborough 010F,E01035091,649,323,156,167,32,32,219,32,187,75,65,10,0
2021,Harborough 011E,E01035092,702,491,157,334,42,42,90,6,84,79,74,5,0
2021,Harborough 011F,E01035093,580,525,290,235,1,1,16,2,14,36,25,11,2
2021,Hinckley and Bosworth 001F,E01035094,465,329,81,248,4,4,96,26,70,35,28,7,1
2021,Hinckley and Bosworth 001G,E01035095,688,515,282,233,1,1,108,66,42,62,49,13,2
2021,Hinckley and Bosworth 011F,E01035096,645,503,223,280,3,3,32,6,26,107,98,9,0
2021,Hinckley and Bosworth 011G,E01035097,627,420,108,312,19,19,70,6,64,118,102,16,0
2021,North West Leicestershire 001F,E01035098,538,411,270,141,6,6,28,23,5,93,83,10,0
2021,North West Leicestershire 001G,E01035099,670,327,164,163,1,1,120,91,29,221,212,9,1
2021,North West Leicestershire 003E,E01035100,781,581,219,362,16,16,77,33,44,107,97,10,0
2021,North West Leicestershire 003F,E01035101,783,510,202,308,32,32,83,9,74,158,149,9,0
2021,Rutland 002E,E01035102,607,432,156,276,8,8,38,1,37,129,113,16,0
2021,Rutland 002F,E01035103,539,298,123,175,30,30,89,16,73,119,106,13,3
2021,Rutland 002G,E01035104,597,358,190,168,12,12,92,13,79,135,112,23,0
2021,Rutland 003E,E01035105,633,459,308,151,4,4,87,14,73,83,73,10,0
2021,Rutland 003F,E01035106,651,473,350,123,21,21,59,4,55,98,82,16,0
2021,Mendip 002F,E01035107,897,744,465,279,2,2,59,6,53,92,79,13,0
2021,Mendip 005E,E01035108,701,514,277,237,37,37,86,10,76,64,49,15,0
2021,Mendip 005F,E01035109,569,425,280,145,8,8,40,5,35,96,77,19,0
2021,Mendip 007G,E01035110,564,346,155,191,3,3,26,3,23,189,170,19,0
2021,Mendip 007H,E01035111,716,521,165,356,27,27,102,17,85,66,59,7,0
2021,Sedgemoor 002H,E01035112,759,651,471,180,4,4,26,24,2,78,58,20,0
2021,Sedgemoor 002I,E01035113,607,441,179,262,6,6,21,0,21,139,131,8,0
2021,Sedgemoor 010E,E01035114,467,212,47,165,27,27,139,14,125,89,83,6,0
2021,Sedgemoor 010F,E01035115,518,432,72,360,8,8,16,5,11,62,53,9,0
2021,Sedgemoor 010G,E01035116,526,397,234,163,0,0,25,19,6,104,97,7,0
2021,Sedgemoor 014H,E01035117,660,461,86,375,21,21,82,6,76,96,86,10,0
2021,Sedgemoor 014I,E01035118,525,331,129,202,18,18,81,8,73,95,90,5,0
2021,Sedgemoor 014J,E01035119,608,350,67,283,3,3,46,16,30,209,199,10,0
2021,Sedgemoor 014K,E01035120,629,497,260,237,0,0,51,1,50,81,62,19,0
2021,South Somerset 011E,E01035121,716,448,261,187,2,2,115,31,84,151,119,32,0
2021,South Somerset 011F,E01035122,799,454,89,365,51,51,138,14,124,156,117,39,0
2021,South Somerset 012E,E01035123,636,466,183,283,7,7,38,5,33,125,113,12,0
2021,South Somerset 012F,E01035124,531,409,129,280,5,5,41,2,39,76,46,30,0
2021,South Somerset 015E,E01035125,632,198,137,61,3,3,71,10,61,360,332,28,0
2021,South Somerset 015F,E01035126,620,229,131,98,1,1,170,39,131,220,205,15,0
2021,Somerset West and Taunton 008E,E01035127,761,627,338,289,24,24,45,4,41,65,54,11,0
2021,Somerset West and Taunton 008F,E01035128,825,528,131,397,86,86,101,5,96,110,100,10,0
2021,Somerset West and Taunton 018E,E01035129,754,453,163,290,52,52,162,56,106,86,81,5,1
2021,Somerset West and Taunton 018F,E01035130,658,271,172,99,2,2,253,172,81,127,111,16,5
2021,Somerset West and Taunton 017E,E01035131,588,343,200,143,9,9,157,95,62,79,69,10,0
2021,Somerset West and Taunton 017F,E01035132,652,476,281,195,12,12,76,32,44,87,77,10,1
2021,Breckland 007F,E01035133,621,286,217,69,2,2,199,35,164,134,118,16,0
2021,Breckland 007G,E01035134,655,392,175,217,13,13,129,18,111,121,103,18,0
2021,Breckland 011F,E01035135,474,320,79,241,40,40,51,11,40,63,57,6,0
2021,Breckland 011G,E01035136,945,771,503,268,12,12,43,7,36,119,97,22,0
2021,Norwich 014E,E01035137,635,165,86,79,1,1,55,29,26,414,393,21,0
2021,Norwich 014F,E01035138,722,252,81,171,0,0,158,39,119,310,293,17,2
2021,Norwich 017B,E01035139,899,261,186,75,3,3,290,50,240,344,317,27,1
2021,Norwich 017C,E01035140,731,193,109,84,2,2,265,147,118,269,257,12,2
2021,South Norfolk 002F,E01035141,702,425,137,288,38,38,96,7,89,143,139,4,0
2021,South Norfolk 002G,E01035142,602,552,371,181,4,4,10,1,9,36,30,6,0
2021,South Norfolk 006H,E01035143,590,480,296,184,6,6,31,5,26,73,60,13,0
2021,South Norfolk 006I,E01035144,714,517,193,324,17,17,125,22,103,55,51,4,0
2021,South Norfolk 007F,E01035145,575,416,96,320,18,18,107,10,97,34,31,3,0
2021,South Norfolk 007G,E01035146,566,367,83,284,16,16,118,8,110,65,60,5,0
2021,South Norfolk 007H,E01035147,498,360,229,131,2,2,46,4,42,90,78,12,0
2021,South Norfolk 007I,E01035148,569,410,204,206,26,26,37,1,36,96,85,11,0
2021,South Norfolk 007J,E01035149,1389,1079,623,456,27,27,90,16,74,193,164,29,0
2021,South Norfolk 016A,E01035150,423,348,54,294,0,0,9,2,7,66,57,9,0
2021,South Norfolk 016B,E01035151,552,360,63,297,5,5,74,1,73,113,99,14,0
2021,South Norfolk 016C,E01035152,603,377,52,325,14,14,25,2,23,187,180,7,0
2021,South Norfolk 016F,E01035153,559,384,44,340,32,32,71,14,57,72,65,7,0
2021,East Suffolk 014C,E01035154,1165,890,729,161,5,5,136,86,50,134,102,32,0
2021,Braintree 011F,E01035155,606,334,129,205,16,16,189,28,161,67,63,4,0
2021,Braintree 011G,E01035156,633,443,187,256,3,3,34,3,31,153,132,21,0
2021,Colchester 007F,E01035157,656,215,102,113,0,0,163,126,37,277,256,21,1
2021,Colchester 007G,E01035158,683,189,103,86,2,2,42,15,27,450,421,29,0
2021,Colchester 010F,E01035159,980,735,91,644,29,29,145,14,131,71,58,13,0
2021,Colchester 010G,E01035160,653,528,259,269,0,0,41,9,32,84,73,11,0
2021,Colchester 011G,E01035161,650,135,39,96,3,3,231,33,198,280,263,17,1
2021,Colchester 011H,E01035162,592,213,75,138,2,2,76,43,33,301,281,20,0
2021,Colchester 011I,E01035163,615,236,76,160,2,2,163,38,125,212,203,9,2
2021,Colchester 011J,E01035164,445,99,40,59,10,10,188,26,162,147,141,6,1
2021,Colchester 015H,E01035165,665,87,18,69,2,2,117,19,98,457,116,341,2
2021,Colchester 015I,E01035166,411,51,19,32,0,0,175,11,164,185,26,159,0
2021,Colchester 023A,E01035167,482,190,34,156,4,4,81,11,70,207,200,7,0
2021,Colchester 023B,E01035168,600,409,113,296,16,16,93,7,86,82,70,12,0
2021,Colchester 023C,E01035169,522,413,54,359,26,26,57,9,48,26,26,0,0
2021,Colchester 023D,E01035170,592,434,80,354,5,5,85,62,23,68,63,5,0
2021,Colchester 023E,E01035171,453,327,129,198,6,6,53,8,45,67,61,6,0
2021,Colchester 023F,E01035172,738,616,244,372,3,3,6,5,1,113,103,10,0
2021,Colchester 024B,E01035173,561,337,179,158,1,1,71,8,63,152,138,14,0
2021,Colchester 024C,E01035174,529,283,85,198,3,3,68,6,62,175,169,6,0
2021,Colchester 024D,E01035175,646,251,46,205,15,15,140,27,113,238,228,10,2
2021,Colchester 024E,E01035176,711,496,211,285,0,0,13,7,6,202,191,11,0
2021,Colchester 024F,E01035177,629,227,66,161,7,7,63,12,51,332,315,17,0
2021,Uttlesford 006E,E01035178,706,456,172,284,10,10,107,79,28,133,119,14,0
2021,Uttlesford 006F,E01035179,456,368,97,271,17,17,40,5,35,31,29,2,0
2021,Uttlesford 006G,E01035180,461,315,118,197,23,23,34,0,34,89,82,7,0
2021,Uttlesford 006H,E01035181,497,369,126,243,23,23,59,16,43,46,38,8,0
2021,Uttlesford 006I,E01035182,557,427,285,142,10,10,65,8,57,55,41,14,0
2021,Darlington 009E,E01035183,602,396,130,266,14,14,135,97,38,56,43,13,1
2021,Darlington 009F,E01035184,612,479,288,191,1,1,47,20,27,85,66,19,0
2021,Darlington 010D,E01035185,648,495,247,248,1,1,54,48,6,98,90,8,0
2021,Darlington 010E,E01035186,572,337,197,140,2,2,27,6,21,206,194,12,0
2021,Darlington 016H,E01035187,1280,303,171,132,2,2,395,134,261,580,537,43,0
2021,Hartlepool 015C,E01035188,933,318,179,139,13,13,247,64,183,352,323,29,3
2021,Middlesbrough 001H,E01035189,679,53,25,28,0,0,467,107,360,158,149,9,1
2021,Middlesbrough 001I,E01035190,650,156,95,61,3,3,241,63,178,249,220,29,1
2021,Middlesbrough 001J,E01035191,697,317,133,184,0,0,120,24,96,257,241,16,3
2021,Middlesbrough 001K,E01035192,422,181,87,94,2,2,60,17,43,178,163,15,1
2021,Middlesbrough 018I,E01035193,696,623,316,307,6,6,27,12,15,40,33,7,0
2021,Middlesbrough 018J,E01035194,574,471,100,371,2,2,37,6,31,64,52,12,0
2021,Middlesbrough 020G,E01035195,628,434,102,332,5,5,24,7,17,165,154,11,0
2021,Middlesbrough 020H,E01035196,582,383,233,150,8,8,47,4,43,144,127,17,0
2021,Stockton-on-Tees 025A,E01035197,684,126,75,51,5,5,423,250,173,128,92,36,2
2021,Stockton-on-Tees 025B,E01035198,685,461,85,376,21,21,103,49,54,100,68,32,0
2021,Stockton-on-Tees 025D,E01035199,665,101,37,64,5,5,348,162,186,209,196,13,2
2021,Stockton-on-Tees 026A,E01035200,698,222,127,95,3,3,122,63,59,346,324,22,5
2021,Stockton-on-Tees 026C,E01035201,711,596,158,438,11,11,40,17,23,64,47,17,0
2021,Stockton-on-Tees 026D,E01035202,829,404,126,278,22,22,132,63,69,271,251,20,0
2021,Stockton-on-Tees 027B,E01035203,603,521,73,448,0,0,10,4,6,72,66,6,0
2021,Stockton-on-Tees 028B,E01035204,779,723,191,532,1,1,3,2,1,52,47,5,0
2021,Bath and North East Somerset 002D,E01035205,731,562,312,250,3,3,82,27,55,84,61,23,0
2021,Bath and North East Somerset 002E,E01035206,590,397,68,329,45,45,114,17,97,34,24,10,0
2021,Bath and North East Somerset 013E,E01035207,845,158,99,59,37,37,172,45,127,478,460,18,0
2021,Bath and North East Somerset 013F,E01035208,612,281,141,140,7,7,72,9,63,252,239,13,0
2021,Bath and North East Somerset 022F,E01035209,403,324,178,146,1,1,14,3,11,64,44,20,0
2021,Bath and North East Somerset 022G,E01035210,451,303,178,125,1,1,46,15,31,101,81,20,0
2021,North Somerset 006H,E01035211,526,383,115,268,8,8,35,1,34,100,95,5,0
2021,North Somerset 006I,E01035212,689,579,255,324,2,2,43,12,31,65,60,5,0
2021,North Somerset 023G,E01035213,765,550,142,408,31,31,72,7,65,112,103,9,0
2021,North Somerset 023H,E01035214,671,530,247,283,5,5,57,17,40,79,67,12,0
2021,North Somerset 027F,E01035215,737,341,176,165,7,7,158,20,138,231,226,5,0
2021,North Somerset 027G,E01035216,910,697,68,629,47,47,95,6,89,71,61,10,0
2021,South Gloucestershire 019H,E01035217,615,402,30,372,28,28,96,5,91,89,82,7,0
2021,South Gloucestershire 019I,E01035218,680,481,119,362,40,40,115,15,100,44,39,5,0
2021,South Gloucestershire 019J,E01035219,449,360,168,192,25,25,21,2,19,43,41,2,0
2021,South Gloucestershire 021H,E01035220,797,569,189,380,6,6,55,5,50,167,152,15,0
2021,South Gloucestershire 021I,E01035221,641,341,48,293,35,35,147,19,128,118,111,7,0
2021,South Gloucestershire 033E,E01035222,676,517,270,247,9,9,42,6,36,108,95,13,0
2021,South Gloucestershire 034A,E01035223,631,499,226,273,14,14,36,5,31,82,71,11,0
2021,South Gloucestershire 034C,E01035224,590,267,88,179,36,36,143,26,117,141,134,7,3
2021,South Gloucestershire 034D,E01035225,631,354,23,331,19,19,140,12,128,118,111,7,0
2021,South Gloucestershire 034E,E01035226,741,377,72,305,55,55,193,19,174,115,107,8,1
2021,South Gloucestershire 035A,E01035227,592,284,124,160,16,16,66,8,58,225,209,16,1
2021,South Gloucestershire 035B,E01035228,720,299,92,207,88,88,129,25,104,204,196,8,0
2021,South Gloucestershire 035C,E01035229,399,141,46,95,33,33,115,9,106,109,105,4,1
2021,South Gloucestershire 035D,E01035230,456,259,58,201,38,38,84,8,76,75,72,3,0
2021,South Gloucestershire 035E,E01035231,480,201,73,128,12,12,17,1,16,250,219,31,0
2021,South Gloucestershire 036B,E01035232,622,421,160,261,3,3,66,8,58,131,123,8,1
2021,South Gloucestershire 036C,E01035233,710,543,207,336,12,12,84,9,75,71,65,6,0
2021,Bracknell Forest 001F,E01035234,431,358,202,156,1,1,22,4,18,50,35,15,0
2021,Bracknell Forest 001G,E01035235,835,736,529,207,4,4,14,7,7,81,73,8,0
2021,Bracknell Forest 002F,E01035236,711,509,266,243,15,15,80,16,64,107,83,24,0
2021,Bracknell Forest 002G,E01035237,584,420,90,330,32,32,69,22,47,62,50,12,1
2021,Bracknell Forest 002H,E01035238,505,392,105,287,22,22,40,16,24,51,42,9,0
2021,Bracknell Forest 002I,E01035239,448,391,180,211,1,1,5,1,4,51,46,5,0
2021,Bracknell Forest 002J,E01035240,607,353,48,305,95,95,81,21,60,78,70,8,0
2021,Bracknell Forest 007F,E01035241,756,150,33,117,16,16,265,27,238,325,314,11,0
2021,Bracknell Forest 007G,E01035242,711,259,106,153,7,7,161,22,139,284,273,11,0
2021,Bracknell Forest 007H,E01035243,649,407,99,308,31,31,98,11,87,112,104,8,1
2021,Bracknell Forest 007I,E01035244,540,324,132,192,2,2,144,55,89,70,66,4,0
2021,Bracknell Forest 009I,E01035245,586,418,88,330,22,22,53,7,46,93,83,10,0
2021,Bracknell Forest 009J,E01035246,651,437,88,349,56,56,74,12,62,84,72,12,0
2021,Slough 011F,E01035247,615,139,22,117,2,2,58,30,28,414,405,9,2
2021,Slough 011G,E01035248,640,177,69,108,3,3,84,53,31,375,358,17,1
2021,Slough 011H,E01035249,402,304,157,147,0,0,8,5,3,90,83,7,0
2021,Slough 011I,E01035250,477,307,65,242,21,21,96,10,86,53,45,8,0
2021,Slough 015B,E01035251,650,280,117,163,20,20,93,62,31,257,238,19,0
2021,Slough 015C,E01035252,486,146,63,83,2,2,27,13,14,311,304,7,0
2021,Slough 015D,E01035253,651,120,19,101,4,4,66,24,42,459,449,10,2
2021,Slough 016B,E01035254,545,175,90,85,15,15,68,12,56,287,277,10,0
2021,West Oxfordshire 012D,E01035255,509,372,214,158,6,6,12,2,10,119,87,32,0
2021,Wokingham 001E,E01035256,1088,781,430,351,4,4,149,87,62,153,104,49,1
2021,Wokingham 008H,E01035257,478,392,231,161,2,2,10,9,1,74,70,4,0
2021,Wokingham 008I,E01035258,521,485,282,203,0,0,1,1,0,35,32,3,0
2021,Wokingham 012I,E01035259,647,440,124,316,29,29,104,57,47,74,66,8,0
2021,Wokingham 012J,E01035260,601,407,46,361,82,82,78,7,71,34,31,3,0
2021,Wokingham 014F,E01035261,702,475,106,369,43,43,112,24,88,72,70,2,0
2021,Wokingham 014G,E01035262,796,667,365,302,1,1,29,23,6,99,84,15,0
2021,Wokingham 017E,E01035263,655,481,75,406,55,55,64,8,56,55,52,3,0
2021,Wokingham 017F,E01035264,724,540,227,313,15,15,34,21,13,135,119,16,0
2021,Wokingham 017G,E01035265,761,606,106,500,49,49,47,5,42,59,55,4,0
2021,Wokingham 017H,E01035266,657,475,203,272,75,75,50,40,10,57,49,8,0
2021,Wokingham 018E,E01035267,595,437,208,229,4,4,47,34,13,107,79,28,0
2021,Wokingham 018F,E01035268,527,292,73,219,28,28,46,4,42,161,132,29,0
2021,Wokingham 018G,E01035269,1258,934,452,482,37,37,171,139,32,112,85,27,4
2021,Dartford 001E,E01035270,586,484,32,452,8,8,12,3,9,82,78,4,0
2021,Dartford 001F,E01035271,565,396,31,365,29,29,29,1,28,111,105,6,0
2021,Dartford 001G,E01035272,601,298,77,221,24,24,179,70,109,99,94,5,1
2021,Dartford 001H,E01035273,459,234,78,156,38,38,145,106,39,40,36,4,2
2021,Dartford 001I,E01035274,581,142,49,93,2,2,362,342,20,68,66,2,7
2021,Dartford 001J,E01035275,583,327,61,266,7,7,106,91,15,141,135,6,2
2021,Dartford 001K,E01035276,529,338,9,329,51,51,71,36,35,69,65,4,0
2021,Dartford 002E,E01035277,698,445,132,313,15,15,50,12,38,188,181,7,0
2021,Dartford 002F,E01035278,671,498,202,296,7,7,36,24,12,130,115,15,0
2021,Dartford 002G,E01035279,830,427,65,362,100,100,94,13,81,209,196,13,0
2021,Dartford 002H,E01035280,754,512,26,486,118,118,50,10,40,74,69,5,0
2021,Dartford 002I,E01035281,755,514,46,468,90,90,69,12,57,82,79,3,0
2021,Dartford 004E,E01035282,714,363,63,300,58,58,61,11,50,232,218,14,0
2021,Dartford 004F,E01035283,647,326,117,209,4,4,165,69,96,148,138,10,4
2021,Gravesham 006F,E01035284,557,289,19,270,98,98,77,12,65,93,91,2,0
2021,Gravesham 006G,E01035285,605,234,85,149,24,24,268,183,85,75,67,8,4
2021,Medway 003F,E01035286,632,440,134,306,28,28,79,14,65,85,72,13,0
2021,Medway 003G,E01035287,715,560,235,325,13,13,68,8,60,74,58,16,0
2021,Medway 004D,E01035288,551,341,105,236,16,16,138,9,129,56,49,7,0
2021,Medway 004E,E01035289,650,360,148,212,19,19,173,21,152,98,88,10,0
2021,Medway 007F,E01035290,768,498,160,338,52,52,79,9,70,139,126,13,0
2021,Medway 007G,E01035291,777,561,237,324,12,12,12,0,12,192,184,8,0
2021,Medway 007H,E01035292,765,217,71,146,58,58,169,42,127,321,279,42,0
2021,Medway 007I,E01035293,728,236,120,116,12,12,233,145,88,244,155,89,3
2021,Medway 009E,E01035294,712,141,58,83,111,111,68,11,57,392,374,18,0
2021,Medway 009F,E01035295,618,301,121,180,3,3,43,20,23,271,253,18,0
2021,Medway 015F,E01035296,730,338,119,219,49,49,135,16,119,208,199,9,0
2021,Medway 015G,E01035297,729,149,49,100,32,32,172,26,146,375,350,25,1
2021,Swale 004H,E01035298,564,288,56,232,58,58,92,16,76,126,117,9,0
2021,Swale 004I,E01035299,632,479,130,349,25,25,25,4,21,103,95,8,0
2021,Swale 006E,E01035300,423,296,185,111,5,5,42,4,38,80,67,13,0
2021,Swale 006F,E01035301,541,398,218,180,6,6,31,10,21,106,97,9,0
2021,Swale 007I,E01035302,518,343,77,266,14,14,63,15,48,98,94,4,0
2021,Swale 007J,E01035303,534,256,77,179,1,1,163,28,135,114,103,11,0
2021,Swale 009F,E01035304,643,547,192,355,14,14,4,1,3,78,70,8,0
2021,Swale 009G,E01035305,634,366,73,293,24,24,94,13,81,150,134,16,0
2021,Swale 009H,E01035306,662,466,190,276,26,26,57,5,52,111,97,14,2
2021,Swale 009I,E01035307,582,349,194,155,9,9,127,20,107,97,86,11,0
2021,Canterbury 012G,E01035308,514,438,303,135,5,5,10,9,1,61,45,16,0
2021,Canterbury 012H,E01035309,464,355,220,135,1,1,27,23,4,80,72,8,1
2021,Canterbury 019D,E01035310,659,335,152,183,13,13,144,91,53,164,151,13,3
2021,Canterbury 019E,E01035311,570,206,86,120,5,5,117,65,52,240,225,15,2
2021,Dover 005F,E01035312,700,439,213,226,34,34,102,38,64,124,104,20,1
2021,Dover 005G,E01035313,606,374,185,189,7,7,105,46,59,118,104,14,2
2021,Dover 006E,E01035314,782,573,106,467,48,48,108,50,58,53,40,13,0
2021,Dover 006F,E01035315,668,502,194,308,7,7,93,67,26,66,55,11,0
2021,Thanet 001F,E01035316,616,126,78,48,1,1,89,23,66,400,385,15,0
2021,Thanet 001G,E01035317,589,111,48,63,2,2,165,14,151,311,296,15,0
2021,Thanet 014E,E01035318,674,524,322,202,18,18,38,6,32,94,66,28,0
2021,Thanet 014F,E01035319,592,448,211,237,0,0,22,12,10,122,104,18,0
2021,Chichester 004G,E01035320,978,575,392,183,17,17,134,14,120,252,224,28,0
2021,Chichester 004H,E01035321,447,298,203,95,6,6,56,10,46,87,66,21,0
2021,Chichester 006E,E01035322,635,381,234,147,7,7,194,27,167,50,36,14,3
2021,Chichester 006F,E01035323,637,418,219,199,34,34,70,10,60,115,100,15,0
2021,Chichester 008G,E01035324,649,244,138,106,84,84,177,21,156,144,135,9,0
2021,Chichester 008H,E01035325,725,401,243,158,50,50,93,8,85,181,112,69,0
2021,Chichester 012G,E01035326,659,366,180,186,28,28,130,7,123,134,105,29,1
2021,Chichester 012H,E01035327,762,522,359,163,18,18,123,15,108,99,74,25,0
2021,Crawley 002F,E01035328,768,642,255,387,3,3,53,42,11,68,64,4,2
2021,Crawley 002G,E01035329,863,617,66,551,6,6,172,164,8,66,63,3,2
2021,Horsham 001E,E01035330,551,372,168,204,26,26,23,1,22,130,117,13,0
2021,Horsham 001F,E01035331,555,426,272,154,3,3,47,1,46,78,60,18,1
2021,Horsham 001G,E01035332,618,283,53,230,56,56,50,3,47,229,222,7,0
2021,Horsham 001H,E01035333,617,432,125,307,42,42,39,1,38,104,80,24,0
2021,Horsham 006G,E01035334,623,363,234,129,6,6,86,9,77,168,154,14,0
2021,Horsham 006H,E01035335,718,206,115,91,46,46,194,28,166,272,252,20,0
2021,Horsham 007E,E01035336,501,405,190,215,0,0,7,0,7,89,81,8,0
2021,Horsham 007F,E01035337,511,322,78,244,40,40,71,1,70,78,71,7,0
2021,Horsham 007G,E01035338,780,500,205,295,10,10,139,24,115,129,111,18,2
2021,Horsham 007H,E01035339,634,452,94,358,42,42,73,5,68,67,62,5,0
2021,Horsham 007I,E01035340,702,410,218,192,5,5,209,26,183,78,72,6,0
2021,Horsham 010F,E01035341,625,442,176,266,47,47,75,8,67,61,47,14,0
2021,Horsham 010G,E01035342,608,463,220,243,7,7,37,2,35,101,90,11,0
2021,Mid Sussex 001H,E01035343,651,264,91,173,10,10,48,2,46,329,310,19,0
2021,Mid Sussex 001I,E01035344,571,444,303,141,2,2,35,3,32,90,78,12,0
2021,Mid Sussex 007E,E01035345,697,459,156,303,32,32,99,5,94,107,86,21,0
2021,Mid Sussex 007F,E01035346,594,368,161,207,11,11,105,4,101,110,90,20,0
2021,Mid Sussex 009H,E01035347,588,251,103,148,0,0,16,1,15,321,305,16,0
2021,Mid Sussex 009I,E01035348,630,279,201,78,4,4,74,9,65,272,247,25,1
2021,Mid Sussex 011G,E01035349,628,472,274,198,7,7,54,1,53,95,85,10,0
2021,Mid Sussex 011H,E01035350,594,285,84,201,16,16,158,5,153,135,126,9,0
2021,Mid Sussex 011I,E01035351,621,509,203,306,28,28,46,4,42,38,37,1,0
2021,Mid Sussex 011J,E01035352,627,428,134,294,28,28,68,3,65,103,87,16,0
2021,Mid Sussex 013F,E01035353,644,491,215,276,15,15,74,2,72,63,51,12,1
2021,Mid Sussex 013G,E01035354,638,477,79,398,34,34,101,6,95,26,24,2,0
2021,Reigate and Banstead 011F,E01035355,621,365,81,284,53,53,94,2,92,109,103,6,0
2021,Reigate and Banstead 011G,E01035356,643,462,189,273,4,4,13,2,11,164,155,9,0
2021,Reigate and Banstead 011H,E01035357,656,351,103,248,41,41,27,1,26,236,230,6,1
2021,Reigate and Banstead 011I,E01035358,687,252,135,117,5,5,39,3,36,385,350,35,6
2021,Reigate and Banstead 016F,E01035359,742,541,53,488,102,102,73,11,62,25,20,5,1
2021,Reigate and Banstead 016G,E01035360,760,681,305,376,15,15,22,1,21,42,38,4,0
2021,Reigate and Banstead 018F,E01035361,644,396,200,196,3,3,27,6,21,217,203,14,1
2021,Reigate and Banstead 018G,E01035362,615,241,95,146,72,72,42,1,41,260,246,14,0
2021,Tandridge 002E,E01035363,624,300,92,208,89,89,64,43,21,171,164,7,0
2021,Tandridge 002F,E01035364,583,382,134,248,0,0,52,25,27,149,140,9,0
2021,Cheshire West and Chester 007F,E01035365,681,227,109,118,18,18,175,55,120,261,225,36,0
2021,Cheshire West and Chester 007G,E01035366,820,519,67,452,15,15,148,84,64,138,132,6,0
2021,Cheshire West and Chester 007H,E01035367,611,266,122,144,1,1,145,105,40,197,178,19,2
2021,Cheshire West and Chester 007I,E01035368,650,83,27,56,0,0,486,294,192,77,75,2,4
2021,Cheshire West and Chester 018D,E01035369,571,377,146,231,14,14,50,4,46,130,125,5,0
2021,Cheshire West and Chester 018E,E01035370,607,548,98,450,2,2,4,2,2,51,43,8,2
2021,Cheshire West and Chester 018F,E01035371,519,369,182,187,2,2,24,9,15,124,113,11,0
2021,Cheshire West and Chester 018G,E01035372,616,544,126,418,14,14,12,3,9,46,40,6,0
2021,Cheshire West and Chester 033G,E01035373,724,313,141,172,19,19,104,17,87,288,274,14,0
2021,Cheshire West and Chester 033H,E01035374,656,82,44,38,10,10,395,75,320,167,150,17,2
2021,Cheshire West and Chester 034F,E01035375,449,129,82,47,3,3,66,6,60,251,235,16,0
2021,Cheshire West and Chester 034G,E01035376,708,249,132,117,13,13,139,20,119,307,275,32,0
2021,Cheshire West and Chester 034H,E01035377,812,283,130,153,69,69,120,14,106,340,292,48,0
2021,Cheshire West and Chester 034I,E01035378,678,312,215,97,2,2,81,7,74,283,266,17,0
2021,Cheshire West and Chester 041E,E01035379,578,421,168,253,51,51,23,2,21,83,72,11,0
2021,Cheshire West and Chester 041F,E01035380,587,481,74,407,40,40,44,8,36,22,21,1,0
2021,Cheshire West and Chester 041G,E01035381,588,475,235,240,8,8,32,8,24,73,53,20,0
2021,Halton 012G,E01035382,638,206,58,148,17,17,112,17,95,303,296,7,0
2021,Halton 012H,E01035383,628,426,232,194,0,0,86,17,69,116,105,11,0
2021,Warrington 009E,E01035384,493,394,114,280,1,1,11,0,11,87,85,2,0
2021,Warrington 009F,E01035385,581,500,141,359,25,25,18,5,13,38,30,8,0
2021,Warrington 009G,E01035386,557,534,169,365,0,0,1,0,1,22,22,0,0
2021,Warrington 009H,E01035387,581,388,82,306,12,12,71,4,67,110,100,10,0
2021,Warrington 009I,E01035388,560,495,156,339,4,4,13,1,12,48,37,11,0
2021,Warrington 010G,E01035389,597,426,212,214,16,16,80,10,70,75,69,6,0
2021,Warrington 010H,E01035390,546,383,123,260,4,4,45,1,44,114,109,5,0
2021,Warrington 020F,E01035391,648,410,64,346,33,33,155,46,109,50,46,4,0
2021,Warrington 020G,E01035392,658,355,140,215,12,12,73,35,38,218,198,20,0
2021,North Northamptonshire 006C,E01035393,637,512,71,441,5,5,8,3,5,112,108,4,0
2021,North Northamptonshire 006D,E01035394,640,417,68,349,0,0,26,23,3,197,191,6,0
2021,North Northamptonshire 006E,E01035395,568,465,165,300,1,1,40,24,16,61,57,4,1
2021,North Northamptonshire 006F,E01035396,516,397,108,289,26,26,47,38,9,46,41,5,0
2021,North Northamptonshire 006G,E01035397,733,464,94,370,10,10,108,6,102,151,145,6,0
2021,North Northamptonshire 006H,E01035398,793,684,394,290,3,3,26,14,12,79,69,10,1
2021,West Northamptonshire 004D,E01035399,542,488,303,185,1,1,21,1,20,32,21,11,0
2021,West Northamptonshire 004E,E01035400,423,339,207,132,2,2,46,5,41,36,28,8,0
2021,West Northamptonshire 003E,E01035401,643,552,292,260,3,3,27,12,15,61,51,10,0
2021,West Northamptonshire 003F,E01035402,509,401,58,343,36,36,36,2,34,36,28,8,0
2021,West Northamptonshire 010D,E01035403,633,270,65,205,46,46,104,8,96,213,200,13,0
2021,West Northamptonshire 010E,E01035404,589,467,211,256,4,4,41,4,37,77,68,9,0
2021,West Northamptonshire 010F,E01035405,701,485,99,386,36,36,54,6,48,126,116,10,0
2021,West Northamptonshire 010G,E01035406,720,512,213,299,14,14,79,1,78,115,104,11,0
2021,North Northamptonshire 011E,E01035407,599,452,185,267,2,2,19,8,11,126,118,8,0
2021,North Northamptonshire 011F,E01035408,618,460,127,333,47,47,68,10,58,43,39,4,0
2021,North Northamptonshire 039E,E01035409,575,455,200,255,16,16,19,6,13,85,71,14,0
2021,North Northamptonshire 039F,E01035410,704,576,268,308,2,2,12,1,11,114,105,9,0
2021,North Northamptonshire 014D,E01035411,680,303,160,143,36,36,167,63,104,172,162,10,2
2021,North Northamptonshire 014E,E01035412,565,313,123,190,9,9,153,79,74,90,84,6,0
2021,North Northamptonshire 018F,E01035413,595,158,85,73,2,2,232,135,97,198,181,17,5
2021,North Northamptonshire 018G,E01035414,642,125,53,72,9,9,293,138,155,213,200,13,2
2021,North Northamptonshire 023D,E01035415,1002,750,190,560,70,70,98,10,88,84,73,11,0
2021,North Northamptonshire 023E,E01035416,886,526,207,319,30,30,137,71,66,188,178,10,5
2021,West Northamptonshire 034D,E01035417,747,107,29,78,30,30,105,25,80,504,485,19,1
2021,West Northamptonshire 034E,E01035418,748,182,110,72,6,6,190,22,168,369,334,35,1
2021,West Northamptonshire 044D,E01035419,642,542,199,343,1,1,9,4,5,90,85,5,0
2021,West Northamptonshire 044E,E01035420,425,361,181,180,0,0,33,25,8,31,26,5,0
2021,West Northamptonshire 035B,E01035421,633,428,105,323,22,22,49,5,44,132,123,9,2
2021,West Northamptonshire 035C,E01035422,556,369,68,301,30,30,78,12,66,79,71,8,0
2021,West Northamptonshire 035D,E01035423,941,472,50,422,63,63,237,21,216,169,148,21,0
2021,West Northamptonshire 039D,E01035424,844,521,56,465,46,46,175,7,168,102,93,9,0
2021,West Northamptonshire 050D,E01035425,623,442,225,217,17,17,54,9,45,110,102,8,0
2021,West Northamptonshire 050E,E01035426,666,533,245,288,32,32,52,2,50,49,41,8,0
2021,West Northamptonshire 051E,E01035427,830,630,77,553,61,61,105,14,91,34,30,4,0
2021,West Northamptonshire 051F,E01035428,870,765,290,475,25,25,36,5,31,44,28,16,0
2021,North Northamptonshire 030D,E01035429,655,345,67,278,30,30,92,11,81,188,173,15,0
2021,North Northamptonshire 030E,E01035430,908,409,162,247,25,25,93,8,85,381,359,22,0
2021,North Northamptonshire 032D,E01035431,680,143,67,76,8,8,164,49,115,363,347,16,2
2021,North Northamptonshire 032E,E01035432,588,134,72,62,38,38,263,68,195,153,140,13,0
2021,Eastleigh 006F,E01035433,624,266,105,161,24,24,112,14,98,222,211,11,0
2021,Eastleigh 006G,E01035434,703,428,166,262,27,27,167,14,153,81,74,7,0
2021,Eastleigh 006H,E01035435,503,288,137,151,2,2,174,17,157,39,32,7,0
2021,Eastleigh 006I,E01035436,519,170,24,146,151,151,146,14,132,52,49,3,0
2021,Eastleigh 006J,E01035437,636,258,58,200,69,69,214,16,198,95,88,7,0
2021,Eastleigh 010F,E01035438,746,476,83,393,105,105,131,10,121,34,27,7,0
2021,Eastleigh 010G,E01035439,720,521,155,366,10,10,76,8,68,113,105,8,0
2021,Eastleigh 010H,E01035440,591,280,47,233,37,37,113,6,107,161,155,6,0
2021,Eastleigh 010I,E01035441,598,476,273,203,14,14,47,2,45,61,49,12,0
2021,Southampton 005G,E01035442,541,164,89,75,5,5,51,47,4,321,311,10,0
2021,Southampton 005H,E01035443,399,74,36,38,3,3,85,37,48,237,226,11,0
2021,Southampton 023E,E01035444,628,146,48,98,11,11,208,121,87,262,234,28,1
2021,Southampton 023F,E01035445,603,86,36,50,38,38,275,100,175,203,197,6,1
2021,Southampton 031F,E01035446,673,155,47,108,130,130,121,5,116,267,256,11,0
2021,Southampton 031G,E01035447,680,385,145,240,26,26,64,10,54,205,189,16,0
2021,Southampton 034A,E01035448,634,181,36,145,12,12,54,11,43,387,377,10,0
2021,Southampton 034B,E01035449,605,301,119,182,6,6,25,16,9,273,261,12,0
2021,Test Valley 013E,E01035450,632,405,112,293,38,38,137,44,93,50,43,7,2
2021,Test Valley 013F,E01035451,651,382,95,287,94,94,106,10,96,69,63,6,0
2021,Test Valley 013G,E01035452,590,429,239,190,5,5,24,3,21,132,111,21,0
2021,Test Valley 016A,E01035453,549,367,73,294,69,69,72,14,58,41,31,10,0
2021,Test Valley 016B,E01035454,586,308,151,157,7,7,226,14,212,45,36,9,0
2021,Test Valley 016C,E01035455,637,372,60,312,52,52,131,21,110,82,69,13,0
2021,Test Valley 016D,E01035456,627,298,58,240,31,31,177,21,156,121,83,38,0
2021,Test Valley 016E,E01035457,590,404,39,365,61,61,79,12,67,46,39,7,0
2021,Test Valley 017A,E01035458,590,367,48,319,73,73,115,11,104,35,30,5,0
2021,Test Valley 017B,E01035459,620,434,104,330,81,81,59,3,56,46,38,8,0
2021,Test Valley 017C,E01035460,526,291,158,133,13,13,166,47,119,55,47,8,1
2021,Test Valley 017D,E01035461,512,262,32,230,25,25,155,22,133,69,62,7,1
2021,Test Valley 017E,E01035462,606,326,50,276,43,43,147,27,120,90,59,31,0
2021,Kingston upon Hull 011F,E01035463,1083,517,245,272,30,30,403,326,77,122,101,21,11
2021,Kingston upon Hull 017G,E01035464,932,104,60,44,6,6,774,479,295,43,36,7,5
2021,Kingston upon Hull 029G,E01035465,649,98,51,47,2,2,178,120,58,370,357,13,1
2021,Kingston upon Hull 029H,E01035466,767,63,38,25,0,0,421,370,51,279,271,8,4
2021,Kingston upon Hull 031H,E01035467,662,294,57,237,2,2,278,64,214,87,79,8,1
2021,Kingston upon Hull 031I,E01035468,552,138,56,82,2,2,324,222,102,82,69,13,6
2021,Kingston upon Hull 034C,E01035469,801,634,151,483,8,8,41,6,35,118,104,14,0
2021,Kingston upon Hull 035A,E01035470,951,840,67,773,2,2,9,4,5,100,88,12,0
2021,Kingston upon Hull 035B,E01035471,592,408,63,345,1,1,7,3,4,176,162,14,0
2021,Kingston upon Hull 035C,E01035472,676,543,70,473,0,0,5,1,4,128,120,8,0
2021,North East Lincolnshire 002E,E01035473,1115,168,99,69,3,3,669,211,458,274,248,26,1
2021,North East Lincolnshire 007E,E01035474,629,552,317,235,1,1,9,0,9,67,55,12,0
2021,North East Lincolnshire 007F,E01035475,642,546,215,331,4,4,23,3,20,69,57,12,0
2021,North East Lincolnshire 020F,E01035476,1179,1000,673,327,4,4,73,8,65,102,81,21,0
2021,North East Lincolnshire 021F,E01035477,766,669,311,358,4,4,11,5,6,82,71,11,0
2021,North East Lincolnshire 021G,E01035478,766,548,92,456,23,23,32,6,26,163,153,10,0
2021,North East Lincolnshire 022F,E01035479,597,520,318,202,28,28,12,3,9,37,31,6,0
2021,North East Lincolnshire 022G,E01035480,653,513,170,343,14,14,63,14,49,63,54,9,0
2021,North Lincolnshire 015E,E01035481,588,277,144,133,1,1,258,153,105,49,46,3,3
2021,North Lincolnshire 015F,E01035482,506,347,65,282,2,2,54,18,36,103,98,5,0
2021,North Lincolnshire 015G,E01035483,519,351,65,286,0,0,45,17,28,123,113,10,0
2021,Hammersmith and Fulham 001F,E01035484,627,145,69,76,11,11,299,106,193,169,146,23,3
2021,Hammersmith and Fulham 001G,E01035485,578,74,46,28,9,9,241,76,165,253,206,47,1
2021,Hammersmith and Fulham 023G,E01035486,881,341,126,215,82,82,135,16,119,322,282,40,1
2021,Hammersmith and Fulham 023H,E01035487,748,207,75,132,47,47,304,163,141,189,173,16,1
2021,Wandsworth 004H,E01035488,744,332,130,202,20,20,46,6,40,346,314,32,0
2021,Wandsworth 004I,E01035489,695,162,70,92,152,152,77,17,60,303,280,23,1
2021,Wandsworth 010H,E01035490,779,350,181,169,28,28,53,15,38,348,316,32,0
2021,Wandsworth 010I,E01035491,623,254,83,171,5,5,13,13,0,351,327,24,0
2021,Wandsworth 010J,E01035492,851,338,59,279,170,170,93,20,73,250,230,20,0
2021,Wandsworth 010K,E01035493,832,233,64,169,61,61,183,64,119,353,338,15,2
2021,Wandsworth 018E,E01035494,960,349,74,275,53,53,66,19,47,492,473,19,0
2021,Wandsworth 018F,E01035495,509,47,34,13,0,0,384,379,5,77,73,4,1
2021,Wandsworth 038A,E01035496,707,245,154,91,2,2,39,13,26,421,390,31,0
2021,Wandsworth 038B,E01035497,652,117,40,77,34,34,254,28,226,247,234,13,0
2021,Wandsworth 038E,E01035498,651,114,56,58,154,154,18,7,11,365,336,29,0
2021,Wandsworth 039C,E01035499,609,146,53,93,0,0,340,299,41,122,108,14,1
2021,Nottingham 023J,E01035500,1025,148,57,91,1,1,179,112,67,695,669,26,2
2021,Nottingham 028H,E01035501,809,67,30,37,3,3,313,146,167,425,409,16,1
2021,Nottingham 028I,E01035502,573,64,34,30,5,5,22,10,12,482,478,4,0
2021,Nottingham 031J,E01035503,416,102,63,39,2,2,27,19,8,284,278,6,1
2021,Nottingham 031K,E01035504,562,95,59,36,1,1,95,51,44,370,363,7,1
2021,Nottingham 031L,E01035505,974,146,77,69,2,2,266,206,60,558,550,8,2
2021,Nottingham 039G,E01035506,1127,168,62,106,3,3,143,59,84,813,774,39,0
2021,Nottingham 041E,E01035507,1010,636,425,211,3,3,147,122,25,221,191,30,3
2021,Nottingham 041F,E01035508,991,311,127,184,2,2,375,294,81,299,266,33,4
2021,Rushcliffe 008F,E01035509,545,486,307,179,1,1,30,7,23,28,24,4,0
2021,Rushcliffe 008G,E01035510,698,472,76,396,78,78,90,12,78,58,50,8,0
2021,Cambridge 005E,E01035511,506,285,138,147,12,12,91,21,70,118,108,10,0
2021,Cambridge 005F,E01035512,408,39,15,24,5,5,83,18,65,281,151,130,0
2021,Cambridge 005G,E01035513,491,160,108,52,4,4,75,7,68,252,133,119,0
2021,Cambridge 005H,E01035514,889,358,244,114,3,3,163,65,98,361,299,62,4
2021,Cambridge 007H,E01035515,401,102,78,24,3,3,87,6,81,209,142,67,0
2021,Cambridge 007I,E01035516,938,526,373,153,9,9,108,22,86,295,174,121,0
2021,Cambridge 007J,E01035517,428,76,51,25,6,6,87,33,54,259,202,57,0
2021,Cambridge 010F,E01035518,809,223,87,136,16,16,141,60,81,429,404,25,0
2021,Cambridge 010G,E01035519,591,213,116,97,3,3,90,38,52,285,272,13,0
2021,Cambridge 013F,E01035520,484,284,172,112,1,1,44,30,14,155,142,13,0
2021,Cambridge 013G,E01035521,559,156,78,78,0,0,192,4,188,211,154,57,0
2021,Cambridge 014B,E01035522,654,94,50,44,16,16,167,23,144,377,360,17,0
2021,Cambridge 014C,E01035523,493,177,112,65,37,37,114,11,103,165,152,13,0
2021,Cambridge 015A,E01035524,587,238,85,153,84,84,143,22,121,122,115,7,0
2021,Cambridge 015B,E01035525,686,312,154,158,16,16,171,89,82,185,168,17,2
2021,Cambridge 015C,E01035526,792,281,129,152,31,31,233,78,155,247,222,25,0
2021,Cambridge 015D,E01035527,531,231,68,163,75,75,103,3,100,122,114,8,0
2021,Cambridge 015E,E01035528,559,211,102,109,7,7,199,152,47,141,139,2,1
2021,Cambridge 015F,E01035529,555,189,51,138,50,50,176,13,163,139,131,8,1
2021,Cambridge 015G,E01035530,565,316,162,154,36,36,82,9,73,131,118,13,0
2021,East Cambridgeshire 001F,E01035531,520,239,72,167,6,6,228,27,201,47,40,7,0
2021,East Cambridgeshire 001G,E01035532,641,433,106,327,43,43,110,18,92,55,50,5,0
2021,East Cambridgeshire 003H,E01035533,637,439,128,311,16,16,34,3,31,148,141,7,0
2021,East Cambridgeshire 003I,E01035534,632,320,202,118,56,56,72,5,67,184,168,16,0
2021,East Cambridgeshire 004H,E01035535,1026,683,379,304,24,24,150,14,136,169,153,16,0
2021,Fenland 011F,E01035536,791,480,203,277,0,0,90,11,79,221,211,10,0
2021,Fenland 011G,E01035537,562,328,145,183,11,11,113,26,87,110,96,14,0
2021,Peterborough 007G,E01035538,641,381,41,340,98,98,98,36,62,64,58,6,0
2021,Peterborough 007H,E01035539,645,222,78,144,4,4,245,85,160,173,156,17,1
2021,Peterborough 013G,E01035540,612,264,152,112,5,5,161,75,86,180,165,15,2
2021,Peterborough 013H,E01035541,627,228,70,158,16,16,180,49,131,203,191,12,0
2021,Peterborough 014F,E01035542,647,167,90,77,6,6,95,33,62,378,361,17,1
2021,Peterborough 014G,E01035543,572,113,81,32,2,2,42,7,35,415,399,16,0
2021,Peterborough 017F,E01035544,734,290,78,212,26,26,121,36,85,297,284,13,0
2021,Peterborough 017G,E01035545,710,374,163,211,7,7,72,26,46,256,236,20,1
2021,Peterborough 019G,E01035546,597,489,278,211,5,5,9,2,7,94,89,5,0
2021,Peterborough 019H,E01035547,604,493,61,432,14,14,35,10,25,62,56,6,0
2021,Peterborough 019I,E01035548,587,289,34,255,46,46,95,26,69,157,150,7,0
2021,Peterborough 019J,E01035549,629,390,56,334,40,40,89,30,59,110,107,3,0
2021,Peterborough 023G,E01035551,594,317,88,229,2,2,68,7,61,207,194,13,0
2021,Peterborough 023H,E01035552,625,540,35,505,9,9,33,7,26,43,39,4,0
2021,Peterborough 023I,E01035553,498,160,26,134,38,38,160,40,120,140,130,10,0
2021,Peterborough 023J,E01035554,514,363,47,316,34,34,41,9,32,75,68,7,1
2021,South Cambridgeshire 003E,E01035555,623,424,56,368,49,49,90,12,78,60,45,15,0
2021,South Cambridgeshire 003F,E01035556,524,400,101,299,0,0,4,0,4,120,111,9,0
2021,South Cambridgeshire 003G,E01035557,550,342,125,217,22,22,117,60,57,68,60,8,1
2021,South Cambridgeshire 003H,E01035558,539,434,203,231,16,16,10,9,1,79,74,5,0
2021,South Cambridgeshire 020F,E01035559,705,438,110,328,27,27,77,17,60,163,152,11,0
2021,South Cambridgeshire 020G,E01035560,813,426,50,376,108,108,187,15,172,91,82,9,1
2021,South Cambridgeshire 022D,E01035561,963,680,425,255,17,17,163,109,54,100,82,18,3
2021,Dacorum 015F,E01035562,657,313,136,177,13,13,109,23,86,222,205,17,0
2021,Dacorum 015G,E01035563,585,204,82,122,16,16,132,16,116,233,226,7,0
2021,Dacorum 015H,E01035564,592,273,75,198,24,24,71,19,52,224,216,8,0
2021,West Oxfordshire 012E,E01035565,480,326,127,199,32,32,67,5,62,55,45,10,0
2021,St Albans 012E,E01035566,612,289,132,157,1,1,33,24,9,288,282,6,1
2021,St Albans 012F,E01035567,675,197,56,141,13,13,207,68,139,257,252,5,1
2021,Stevenage 001E,E01035568,650,278,38,240,169,169,142,35,107,61,53,8,0
2021,Stevenage 001F,E01035569,661,388,150,238,9,9,175,156,19,88,78,10,1
2021,Stevenage 008E,E01035570,739,275,112,163,2,2,212,169,43,250,238,12,0
2021,Stevenage 008F,E01035571,683,221,110,111,3,3,316,272,44,142,134,8,1
2021,Watford 007E,E01035572,549,265,70,195,21,21,100,1,99,163,154,9,0
2021,Watford 007F,E01035573,610,334,164,170,0,0,6,2,4,270,254,16,0
2021,Watford 009E,E01035574,601,156,63,93,30,30,73,8,65,341,332,9,1
2021,Watford 009F,E01035575,539,228,86,142,3,3,13,1,12,295,283,12,0
2021,Watford 009G,E01035576,572,135,86,49,3,3,92,11,81,342,328,14,0
2021,Watford 009H,E01035577,693,206,58,148,20,20,70,9,61,397,388,9,0
2021,Watford 009I,E01035578,605,138,64,74,10,10,39,6,33,418,405,13,0
2021,Watford 011F,E01035579,702,229,81,148,15,15,142,17,125,316,300,16,0
2021,Watford 011G,E01035580,445,239,84,155,7,7,31,6,25,168,154,14,0
2021,St Albans 021C,E01035581,629,446,236,210,0,0,124,100,24,57,46,11,2
2021,Stevenage 013A,E01035582,687,568,285,283,2,2,8,4,4,109,104,5,0
2021,Broxbourne 005F,E01035583,544,305,109,196,28,28,90,5,85,121,106,15,0
2021,Broxbourne 005G,E01035584,673,349,109,240,5,5,171,31,140,148,129,19,0
2021,Broxbourne 013E,E01035585,705,238,80,158,28,28,225,49,176,213,202,11,1
2021,Broxbourne 013F,E01035586,616,296,122,174,6,6,235,63,172,74,64,10,5
2021,East Hertfordshire 001E,E01035587,629,458,137,321,30,30,89,2,87,52,44,8,0
2021,East Hertfordshire 001F,E01035588,488,386,184,202,20,20,65,11,54,17,15,2,0
2021,East Hertfordshire 001G,E01035589,431,388,215,173,2,2,11,1,10,30,27,3,0
2021,East Hertfordshire 004D,E01035590,664,411,151,260,28,28,101,5,96,124,111,13,0
2021,East Hertfordshire 004E,E01035591,613,192,106,86,15,15,108,7,101,296,283,13,2
2021,East Hertfordshire 006D,E01035592,443,336,149,187,11,11,28,3,25,68,58,10,0
2021,East Hertfordshire 006E,E01035593,792,564,278,286,1,1,167,16,151,60,50,10,0
2021,East Hertfordshire 007G,E01035594,702,369,150,219,5,5,92,13,79,236,221,15,0
2021,East Hertfordshire 007H,E01035595,590,185,100,85,13,13,100,7,93,292,276,16,0
2021,East Hertfordshire 017F,E01035596,753,336,128,208,22,22,90,4,86,305,286,19,0
2021,East Hertfordshire 017G,E01035597,779,352,204,148,6,6,96,14,82,324,301,23,1
2021,Hertsmere 011F,E01035598,638,359,160,199,7,7,66,6,60,205,194,11,1
2021,Hertsmere 011G,E01035599,681,253,60,193,54,54,62,2,60,312,295,17,0
2021,Three Rivers 001F,E01035600,639,525,282,243,0,0,24,8,16,90,78,12,0
2021,Three Rivers 001G,E01035601,624,312,114,198,17,17,77,11,66,216,205,11,2
2021,Three Rivers 002F,E01035602,536,447,227,220,0,0,27,7,20,62,52,10,0
2021,Three Rivers 002G,E01035603,833,552,180,372,36,36,172,10,162,73,69,4,0
2021,Welwyn Hatfield 007F,E01035604,714,177,52,125,242,242,224,73,151,71,66,5,0
2021,Welwyn Hatfield 007G,E01035605,737,282,67,215,12,12,273,214,59,167,159,8,3
2021,Welwyn Hatfield 009E,E01035606,708,373,133,240,4,4,186,164,22,142,134,8,3
2021,Welwyn Hatfield 009F,E01035607,553,215,54,161,15,15,163,46,117,160,155,5,0
2021,Welwyn Hatfield 017C,E01035608,618,500,302,198,2,2,21,18,3,95,77,18,0
2021,East Hertfordshire 019C,E01035609,581,404,219,185,9,9,77,13,64,91,79,12,0
2021,Gateshead 008F,E01035610,906,382,205,177,0,0,73,19,54,445,407,38,6
2021,Gateshead 027E,E01035611,695,234,43,191,2,2,101,64,37,357,336,21,1
2021,Gateshead 027F,E01035612,509,139,77,62,0,0,301,274,27,63,55,8,6
2021,Newcastle upon Tyne 032C,E01035613,646,435,155,280,4,4,124,113,11,83,78,5,0
2021,Newcastle upon Tyne 032D,E01035614,606,541,72,469,7,7,12,3,9,46,39,7,0
2021,Newcastle upon Tyne 032E,E01035615,582,483,66,417,13,13,7,6,1,78,71,7,1
2021,Newcastle upon Tyne 032F,E01035616,593,426,48,378,1,1,95,8,87,71,63,8,0
2021,Newcastle upon Tyne 036A,E01035617,897,141,83,58,1,1,488,171,317,263,241,22,4
2021,Newcastle upon Tyne 038B,E01035618,450,69,41,28,1,1,94,48,46,282,268,14,4
2021,Newcastle upon Tyne 038C,E01035619,602,47,22,25,1,1,416,332,84,129,118,11,9
2021,Newcastle upon Tyne 039B,E01035620,460,41,21,20,0,0,118,7,111,301,282,19,0
2021,Newcastle upon Tyne 039C,E01035621,493,118,72,46,0,0,165,41,124,210,186,24,0
2021,Newcastle upon Tyne 040A,E01035622,655,50,29,21,1,1,549,330,219,53,47,6,2
2021,Newcastle upon Tyne 040B,E01035623,563,111,56,55,3,3,313,140,173,133,127,6,3
2021,Gateshead 029D,E01035624,767,410,278,132,7,7,238,207,31,111,87,24,1
2021,North Tyneside 007E,E01035625,773,495,155,340,25,25,195,120,75,58,52,6,0
2021,North Tyneside 007F,E01035626,820,584,116,468,1,1,133,72,61,102,90,12,0
2021,North Tyneside 018F,E01035627,648,504,188,316,1,1,65,56,9,78,66,12,0
2021,North Tyneside 018G,E01035628,616,542,113,429,8,8,47,9,38,19,14,5,0
2021,Northumberland 015E,E01035629,671,503,219,284,11,11,55,9,46,102,80,22,0
2021,Northumberland 015F,E01035630,688,566,261,305,9,9,62,9,53,51,43,8,0
2021,Northumberland 023F,E01035631,743,495,251,244,10,10,118,81,37,118,96,22,2
2021,Northumberland 023G,E01035632,738,539,155,384,7,7,77,42,35,115,95,20,0
2021,Northumberland 025E,E01035633,610,469,269,200,3,3,68,60,8,70,58,12,0
2021,Northumberland 025F,E01035634,403,346,138,208,1,1,11,3,8,45,38,7,0
2021,Northumberland 025G,E01035635,639,542,59,483,7,7,26,8,18,64,51,13,0
2021,Northumberland 038G,E01035636,964,764,426,338,2,2,83,32,51,115,96,19,0
2021,Northumberland 043F,E01035637,454,305,192,113,0,0,24,4,20,125,96,29,0
2021,Hackney 002G,E01035638,847,158,81,77,4,4,294,195,99,389,372,17,2
2021,Hackney 002H,E01035639,808,126,46,80,84,84,340,103,237,258,248,10,0
2021,Hackney 020F,E01035640,636,206,96,110,2,2,230,66,164,196,177,19,2
2021,Hackney 020G,E01035641,613,99,27,72,52,52,173,20,153,287,273,14,2
2021,Hackney 025G,E01035642,854,229,75,154,53,53,245,103,142,324,289,35,3
2021,Hackney 025H,E01035643,742,168,46,122,83,83,275,184,91,215,186,29,1
2021,Hackney 025I,E01035644,606,154,51,103,13,13,114,82,32,321,286,35,4
2021,Hackney 025J,E01035645,617,61,24,37,11,11,374,147,227,167,158,9,4
2021,Hackney 026E,E01035646,666,150,56,94,15,15,289,190,99,209,191,18,3
2021,Hackney 026F,E01035647,598,198,94,104,44,44,50,10,40,306,287,19,0
2021,Hackney 026G,E01035648,705,80,29,51,76,76,426,306,120,122,114,8,1
2021,Hackney 026H,E01035649,670,188,72,116,40,40,197,80,117,244,214,30,1
2021,Hackney 031C,E01035650,914,120,46,74,10,10,464,51,413,311,290,21,9
2021,Islington 007E,E01035651,694,182,66,116,11,11,190,110,80,308,297,11,3
2021,Islington 007F,E01035652,609,179,69,110,3,3,87,48,39,340,319,21,0
2021,Islington 011J,E01035653,757,188,44,144,69,69,139,15,124,361,338,23,0
2021,Islington 011K,E01035654,504,91,24,67,105,105,195,36,159,113,104,9,0
2021,Islington 020F,E01035655,747,238,131,107,0,0,299,272,27,210,193,17,0
2021,Islington 020G,E01035656,721,148,71,77,101,101,171,46,125,301,287,14,0
2021,Tower Hamlets 001E,E01035657,508,212,29,183,24,24,35,10,25,237,221,16,0
2021,Tower Hamlets 001F,E01035658,590,341,12,329,86,86,97,18,79,65,59,6,1
2021,Tower Hamlets 001G,E01035659,593,145,38,107,22,22,280,60,220,145,136,9,1
2021,Tower Hamlets 002E,E01035660,583,105,34,71,4,4,217,153,64,257,243,14,0
2021,Tower Hamlets 002F,E01035661,499,90,34,56,51,51,226,76,150,130,122,8,2
2021,Tower Hamlets 004H,E01035662,643,252,50,202,9,9,37,4,33,345,328,17,0
2021,Tower Hamlets 004I,E01035663,557,161,54,107,49,49,146,18,128,201,187,14,0
2021,Tower Hamlets 006E,E01035664,1107,312,151,161,14,14,450,201,249,327,295,32,4
2021,Tower Hamlets 008F,E01035665,674,215,41,174,109,109,114,18,96,236,218,18,0
2021,Tower Hamlets 008G,E01035666,731,110,23,87,22,22,286,51,235,313,297,16,0
2021,Tower Hamlets 008H,E01035667,682,107,31,76,10,10,344,72,272,220,208,12,1
2021,Tower Hamlets 009E,E01035668,824,171,62,109,26,26,276,82,194,348,329,19,3
2021,Tower Hamlets 009F,E01035669,641,109,48,61,16,16,154,14,140,362,340,22,0
2021,Tower Hamlets 010G,E01035670,836,153,55,98,5,5,400,321,79,273,250,23,5
2021,Tower Hamlets 012F,E01035671,894,288,33,255,103,103,220,33,187,283,268,15,0
2021,Tower Hamlets 012G,E01035672,1012,125,34,91,16,16,522,283,239,348,332,16,1
2021,Tower Hamlets 012H,E01035673,454,96,12,84,19,19,152,15,137,186,175,11,1
2021,Tower Hamlets 014F,E01035674,567,207,36,171,3,3,227,64,163,129,120,9,1
2021,Tower Hamlets 014G,E01035675,653,67,26,41,5,5,316,113,203,265,252,13,0
2021,Tower Hamlets 014H,E01035676,480,111,25,86,7,7,280,82,198,80,72,8,2
2021,Tower Hamlets 014I,E01035677,595,167,15,152,22,22,253,59,194,153,144,9,0
2021,Tower Hamlets 018E,E01035678,752,289,60,229,66,66,226,47,179,171,151,20,0
2021,Tower Hamlets 018F,E01035679,639,166,86,80,26,26,154,51,103,292,283,9,1
2021,Tower Hamlets 019E,E01035680,735,120,20,100,128,128,271,19,252,216,197,19,0
2021,Tower Hamlets 019F,E01035681,627,73,25,48,33,33,425,90,335,94,84,10,2
2021,Tower Hamlets 019G,E01035682,495,93,16,77,31,31,198,95,103,172,165,7,1
2021,Tower Hamlets 019H,E01035683,491,66,22,44,1,1,314,124,190,107,102,5,3
2021,Tower Hamlets 020E,E01035684,506,143,10,133,30,30,225,57,168,107,99,8,1
2021,Tower Hamlets 020F,E01035685,495,68,23,45,3,3,340,131,209,81,76,5,3
2021,Tower Hamlets 021G,E01035686,572,61,27,34,5,5,123,13,110,383,364,19,0
2021,Tower Hamlets 021H,E01035687,675,108,45,63,43,43,180,23,157,344,320,24,0
2021,Tower Hamlets 021I,E01035688,693,104,63,41,16,16,125,17,108,448,433,15,0
2021,Tower Hamlets 021J,E01035689,695,113,30,83,86,86,175,24,151,321,305,16,0
2021,Tower Hamlets 023E,E01035690,823,192,40,152,27,27,158,35,123,445,427,18,1
2021,Tower Hamlets 023F,E01035691,758,221,70,151,24,24,132,22,110,379,353,26,2
2021,Tower Hamlets 024E,E01035692,573,129,26,103,43,43,184,52,132,216,203,13,1
2021,Tower Hamlets 024F,E01035693,619,157,56,101,33,33,170,53,117,259,245,14,0
2021,Tower Hamlets 024G,E01035694,818,128,41,87,8,8,371,167,204,308,289,19,3
2021,Tower Hamlets 024H,E01035695,588,97,44,53,5,5,350,194,156,134,121,13,2
2021,Tower Hamlets 026E,E01035696,602,190,58,132,12,12,87,14,73,313,287,26,0
2021,Tower Hamlets 026F,E01035697,671,141,61,80,31,31,93,60,33,406,385,21,0
2021,Tower Hamlets 032F,E01035698,476,107,31,76,17,17,120,7,113,232,225,7,0
2021,Tower Hamlets 032G,E01035699,827,125,24,101,10,10,258,31,227,434,420,14,0
2021,Tower Hamlets 034A,E01035700,625,118,36,82,2,2,29,6,23,476,460,16,0
2021,Tower Hamlets 034B,E01035701,664,143,38,105,17,17,52,36,16,452,433,19,0
2021,Tower Hamlets 034C,E01035702,577,119,43,76,5,5,145,26,119,307,285,22,1
2021,Tower Hamlets 036B,E01035703,501,120,55,65,0,0,15,7,8,366,352,14,0
2021,Tower Hamlets 036C,E01035704,593,101,30,71,4,4,183,30,153,305,292,13,0
2021,Tower Hamlets 036D,E01035705,559,141,62,79,13,13,219,34,185,186,171,15,0
2021,Tower Hamlets 036E,E01035706,562,139,44,95,58,58,126,11,115,238,231,7,1
2021,Camden 015F,E01035707,1130,416,219,197,7,7,306,130,176,398,359,39,3
2021,Camden 022F,E01035708,736,166,114,52,39,39,288,31,257,242,221,21,1
2021,Camden 022G,E01035709,635,90,53,37,1,1,425,419,6,114,103,11,5
2021,Camden 023F,E01035710,901,111,62,49,6,6,542,459,83,235,221,14,7
2021,Camden 026E,E01035711,901,224,145,79,11,11,322,202,120,341,296,45,3
2021,Camden 029E,E01035712,742,123,69,54,5,5,404,185,219,209,188,21,1
2021,Kensington and Chelsea 016F,E01035713,996,340,235,105,3,3,114,14,100,539,477,62,0
2021,Kensington and Chelsea 020F,E01035714,933,446,293,153,2,2,66,23,43,419,373,46,0
2021,Westminster 007H,E01035715,1172,423,228,195,4,4,189,44,145,555,521,34,1
2021,Westminster 013G,E01035716,1263,196,127,69,3,3,498,126,372,562,489,73,4
2021,Westminster 014H,E01035717,997,238,128,110,8,8,278,37,241,473,437,36,0
2021,Westminster 019G,E01035718,732,333,240,93,4,4,19,6,13,375,273,102,1
2021,Westminster 021F,E01035719,633,218,133,85,2,2,166,86,80,244,226,18,3
2021,Westminster 021G,E01035720,590,148,84,64,17,17,243,114,129,181,158,23,1
2021,Westminster 023H,E01035721,1307,263,168,95,6,6,632,207,425,400,356,44,6
2021,Westminster 024G,E01035722,1180,220,132,88,3,3,161,16,145,796,769,27,0
2021,Cherwell 001E,E01035723,543,425,242,183,4,4,35,7,28,79,66,13,0
2021,Cherwell 001F,E01035724,710,468,89,379,56,56,147,31,116,39,34,5,0
2021,Cherwell 004I,E01035725,493,281,43,238,46,46,99,23,76,67,67,0,0
2021,Cherwell 004J,E01035726,764,360,188,172,9,9,39,1,38,356,340,16,0
2021,Cherwell 008E,E01035727,666,431,55,376,47,47,112,6,106,76,71,5,0
2021,Cherwell 008F,E01035728,546,373,179,194,27,27,92,8,84,53,49,4,1
2021,Cherwell 008G,E01035729,658,516,286,230,21,21,66,5,61,55,48,7,0
2021,Cherwell 010F,E01035730,633,245,50,195,36,36,47,3,44,305,300,5,0
2021,Cherwell 010G,E01035731,612,410,203,207,37,37,85,11,74,80,75,5,0
2021,Cherwell 011G,E01035733,626,393,126,267,60,60,85,10,75,88,71,17,0
2021,Cherwell 011H,E01035734,449,178,38,140,3,3,47,3,44,221,55,166,0
2021,Cherwell 015E,E01035735,966,444,303,141,8,8,222,32,190,292,251,41,0
2021,Cherwell 015F,E01035736,496,264,67,197,61,61,73,11,62,98,86,12,0
2021,Cherwell 016G,E01035737,673,445,47,398,40,40,115,13,102,73,69,4,0
2021,Cherwell 016H,E01035738,604,361,49,312,44,44,126,16,110,73,58,15,0
2021,Cherwell 016I,E01035739,761,597,321,276,7,7,58,4,54,99,84,15,0
2021,Oxford 003E,E01035740,729,383,305,78,3,3,49,19,30,294,240,54,0
2021,Oxford 008F,E01035741,612,307,184,123,5,5,51,10,41,249,189,60,0
2021,Oxford 008G,E01035742,607,181,136,45,17,17,74,19,55,335,302,33,0
2021,Oxford 019C,E01035743,451,219,127,92,0,0,79,76,3,151,146,5,2
2021,Oxford 019D,E01035744,459,144,63,81,51,51,92,15,77,171,163,8,1
2021,South Oxfordshire 010E,E01035745,650,337,156,181,32,32,179,32,147,102,45,57,0
2021,South Oxfordshire 010F,E01035746,665,309,44,265,60,60,148,18,130,148,102,46,0
2021,South Oxfordshire 011E,E01035747,439,344,205,139,3,3,19,2,17,73,67,6,0
2021,South Oxfordshire 011F,E01035748,657,437,248,189,3,3,72,10,62,145,125,20,0
2021,South Oxfordshire 015F,E01035749,1010,644,55,589,169,169,124,14,110,73,60,13,0
2021,South Oxfordshire 015G,E01035750,485,381,231,150,1,1,68,12,56,35,28,7,0
2021,South Oxfordshire 015H,E01035751,628,408,164,244,29,29,84,15,69,107,102,5,0
2021,South Oxfordshire 015I,E01035752,599,391,171,220,39,39,82,10,72,86,62,24,1
2021,Vale of White Horse 007D,E01035753,799,496,183,313,53,53,181,15,166,69,53,16,0
2021,Vale of White Horse 007E,E01035754,776,636,331,305,8,8,38,3,35,94,72,22,0
2021,Vale of White Horse 010F,E01035755,638,435,200,235,19,19,135,25,110,49,35,14,0
2021,Vale of White Horse 010G,E01035756,620,494,263,231,5,5,61,11,50,60,52,8,0
2021,Vale of White Horse 014G,E01035757,598,254,128,126,25,25,109,18,91,210,191,19,0
2021,Vale of White Horse 014H,E01035758,657,417,267,150,18,18,41,8,33,181,159,22,0
2021,Vale of White Horse 015G,E01035759,618,467,220,247,18,18,57,7,50,76,67,9,0
2021,Vale of White Horse 015H,E01035760,624,408,74,334,58,58,86,22,64,72,61,11,0
2021,Vale of White Horse 015I,E01035761,614,416,134,282,63,63,85,11,74,50,31,19,0
2021,West Oxfordshire 004H,E01035762,631,423,244,179,23,23,72,6,66,113,97,16,0
2021,Isle of Anglesey 001A,W01000003,1141,673,418,255,1,1,230,184,46,233,205,28,4
2021,Isle of Anglesey 001B,W01000004,582,441,319,122,0,0,76,62,14,65,39,26,0
2021,Isle of Anglesey 005A,W01000005,820,509,377,132,2,2,147,135,12,159,134,25,3
2021,Isle of Anglesey 006A,W01000006,656,500,323,177,4,4,60,58,2,89,62,27,3
2021,Isle of Anglesey 009A,W01000007,758,544,373,171,1,1,61,52,9,150,114,36,2
2021,Isle of Anglesey 008A,W01000008,643,506,331,175,0,0,51,45,6,85,72,13,1
2021,Isle of Anglesey 007C,W01000009,781,544,347,197,2,2,112,97,15,120,91,29,3
2021,Isle of Anglesey 002A,W01000010,880,740,549,191,2,2,30,25,5,107,79,28,1
2021,Isle of Anglesey 008B,W01000011,564,378,283,95,1,1,55,50,5,130,111,19,0
2021,Isle of Anglesey 006B,W01000012,781,515,341,174,3,3,170,71,99,91,75,16,2
2021,Isle of Anglesey 005B,W01000013,958,802,560,242,1,1,52,37,15,103,78,25,0
2021,Isle of Anglesey 006C,W01000014,971,620,322,298,1,1,200,128,72,144,106,38,6
2021,Isle of Anglesey 008C,W01000015,646,516,348,168,1,1,43,36,7,83,64,19,3
2021,Isle of Anglesey 003A,W01000016,586,241,120,121,1,1,90,49,41,254,227,27,0
2021,Isle of Anglesey 003B,W01000017,727,440,264,176,0,0,163,100,63,123,109,14,1
2021,Isle of Anglesey 001C,W01000018,583,412,290,122,0,0,84,62,22,86,61,25,1
2021,Isle of Anglesey 005C,W01000019,645,535,403,132,1,1,29,9,20,80,57,23,0
2021,Isle of Anglesey 002C,W01000021,1014,763,521,242,2,2,94,83,11,155,131,24,0
2021,Isle of Anglesey 004A,W01000022,678,505,354,151,3,3,68,59,9,102,71,31,0
2021,Isle of Anglesey 007D,W01000023,636,416,231,185,6,6,118,96,22,92,71,21,4
2021,Isle of Anglesey 007E,W01000024,505,248,122,126,1,1,39,9,30,216,109,107,1
2021,Isle of Anglesey 009B,W01000025,922,697,405,292,3,3,99,77,22,123,89,34,0
2021,Isle of Anglesey 005D,W01000026,576,427,316,111,5,5,69,58,11,72,57,15,3
2021,Isle of Anglesey 009C,W01000027,782,538,314,224,5,5,111,93,18,127,100,27,1
2021,Isle of Anglesey 001D,W01000028,811,548,353,195,2,2,158,142,16,100,73,27,3
2021,Isle of Anglesey 003C,W01000029,714,375,200,175,5,5,163,122,41,161,141,20,10
2021,Isle of Anglesey 003D,W01000030,1062,523,285,238,5,5,347,227,120,184,157,27,3
2021,Isle of Anglesey 001E,W01000031,672,503,346,157,1,1,70,51,19,98,69,29,0
2021,Isle of Anglesey 003E,W01000033,722,299,179,120,2,2,357,312,45,56,50,6,8
2021,Isle of Anglesey 004B,W01000034,638,489,271,218,0,0,104,66,38,42,30,12,3
2021,Isle of Anglesey 005E,W01000035,793,570,388,182,5,5,84,76,8,130,100,30,4
2021,Isle of Anglesey 003F,W01000036,516,228,130,98,1,1,171,134,37,115,105,10,1
2021,Isle of Anglesey 003G,W01000037,502,353,206,147,2,2,86,80,6,56,42,14,5
2021,Isle of Anglesey 009D,W01000038,1013,743,488,255,2,2,143,123,20,120,85,35,5
2021,Isle of Anglesey 004D,W01000040,498,407,309,98,3,3,4,4,0,84,61,23,0
2021,Isle of Anglesey 006D,W01000041,634,209,106,103,1,1,367,327,40,52,43,9,5
2021,Isle of Anglesey 008D,W01000042,904,645,405,240,4,4,133,111,22,122,97,25,0
2021,Isle of Anglesey 004F,W01000044,514,471,327,144,2,2,10,8,2,31,21,10,0
2021,Gwynedd 011A,W01000047,565,408,289,119,2,2,66,27,39,87,60,27,2
2021,Gwynedd 003A,W01000050,607,404,252,152,0,0,57,22,35,146,114,32,0
2021,Gwynedd 015A,W01000051,940,505,355,150,2,2,239,81,158,192,146,46,2
2021,Gwynedd 004A,W01000052,467,378,237,141,3,3,42,16,26,44,35,9,0
2021,Gwynedd 004B,W01000053,493,405,233,172,2,2,22,10,12,64,47,17,0
2021,Gwynedd 007A,W01000054,454,355,241,114,2,2,52,21,31,44,32,12,1
2021,Gwynedd 009A,W01000056,811,505,320,185,0,0,156,53,103,150,126,24,0
2021,Gwynedd 016C,W01000057,630,507,396,111,4,4,49,28,21,69,43,26,1
2021,Gwynedd 006A,W01000059,952,469,279,190,4,4,351,138,213,126,108,18,2
2021,Gwynedd 015B,W01000060,600,449,338,111,2,2,56,19,37,93,72,21,0
2021,Gwynedd 011B,W01000061,767,524,406,118,1,1,108,30,78,134,96,38,0
2021,Gwynedd 001A,W01000062,558,95,62,33,0,0,116,19,97,347,330,17,0
2021,Gwynedd 005A,W01000063,804,529,316,213,1,1,168,88,80,98,69,29,8
2021,Gwynedd 002A,W01000064,773,469,234,235,3,3,168,74,94,132,121,11,1
2021,Gwynedd 009B,W01000065,530,332,245,87,1,1,87,38,49,109,93,16,1
2021,Gwynedd 010A,W01000066,499,367,266,101,1,1,57,22,35,73,57,16,1
2021,Gwynedd 016D,W01000067,568,376,265,111,2,2,43,14,29,147,119,28,0
2021,Gwynedd 016E,W01000068,664,393,272,121,2,2,178,69,109,90,74,16,1
2021,Gwynedd 012A,W01000070,538,416,300,116,2,2,44,20,24,76,46,30,0
2021,Gwynedd 003B,W01000071,1000,720,392,328,1,1,116,46,70,158,127,31,5
2021,Gwynedd 002B,W01000072,693,452,269,183,0,0,154,48,106,86,72,14,1
2021,Gwynedd 008A,W01000073,719,583,373,210,1,1,67,32,35,66,42,24,2
2021,Gwynedd 013B,W01000074,893,674,518,156,2,2,88,32,56,129,103,26,0
2021,Gwynedd 002C,W01000075,638,228,126,102,2,2,198,100,98,209,183,26,1
2021,Gwynedd 001B,W01000076,492,224,151,73,3,3,61,20,41,204,187,17,0
2021,Gwynedd 001C,W01000077,543,168,96,72,1,1,162,61,101,211,188,23,1
2021,Gwynedd 011C,W01000078,682,490,339,151,5,5,100,37,63,86,65,21,1
2021,Gwynedd 014C,W01000080,705,438,336,102,3,3,152,27,125,111,77,34,1
2021,Gwynedd 005B,W01000081,880,590,361,229,2,2,152,67,85,134,100,34,2
2021,Gwynedd 015C,W01000082,447,300,219,81,0,0,50,31,19,97,74,23,0
2021,Gwynedd 015D,W01000083,565,441,320,121,4,4,25,9,16,93,56,37,2
2021,Gwynedd 014D,W01000084,497,361,266,95,3,3,44,18,26,89,69,20,0
2021,Gwynedd 017C,W01000085,949,713,598,115,1,1,72,24,48,162,129,33,1
2021,Gwynedd 008B,W01000086,921,666,437,229,3,3,161,63,98,89,70,19,2
2021,Gwynedd 004C,W01000087,758,577,319,258,3,3,104,32,72,72,55,17,2
2021,Gwynedd 007B,W01000088,822,658,388,270,3,3,81,30,51,78,60,18,2
2021,Gwynedd 011D,W01000089,827,613,448,165,4,4,75,29,46,135,96,39,0
2021,Gwynedd 002D,W01000090,526,173,82,91,3,3,307,182,125,40,28,12,3
2021,Gwynedd 001D,W01000091,483,158,86,72,3,3,272,153,119,45,31,14,5
2021,Gwynedd 001E,W01000092,613,175,124,51,7,7,67,14,53,364,343,21,0
2021,Gwynedd 006B,W01000093,1046,764,488,276,2,2,67,33,34,212,176,36,1
2021,Gwynedd 012B,W01000094,526,370,261,109,2,2,59,24,35,95,60,35,0
2021,Gwynedd 012C,W01000095,562,366,256,110,2,2,107,42,65,87,62,25,0
2021,Gwynedd 003C,W01000096,529,321,172,149,0,0,143,63,80,62,47,15,3
2021,Gwynedd 003D,W01000097,537,302,169,133,2,2,101,36,65,132,116,16,0
2021,Gwynedd 006C,W01000098,1032,432,198,234,2,2,512,343,169,78,56,22,8
2021,Gwynedd 005C,W01000099,711,582,337,245,2,2,59,22,37,67,54,13,1
2021,Gwynedd 010B,W01000100,474,335,252,83,0,0,70,11,59,66,53,13,3
2021,Gwynedd 013D,W01000101,621,434,272,162,4,4,102,41,61,79,60,19,2
2021,Gwynedd 002E,W01000102,762,503,263,240,0,0,160,31,129,99,83,16,0
2021,Gwynedd 005D,W01000103,524,378,215,163,0,0,58,33,25,86,75,11,2
2021,Gwynedd 008C,W01000104,803,496,316,180,6,6,172,83,89,127,105,22,2
2021,Gwynedd 010C,W01000105,727,451,295,156,3,3,117,41,76,155,118,37,1
2021,Gwynedd 010D,W01000106,796,608,480,128,0,0,68,14,54,120,74,46,0
2021,Gwynedd 010E,W01000107,563,368,263,105,1,1,129,36,93,64,40,24,1
2021,Gwynedd 012D,W01000108,1028,552,371,181,3,3,214,74,140,258,220,38,1
2021,Gwynedd 012E,W01000109,814,437,276,161,2,2,218,106,112,150,123,27,7
2021,Gwynedd 006D,W01000110,648,468,277,191,4,4,138,50,88,37,27,10,1
2021,Gwynedd 007C,W01000111,744,373,205,168,4,4,178,85,93,184,162,22,5
2021,Gwynedd 008D,W01000112,843,612,372,240,1,1,126,55,71,104,81,23,0
2021,Gwynedd 009C,W01000113,811,607,419,188,4,4,104,41,63,95,74,21,1
2021,Gwynedd 009D,W01000114,641,466,349,117,2,2,105,38,67,67,41,26,1
2021,Gwynedd 003E,W01000115,890,676,403,273,3,3,108,58,50,100,65,35,3
2021,Gwynedd 017D,W01000116,867,652,524,128,4,4,41,13,28,170,140,30,0
2021,Gwynedd 017E,W01000117,693,337,224,113,1,1,188,62,126,166,144,22,1
2021,Gwynedd 007D,W01000118,715,564,347,217,0,0,80,36,44,71,53,18,0
2021,Gwynedd 004D,W01000119,1049,727,417,310,1,1,76,30,46,242,209,33,3
2021,Conwy 015A,W01000121,517,383,241,142,0,0,60,14,46,74,50,24,0
2021,Conwy 014A,W01000122,852,611,408,203,6,6,78,32,46,156,129,27,1
2021,Conwy 013A,W01000123,829,518,312,206,4,4,166,49,117,141,122,19,0
2021,Conwy 012A,W01000124,880,694,484,210,1,1,67,22,45,118,92,26,0
2021,Conwy 013B,W01000125,709,570,353,217,5,5,54,25,29,80,59,21,0
2021,Conwy 009A,W01000126,730,547,298,249,4,4,35,7,28,144,120,24,0
2021,Conwy 009B,W01000127,580,340,201,139,1,1,172,91,81,67,56,11,0
2021,Conwy 009C,W01000128,647,444,245,199,2,2,91,32,59,110,91,19,0
2021,Conwy 012B,W01000129,530,293,175,118,9,9,140,43,97,86,74,12,2
2021,Conwy 012C,W01000130,742,521,374,147,2,2,26,6,20,192,165,27,1
2021,Conwy 012D,W01000131,699,508,290,218,3,3,115,27,88,73,58,15,0
2021,Conwy 001A,W01000132,740,423,273,150,1,1,25,4,21,291,261,30,0
2021,Conwy 002A,W01000133,826,712,553,159,5,5,23,4,19,86,72,14,0
2021,Conwy 015B,W01000134,941,542,343,199,0,0,193,53,140,201,160,41,5
2021,Conwy 006A,W01000135,996,879,681,198,14,14,7,0,7,96,74,22,0
2021,Conwy 006B,W01000136,848,604,391,213,0,0,98,26,72,146,129,17,0
2021,Conwy 015C,W01000137,627,481,327,154,1,1,24,11,13,121,103,18,0
2021,Conwy 008A,W01000138,948,604,346,258,14,14,226,75,151,102,81,21,2
2021,Conwy 007A,W01000139,668,548,297,251,4,4,43,17,26,73,59,14,0
2021,Conwy 010B,W01000140,785,512,274,238,3,3,125,36,89,145,125,20,0
2021,Conwy 010C,W01000141,816,666,527,139,2,2,19,3,16,129,111,18,0
2021,Conwy 010D,W01000142,729,659,474,185,3,3,6,1,5,61,55,6,0
2021,Conwy 007B,W01000143,653,400,233,167,0,0,39,13,26,214,190,24,0
2021,Conwy 007C,W01000144,815,267,156,111,0,0,168,21,147,380,362,18,0
2021,Conwy 008B,W01000145,572,312,170,142,2,2,177,75,102,80,71,9,1
2021,Conwy 001B,W01000146,1010,505,358,147,1,1,34,8,26,470,433,37,0
2021,Conwy 001C,W01000147,770,535,413,122,2,2,34,9,25,199,177,22,0
2021,Conwy 015D,W01000148,450,297,175,122,2,2,64,20,44,87,71,16,0
2021,Conwy 005A,W01000149,692,533,378,155,1,1,12,4,8,146,121,25,0
2021,Conwy 005B,W01000150,636,530,327,203,15,15,6,3,3,85,71,14,0
2021,Conwy 005C,W01000151,617,377,178,199,17,17,127,57,70,96,81,15,0
2021,Conwy 005D,W01000152,606,437,253,184,13,13,27,2,25,129,111,18,0
2021,Conwy 009D,W01000153,745,590,365,225,7,7,60,23,37,86,70,16,2
2021,Conwy 003A,W01000154,601,500,323,177,7,7,9,2,7,85,75,10,0
2021,Conwy 004A,W01000155,649,464,330,134,2,2,7,3,4,176,139,37,0
2021,Conwy 004B,W01000156,833,564,429,135,4,4,61,7,54,204,181,23,0
2021,Conwy 004C,W01000157,692,335,175,160,1,1,216,92,124,134,114,20,6
2021,Conwy 004D,W01000158,777,609,435,174,4,4,72,10,62,91,75,16,1
2021,Conwy 014B,W01000159,577,390,272,118,2,2,49,18,31,136,109,27,0
2021,Conwy 014C,W01000162,755,580,383,197,1,1,71,28,43,102,62,40,1
2021,Conwy 009E,W01000163,526,218,125,93,2,2,244,148,96,61,51,10,1
2021,Conwy 009F,W01000164,541,407,210,197,4,4,37,4,33,93,84,9,0
2021,Conwy 006C,W01000165,857,773,535,238,1,1,3,1,2,80,66,14,0
2021,Conwy 006D,W01000166,1173,821,395,426,18,18,166,50,116,167,147,20,1
2021,Conwy 011C,W01000167,846,539,291,248,3,3,171,81,90,132,120,12,1
2021,Conwy 002B,W01000168,753,465,267,198,5,5,149,45,104,134,119,15,0
2021,Conwy 001D,W01000169,922,392,246,146,4,4,210,67,143,316,298,18,0
2021,Conwy 013C,W01000170,819,642,414,228,3,3,61,29,32,113,97,16,0
2021,Conwy 013D,W01000171,688,418,260,158,2,2,125,19,106,143,125,18,0
2021,Conwy 013E,W01000172,634,380,205,175,4,4,101,41,60,149,130,19,0
2021,Conwy 003B,W01000173,647,486,284,202,1,1,8,2,6,152,130,22,0
2021,Conwy 003C,W01000174,732,613,393,220,7,7,10,4,6,101,81,20,1
2021,Conwy 003D,W01000175,763,695,541,154,0,0,4,2,2,64,55,9,0
2021,Conwy 011D,W01000176,712,404,213,191,2,2,89,39,50,215,194,21,2
2021,Conwy 011E,W01000177,617,513,262,251,5,5,44,9,35,55,42,13,0
2021,Conwy 010E,W01000178,888,408,223,185,11,11,294,102,192,173,159,14,2
2021,Conwy 010F,W01000179,922,753,493,260,5,5,31,6,25,133,114,19,0
2021,Conwy 008C,W01000180,560,504,297,207,2,2,4,1,3,50,39,11,0
2021,Conwy 008D,W01000181,608,482,236,246,4,4,4,2,2,118,94,24,0
2021,Conwy 007D,W01000182,1000,415,289,126,1,1,118,17,101,465,432,33,1
2021,Conwy 008E,W01000183,662,449,271,178,0,0,53,5,48,160,141,19,0
2021,Conwy 005E,W01000184,1060,758,502,256,11,11,82,28,54,209,176,33,0
2021,Conwy 015E,W01000185,547,423,287,136,1,1,51,12,39,72,54,18,0
2021,Conwy 001E,W01000186,786,311,215,96,1,1,345,87,258,124,107,17,5
2021,Conwy 002C,W01000187,656,174,101,73,4,4,431,170,261,42,33,9,5
2021,Conwy 002D,W01000188,751,596,393,203,7,7,79,23,56,69,55,14,0
2021,Conwy 015F,W01000189,638,445,296,149,2,2,86,10,76,105,76,29,0
2021,Conwy 014D,W01000190,605,411,284,127,1,1,60,24,36,133,103,30,0
2021,Denbighshire 009A,W01000191,870,595,323,272,1,1,93,78,15,180,148,32,1
2021,Denbighshire 016A,W01000192,447,313,206,107,4,4,55,50,5,73,55,18,2
2021,Denbighshire 015A,W01000193,564,309,186,123,2,2,129,92,37,124,107,17,0
2021,Denbighshire 011A,W01000194,913,527,291,236,9,9,87,19,68,289,265,24,1
2021,Denbighshire 012A,W01000195,656,555,361,194,0,0,29,5,24,72,55,17,0
2021,Denbighshire 012B,W01000196,557,433,206,227,1,1,24,3,21,99,83,16,0
2021,Denbighshire 012C,W01000197,729,517,296,221,5,5,107,57,50,100,78,22,0
2021,Denbighshire 011B,W01000198,618,174,97,77,6,6,398,286,112,32,31,1,8
2021,Denbighshire 011C,W01000199,717,441,260,181,5,5,154,98,56,112,94,18,5
2021,Denbighshire 008A,W01000200,535,450,259,191,0,0,9,7,2,76,56,20,0
2021,Denbighshire 008B,W01000201,725,424,205,219,7,7,138,92,46,151,127,24,5
2021,Denbighshire 015B,W01000202,667,552,343,209,4,4,41,36,5,70,49,21,0
2021,Denbighshire 013A,W01000203,1055,870,554,316,4,4,72,45,27,108,79,29,1
2021,Denbighshire 013B,W01000204,667,491,333,158,1,1,77,39,38,98,84,14,0
2021,Denbighshire 016B,W01000205,537,381,253,128,1,1,71,55,16,83,53,30,1
2021,Denbighshire 013C,W01000206,891,651,393,258,1,1,95,70,25,144,119,25,0
2021,Denbighshire 015C,W01000207,977,726,443,283,4,4,81,64,17,166,127,39,0
2021,Denbighshire 016C,W01000208,627,341,238,103,5,5,67,13,54,214,188,26,0
2021,Denbighshire 016D,W01000209,663,410,258,152,0,0,183,102,81,68,55,13,2
2021,Denbighshire 016E,W01000210,618,471,313,158,7,7,46,24,22,91,72,19,3
2021,Denbighshire 012D,W01000211,765,587,377,210,1,1,56,38,18,121,88,33,0
2021,Denbighshire 003A,W01000212,944,819,513,306,3,3,14,10,4,108,91,17,0
2021,Denbighshire 002A,W01000213,600,268,160,108,1,1,193,144,49,131,109,22,7
2021,Denbighshire 002B,W01000214,523,329,189,140,0,0,65,18,47,129,119,10,0
2021,Denbighshire 002C,W01000215,581,524,329,195,0,0,3,1,2,54,49,5,0
2021,Denbighshire 002D,W01000216,581,318,170,148,28,28,128,53,75,105,92,13,2
2021,Denbighshire 008C,W01000217,882,623,358,265,3,3,118,105,13,137,107,30,1
2021,Denbighshire 001A,W01000218,739,481,297,184,14,14,76,43,33,166,143,23,2
2021,Denbighshire 001B,W01000219,1091,747,437,310,10,10,38,9,29,296,269,27,0
2021,Denbighshire 001C,W01000220,885,710,516,194,4,4,15,6,9,156,131,25,0
2021,Denbighshire 003B,W01000221,684,454,324,130,5,5,19,4,15,204,175,29,2
2021,Denbighshire 003C,W01000222,864,671,449,222,3,3,21,5,16,169,148,21,0
2021,Denbighshire 009B,W01000223,593,465,291,174,3,3,5,3,2,120,104,16,0
2021,Denbighshire 009C,W01000224,694,482,278,204,6,6,96,69,27,109,88,21,1
2021,Denbighshire 009D,W01000225,712,469,291,178,6,6,78,42,36,155,137,18,4
2021,Denbighshire 004A,W01000226,741,522,348,174,1,1,89,65,24,127,100,27,2
2021,Denbighshire 004B,W01000227,724,502,325,177,3,3,66,47,19,152,137,15,1
2021,Denbighshire 004C,W01000228,616,284,191,93,11,11,61,16,45,260,232,28,0
2021,Denbighshire 017E,W01000229,770,552,385,167,1,1,112,99,13,104,87,17,1
2021,Denbighshire 017F,W01000230,914,732,458,274,6,6,24,16,8,150,129,21,2
2021,Denbighshire 017A,W01000231,617,414,215,199,3,3,53,39,14,147,122,25,0
2021,Denbighshire 017B,W01000232,704,571,318,253,10,10,6,3,3,117,99,18,0
2021,Denbighshire 017C,W01000233,585,428,252,176,3,3,36,27,9,116,100,16,2
2021,Denbighshire 017G,W01000234,877,459,156,303,6,6,273,132,141,137,125,12,2
2021,Denbighshire 017D,W01000235,580,450,238,212,14,14,15,8,7,101,86,15,0
2021,Denbighshire 006A,W01000236,816,294,129,165,1,1,330,232,98,182,158,24,9
2021,Denbighshire 006B,W01000237,654,210,107,103,2,2,354,251,103,86,76,10,2
2021,Denbighshire 006C,W01000238,698,459,218,241,4,4,50,28,22,184,163,21,1
2021,Denbighshire 004D,W01000239,844,212,106,106,3,3,219,36,183,410,393,17,0
2021,Denbighshire 004E,W01000240,830,153,93,60,3,3,204,47,157,469,443,26,1
2021,Denbighshire 004F,W01000241,568,218,92,126,3,3,95,16,79,252,241,11,0
2021,Denbighshire 014A,W01000242,955,543,301,242,1,1,230,143,87,180,152,28,1
2021,Denbighshire 014B,W01000243,936,534,326,208,3,3,162,73,89,237,215,22,0
2021,Denbighshire 014C,W01000244,736,649,446,203,1,1,15,4,11,71,49,22,0
2021,Denbighshire 010A,W01000245,840,604,350,254,1,1,103,53,50,131,119,12,1
2021,Denbighshire 010B,W01000246,730,450,259,191,1,1,152,105,47,125,95,30,2
2021,Denbighshire 010C,W01000247,788,591,385,206,0,0,72,43,29,125,104,21,0
2021,Denbighshire 008D,W01000248,698,535,335,200,2,2,43,34,9,118,94,24,0
2021,Flintshire 014A,W01000249,512,470,264,206,1,1,5,3,2,36,31,5,0
2021,Flintshire 014B,W01000250,629,556,353,203,0,0,12,9,3,61,52,9,0
2021,Flintshire 013A,W01000251,631,421,213,208,2,2,159,147,12,46,38,8,3
2021,Flintshire 010A,W01000252,731,642,430,212,2,2,32,11,21,55,49,6,0
2021,Flintshire 003A,W01000253,782,587,349,238,3,3,89,78,11,103,87,16,0
2021,Flintshire 003B,W01000254,931,552,311,241,0,0,206,139,67,172,159,13,1
2021,Flintshire 015A,W01000255,958,696,348,348,1,1,121,119,2,140,121,19,0
2021,Flintshire 015B,W01000256,658,422,170,252,9,9,122,106,16,105,92,13,0
2021,Flintshire 015C,W01000257,1173,1044,475,569,7,7,22,17,5,100,86,14,0
2021,Flintshire 006A,W01000258,916,744,449,295,2,2,84,78,6,86,65,21,0
2021,Flintshire 017A,W01000259,782,440,249,191,4,4,185,155,30,151,128,23,2
2021,Flintshire 017B,W01000260,765,668,381,287,3,3,12,10,2,82,73,9,0
2021,Flintshire 014C,W01000261,634,511,279,232,0,0,19,17,2,104,84,20,0
2021,Flintshire 017C,W01000262,629,356,160,196,1,1,136,121,15,136,121,15,0
2021,Flintshire 017D,W01000263,605,254,123,131,2,2,282,165,117,67,54,13,0
2021,Flintshire 012A,W01000264,711,522,230,292,7,7,78,33,45,104,93,11,0
2021,Flintshire 012B,W01000265,678,562,331,231,3,3,25,15,10,88,76,12,0
2021,Flintshire 017E,W01000266,771,577,277,300,2,2,43,28,15,149,133,16,0
2021,Flintshire 017F,W01000267,871,728,317,411,3,3,50,46,4,90,69,21,0
2021,Flintshire 013B,W01000268,688,612,345,267,0,0,24,24,0,52,37,15,0
2021,Flintshire 020A,W01000269,729,457,258,199,1,1,134,126,8,137,119,18,0
2021,Flintshire 006B,W01000270,517,445,261,184,9,9,16,16,0,47,36,11,0
2021,Flintshire 006C,W01000271,589,433,277,156,3,3,49,45,4,104,81,23,0
2021,Flintshire 006D,W01000272,769,645,428,217,1,1,66,62,4,57,47,10,0
2021,Flintshire 007A,W01000273,657,436,247,189,2,2,148,98,50,71,61,10,0
2021,Flintshire 007B,W01000274,896,354,142,212,5,5,320,259,61,217,203,14,0
2021,Flintshire 007C,W01000275,491,391,206,185,0,0,17,10,7,83,71,12,0
2021,Flintshire 008A,W01000276,493,353,131,222,11,11,36,5,31,93,83,10,0
2021,Flintshire 008B,W01000277,552,425,179,246,1,1,11,5,6,115,97,18,0
2021,Flintshire 007D,W01000278,604,246,110,136,10,10,279,214,65,69,64,5,0
2021,Flintshire 008C,W01000279,510,463,296,167,3,3,16,5,11,27,21,6,1
2021,Flintshire 010B,W01000280,689,565,267,298,5,5,75,34,41,44,36,8,0
2021,Flintshire 008D,W01000281,513,420,242,178,1,1,27,21,6,65,49,16,0
2021,Flintshire 010C,W01000282,570,531,178,353,2,2,5,3,2,32,31,1,0
2021,Flintshire 008E,W01000283,951,717,359,358,1,1,63,48,15,170,137,33,0
2021,Flintshire 013C,W01000284,720,626,339,287,5,5,4,0,4,85,73,12,0
2021,Flintshire 013D,W01000285,674,610,388,222,2,2,3,2,1,59,49,10,0
2021,Flintshire 013E,W01000286,890,738,308,430,8,8,10,8,2,134,113,21,0
2021,Flintshire 001A,W01000287,876,613,418,195,5,5,134,91,43,123,101,22,1
2021,Flintshire 004A,W01000288,997,378,195,183,2,2,451,357,94,165,144,21,1
2021,Flintshire 005A,W01000289,520,463,232,231,0,0,13,2,11,44,33,11,0
2021,Flintshire 004B,W01000290,708,222,115,107,1,1,365,234,131,119,105,14,1
2021,Flintshire 005B,W01000291,584,406,201,205,3,3,92,10,82,83,75,8,0
2021,Flintshire 004C,W01000292,537,312,152,160,0,0,143,121,22,82,75,7,0
2021,Flintshire 004D,W01000293,1120,791,240,551,10,10,176,69,107,143,124,19,0
2021,Flintshire 005C,W01000294,748,664,378,286,0,0,25,7,18,59,47,12,0
2021,Flintshire 005D,W01000295,624,507,271,236,3,3,41,13,28,73,48,25,0
2021,Flintshire 003C,W01000296,644,334,161,173,1,1,231,184,47,77,68,9,1
2021,Flintshire 003D,W01000297,514,347,174,173,0,0,81,9,72,86,79,7,0
2021,Flintshire 001B,W01000298,679,479,293,186,0,0,99,83,16,101,82,19,0
2021,Flintshire 019A,W01000299,832,715,463,252,6,6,52,42,10,59,46,13,0
2021,Flintshire 019B,W01000300,740,597,371,226,1,1,51,48,3,91,65,26,0
2021,Flintshire 006E,W01000301,739,599,353,246,2,2,65,43,22,73,58,15,0
2021,Flintshire 013F,W01000302,876,701,446,255,14,14,16,12,4,145,132,13,0
2021,Flintshire 018A,W01000303,736,641,376,265,2,2,29,23,6,64,55,9,0
2021,Flintshire 003E,W01000304,958,370,218,152,9,9,360,264,96,218,193,25,1
2021,Flintshire 003F,W01000305,806,535,306,229,0,0,177,123,54,94,84,10,0
2021,Flintshire 002A,W01000306,995,722,417,305,14,14,139,109,30,119,99,20,1
2021,Flintshire 020B,W01000307,567,514,283,231,5,5,8,5,3,40,34,6,0
2021,Flintshire 020C,W01000308,502,375,196,179,0,0,78,46,32,49,39,10,0
2021,Flintshire 019C,W01000309,930,621,327,294,3,3,139,105,34,163,141,22,4
2021,Flintshire 020D,W01000310,794,658,383,275,5,5,62,44,18,69,52,17,0
2021,Flintshire 011A,W01000311,754,458,250,208,4,4,184,147,37,108,93,15,0
2021,Flintshire 011B,W01000312,768,551,324,227,10,10,119,35,84,88,69,19,0
2021,Flintshire 016A,W01000313,687,444,229,215,9,9,129,94,35,105,87,18,0
2021,Flintshire 016B,W01000314,605,372,228,144,3,3,104,47,57,126,113,13,0
2021,Flintshire 016C,W01000315,900,613,377,236,10,10,139,72,67,138,114,24,0
2021,Flintshire 016D,W01000316,505,453,285,168,0,0,7,6,1,45,34,11,0
2021,Flintshire 016E,W01000317,651,604,332,272,4,4,19,9,10,24,21,3,0
2021,Flintshire 016F,W01000318,502,164,70,94,1,1,301,212,89,36,26,10,0
2021,Flintshire 016G,W01000319,712,435,255,180,1,1,150,87,63,125,112,13,1
2021,Flintshire 002B,W01000320,792,458,262,196,3,3,209,195,14,120,95,25,2
2021,Flintshire 014D,W01000321,714,637,370,267,0,0,16,10,6,61,49,12,0
2021,Flintshire 014E,W01000322,603,493,297,196,5,5,59,32,27,46,36,10,0
2021,Flintshire 012C,W01000323,690,549,335,214,2,2,48,45,3,90,69,21,1
2021,Flintshire 012D,W01000324,644,574,336,238,0,0,23,23,0,47,37,10,0
2021,Flintshire 010D,W01000325,736,618,334,284,4,4,54,48,6,60,50,10,0
2021,Flintshire 018B,W01000326,902,775,337,438,1,1,73,55,18,53,42,11,0
2021,Flintshire 018C,W01000327,1033,878,449,429,3,3,58,42,16,94,79,15,0
2021,Flintshire 011C,W01000328,875,524,284,240,5,5,118,83,35,226,211,15,2
2021,Flintshire 015D,W01000329,722,408,162,246,3,3,160,143,17,151,134,17,0
2021,Flintshire 015E,W01000330,907,420,178,242,7,7,294,229,65,184,172,12,2
2021,Flintshire 015F,W01000331,619,509,273,236,1,1,53,40,13,56,45,11,0
2021,Flintshire 009A,W01000332,756,524,242,282,0,0,113,97,16,119,109,10,0
2021,Flintshire 009B,W01000333,649,215,92,123,1,1,353,191,162,79,71,8,1
2021,Flintshire 009C,W01000334,814,511,282,229,1,1,90,44,46,211,194,17,1
2021,Flintshire 009D,W01000335,495,225,101,124,9,9,214,196,18,46,37,9,1
2021,Flintshire 009E,W01000336,550,204,92,112,1,1,299,226,73,46,34,12,0
2021,Flintshire 009F,W01000337,970,639,372,267,4,4,84,64,20,243,226,17,0
2021,Flintshire 001C,W01000338,783,590,331,259,3,3,85,81,4,102,80,22,3
2021,Flintshire 019D,W01000339,704,533,317,216,1,1,122,86,36,47,34,13,1
2021,Flintshire 002C,W01000340,969,847,502,345,4,4,18,16,2,100,81,19,0
2021,Wrexham 023C,W01000341,674,439,219,220,1,1,135,126,9,91,84,7,8
2021,Wrexham 023E,W01000342,693,308,153,155,2,2,264,250,14,115,102,13,4
2021,Wrexham 023B,W01000343,467,423,291,132,0,0,9,9,0,35,25,10,0
2021,Wrexham 023A,W01000344,581,537,361,176,2,2,7,7,0,35,24,11,0
2021,Wrexham 018A,W01000345,697,563,382,181,3,3,33,29,4,96,75,21,2
2021,Wrexham 018B,W01000346,625,503,327,176,1,1,32,32,0,89,77,12,0
2021,Wrexham 006A,W01000347,1172,827,270,557,4,4,63,43,20,275,253,22,3
2021,Wrexham 006B,W01000348,611,290,130,160,0,0,262,254,8,56,42,14,3
2021,Wrexham 011A,W01000349,1046,598,231,367,34,34,229,127,102,183,165,18,2
2021,Wrexham 011B,W01000350,860,236,117,119,2,2,158,77,81,459,378,81,5
2021,Wrexham 005A,W01000351,885,597,315,282,4,4,150,85,65,134,109,25,0
2021,Wrexham 017A,W01000354,729,573,330,243,3,3,63,58,5,89,65,24,1
2021,Wrexham 017B,W01000355,826,363,186,177,0,0,323,267,56,131,112,19,9
2021,Wrexham 017C,W01000356,624,349,175,174,1,1,230,223,7,38,27,11,6
2021,Wrexham 019C,W01000359,526,403,207,196,1,1,55,35,20,66,56,10,1
2021,Wrexham 019D,W01000360,515,311,171,140,2,2,158,154,4,44,34,10,0
2021,Wrexham 019E,W01000361,881,540,323,217,0,0,236,141,95,103,76,27,2
2021,Wrexham 006C,W01000362,599,281,143,138,4,4,263,250,13,50,39,11,1
2021,Wrexham 006D,W01000363,678,483,281,202,1,1,110,102,8,84,74,10,0
2021,Wrexham 006E,W01000364,650,514,295,219,2,2,32,16,16,102,89,13,0
2021,Wrexham 011C,W01000365,814,572,373,199,3,3,93,70,23,145,126,19,1
2021,Wrexham 014A,W01000366,633,343,163,180,8,8,190,172,18,84,74,10,8
2021,Wrexham 014B,W01000367,538,438,244,194,0,0,27,24,3,72,56,16,1
2021,Wrexham 008A,W01000368,916,784,544,240,3,3,20,17,3,108,83,25,1
2021,Wrexham 021B,W01000369,602,474,348,126,0,0,75,68,7,52,39,13,1
2021,Wrexham 021D,W01000370,683,545,319,226,3,3,27,21,6,108,95,13,0
2021,Wrexham 008B,W01000371,498,285,144,141,0,0,31,23,8,181,168,13,1
2021,Wrexham 008C,W01000372,708,222,132,90,1,1,199,110,89,286,269,17,0
2021,Wrexham 005B,W01000373,729,360,166,194,3,3,266,255,11,94,81,13,6
2021,Wrexham 003A,W01000374,594,343,191,152,1,1,191,169,22,58,48,10,1
2021,Wrexham 003B,W01000375,888,603,212,391,0,0,125,80,45,160,144,16,0
2021,Wrexham 003C,W01000376,561,470,267,203,3,3,41,37,4,47,34,13,0
2021,Wrexham 004A,W01000377,626,494,232,262,2,2,61,54,7,68,58,10,1
2021,Wrexham 004B,W01000378,520,242,105,137,4,4,186,154,32,83,75,8,5
2021,Wrexham 004C,W01000379,720,331,176,155,2,2,316,303,13,62,52,10,9
2021,Wrexham 004D,W01000380,537,466,205,261,0,0,11,10,1,60,50,10,0
2021,Wrexham 012A,W01000381,498,245,157,88,4,4,114,108,6,129,121,8,6
2021,Wrexham 012B,W01000382,676,163,88,75,0,0,382,91,291,131,122,9,0
2021,Wrexham 022C,W01000384,487,380,238,142,2,2,41,39,2,61,53,8,3
2021,Wrexham 014C,W01000385,762,649,408,241,1,1,25,21,4,87,64,23,0
2021,Wrexham 015A,W01000386,662,332,161,171,3,3,186,180,6,135,121,14,6
2021,Wrexham 008D,W01000387,493,442,284,158,1,1,13,12,1,37,33,4,0
2021,Wrexham 008E,W01000388,473,357,194,163,4,4,72,67,5,36,30,6,4
2021,Wrexham 017D,W01000389,862,651,362,289,0,0,131,122,9,80,58,22,0
2021,Wrexham 021A,W01000390,756,637,376,261,0,0,44,39,5,74,59,15,1
2021,Wrexham 003D,W01000391,622,502,290,212,0,0,78,74,4,40,33,7,2
2021,Wrexham 003E,W01000392,645,272,112,160,3,3,303,280,23,63,52,11,4
2021,Wrexham 023G,W01000393,809,551,328,223,0,0,173,154,19,79,60,19,6
2021,Wrexham 016A,W01000394,500,383,243,140,0,0,17,9,8,100,87,13,0
2021,Wrexham 016B,W01000395,446,327,191,136,0,0,60,36,24,58,47,11,1
2021,Wrexham 013A,W01000398,545,414,266,148,1,1,69,65,4,60,50,10,1
2021,Wrexham 013B,W01000399,472,413,232,181,3,3,20,16,4,36,27,9,0
2021,Wrexham 005C,W01000400,811,565,244,321,1,1,141,134,7,104,90,14,0
2021,Wrexham 005D,W01000401,863,527,212,315,0,0,194,137,57,142,125,17,0
2021,Wrexham 011D,W01000402,1148,455,262,193,6,6,103,39,64,581,544,37,3
2021,Wrexham 018C,W01000403,564,420,271,149,3,3,42,41,1,98,86,12,1
2021,Wrexham 018D,W01000404,873,622,366,256,3,3,96,73,23,149,131,18,3
2021,Wrexham 015B,W01000405,920,503,262,241,6,6,298,225,73,111,91,20,2
2021,Wrexham 013C,W01000406,864,478,244,234,3,3,300,266,34,78,64,14,5
2021,Wrexham 016C,W01000407,624,481,266,215,2,2,8,4,4,133,109,24,0
2021,Wrexham 013D,W01000408,502,311,173,138,0,0,125,73,52,65,49,16,1
2021,Wrexham 017E,W01000409,784,130,69,61,1,1,610,548,62,39,31,8,4
2021,Wrexham 014D,W01000410,747,527,289,238,1,1,85,41,44,134,108,26,0
2021,Wrexham 015C,W01000411,759,315,175,140,1,1,276,220,56,162,149,13,5
2021,Wrexham 015D,W01000412,656,455,239,216,4,4,57,48,9,140,123,17,0
2021,Wrexham 010C,W01000413,513,61,31,30,0,0,423,411,12,27,20,7,2
2021,Wrexham 010D,W01000414,522,152,79,73,1,1,306,276,30,57,48,9,6
2021,Wrexham 023F,W01000415,668,500,303,197,1,1,72,55,17,93,78,15,2
2021,Wrexham 023D,W01000416,502,449,257,192,0,0,3,2,1,50,44,6,0
2021,Wrexham 022B,W01000417,675,576,349,227,1,1,13,11,2,85,76,9,0
2021,Wrexham 022A,W01000418,740,513,289,224,3,3,121,103,18,103,80,23,0
2021,Wrexham 016D,W01000419,615,292,115,177,5,5,239,224,15,73,55,18,6
2021,Wrexham 016E,W01000420,678,392,205,187,0,0,138,70,68,146,132,14,2
2021,Wrexham 008F,W01000422,970,669,419,250,1,1,139,102,37,158,136,22,3
2021,Wrexham 012D,W01000423,886,412,146,266,6,6,267,245,22,196,178,18,5
2021,Wrexham 012E,W01000424,598,359,201,158,1,1,128,63,65,110,92,18,0
2021,Wrexham 010E,W01000425,808,196,88,108,3,3,552,533,19,49,43,6,8
2021,Powys 021A,W01000426,640,487,327,160,3,3,85,73,12,63,46,17,2
2021,Powys 011A,W01000427,594,455,355,100,2,2,59,50,9,78,47,31,0
2021,Powys 005A,W01000428,607,410,286,124,2,2,26,25,1,167,137,30,2
2021,Powys 010A,W01000429,999,843,589,254,3,3,18,13,5,135,92,43,0
2021,Powys 015A,W01000430,631,428,312,116,4,4,41,27,14,156,131,25,2
2021,Powys 014A,W01000431,608,333,187,146,0,0,106,50,56,169,149,20,0
2021,Powys 014B,W01000432,555,402,275,127,0,0,48,29,19,105,93,12,0
2021,Powys 006A,W01000433,1037,763,501,262,3,3,123,97,26,142,104,38,6
2021,Powys 007A,W01000434,734,540,408,132,3,3,99,51,48,91,65,26,1
2021,Powys 012A,W01000438,624,475,393,82,4,4,81,43,38,64,41,23,0
2021,Powys 007B,W01000439,858,642,413,229,4,4,49,31,18,163,121,42,0
2021,Powys 020A,W01000440,566,454,330,124,1,1,14,12,2,97,78,19,0
2021,Powys 005B,W01000441,660,484,318,166,5,5,32,28,4,138,107,31,1
2021,Powys 004A,W01000442,903,709,497,212,1,1,51,38,13,139,95,44,3
2021,Powys 015B,W01000443,1030,795,596,199,2,2,50,45,5,182,127,55,1
2021,Powys 002A,W01000444,1019,781,552,229,3,3,55,31,24,180,125,55,0
2021,Powys 015C,W01000445,645,491,367,124,3,3,64,60,4,84,56,28,3
2021,Powys 015D,W01000446,898,505,356,149,4,4,165,104,61,222,183,39,2
2021,Powys 007C,W01000447,879,668,453,215,2,2,64,53,11,144,111,33,1
2021,Powys 011B,W01000448,625,437,314,123,0,0,112,69,43,76,55,21,0
2021,Powys 011C,W01000449,759,480,340,140,1,1,90,65,25,185,163,22,3
2021,Powys 014C,W01000450,606,488,373,115,6,6,9,9,0,103,84,19,0
2021,Powys 012B,W01000451,498,383,269,114,0,0,48,29,19,67,55,12,0
2021,Powys 004B,W01000452,874,688,507,181,1,1,75,58,17,109,76,33,1
2021,Powys 010B,W01000453,585,460,332,128,1,1,22,16,6,101,79,22,1
2021,Powys 013A,W01000454,721,263,167,96,1,1,159,99,60,295,276,19,3
2021,Powys 013B,W01000455,970,596,382,214,2,2,208,99,109,163,142,21,1
2021,Powys 013C,W01000456,1110,713,528,185,2,2,101,32,69,293,263,30,1
2021,Powys 002B,W01000457,894,727,443,284,0,0,58,56,2,109,80,29,0
2021,Powys 002C,W01000458,821,631,374,257,0,0,50,27,23,140,117,23,0
2021,Powys 014D,W01000459,534,409,305,104,0,0,28,25,3,96,66,30,1
2021,Powys 006B,W01000460,721,526,359,167,8,8,77,61,16,110,85,25,0
2021,Powys 001A,W01000461,695,460,304,156,2,2,113,55,58,118,91,27,2
2021,Powys 011D,W01000464,534,432,336,96,0,0,16,15,1,86,64,22,0
2021,Powys 018E,W01000465,450,356,232,124,1,1,40,22,18,52,40,12,1
2021,Powys 010C,W01000466,612,366,243,123,0,0,144,88,56,100,81,19,2
2021,Powys 010D,W01000467,812,434,313,121,0,0,137,90,47,238,212,26,3
2021,Powys 001D,W01000470,873,612,422,190,2,2,79,56,23,179,152,27,1
2021,Powys 014E,W01000471,844,624,461,163,2,2,87,52,35,131,106,25,0
2021,Powys 012C,W01000472,543,393,297,96,0,0,38,31,7,106,85,21,6
2021,Powys 004C,W01000473,1032,555,367,188,2,2,284,188,96,187,151,36,4
2021,Powys 020B,W01000474,771,563,411,152,3,3,65,37,28,140,101,39,0
2021,Powys 001E,W01000475,1027,811,605,206,3,3,38,19,19,174,122,52,1
2021,Powys 005C,W01000476,618,400,259,141,3,3,77,63,14,138,116,22,0
2021,Powys 012D,W01000477,659,557,421,136,4,4,17,14,3,81,60,21,0
2021,Powys 009A,W01000478,772,284,143,141,2,2,365,88,277,117,99,18,4
2021,Powys 009B,W01000479,600,269,167,102,2,2,232,209,23,95,82,13,2
2021,Powys 008A,W01000480,1009,390,241,149,1,1,359,212,147,257,227,30,2
2021,Powys 008B,W01000481,1102,711,481,230,1,1,163,84,79,224,197,27,3
2021,Powys 008C,W01000482,894,612,406,206,4,4,120,46,74,158,132,26,0
2021,Powys 009C,W01000483,776,309,158,151,2,2,369,300,69,93,80,13,3
2021,Powys 011E,W01000484,726,552,413,139,2,2,22,19,3,150,115,35,0
2021,Powys 011F,W01000485,762,603,478,125,1,1,42,26,16,116,92,24,0
2021,Powys 011G,W01000486,511,288,207,81,1,1,131,77,54,86,69,17,5
2021,Powys 012E,W01000487,989,568,406,162,1,1,157,104,53,261,222,39,2
2021,Powys 006C,W01000488,925,736,494,242,2,2,37,29,8,150,125,25,0
2021,Powys 017A,W01000489,804,415,241,174,1,1,192,137,55,194,168,26,2
2021,Powys 017D,W01000492,843,442,296,146,2,2,125,54,71,273,249,24,1
2021,Powys 017E,W01000493,618,421,287,134,0,0,75,17,58,121,52,69,1
2021,Powys 015E,W01000494,755,494,341,153,6,6,143,93,50,112,80,32,0
2021,Powys 021B,W01000496,902,700,445,255,2,2,112,105,7,83,55,28,5
2021,Powys 005D,W01000497,580,460,281,179,2,2,29,27,2,89,75,14,0
2021,Powys 003A,W01000498,701,193,127,66,0,0,324,117,207,179,160,19,5
2021,Powys 003B,W01000499,553,260,149,111,1,1,147,59,88,140,124,16,5
2021,Powys 003C,W01000500,726,456,267,189,1,1,134,29,105,135,115,20,0
2021,Powys 003D,W01000501,1065,599,415,184,6,6,223,129,94,234,206,28,3
2021,Powys 021C,W01000502,960,721,487,234,0,0,136,72,64,101,68,33,2
2021,Powys 020C,W01000503,449,340,260,80,2,2,2,1,1,105,79,26,0
2021,Powys 021D,W01000504,537,240,144,96,0,0,234,219,15,58,47,11,5
2021,Powys 021E,W01000505,658,461,310,151,1,1,104,81,23,91,76,15,1
2021,Ceredigion 005A,W01000506,664,428,337,91,3,3,89,16,73,144,109,35,0
2021,Ceredigion 009A,W01000507,525,444,330,114,0,0,14,3,11,67,47,20,0
2021,Ceredigion 009B,W01000508,506,300,195,105,2,2,104,35,69,100,81,19,0
2021,Ceredigion 009C,W01000509,889,617,465,152,1,1,162,43,119,109,90,19,0
2021,Ceredigion 009D,W01000510,627,251,158,93,3,3,224,47,177,148,132,16,1
2021,Ceredigion 009E,W01000511,558,218,141,77,3,3,141,54,87,195,176,19,1
2021,Ceredigion 002A,W01000512,560,280,194,86,4,4,65,14,51,211,184,27,0
2021,Ceredigion 002B,W01000513,908,155,105,50,4,4,113,13,100,636,599,37,0
2021,Ceredigion 003A,W01000515,590,289,157,132,1,1,222,44,178,78,70,8,0
2021,Ceredigion 003B,W01000516,690,351,195,156,0,0,200,50,150,139,119,20,0
2021,Ceredigion 002D,W01000517,531,137,93,44,1,1,73,11,62,320,310,10,0
2021,Ceredigion 003C,W01000518,527,294,218,76,5,5,76,13,63,151,141,10,1
2021,Ceredigion 010A,W01000519,767,618,452,166,1,1,50,11,39,98,77,21,0
2021,Ceredigion 010B,W01000522,555,462,343,119,2,2,31,5,26,60,40,20,0
2021,Ceredigion 001C,W01000523,798,637,423,214,0,0,46,11,35,115,86,29,0
2021,Ceredigion 005B,W01000524,840,657,456,201,7,7,39,6,33,136,99,37,1
2021,Ceredigion 011A,W01000525,508,406,307,99,2,2,8,1,7,92,71,21,0
2021,Ceredigion 008A,W01000527,430,206,157,49,0,0,43,8,35,181,153,28,0
2021,Ceredigion 008B,W01000528,621,354,262,92,1,1,158,40,118,108,91,17,0
2021,Ceredigion 010C,W01000531,818,612,447,165,2,2,72,17,55,131,101,30,1
2021,Ceredigion 010D,W01000533,655,397,259,138,4,4,133,31,102,121,96,25,0
2021,Ceredigion 011B,W01000534,652,517,355,162,0,0,21,3,18,114,86,28,0
2021,Ceredigion 008C,W01000535,893,668,485,183,2,2,90,27,63,131,93,38,2
2021,Ceredigion 011E,W01000536,618,489,377,112,6,6,26,2,24,97,67,30,0
2021,Ceredigion 008D,W01000537,638,519,378,141,5,5,14,3,11,100,74,26,0
2021,Ceredigion 005C,W01000538,663,521,364,157,0,0,22,5,17,120,93,27,0
2021,Ceredigion 005D,W01000539,512,438,302,136,0,0,5,1,4,69,43,26,0
2021,Ceredigion 005E,W01000540,552,399,269,130,0,0,47,6,41,106,83,23,0
2021,Ceredigion 008E,W01000541,756,608,430,178,0,0,36,11,25,112,90,22,0
2021,Ceredigion 011F,W01000542,956,766,533,233,4,4,45,13,32,141,120,21,0
2021,Ceredigion 011C,W01000543,872,666,454,212,1,1,57,9,48,148,107,41,0
2021,Ceredigion 007D,W01000545,875,722,540,182,3,3,41,6,35,109,78,31,0
2021,Ceredigion 009F,W01000546,543,398,299,99,1,1,72,22,50,72,54,18,0
2021,Ceredigion 009G,W01000547,530,436,310,126,0,0,36,13,23,58,45,13,0
2021,Ceredigion 001D,W01000548,758,534,349,185,0,0,108,19,89,116,94,22,0
2021,Ceredigion 001E,W01000549,770,635,383,252,6,6,21,6,15,108,90,18,0
2021,Ceredigion 011G,W01000550,532,380,264,116,0,0,51,14,37,101,78,23,0
2021,Ceredigion 010E,W01000551,590,484,352,132,0,0,49,15,34,57,36,21,0
2021,Ceredigion 011D,W01000552,849,659,408,251,2,2,39,8,31,149,120,29,0
2021,Pembrokeshire 011A,W01000553,552,445,309,136,0,0,29,16,13,78,58,20,0
2021,Pembrokeshire 009A,W01000554,764,648,427,221,2,2,42,33,9,72,51,21,0
2021,Pembrokeshire 008A,W01000555,647,536,368,168,0,0,27,18,9,84,64,20,0
2021,Pembrokeshire 008B,W01000556,524,420,301,119,3,3,40,25,15,59,41,18,2
2021,Pembrokeshire 014A,W01000557,636,504,305,199,2,2,35,26,9,95,74,21,0
2021,Pembrokeshire 001A,W01000558,911,698,486,212,4,4,58,35,23,151,121,30,0
2021,Pembrokeshire 001B,W01000559,625,519,377,142,4,4,10,3,7,92,62,30,0
2021,Pembrokeshire 001C,W01000560,572,423,309,114,0,0,72,31,41,77,57,20,0
2021,Pembrokeshire 001D,W01000561,570,435,283,152,3,3,57,14,43,75,60,15,0
2021,Pembrokeshire 002A,W01000562,719,548,410,138,4,4,54,43,11,113,87,26,0
2021,Pembrokeshire 011B,W01000563,459,365,251,114,3,3,16,12,4,75,61,14,0
2021,Pembrokeshire 011C,W01000564,586,449,291,158,1,1,54,5,49,82,70,12,0
2021,Pembrokeshire 002B,W01000565,888,609,454,155,1,1,160,57,103,118,92,26,0
2021,Pembrokeshire 002C,W01000566,747,494,345,149,0,0,131,61,70,122,96,26,0
2021,Pembrokeshire 002D,W01000567,938,623,409,214,2,2,81,73,8,232,192,40,0
2021,Pembrokeshire 005B,W01000569,471,240,141,99,1,1,85,72,13,145,66,79,0
2021,Pembrokeshire 005C,W01000570,642,152,75,77,2,2,362,251,111,126,118,8,0
2021,Pembrokeshire 006A,W01000571,1088,695,429,266,1,1,209,108,101,181,160,21,2
2021,Pembrokeshire 005D,W01000572,845,594,387,207,0,0,94,79,15,155,117,38,2
2021,Pembrokeshire 006B,W01000573,1156,831,491,340,0,0,76,69,7,249,212,37,0
2021,Pembrokeshire 015A,W01000574,773,556,393,163,3,3,74,53,21,140,107,33,0
2021,Pembrokeshire 008C,W01000575,1125,781,476,305,2,2,180,119,61,162,135,27,0
2021,Pembrokeshire 011D,W01000576,1046,806,545,261,5,5,111,63,48,123,91,32,1
2021,Pembrokeshire 007A,W01000577,647,533,353,180,6,6,24,21,3,84,54,30,0
2021,Pembrokeshire 014B,W01000578,772,642,445,197,2,2,51,41,10,77,58,19,0
2021,Pembrokeshire 003A,W01000579,1025,744,507,237,1,1,138,87,51,142,103,39,0
2021,Pembrokeshire 009B,W01000580,983,806,505,301,0,0,89,52,37,88,70,18,0
2021,Pembrokeshire 003B,W01000581,629,508,353,155,2,2,66,42,24,53,30,23,0
2021,Pembrokeshire 004A,W01000582,696,576,416,160,0,0,16,15,1,104,82,22,0
2021,Pembrokeshire 004B,W01000583,598,428,276,152,4,4,72,45,27,93,65,28,1
2021,Pembrokeshire 014C,W01000584,873,619,417,202,2,2,159,89,70,92,54,38,1
2021,Pembrokeshire 007B,W01000585,565,416,297,119,1,1,26,15,11,122,83,39,0
2021,Pembrokeshire 006C,W01000586,930,527,321,206,1,1,307,162,145,94,81,13,1
2021,Pembrokeshire 010A,W01000587,1051,585,380,205,0,0,150,94,56,316,281,35,0
2021,Pembrokeshire 010B,W01000588,1043,541,330,211,3,3,357,306,51,142,119,23,0
2021,Pembrokeshire 012A,W01000589,546,295,158,137,2,2,140,119,21,109,95,14,0
2021,Pembrokeshire 012B,W01000590,561,354,237,117,2,2,134,122,12,71,51,20,0
2021,Pembrokeshire 012C,W01000591,698,446,254,192,2,2,136,66,70,114,90,24,0
2021,Pembrokeshire 012D,W01000592,518,230,131,99,0,0,223,212,11,64,48,16,1
2021,Pembrokeshire 012E,W01000594,1009,499,292,207,0,0,323,273,50,183,158,25,4
2021,Pembrokeshire 007C,W01000595,1178,702,443,259,6,6,213,123,90,257,221,36,0
2021,Pembrokeshire 007D,W01000596,732,585,382,203,3,3,41,12,29,103,70,33,0
2021,Pembrokeshire 002E,W01000597,524,379,313,66,2,2,79,35,44,64,43,21,0
2021,Pembrokeshire 009C,W01000598,1018,690,443,247,1,1,183,118,65,144,124,20,0
2021,Pembrokeshire 009D,W01000599,897,606,369,237,4,4,186,140,46,101,79,22,0
2021,Pembrokeshire 013A,W01000600,836,373,203,170,1,1,173,64,109,288,256,32,1
2021,Pembrokeshire 013B,W01000601,660,259,157,102,1,1,338,317,21,57,45,12,5
2021,Pembrokeshire 013C,W01000602,582,397,267,130,0,0,42,11,31,143,130,13,0
2021,Pembrokeshire 013D,W01000603,834,519,275,244,2,2,88,42,46,225,214,11,0
2021,Pembrokeshire 013E,W01000604,754,389,233,156,2,2,272,80,192,89,82,7,2
2021,Pembrokeshire 013F,W01000605,768,568,324,244,1,1,94,52,42,105,90,15,0
2021,Pembrokeshire 015B,W01000606,726,286,158,128,0,0,370,335,35,67,49,18,3
2021,Pembrokeshire 015C,W01000607,1063,562,286,276,2,2,365,213,152,133,111,22,1
2021,Pembrokeshire 015D,W01000608,732,396,284,112,1,1,101,39,62,234,205,29,0
2021,Pembrokeshire 014D,W01000609,1166,965,710,255,3,3,79,53,26,119,85,34,0
2021,Pembrokeshire 016A,W01000610,743,588,419,169,2,2,46,26,20,107,82,25,0
2021,Pembrokeshire 004C,W01000611,934,758,464,294,4,4,52,13,39,120,88,32,0
2021,Pembrokeshire 003C,W01000612,846,592,446,146,6,6,116,80,36,129,86,43,3
2021,Pembrokeshire 001E,W01000613,957,750,583,167,0,0,55,30,25,151,111,40,1
2021,Pembrokeshire 008D,W01000614,623,442,298,144,0,0,85,64,21,96,65,31,0
2021,Pembrokeshire 002F,W01000617,634,431,306,125,3,3,102,57,45,98,71,27,0
2021,Pembrokeshire 003D,W01000618,685,461,339,122,4,4,133,81,52,87,60,27,0
2021,Pembrokeshire 016B,W01000619,948,658,470,188,2,2,139,113,26,146,126,20,3
2021,Pembrokeshire 008E,W01000622,618,484,341,143,2,2,37,31,6,95,73,22,0
2021,Pembrokeshire 004D,W01000623,820,641,424,217,2,2,52,28,24,125,83,42,0
2021,Carmarthenshire 005A,W01000624,964,803,517,286,4,4,41,37,4,114,80,34,2
2021,Carmarthenshire 013A,W01000625,495,276,158,118,0,0,148,96,52,68,52,16,3
2021,Carmarthenshire 013B,W01000626,758,450,283,167,1,1,152,74,78,155,141,14,0
2021,Carmarthenshire 013C,W01000627,987,736,430,306,0,0,118,68,50,133,108,25,0
2021,Carmarthenshire 024A,W01000628,638,511,315,196,0,0,46,19,27,81,65,16,0
2021,Carmarthenshire 024B,W01000629,737,444,240,204,2,2,111,34,77,180,155,25,0
2021,Carmarthenshire 024C,W01000630,647,435,246,189,2,2,81,31,50,128,114,14,1
2021,Carmarthenshire 024D,W01000631,755,327,185,142,2,2,322,305,17,99,85,14,5
2021,Carmarthenshire 021A,W01000632,592,412,246,166,2,2,69,62,7,106,90,16,3
2021,Carmarthenshire 021B,W01000633,707,391,262,129,2,2,148,87,61,166,141,25,0
2021,Carmarthenshire 021C,W01000634,636,548,396,152,1,1,10,7,3,76,61,15,1
2021,Carmarthenshire 025A,W01000635,999,829,403,426,2,2,54,33,21,114,87,27,0
2021,Carmarthenshire 025B,W01000636,976,620,270,350,6,6,267,215,52,80,64,16,3
2021,Carmarthenshire 007A,W01000637,641,319,171,148,2,2,219,130,89,99,83,16,2
2021,Carmarthenshire 007B,W01000638,489,221,127,94,0,0,198,140,58,70,66,4,0
2021,Carmarthenshire 007C,W01000639,677,353,206,147,1,1,169,112,57,154,137,17,0
2021,Carmarthenshire 007D,W01000640,540,443,317,126,4,4,8,2,6,85,72,13,0
2021,Carmarthenshire 008A,W01000641,1193,411,299,112,2,2,273,149,124,504,470,34,3
2021,Carmarthenshire 008B,W01000642,775,580,357,223,3,3,73,12,61,119,102,17,0
2021,Carmarthenshire 006A,W01000643,697,393,216,177,4,4,166,88,78,133,116,17,1
2021,Carmarthenshire 006B,W01000644,739,510,209,301,3,3,67,5,62,159,133,26,0
2021,Carmarthenshire 006C,W01000645,847,507,264,243,2,2,129,31,98,209,185,24,0
2021,Carmarthenshire 003A,W01000646,949,638,468,170,1,1,81,63,18,229,195,34,0
2021,Carmarthenshire 002A,W01000647,623,513,380,133,2,2,29,24,5,79,60,19,0
2021,Carmarthenshire 006D,W01000648,567,495,326,169,5,5,21,19,2,46,36,10,0
2021,Carmarthenshire 006E,W01000649,646,540,382,158,2,2,43,40,3,61,49,12,0
2021,Carmarthenshire 002B,W01000650,704,586,454,132,0,0,29,16,13,89,63,26,0
2021,Carmarthenshire 020A,W01000651,690,492,276,216,2,2,72,49,23,124,114,10,0
2021,Carmarthenshire 020B,W01000652,720,423,256,167,1,1,211,155,56,84,71,13,1
2021,Carmarthenshire 023A,W01000653,644,478,295,183,2,2,77,40,37,86,79,7,1
2021,Carmarthenshire 023B,W01000654,748,462,279,183,2,2,56,31,25,228,202,26,0
2021,Carmarthenshire 020C,W01000655,798,442,255,187,2,2,222,208,14,126,106,20,6
2021,Carmarthenshire 010A,W01000656,890,595,359,236,2,2,172,134,38,117,91,26,4
2021,Carmarthenshire 010B,W01000657,522,330,216,114,2,2,118,112,6,71,57,14,1
2021,Carmarthenshire 010C,W01000658,584,388,226,162,0,0,81,33,48,114,86,28,1
2021,Carmarthenshire 026A,W01000659,755,396,237,159,0,0,174,69,105,184,164,20,1
2021,Carmarthenshire 026B,W01000660,734,370,238,132,1,1,211,146,65,147,136,11,5
2021,Carmarthenshire 016A,W01000662,938,738,445,293,1,1,98,92,6,99,79,20,2
2021,Carmarthenshire 016B,W01000663,1088,815,456,359,4,4,198,170,28,69,52,17,2
2021,Carmarthenshire 016C,W01000664,1071,878,414,464,5,5,57,53,4,131,104,27,0
2021,Carmarthenshire 017A,W01000665,767,674,394,280,3,3,31,24,7,59,46,13,0
2021,Carmarthenshire 017B,W01000666,725,515,234,281,1,1,99,79,20,110,95,15,0
2021,Carmarthenshire 023C,W01000667,943,756,361,395,1,1,64,58,6,121,99,22,1
2021,Carmarthenshire 018A,W01000670,717,416,266,150,2,2,153,116,37,142,122,20,4
2021,Carmarthenshire 018B,W01000671,884,697,425,272,2,2,100,61,39,85,59,26,0
2021,Carmarthenshire 027E,W01000672,638,452,284,168,3,3,83,30,53,100,63,37,0
2021,Carmarthenshire 027F,W01000673,512,344,248,96,3,3,81,52,29,84,65,19,0
2021,Carmarthenshire 027A,W01000674,852,722,514,208,4,4,23,21,2,103,75,28,0
2021,Carmarthenshire 012A,W01000675,856,686,449,237,1,1,86,83,3,83,60,23,0
2021,Carmarthenshire 004A,W01000676,669,558,387,171,1,1,16,14,2,94,73,21,0
2021,Carmarthenshire 004B,W01000677,700,382,238,144,2,2,120,82,38,195,161,34,1
2021,Carmarthenshire 002C,W01000678,585,421,317,104,0,0,108,86,22,56,37,19,0
2021,Carmarthenshire 002D,W01000679,534,352,233,119,1,1,61,32,29,119,95,24,1
2021,Carmarthenshire 011A,W01000680,947,786,482,304,1,1,55,18,37,105,85,20,0
2021,Carmarthenshire 011B,W01000681,896,547,337,210,2,2,211,181,30,136,111,25,0
2021,Carmarthenshire 005B,W01000682,585,479,327,152,6,6,36,25,11,64,45,19,0
2021,Carmarthenshire 005C,W01000683,481,400,284,116,2,2,19,14,5,60,38,22,0
2021,Carmarthenshire 005D,W01000684,767,640,436,204,3,3,42,22,20,82,57,25,0
2021,Carmarthenshire 001A,W01000685,674,461,313,148,2,2,116,99,17,93,70,23,2
2021,Carmarthenshire 001B,W01000686,544,459,334,125,1,1,16,16,0,68,44,24,0
2021,Carmarthenshire 004C,W01000687,818,672,488,184,0,0,47,44,3,99,68,31,0
2021,Carmarthenshire 003B,W01000688,767,478,326,152,3,3,190,149,41,93,72,21,3
2021,Carmarthenshire 003C,W01000689,753,663,455,208,1,1,4,1,3,85,71,14,0
2021,Carmarthenshire 019A,W01000690,765,589,361,228,1,1,100,89,11,72,58,14,3
2021,Carmarthenshire 019B,W01000691,779,583,356,227,1,1,151,101,50,44,34,10,0
2021,Carmarthenshire 019C,W01000692,638,475,250,225,0,0,84,53,31,79,68,11,0
2021,Carmarthenshire 008C,W01000693,522,340,216,124,3,3,145,132,13,32,22,10,2
2021,Carmarthenshire 008D,W01000694,652,554,391,163,6,6,14,11,3,77,57,20,1
2021,Carmarthenshire 012B,W01000695,971,748,371,377,4,4,108,92,16,108,91,17,3
2021,Carmarthenshire 012C,W01000696,684,521,345,176,2,2,94,87,7,66,50,16,1
2021,Carmarthenshire 015A,W01000697,846,573,325,248,2,2,109,97,12,162,148,14,0
2021,Carmarthenshire 015B,W01000698,809,559,316,243,0,0,162,146,16,87,67,20,1
2021,Carmarthenshire 015C,W01000699,576,526,315,211,0,0,0,0,0,50,41,9,0
2021,Carmarthenshire 027G,W01000700,890,744,508,236,1,1,48,44,4,96,77,19,1
2021,Carmarthenshire 001C,W01000701,680,531,370,161,3,3,45,38,7,101,74,27,0
2021,Carmarthenshire 001D,W01000702,516,303,206,97,2,2,119,92,27,92,79,13,0
2021,Carmarthenshire 022A,W01000703,817,450,265,185,0,0,113,37,76,254,231,23,0
2021,Carmarthenshire 022B,W01000704,716,584,345,239,1,1,63,46,17,66,48,18,2
2021,Carmarthenshire 022C,W01000705,801,455,265,190,0,0,200,188,12,146,125,21,0
2021,Carmarthenshire 025C,W01000706,669,450,267,183,3,3,127,103,24,87,75,12,2
2021,Carmarthenshire 025D,W01000707,608,311,171,140,0,0,231,223,8,63,50,13,3
2021,Carmarthenshire 025E,W01000708,597,268,148,120,2,2,231,201,30,96,85,11,0
2021,Carmarthenshire 004D,W01000709,925,756,526,230,5,5,71,27,44,93,68,25,0
2021,Carmarthenshire 021D,W01000710,893,812,524,288,3,3,8,4,4,70,54,16,0
2021,Carmarthenshire 021E,W01000711,887,550,360,190,2,2,227,207,20,104,80,24,4
2021,Carmarthenshire 015D,W01000712,726,569,306,263,1,1,38,17,21,118,106,12,0
2021,Carmarthenshire 015E,W01000713,592,454,263,191,2,2,72,60,12,64,43,21,0
2021,Carmarthenshire 013D,W01000714,651,387,226,161,0,0,175,135,40,87,79,8,2
2021,Carmarthenshire 013E,W01000715,559,465,304,161,1,1,24,4,20,69,56,13,0
2021,Carmarthenshire 016D,W01000716,570,486,296,190,1,1,24,17,7,59,39,20,0
2021,Carmarthenshire 016E,W01000717,642,413,236,177,2,2,166,155,11,58,47,11,3
2021,Carmarthenshire 010D,W01000718,624,377,239,138,2,2,142,123,19,100,83,17,3
2021,Carmarthenshire 010E,W01000719,623,496,303,193,1,1,77,64,13,48,41,7,1
2021,Carmarthenshire 027B,W01000720,786,580,358,222,2,2,70,40,30,134,118,16,0
2021,Carmarthenshire 027C,W01000721,583,395,225,170,0,0,110,72,38,78,63,15,0
2021,Carmarthenshire 012D,W01000722,577,497,359,138,3,3,21,20,1,56,39,17,0
2021,Carmarthenshire 012E,W01000723,645,533,356,177,2,2,35,33,2,75,55,20,0
2021,Carmarthenshire 011C,W01000724,808,580,340,240,3,3,153,102,51,69,51,18,3
2021,Carmarthenshire 011D,W01000725,1023,747,455,292,3,3,181,123,58,91,70,21,1
2021,Carmarthenshire 003D,W01000728,852,722,511,211,6,6,32,26,6,91,64,27,1
2021,Carmarthenshire 018C,W01000729,519,334,224,110,1,1,110,102,8,74,59,15,0
2021,Carmarthenshire 018D,W01000730,541,411,258,153,0,0,78,73,5,52,38,14,0
2021,Carmarthenshire 017C,W01000731,1059,820,470,350,1,1,92,84,8,144,113,31,2
2021,Carmarthenshire 026D,W01000732,607,344,225,119,0,0,52,20,32,211,194,17,0
2021,Carmarthenshire 026E,W01000733,596,164,107,57,0,0,255,181,74,170,152,18,7
2021,Carmarthenshire 026F,W01000734,603,282,158,124,2,2,88,36,52,231,205,26,0
2021,Carmarthenshire 027D,W01000735,1066,769,501,268,1,1,114,86,28,181,151,30,1
2021,Swansea 028A,W01000736,766,715,453,262,1,1,6,2,4,44,32,12,0
2021,Swansea 028B,W01000737,685,566,400,166,2,2,41,32,9,76,52,24,0
2021,Swansea 014A,W01000738,737,298,167,131,1,1,373,344,29,56,47,9,9
2021,Swansea 014B,W01000739,1109,471,188,283,4,4,284,165,119,345,325,20,5
2021,Swansea 014C,W01000740,621,518,336,182,0,0,32,5,27,71,52,19,0
2021,Swansea 014D,W01000741,861,492,214,278,2,2,262,180,82,102,81,21,3
2021,Swansea 016A,W01000742,804,178,116,62,1,1,505,250,255,113,96,17,7
2021,Swansea 016B,W01000744,767,343,163,180,1,1,184,87,97,239,216,23,0
2021,Swansea 025B,W01000745,1019,229,136,93,5,5,200,12,188,581,549,32,4
2021,Swansea 025C,W01000746,716,280,166,114,0,0,170,44,126,264,230,34,2
2021,Swansea 024A,W01000747,670,224,113,111,3,3,64,9,55,379,357,22,0
2021,Swansea 026A,W01000749,899,434,305,129,3,3,121,8,113,341,297,44,0
2021,Swansea 002A,W01000750,672,395,268,127,1,1,174,149,25,98,84,14,4
2021,Swansea 002B,W01000751,619,531,329,202,1,1,14,6,8,73,51,22,0
2021,Swansea 002C,W01000752,632,308,167,141,2,2,198,178,20,120,106,14,4
2021,Swansea 002D,W01000753,601,388,206,182,0,0,134,60,74,79,68,11,0
2021,Swansea 002E,W01000754,698,474,256,218,1,1,79,14,65,144,125,19,0
2021,Swansea 017A,W01000755,893,592,299,293,0,0,152,72,80,145,116,29,4
2021,Swansea 017B,W01000756,725,296,159,137,0,0,347,279,68,74,68,6,8
2021,Swansea 017C,W01000757,702,466,295,171,4,4,144,68,76,86,60,26,2
2021,Swansea 017D,W01000758,807,621,299,322,0,0,79,47,32,100,82,18,7
2021,Swansea 012A,W01000759,669,588,400,188,1,1,11,1,10,69,54,15,0
2021,Swansea 013A,W01000760,707,432,226,206,3,3,106,82,24,166,144,22,0
2021,Swansea 013B,W01000761,636,434,216,218,0,0,78,69,9,123,112,11,1
2021,Swansea 013C,W01000762,618,285,143,142,0,0,276,235,41,56,47,9,1
2021,Swansea 015A,W01000763,611,416,228,188,2,2,22,9,13,171,151,20,0
2021,Swansea 015B,W01000764,713,464,228,236,0,0,80,28,52,169,145,24,0
2021,Swansea 015C,W01000765,755,467,272,195,2,2,74,6,68,211,179,32,1
2021,Swansea 015D,W01000766,624,477,251,226,2,2,12,1,11,133,113,20,0
2021,Swansea 015E,W01000767,716,389,240,149,3,3,239,154,85,83,73,10,2
2021,Swansea 032A,W01000768,609,453,267,186,1,1,91,7,84,64,53,11,0
2021,Swansea 032B,W01000769,602,511,308,203,1,1,24,6,18,66,51,15,0
2021,Swansea 032D,W01000770,639,556,300,256,7,7,15,4,11,61,50,11,0
2021,Swansea 032G,W01000771,539,446,265,181,1,1,48,45,3,44,29,15,0
2021,Swansea 018A,W01000772,619,507,309,198,0,0,72,68,4,39,28,11,1
2021,Swansea 005B,W01000774,761,511,274,237,1,1,119,39,80,128,94,34,2
2021,Swansea 030A,W01000775,694,563,408,155,6,6,45,23,22,79,51,28,1
2021,Swansea 030B,W01000776,725,639,453,186,4,4,29,23,6,53,30,23,0
2021,Swansea 012B,W01000777,769,618,366,252,1,1,60,28,32,88,80,8,2
2021,Swansea 012C,W01000778,765,584,273,311,0,0,14,10,4,167,140,27,0
2021,Swansea 012D,W01000779,590,394,208,186,3,3,118,106,12,73,63,10,2
2021,Swansea 032E,W01000781,704,635,427,208,2,2,9,4,5,58,38,20,0
2021,Swansea 032F,W01000782,517,460,288,172,2,2,11,2,9,44,37,7,0
2021,Swansea 007A,W01000784,591,443,255,188,2,2,60,51,9,83,71,12,3
2021,Swansea 007B,W01000785,735,655,334,321,2,2,38,8,30,39,33,6,1
2021,Swansea 007C,W01000786,572,516,293,223,1,1,3,1,2,51,41,10,1
2021,Swansea 016C,W01000787,673,448,263,185,1,1,53,12,41,171,153,18,0
2021,Swansea 016D,W01000788,713,441,237,204,0,0,69,14,55,203,172,31,0
2021,Swansea 016E,W01000789,632,327,169,158,1,1,97,50,47,204,182,22,3
2021,Swansea 016F,W01000790,909,479,270,209,7,7,122,9,113,301,265,36,0
2021,Swansea 004A,W01000791,620,490,228,262,2,2,35,16,19,93,75,18,0
2021,Swansea 004B,W01000792,692,616,359,257,2,2,8,2,6,66,55,11,0
2021,Swansea 004C,W01000793,750,612,263,349,2,2,16,2,14,119,106,13,1
2021,Swansea 010A,W01000794,929,652,247,405,1,1,89,25,64,184,165,19,3
2021,Swansea 006A,W01000795,694,553,274,279,0,0,25,0,25,116,96,20,0
2021,Swansea 010B,W01000797,652,539,307,232,1,1,56,6,50,56,42,14,0
2021,Swansea 010C,W01000798,649,516,329,187,1,1,68,34,34,64,51,13,0
2021,Swansea 010D,W01000799,758,316,134,182,5,5,301,188,113,134,120,14,2
2021,Swansea 006C,W01000800,586,532,301,231,0,0,2,1,1,52,44,8,0
2021,Swansea 006D,W01000801,758,306,144,162,0,0,309,172,137,143,129,14,0
2021,Swansea 007D,W01000802,1003,633,335,298,1,1,241,203,38,122,104,18,6
2021,Swansea 002F,W01000803,795,640,400,240,3,3,92,90,2,59,45,14,1
2021,Swansea 028C,W01000804,711,592,429,163,12,12,38,5,33,69,51,18,0
2021,Swansea 028D,W01000805,473,441,260,181,0,0,2,1,1,30,26,4,0
2021,Swansea 003A,W01000806,616,456,264,192,5,5,70,58,12,83,68,15,2
2021,Swansea 003B,W01000807,552,492,296,196,0,0,3,1,2,57,48,9,0
2021,Swansea 003C,W01000808,618,491,320,171,2,2,51,38,13,73,56,17,1
2021,Swansea 008A,W01000809,715,469,235,234,4,4,78,21,57,163,140,23,1
2021,Swansea 003D,W01000810,634,185,86,99,3,3,389,379,10,48,39,9,9
2021,Swansea 008B,W01000811,668,357,177,180,1,1,200,147,53,109,94,15,1
2021,Swansea 008C,W01000812,712,276,158,118,0,0,186,16,170,250,231,19,0
2021,Swansea 008D,W01000813,685,552,321,231,2,2,13,2,11,118,99,19,0
2021,Swansea 008E,W01000814,637,333,191,142,2,2,155,89,66,145,133,12,2
2021,Swansea 003E,W01000815,645,566,346,220,0,0,18,1,17,61,49,12,0
2021,Swansea 003F,W01000816,745,558,320,238,3,3,38,4,34,144,118,26,2
2021,Swansea 009A,W01000817,867,275,112,163,2,2,523,307,216,59,50,9,8
2021,Swansea 009B,W01000818,652,348,213,135,0,0,225,206,19,74,63,11,5
2021,Swansea 009C,W01000819,635,567,358,209,0,0,11,2,9,56,48,8,1
2021,Swansea 009D,W01000820,622,447,248,199,1,1,86,31,55,88,74,14,0
2021,Swansea 009E,W01000821,628,454,269,185,3,3,99,50,49,72,56,16,0
2021,Swansea 009F,W01000822,582,458,326,132,0,0,69,43,26,53,40,13,2
2021,Swansea 031A,W01000823,786,715,472,243,12,12,18,3,15,41,35,6,0
2021,Swansea 031B,W01000824,756,576,386,190,2,2,37,4,33,141,122,19,0
2021,Swansea 031C,W01000825,647,459,299,160,3,3,29,7,22,154,123,31,2
2021,Swansea 031D,W01000826,605,512,356,156,2,2,6,3,3,85,66,19,0
2021,Swansea 031E,W01000827,592,466,304,162,1,1,9,4,5,116,93,23,0
2021,Swansea 018B,W01000828,731,658,439,219,3,3,8,2,6,61,41,20,1
2021,Swansea 018C,W01000829,853,633,358,275,2,2,104,81,23,114,91,23,0
2021,Swansea 011A,W01000830,710,82,43,39,0,0,555,229,326,67,52,15,6
2021,Swansea 013D,W01000831,814,307,154,153,1,1,370,365,5,120,106,14,16
2021,Swansea 011B,W01000832,749,214,121,93,0,0,456,318,138,68,60,8,11
2021,Swansea 011C,W01000833,739,207,101,106,2,2,440,399,41,83,75,8,7
2021,Swansea 011D,W01000834,559,219,127,92,2,2,281,270,11,44,37,7,13
2021,Swansea 013E,W01000835,603,322,182,140,1,1,215,204,11,63,55,8,2
2021,Swansea 011E,W01000836,918,380,126,254,2,2,396,327,69,116,102,14,24
2021,Swansea 004D,W01000837,915,799,352,447,10,10,19,4,15,87,76,11,0
2021,Swansea 004E,W01000838,555,302,151,151,1,1,189,96,93,62,47,15,1
2021,Swansea 030C,W01000839,464,405,278,127,0,0,6,1,5,53,43,10,0
2021,Swansea 030D,W01000840,700,638,460,178,0,0,4,3,1,58,40,18,0
2021,Swansea 005C,W01000841,650,463,274,189,4,4,112,101,11,70,51,19,1
2021,Swansea 005D,W01000842,592,498,298,200,0,0,33,21,12,60,44,16,1
2021,Swansea 005E,W01000843,576,467,239,228,3,3,22,18,4,84,70,14,0
2021,Swansea 005F,W01000844,613,339,139,200,0,0,194,157,37,77,72,5,3
2021,Swansea 001A,W01000845,836,681,374,307,1,1,61,2,59,93,74,19,0
2021,Swansea 001B,W01000846,972,586,246,340,1,1,115,8,107,270,241,29,0
2021,Swansea 001C,W01000847,522,417,252,165,0,0,54,51,3,50,43,7,1
2021,Swansea 001D,W01000848,502,258,130,128,0,0,196,191,5,45,38,7,3
2021,Swansea 021A,W01000849,1021,461,255,206,2,2,238,110,128,314,277,37,6
2021,Swansea 021C,W01000851,728,443,236,207,0,0,135,103,32,147,128,19,3
2021,Swansea 021D,W01000852,615,408,240,168,4,4,53,25,28,148,123,25,2
2021,Swansea 022A,W01000853,725,587,270,317,0,0,70,3,67,68,55,13,0
2021,Swansea 022B,W01000854,587,511,248,263,1,1,16,1,15,59,47,12,0
2021,Swansea 022C,W01000855,638,534,346,188,0,0,50,4,46,54,44,10,0
2021,Swansea 022D,W01000856,920,306,160,146,1,1,484,422,62,125,105,20,4
2021,Swansea 022E,W01000857,979,460,292,168,1,1,361,135,226,151,132,19,6
2021,Swansea 027A,W01000858,683,516,289,227,1,1,16,3,13,149,136,13,1
2021,Swansea 027B,W01000859,655,549,386,163,8,8,46,36,10,47,36,11,5
2021,Swansea 027C,W01000860,650,600,402,198,1,1,2,0,2,47,41,6,0
2021,Swansea 027D,W01000861,432,267,155,112,1,1,22,5,17,139,126,13,3
2021,Swansea 019A,W01000862,685,105,55,50,1,1,512,503,9,60,53,7,7
2021,Swansea 019B,W01000863,767,153,86,67,3,3,503,451,52,102,71,31,6
2021,Swansea 019C,W01000864,681,166,78,88,0,0,437,424,13,74,67,7,4
2021,Swansea 019D,W01000865,583,297,155,142,2,2,216,204,12,65,54,11,3
2021,Swansea 019E,W01000866,495,203,112,91,0,0,219,213,6,63,57,6,10
2021,Swansea 019F,W01000867,570,208,135,73,0,0,323,277,46,36,32,4,3
2021,Swansea 024B,W01000868,483,426,224,202,0,0,10,5,5,43,30,13,4
2021,Swansea 024C,W01000869,683,320,192,128,2,2,130,43,87,228,215,13,3
2021,Swansea 024D,W01000870,585,298,178,120,0,0,47,3,44,239,222,17,1
2021,Swansea 026B,W01000871,807,218,129,89,5,5,151,12,139,430,407,23,3
2021,Swansea 024E,W01000872,630,503,295,208,8,8,15,7,8,104,88,16,0
2021,Swansea 026C,W01000873,528,137,81,56,3,3,73,6,67,315,311,4,0
2021,Swansea 024F,W01000874,612,285,156,129,0,0,30,5,25,297,284,13,0
2021,Swansea 026D,W01000875,736,177,105,72,0,0,97,9,88,461,439,22,1
2021,Swansea 026E,W01000876,566,229,120,109,1,1,40,3,37,296,281,15,0
2021,Swansea 007E,W01000877,722,643,342,301,1,1,17,5,12,61,49,12,0
2021,Swansea 007F,W01000878,590,452,262,190,1,1,61,40,21,75,60,15,1
2021,Swansea 029A,W01000879,753,678,450,228,3,3,10,5,5,62,49,13,0
2021,Swansea 029B,W01000880,750,639,438,201,4,4,38,7,31,69,50,19,0
2021,Swansea 029C,W01000881,690,322,224,98,1,1,266,251,15,96,81,15,5
2021,Swansea 029D,W01000882,816,458,260,198,1,1,269,259,10,88,66,22,0
2021,Neath Port Talbot 016A,W01000883,613,552,357,195,0,0,9,3,6,52,34,18,0
2021,Neath Port Talbot 017A,W01000884,584,306,196,110,0,0,72,21,51,204,176,28,2
2021,Neath Port Talbot 017B,W01000885,666,314,170,144,2,2,255,78,177,95,72,23,0
2021,Neath Port Talbot 017C,W01000886,744,319,202,117,3,3,135,12,123,287,270,17,0
2021,Neath Port Talbot 021C,W01000887,941,670,335,335,2,2,186,35,151,83,71,12,0
2021,Neath Port Talbot 004A,W01000888,1111,870,446,424,11,11,118,53,65,112,86,26,0
2021,Neath Port Talbot 015A,W01000889,808,653,354,299,0,0,48,8,40,107,76,31,0
2021,Neath Port Talbot 015B,W01000890,688,643,384,259,0,0,10,0,10,35,18,17,0
2021,Neath Port Talbot 015C,W01000891,635,413,226,187,0,0,109,52,57,111,90,21,2
2021,Neath Port Talbot 015D,W01000892,829,684,373,311,4,4,66,27,39,74,52,22,1
2021,Neath Port Talbot 003A,W01000893,815,575,340,235,3,3,104,58,46,132,111,21,1
2021,Neath Port Talbot 013A,W01000894,668,477,287,190,0,0,113,47,66,77,61,16,1
2021,Neath Port Talbot 013B,W01000895,798,400,214,186,1,1,165,47,118,227,208,19,5
2021,Neath Port Talbot 013C,W01000896,645,259,125,134,4,4,276,147,129,101,87,14,5
2021,Neath Port Talbot 013D,W01000897,610,394,243,151,1,1,108,56,52,104,93,11,3
2021,Neath Port Talbot 014A,W01000898,643,504,293,211,0,0,79,31,48,59,45,14,1
2021,Neath Port Talbot 014B,W01000899,795,650,341,309,1,1,83,26,57,60,42,18,1
2021,Neath Port Talbot 014C,W01000900,796,383,226,157,0,0,324,119,205,87,66,21,2
2021,Neath Port Talbot 014D,W01000901,750,495,279,216,1,1,189,102,87,65,50,15,0
2021,Neath Port Talbot 006C,W01000904,656,568,315,253,1,1,8,0,8,79,63,16,0
2021,Neath Port Talbot 006D,W01000905,642,451,250,201,2,2,97,48,49,90,74,16,2
2021,Neath Port Talbot 007B,W01000907,749,385,223,162,0,0,312,68,244,51,38,13,1
2021,Neath Port Talbot 006E,W01000908,738,587,382,205,3,3,74,8,66,74,47,27,0
2021,Neath Port Talbot 009A,W01000909,487,367,239,128,2,2,80,45,35,38,26,12,0
2021,Neath Port Talbot 009B,W01000910,646,568,356,212,0,0,13,2,11,65,49,16,0
2021,Neath Port Talbot 009C,W01000911,494,454,272,182,0,0,6,2,4,34,24,10,0
2021,Neath Port Talbot 010A,W01000912,557,345,187,158,0,0,120,38,82,91,71,20,1
2021,Neath Port Talbot 010B,W01000913,543,361,188,173,0,0,42,9,33,140,123,17,0
2021,Neath Port Talbot 010C,W01000914,690,333,170,163,0,0,263,132,131,93,76,17,1
2021,Neath Port Talbot 010D,W01000915,484,364,179,185,1,1,56,19,37,63,55,8,0
2021,Neath Port Talbot 010E,W01000916,491,399,207,192,2,2,11,3,8,79,65,14,0
2021,Neath Port Talbot 002A,W01000918,865,603,362,241,1,1,159,58,101,100,73,27,2
2021,Neath Port Talbot 020A,W01000919,508,403,247,156,0,0,76,42,34,29,22,7,0
2021,Neath Port Talbot 021G,W01000921,643,274,180,94,0,0,331,181,150,35,27,8,3
2021,Neath Port Talbot 007C,W01000922,730,461,252,209,0,0,165,48,117,102,81,21,2
2021,Neath Port Talbot 003B,W01000925,666,373,216,157,1,1,232,70,162,60,50,10,0
2021,Neath Port Talbot 003C,W01000926,867,654,398,256,1,1,59,10,49,153,119,34,0
2021,Neath Port Talbot 020B,W01000927,885,624,278,346,0,0,135,66,69,124,106,18,2
2021,Neath Port Talbot 020C,W01000928,705,479,296,183,0,0,142,63,79,83,65,18,1
2021,Neath Port Talbot 020D,W01000929,552,355,220,135,0,0,136,75,61,61,45,16,0
2021,Neath Port Talbot 021F,W01000930,544,354,236,118,0,0,98,42,56,92,77,15,0
2021,Neath Port Talbot 020E,W01000931,591,416,248,168,2,2,102,47,55,71,50,21,0
2021,Neath Port Talbot 019A,W01000932,479,301,174,127,1,1,125,44,81,51,35,16,1
2021,Neath Port Talbot 019B,W01000933,758,673,339,334,0,0,25,11,14,60,44,16,0
2021,Neath Port Talbot 008A,W01000934,641,343,205,138,1,1,95,25,70,200,187,13,2
2021,Neath Port Talbot 008B,W01000935,836,360,240,120,2,2,238,45,193,233,217,16,3
2021,Neath Port Talbot 012A,W01000936,629,300,155,145,0,0,249,115,134,77,67,10,3
2021,Neath Port Talbot 013E,W01000937,934,486,241,245,2,2,251,87,164,190,175,15,5
2021,Neath Port Talbot 008C,W01000938,633,513,348,165,2,2,58,14,44,60,40,20,0
2021,Neath Port Talbot 008D,W01000939,652,241,156,85,1,1,255,46,209,154,130,24,1
2021,Neath Port Talbot 008E,W01000940,578,290,173,117,0,0,218,107,111,68,54,14,2
2021,Neath Port Talbot 012B,W01000941,659,334,173,161,1,1,214,85,129,108,91,17,2
2021,Neath Port Talbot 012C,W01000942,785,358,192,166,0,0,329,170,159,92,75,17,6
2021,Neath Port Talbot 012D,W01000943,607,535,315,220,0,0,24,3,21,48,38,10,0
2021,Neath Port Talbot 002B,W01000944,517,359,240,119,1,1,93,32,61,63,45,18,1
2021,Neath Port Talbot 014E,W01000945,504,361,212,149,0,0,79,48,31,64,45,19,0
2021,Neath Port Talbot 004B,W01000946,719,519,284,235,3,3,125,38,87,71,49,22,1
2021,Neath Port Talbot 004C,W01000947,900,516,248,268,3,3,286,138,148,88,70,18,7
2021,Neath Port Talbot 004D,W01000948,872,557,307,250,3,3,179,37,142,133,114,19,0
2021,Neath Port Talbot 018A,W01000949,563,466,256,210,0,0,39,22,17,58,43,15,0
2021,Neath Port Talbot 018B,W01000950,665,446,232,214,1,1,27,3,24,191,164,27,0
2021,Neath Port Talbot 018C,W01000951,826,452,249,203,2,2,190,22,168,182,154,28,0
2021,Neath Port Talbot 018D,W01000952,489,368,187,181,2,2,28,7,21,90,79,11,1
2021,Neath Port Talbot 021B,W01000953,728,474,305,169,2,2,144,61,83,107,89,18,1
2021,Neath Port Talbot 021A,W01000954,629,489,312,177,0,0,29,2,27,111,87,24,0
2021,Neath Port Talbot 004E,W01000955,600,470,255,215,0,0,80,18,62,50,39,11,0
2021,Neath Port Talbot 004F,W01000956,532,484,355,129,1,1,2,1,1,45,28,17,0
2021,Neath Port Talbot 017D,W01000957,832,349,229,120,0,0,367,161,206,107,84,23,9
2021,Neath Port Talbot 016B,W01000958,639,249,148,101,0,0,339,174,165,47,39,8,4
2021,Neath Port Talbot 017E,W01000959,757,545,309,236,0,0,77,31,46,132,109,23,3
2021,Neath Port Talbot 017F,W01000960,814,465,239,226,1,1,220,103,117,125,102,23,3
2021,Neath Port Talbot 016C,W01000961,703,426,249,177,0,0,193,105,88,83,61,22,1
2021,Neath Port Talbot 016D,W01000962,601,243,144,99,1,1,260,137,123,92,82,10,5
2021,Neath Port Talbot 016E,W01000963,789,380,216,164,1,1,284,131,153,121,90,31,3
2021,Neath Port Talbot 016F,W01000964,762,390,235,155,1,1,291,117,174,78,56,22,2
2021,Neath Port Talbot 002C,W01000965,874,593,388,205,2,2,168,76,92,108,86,22,3
2021,Neath Port Talbot 018E,W01000966,661,469,291,178,1,1,69,26,43,122,106,16,0
2021,Neath Port Talbot 019C,W01000967,675,385,213,172,1,1,126,21,105,162,135,27,1
2021,Neath Port Talbot 019D,W01000968,860,575,307,268,0,0,165,43,122,118,95,23,2
2021,Neath Port Talbot 009D,W01000969,655,569,308,261,1,1,42,5,37,43,30,13,0
2021,Neath Port Talbot 021D,W01000970,474,345,195,150,0,0,86,42,44,42,31,11,1
2021,Neath Port Talbot 004G,W01000971,596,426,240,186,0,0,85,47,38,84,65,19,1
2021,Neath Port Talbot 020F,W01000973,651,360,213,147,1,1,184,86,98,103,80,23,3
2021,Bridgend 006A,W01000974,1049,825,404,421,4,4,72,13,59,148,116,32,0
2021,Bridgend 004A,W01000975,873,425,238,187,1,1,364,102,262,81,69,12,2
2021,Bridgend 003A,W01000976,449,297,168,129,1,1,70,33,37,79,68,11,2
2021,Bridgend 003B,W01000977,576,352,190,162,0,0,143,35,108,78,68,10,3
2021,Bridgend 004B,W01000978,779,541,312,229,1,1,80,10,70,157,138,19,0
2021,Bridgend 015A,W01000979,700,449,202,247,0,0,80,7,73,171,156,15,0
2021,Bridgend 016A,W01000980,567,362,178,184,1,1,109,5,104,95,83,12,0
2021,Bridgend 016B,W01000981,498,138,72,66,0,0,331,30,301,29,23,6,0
2021,Bridgend 016C,W01000982,640,458,283,175,2,2,79,2,77,101,86,15,0
2021,Bridgend 015B,W01000983,667,505,204,301,0,0,21,0,21,141,127,14,0
2021,Bridgend 016D,W01000984,955,607,311,296,2,2,116,5,111,230,206,24,0
2021,Bridgend 015C,W01000985,516,443,221,222,4,4,4,0,4,65,59,6,0
2021,Bridgend 007A,W01000986,732,526,216,310,1,1,66,7,59,139,117,22,0
2021,Bridgend 007B,W01000987,1047,655,299,356,2,2,265,81,184,124,100,24,1
2021,Bridgend 013A,W01000989,681,542,291,251,0,0,39,10,29,100,79,21,0
2021,Bridgend 017B,W01000990,678,373,191,182,4,4,226,57,169,72,56,16,3
2021,Bridgend 001A,W01000991,454,182,108,74,0,0,201,91,110,68,64,4,3
2021,Bridgend 001B,W01000992,618,397,258,139,1,1,38,13,25,180,162,18,2
2021,Bridgend 001C,W01000993,584,390,244,146,0,0,49,26,23,144,125,19,1
2021,Bridgend 001D,W01000994,586,388,232,156,0,0,87,9,78,111,98,13,0
2021,Bridgend 001E,W01000995,647,505,303,202,2,2,11,0,11,129,110,19,0
2021,Bridgend 008A,W01000996,647,483,280,203,1,1,104,41,63,59,40,19,0
2021,Bridgend 012A,W01000997,780,621,375,246,2,2,63,15,48,94,77,17,0
2021,Bridgend 010A,W01000999,612,382,237,145,0,0,181,73,108,48,34,14,1
2021,Bridgend 010B,W01001000,740,560,313,247,3,3,64,24,40,109,89,20,4
2021,Bridgend 010C,W01001001,763,549,301,248,2,2,145,38,107,67,54,13,0
2021,Bridgend 010D,W01001002,1059,467,195,272,0,0,377,131,246,213,176,37,2
2021,Bridgend 015D,W01001003,578,484,312,172,0,0,44,4,40,50,41,9,0
2021,Bridgend 009A,W01001004,481,289,164,125,0,0,104,39,65,88,72,16,0
2021,Bridgend 009B,W01001005,737,617,336,281,2,2,11,3,8,106,91,15,1
2021,Bridgend 009C,W01001006,952,873,507,366,1,1,5,0,5,72,60,12,1
2021,Bridgend 009D,W01001007,754,485,219,266,2,2,174,51,123,93,81,12,0
2021,Bridgend 011B,W01001008,1143,1033,555,478,2,2,20,3,17,88,76,12,0
2021,Bridgend 004C,W01001009,498,363,191,172,2,2,55,14,41,78,59,19,0
2021,Bridgend 012B,W01001010,509,300,170,130,2,2,174,10,164,33,30,3,0
2021,Bridgend 012C,W01001011,567,421,222,199,0,0,69,12,57,77,65,12,0
2021,Bridgend 005A,W01001012,591,505,276,229,2,2,5,1,4,79,70,9,0
2021,Bridgend 005B,W01001013,632,442,291,151,0,0,125,46,79,65,47,18,0
2021,Bridgend 002A,W01001014,775,464,282,182,1,1,131,18,113,177,154,23,2
2021,Bridgend 002B,W01001015,604,406,251,155,4,4,119,48,71,75,57,18,0
2021,Bridgend 005C,W01001016,744,606,418,188,1,1,23,6,17,114,94,20,0
2021,Bridgend 002C,W01001017,612,511,276,235,1,1,31,1,30,66,58,8,3
2021,Bridgend 002D,W01001018,630,427,260,167,0,0,36,13,23,166,150,16,1
2021,Bridgend 005D,W01001019,630,430,259,171,2,2,125,66,59,72,54,18,1
2021,Bridgend 002E,W01001020,631,389,221,168,0,0,174,59,115,65,54,11,3
2021,Bridgend 014A,W01001021,760,382,196,186,1,1,154,22,132,221,201,20,2
2021,Bridgend 014B,W01001022,626,288,165,123,0,0,253,70,183,85,70,15,0
2021,Bridgend 014C,W01001023,822,427,241,186,1,1,240,39,201,150,135,15,4
2021,Bridgend 003C,W01001024,527,332,181,151,2,2,33,11,22,158,136,22,2
2021,Bridgend 003D,W01001025,521,379,210,169,1,1,18,3,15,123,108,15,0
2021,Bridgend 012D,W01001026,867,486,236,250,1,1,263,65,198,115,94,21,2
2021,Bridgend 017C,W01001027,714,585,368,217,0,0,76,23,53,53,37,16,0
2021,Bridgend 014D,W01001028,879,687,375,312,2,2,51,8,43,139,120,19,0
2021,Bridgend 019A,W01001029,818,670,458,212,2,2,2,1,1,144,120,24,0
2021,Bridgend 019B,W01001030,858,711,445,266,0,0,62,4,58,84,61,23,1
2021,Bridgend 018A,W01001031,639,595,382,213,0,0,7,3,4,37,31,6,0
2021,Bridgend 018B,W01001032,824,691,463,228,5,5,6,0,6,122,98,24,0
2021,Bridgend 003E,W01001033,749,570,295,275,3,3,33,7,26,143,127,16,0
2021,Bridgend 003F,W01001034,638,410,221,189,3,3,83,5,78,142,133,9,0
2021,Bridgend 014E,W01001035,819,371,186,185,4,4,236,50,186,206,190,16,2
2021,Bridgend 017D,W01001036,664,556,337,219,0,0,30,0,30,78,65,13,0
2021,Bridgend 013B,W01001037,741,652,385,267,2,2,16,4,12,71,58,13,0
2021,Bridgend 011C,W01001038,1140,817,372,445,2,2,141,19,122,179,148,31,1
2021,Bridgend 009E,W01001039,686,504,271,233,1,1,110,21,89,71,58,13,0
2021,Bridgend 009F,W01001040,675,531,299,232,1,1,62,13,49,81,73,8,0
2021,Bridgend 013C,W01001041,921,839,486,353,3,3,8,2,6,71,53,18,0
2021,Bridgend 004D,W01001042,578,410,222,188,0,0,16,2,14,152,137,15,0
2021,Bridgend 004E,W01001043,514,388,215,173,0,0,15,3,12,111,104,7,0
2021,Bridgend 019C,W01001044,754,439,252,187,2,2,193,54,139,117,98,19,3
2021,Bridgend 019D,W01001045,772,521,309,212,2,2,32,8,24,215,199,16,2
2021,Bridgend 018C,W01001046,979,598,403,195,5,5,23,5,18,352,309,43,1
2021,Bridgend 018D,W01001047,760,584,357,227,2,2,79,22,57,95,81,14,0
2021,Bridgend 008B,W01001048,650,487,261,226,0,0,35,12,23,128,110,18,0
2021,Bridgend 008C,W01001049,515,300,162,138,2,2,150,66,84,62,48,14,1
2021,Bridgend 008D,W01001050,651,416,219,197,1,1,124,40,84,108,83,25,2
2021,Bridgend 008E,W01001051,748,459,231,228,3,3,200,12,188,86,74,12,0
2021,Bridgend 008F,W01001052,587,310,143,167,0,0,183,64,119,94,76,18,0
2021,Bridgend 018E,W01001053,468,405,281,124,9,9,19,2,17,35,28,7,0
2021,Bridgend 018F,W01001054,557,496,315,181,2,2,6,2,4,52,43,9,1
2021,Bridgend 007C,W01001055,495,280,149,131,1,1,160,43,117,53,41,12,1
2021,Bridgend 007D,W01001056,516,420,258,162,0,0,53,18,35,41,26,15,2
2021,Bridgend 006B,W01001057,806,411,190,221,5,5,300,76,224,88,80,8,2
2021,Bridgend 006C,W01001058,784,611,308,303,0,0,59,15,44,113,95,18,1
2021,Vale of Glamorgan 015A,W01001059,840,691,352,339,0,0,65,11,54,84,72,12,0
2021,Vale of Glamorgan 015B,W01001060,647,605,376,229,2,2,4,1,3,36,28,8,0
2021,Vale of Glamorgan 013A,W01001062,582,427,194,233,1,1,6,3,3,148,136,12,0
2021,Vale of Glamorgan 012A,W01001063,695,477,208,269,1,1,33,6,27,184,164,20,0
2021,Vale of Glamorgan 013B,W01001064,602,279,141,138,0,0,238,154,84,82,74,8,3
2021,Vale of Glamorgan 012B,W01001065,668,452,209,243,4,4,83,30,53,129,111,18,0
2021,Vale of Glamorgan 015D,W01001066,794,464,225,239,0,0,144,56,88,186,174,12,0
2021,Vale of Glamorgan 009A,W01001067,605,281,145,136,0,0,271,140,131,52,42,10,1
2021,Vale of Glamorgan 009B,W01001068,714,441,197,244,7,7,121,29,92,145,130,15,0
2021,Vale of Glamorgan 012C,W01001069,728,370,179,191,0,0,139,22,117,219,202,17,0
2021,Vale of Glamorgan 009C,W01001070,526,262,129,133,0,0,73,3,70,191,163,28,0
2021,Vale of Glamorgan 009D,W01001071,650,431,202,229,0,0,105,75,30,112,93,19,2
2021,Vale of Glamorgan 009E,W01001072,1049,909,359,550,5,5,33,4,29,102,84,18,0
2021,Vale of Glamorgan 015E,W01001073,1060,420,200,220,0,0,388,99,289,250,230,20,2
2021,Vale of Glamorgan 004A,W01001075,476,404,199,205,1,1,27,24,3,44,39,5,0
2021,Vale of Glamorgan 004B,W01001076,627,408,180,228,2,2,59,29,30,157,142,15,1
2021,Vale of Glamorgan 004C,W01001077,620,432,245,187,0,0,149,112,37,38,31,7,1
2021,Vale of Glamorgan 004D,W01001078,510,429,238,191,0,0,47,41,6,34,24,10,0
2021,Vale of Glamorgan 012E,W01001079,669,396,187,209,1,1,40,19,21,232,214,18,0
2021,Vale of Glamorgan 012F,W01001080,635,412,190,222,0,0,92,74,18,131,111,20,0
2021,Vale of Glamorgan 007A,W01001081,718,400,187,213,0,0,229,172,57,89,69,20,0
2021,Vale of Glamorgan 002A,W01001082,780,569,409,160,2,2,61,50,11,148,133,15,0
2021,Vale of Glamorgan 002B,W01001083,713,631,398,233,1,1,33,12,21,48,34,14,0
2021,Vale of Glamorgan 002C,W01001084,761,620,409,211,5,5,39,12,27,97,77,20,0
2021,Vale of Glamorgan 002D,W01001085,631,552,313,239,2,2,26,4,22,51,31,20,0
2021,Vale of Glamorgan 006A,W01001086,671,578,359,219,2,2,4,0,4,87,63,24,0
2021,Vale of Glamorgan 006B,W01001087,640,569,353,216,1,1,8,5,3,61,48,13,1
2021,Vale of Glamorgan 006C,W01001088,965,569,283,286,2,2,332,148,184,54,35,19,8
2021,Vale of Glamorgan 006D,W01001089,695,608,361,247,2,2,37,8,29,48,33,15,0
2021,Vale of Glamorgan 006E,W01001090,634,556,303,253,1,1,24,14,10,53,38,15,0
2021,Vale of Glamorgan 010A,W01001091,747,685,445,240,3,3,7,3,4,52,42,10,0
2021,Vale of Glamorgan 007B,W01001092,829,575,238,337,0,0,173,109,64,79,71,8,2
2021,Vale of Glamorgan 013C,W01001093,770,432,230,202,4,4,251,211,40,83,63,20,0
2021,Vale of Glamorgan 007C,W01001094,514,250,136,114,0,0,208,102,106,55,45,10,1
2021,Vale of Glamorgan 007D,W01001095,629,217,95,122,0,0,368,294,74,42,34,8,2
2021,Vale of Glamorgan 007E,W01001096,640,443,218,225,0,0,119,71,48,78,66,12,0
2021,Vale of Glamorgan 007F,W01001097,587,309,154,155,0,0,192,180,12,85,74,11,1
2021,Vale of Glamorgan 010B,W01001098,457,422,275,147,2,2,4,2,2,29,21,8,0
2021,Vale of Glamorgan 013D,W01001099,569,297,143,154,0,0,216,150,66,54,47,7,2
2021,Vale of Glamorgan 010C,W01001100,632,565,340,225,1,1,43,42,1,23,15,8,0
2021,Vale of Glamorgan 013E,W01001101,681,398,190,208,0,0,42,21,21,241,224,17,0
2021,Vale of Glamorgan 013F,W01001102,676,453,199,254,1,1,11,1,10,211,189,22,0
2021,Vale of Glamorgan 010D,W01001103,514,461,260,201,3,3,5,2,3,45,37,8,0
2021,Vale of Glamorgan 004E,W01001104,898,677,360,317,3,3,94,13,81,124,104,20,0
2021,Vale of Glamorgan 001A,W01001105,1147,1008,598,410,5,5,50,22,28,84,61,23,0
2021,Vale of Glamorgan 011A,W01001106,623,537,341,196,2,2,39,15,24,45,35,10,0
2021,Vale of Glamorgan 011B,W01001107,731,588,413,175,1,1,51,47,4,90,72,18,1
2021,Vale of Glamorgan 014A,W01001108,848,508,232,276,2,2,35,15,20,303,153,150,0
2021,Vale of Glamorgan 011C,W01001109,624,511,331,180,3,3,64,54,10,46,32,14,0
2021,Vale of Glamorgan 011D,W01001110,664,494,280,214,4,4,53,8,45,113,72,41,0
2021,Vale of Glamorgan 011E,W01001111,567,307,181,126,2,2,168,153,15,89,71,18,1
2021,Vale of Glamorgan 011F,W01001112,592,444,230,214,4,4,5,1,4,139,128,11,0
2021,Vale of Glamorgan 003A,W01001113,948,828,489,339,2,2,26,20,6,92,66,26,0
2021,Vale of Glamorgan 008A,W01001114,646,590,402,188,1,1,9,5,4,46,39,7,0
2021,Vale of Glamorgan 008B,W01001115,860,710,399,311,2,2,83,66,17,65,53,12,0
2021,Vale of Glamorgan 005A,W01001116,816,675,444,231,2,2,10,6,4,129,110,19,0
2021,Vale of Glamorgan 014B,W01001117,588,483,301,182,0,0,43,14,29,62,49,13,0
2021,Vale of Glamorgan 003B,W01001119,744,629,333,296,3,3,28,13,15,84,63,21,0
2021,Vale of Glamorgan 014D,W01001120,595,498,295,203,0,0,3,0,3,94,73,21,0
2021,Vale of Glamorgan 014E,W01001121,726,488,281,207,1,1,153,99,54,84,68,16,0
2021,Vale of Glamorgan 014F,W01001122,837,513,208,305,2,2,10,2,8,312,213,99,0
2021,Vale of Glamorgan 005B,W01001123,784,552,352,200,2,2,42,30,12,188,164,24,0
2021,Vale of Glamorgan 005C,W01001124,695,440,217,223,2,2,37,22,15,216,182,34,0
2021,Vale of Glamorgan 005D,W01001125,633,494,285,209,1,1,30,8,22,108,93,15,0
2021,Vale of Glamorgan 001B,W01001127,711,612,336,276,0,0,42,4,38,57,43,14,0
2021,Vale of Glamorgan 001C,W01001128,717,597,349,248,2,2,49,18,31,69,52,17,0
2021,Vale of Glamorgan 004F,W01001129,589,417,164,253,4,4,123,66,57,45,34,11,0
2021,Vale of Glamorgan 005F,W01001130,494,371,191,180,1,1,11,6,5,111,100,11,0
2021,Vale of Glamorgan 008C,W01001131,737,367,171,196,0,0,292,147,145,76,64,12,2
2021,Vale of Glamorgan 008D,W01001132,583,488,239,249,2,2,11,8,3,82,67,15,0
2021,Vale of Glamorgan 008E,W01001133,962,771,499,272,1,1,8,1,7,181,164,17,1
2021,Vale of Glamorgan 008F,W01001134,523,451,297,154,0,0,2,0,2,70,57,13,0
2021,Vale of Glamorgan 003C,W01001135,972,814,398,416,2,2,95,20,75,61,40,21,0
2021,Vale of Glamorgan 003D,W01001136,696,590,371,219,1,1,45,9,36,60,45,15,0
2021,Rhondda Cynon Taf 005A,W01001137,1104,693,405,288,1,1,145,31,114,263,219,44,2
2021,Rhondda Cynon Taf 005B,W01001138,640,357,199,158,0,0,168,52,116,112,95,17,3
2021,Rhondda Cynon Taf 005C,W01001139,597,454,252,202,1,1,21,4,17,121,105,16,0
2021,Rhondda Cynon Taf 005D,W01001140,641,426,258,168,1,1,66,19,47,148,130,18,0
2021,Rhondda Cynon Taf 005E,W01001141,673,409,227,182,1,1,144,49,95,119,103,16,0
2021,Rhondda Cynon Taf 005F,W01001142,835,550,302,248,5,5,97,21,76,183,159,24,0
2021,Rhondda Cynon Taf 012A,W01001143,634,497,287,210,0,0,13,3,10,124,109,15,0
2021,Rhondda Cynon Taf 012B,W01001144,702,371,225,146,0,0,203,123,80,128,112,16,0
2021,Rhondda Cynon Taf 012C,W01001145,777,488,258,230,0,0,138,63,75,151,133,18,0
2021,Rhondda Cynon Taf 012D,W01001146,633,471,258,213,0,0,39,17,22,122,105,17,1
2021,Rhondda Cynon Taf 004A,W01001147,867,588,331,257,1,1,141,39,102,137,121,16,0
2021,Rhondda Cynon Taf 002A,W01001148,832,506,281,225,1,1,78,8,70,247,211,36,0
2021,Rhondda Cynon Taf 003A,W01001149,626,435,264,171,0,0,100,51,49,91,77,14,0
2021,Rhondda Cynon Taf 003B,W01001150,871,448,261,187,0,0,76,27,49,347,331,16,0
2021,Rhondda Cynon Taf 003C,W01001151,787,664,396,268,1,1,59,12,47,63,45,18,0
2021,Rhondda Cynon Taf 002B,W01001152,834,665,371,294,1,1,84,41,43,83,49,34,1
2021,Rhondda Cynon Taf 002C,W01001153,684,408,217,191,0,0,139,72,67,137,118,19,0
2021,Rhondda Cynon Taf 003D,W01001154,687,422,249,173,1,1,145,69,76,116,98,18,3
2021,Rhondda Cynon Taf 002D,W01001155,699,476,302,174,0,0,31,7,24,192,166,26,0
2021,Rhondda Cynon Taf 003E,W01001156,549,515,262,253,1,1,6,2,4,27,18,9,0
2021,Rhondda Cynon Taf 028A,W01001157,594,474,262,212,0,0,27,2,25,93,80,13,0
2021,Rhondda Cynon Taf 028B,W01001158,639,443,215,228,0,0,109,42,67,86,75,11,1
2021,Rhondda Cynon Taf 028C,W01001159,654,527,202,325,4,4,18,1,17,105,92,13,0
2021,Rhondda Cynon Taf 029A,W01001160,678,582,332,250,1,1,10,4,6,85,75,10,0
2021,Rhondda Cynon Taf 025A,W01001162,1063,681,249,432,3,3,264,130,134,110,93,17,5
2021,Rhondda Cynon Taf 019A,W01001164,672,508,256,252,0,0,18,11,7,146,128,18,0
2021,Rhondda Cynon Taf 019B,W01001165,579,406,208,198,1,1,80,31,49,92,79,13,0
2021,Rhondda Cynon Taf 016A,W01001166,577,346,222,124,3,3,28,11,17,200,178,22,0
2021,Rhondda Cynon Taf 016B,W01001167,627,425,268,157,0,0,18,5,13,184,156,28,0
2021,Rhondda Cynon Taf 004B,W01001168,609,444,287,157,0,0,79,45,34,84,70,14,2
2021,Rhondda Cynon Taf 004C,W01001169,1053,611,256,355,2,2,357,151,206,80,61,19,3
2021,Rhondda Cynon Taf 004D,W01001170,529,484,312,172,1,1,9,3,6,35,28,7,0
2021,Rhondda Cynon Taf 017A,W01001171,617,456,287,169,3,3,38,8,30,120,106,14,0
2021,Rhondda Cynon Taf 020A,W01001172,636,489,280,209,0,0,35,18,17,110,98,12,2
2021,Rhondda Cynon Taf 020B,W01001173,620,365,209,156,4,4,175,115,60,75,64,11,1
2021,Rhondda Cynon Taf 020C,W01001174,628,287,177,110,1,1,229,156,73,111,97,14,0
2021,Rhondda Cynon Taf 009A,W01001175,596,432,287,145,0,0,45,25,20,119,107,12,0
2021,Rhondda Cynon Taf 013A,W01001176,620,440,274,166,1,1,26,3,23,153,134,19,0
2021,Rhondda Cynon Taf 009B,W01001177,602,450,315,135,1,1,14,2,12,137,117,20,0
2021,Rhondda Cynon Taf 023A,W01001178,688,479,261,218,1,1,87,33,54,120,96,24,1
2021,Rhondda Cynon Taf 023B,W01001179,736,403,245,158,2,2,245,151,94,82,65,17,4
2021,Rhondda Cynon Taf 015A,W01001180,670,303,176,127,0,0,270,176,94,93,83,10,4
2021,Rhondda Cynon Taf 015B,W01001181,630,428,220,208,0,0,130,67,63,72,55,17,0
2021,Rhondda Cynon Taf 026A,W01001184,946,739,402,337,4,4,74,27,47,128,102,26,1
2021,Rhondda Cynon Taf 022A,W01001185,981,553,267,286,3,3,251,125,126,169,151,18,5
2021,Rhondda Cynon Taf 001A,W01001186,695,548,277,271,0,0,84,38,46,63,56,7,0
2021,Rhondda Cynon Taf 001B,W01001187,593,467,276,191,0,0,56,12,44,70,54,16,0
2021,Rhondda Cynon Taf 001C,W01001188,602,272,183,89,1,1,175,94,81,152,134,18,2
2021,Rhondda Cynon Taf 029C,W01001189,680,413,204,209,1,1,158,74,84,105,91,14,3
2021,Rhondda Cynon Taf 029D,W01001190,1174,930,391,539,2,2,76,18,58,165,140,25,1
2021,Rhondda Cynon Taf 031B,W01001192,607,282,144,138,1,1,273,92,181,51,37,14,0
2021,Rhondda Cynon Taf 030A,W01001193,474,428,257,171,0,0,12,9,3,34,23,11,0
2021,Rhondda Cynon Taf 030B,W01001194,876,772,373,399,3,3,8,4,4,93,78,15,0
2021,Rhondda Cynon Taf 030C,W01001195,653,444,237,207,0,0,116,50,66,92,73,19,1
2021,Rhondda Cynon Taf 027B,W01001196,615,510,238,272,1,1,14,3,11,90,78,12,0
2021,Rhondda Cynon Taf 027C,W01001197,493,469,289,180,0,0,6,2,4,18,13,5,0
2021,Rhondda Cynon Taf 027D,W01001198,659,561,316,245,1,1,13,5,8,84,70,14,0
2021,Rhondda Cynon Taf 027E,W01001199,707,608,305,303,0,0,20,6,14,79,66,13,0
2021,Rhondda Cynon Taf 009C,W01001202,821,467,335,132,0,0,143,44,99,211,174,37,0
2021,Rhondda Cynon Taf 009D,W01001203,587,259,178,81,2,2,259,134,125,64,45,19,3
2021,Rhondda Cynon Taf 006A,W01001204,681,529,253,276,0,0,26,5,21,126,111,15,0
2021,Rhondda Cynon Taf 006B,W01001205,699,485,302,183,0,0,101,41,60,112,100,12,1
2021,Rhondda Cynon Taf 006C,W01001206,635,439,271,168,1,1,98,27,71,96,82,14,1
2021,Rhondda Cynon Taf 006D,W01001207,556,269,156,113,0,0,226,132,94,60,46,14,1
2021,Rhondda Cynon Taf 006E,W01001208,734,471,290,181,0,0,58,15,43,201,181,20,4
2021,Rhondda Cynon Taf 008A,W01001209,582,244,155,89,1,1,202,95,107,134,113,21,1
2021,Rhondda Cynon Taf 008B,W01001210,640,415,259,156,2,2,59,23,36,163,144,19,1
2021,Rhondda Cynon Taf 008C,W01001211,629,405,255,150,2,2,57,11,46,165,147,18,0
2021,Rhondda Cynon Taf 008D,W01001212,585,373,219,154,3,3,76,8,68,133,118,15,0
2021,Rhondda Cynon Taf 011B,W01001214,529,453,276,177,0,0,18,8,10,58,46,12,0
2021,Rhondda Cynon Taf 011D,W01001216,656,481,288,193,0,0,42,15,27,132,111,21,1
2021,Rhondda Cynon Taf 018A,W01001217,465,278,163,115,0,0,110,76,34,76,67,9,1
2021,Rhondda Cynon Taf 018B,W01001218,639,476,290,186,0,0,16,10,6,147,125,22,0
2021,Rhondda Cynon Taf 018C,W01001219,602,291,178,113,0,0,189,70,119,118,106,12,4
2021,Rhondda Cynon Taf 018D,W01001220,622,456,264,192,1,1,49,27,22,116,95,21,0
2021,Rhondda Cynon Taf 001D,W01001221,612,330,225,105,2,2,197,129,68,81,68,13,2
2021,Rhondda Cynon Taf 001E,W01001222,640,214,136,78,1,1,355,199,156,65,48,17,5
2021,Rhondda Cynon Taf 031C,W01001223,781,653,364,289,3,3,13,3,10,112,94,18,0
2021,Rhondda Cynon Taf 031D,W01001224,766,705,320,385,0,0,5,1,4,56,49,7,0
2021,Rhondda Cynon Taf 031E,W01001225,654,585,327,258,2,2,3,1,2,64,52,12,0
2021,Rhondda Cynon Taf 031F,W01001226,716,470,212,258,0,0,132,40,92,114,98,16,0
2021,Rhondda Cynon Taf 021C,W01001227,550,464,279,185,0,0,20,5,15,66,53,13,0
2021,Rhondda Cynon Taf 021D,W01001228,744,543,350,193,3,3,67,12,55,131,119,12,0
2021,Rhondda Cynon Taf 017B,W01001229,643,488,277,211,0,0,10,4,6,144,128,16,1
2021,Rhondda Cynon Taf 017C,W01001230,628,558,332,226,1,1,7,2,5,62,45,17,0
2021,Rhondda Cynon Taf 017D,W01001231,679,404,232,172,1,1,60,13,47,214,192,22,0
2021,Rhondda Cynon Taf 020D,W01001232,590,373,232,141,0,0,108,39,69,108,97,11,1
2021,Rhondda Cynon Taf 001F,W01001233,782,645,421,224,0,0,75,37,38,62,46,16,0
2021,Rhondda Cynon Taf 021E,W01001234,661,556,350,206,1,1,12,3,9,92,74,18,0
2021,Rhondda Cynon Taf 021F,W01001235,748,460,247,213,2,2,82,15,67,204,163,41,0
2021,Rhondda Cynon Taf 021G,W01001236,661,528,303,225,1,1,32,8,24,100,82,18,0
2021,Rhondda Cynon Taf 022B,W01001237,602,356,189,167,0,0,198,75,123,48,32,16,0
2021,Rhondda Cynon Taf 022C,W01001238,691,213,114,99,1,1,432,69,363,43,37,6,2
2021,Rhondda Cynon Taf 026B,W01001239,626,252,134,118,0,0,300,122,178,72,64,8,2
2021,Rhondda Cynon Taf 026C,W01001240,857,704,358,346,0,0,63,32,31,90,74,16,0
2021,Rhondda Cynon Taf 026D,W01001241,756,499,233,266,3,3,143,44,99,107,87,20,4
2021,Rhondda Cynon Taf 030D,W01001242,575,460,262,198,0,0,57,21,36,57,44,13,1
2021,Rhondda Cynon Taf 030E,W01001243,689,322,180,142,0,0,276,78,198,88,76,12,3
2021,Rhondda Cynon Taf 025B,W01001244,627,573,397,176,1,1,22,6,16,31,19,12,0
2021,Rhondda Cynon Taf 025C,W01001245,515,493,320,173,2,2,4,2,2,16,14,2,0
2021,Rhondda Cynon Taf 025D,W01001246,620,470,280,190,0,0,81,35,46,69,60,9,0
2021,Rhondda Cynon Taf 016C,W01001247,719,475,279,196,1,1,63,24,39,178,160,18,2
2021,Rhondda Cynon Taf 016D,W01001248,859,619,341,278,0,0,49,7,42,191,158,33,0
2021,Rhondda Cynon Taf 024A,W01001249,700,474,304,170,2,2,98,33,65,126,103,23,0
2021,Rhondda Cynon Taf 024B,W01001250,624,518,282,236,0,0,25,18,7,81,56,25,0
2021,Rhondda Cynon Taf 024C,W01001251,664,255,135,120,1,1,343,177,166,64,55,9,1
2021,Rhondda Cynon Taf 024D,W01001252,668,557,276,281,0,0,19,7,12,92,80,12,0
2021,Rhondda Cynon Taf 023C,W01001253,605,454,241,213,2,2,54,33,21,93,78,15,2
2021,Rhondda Cynon Taf 023E,W01001255,836,498,224,274,0,0,236,147,89,101,85,16,1
2021,Rhondda Cynon Taf 019C,W01001256,535,379,223,156,2,2,20,5,15,134,116,18,0
2021,Rhondda Cynon Taf 019D,W01001257,533,438,252,186,2,2,48,22,26,43,31,12,2
2021,Rhondda Cynon Taf 019E,W01001258,639,419,248,171,2,2,76,16,60,141,121,20,1
2021,Rhondda Cynon Taf 018E,W01001259,675,509,288,221,1,1,78,21,57,87,65,22,0
2021,Rhondda Cynon Taf 014C,W01001260,507,267,156,111,3,3,100,41,59,137,120,17,0
2021,Rhondda Cynon Taf 018F,W01001261,557,378,230,148,1,1,11,7,4,167,132,35,0
2021,Rhondda Cynon Taf 022D,W01001262,621,259,133,126,1,1,87,11,76,274,248,26,0
2021,Rhondda Cynon Taf 022E,W01001263,633,213,127,86,1,1,76,8,68,342,319,23,1
2021,Rhondda Cynon Taf 022F,W01001264,511,206,121,85,3,3,33,23,10,269,255,14,0
2021,Rhondda Cynon Taf 007A,W01001265,732,537,340,197,1,1,42,9,33,151,129,22,1
2021,Rhondda Cynon Taf 007B,W01001266,623,318,218,100,3,3,191,47,144,111,93,18,0
2021,Rhondda Cynon Taf 007C,W01001267,680,452,324,128,1,1,117,48,69,108,98,10,2
2021,Rhondda Cynon Taf 007D,W01001268,589,406,278,128,2,2,27,9,18,154,133,21,0
2021,Rhondda Cynon Taf 010A,W01001269,641,510,336,174,1,1,9,1,8,121,100,21,0
2021,Rhondda Cynon Taf 010B,W01001270,650,483,285,198,0,0,33,6,27,134,120,14,0
2021,Rhondda Cynon Taf 010C,W01001271,721,466,312,154,1,1,58,16,42,195,175,20,1
2021,Rhondda Cynon Taf 010D,W01001272,612,423,280,143,2,2,117,20,97,70,54,16,0
2021,Rhondda Cynon Taf 010E,W01001273,761,574,388,186,3,3,61,8,53,122,105,17,1
2021,Rhondda Cynon Taf 013B,W01001274,522,214,143,71,1,1,172,103,69,132,118,14,3
2021,Rhondda Cynon Taf 013C,W01001275,795,496,302,194,1,1,47,15,32,251,232,19,0
2021,Rhondda Cynon Taf 013D,W01001276,631,367,256,111,1,1,65,4,61,198,187,11,0
2021,Rhondda Cynon Taf 028D,W01001277,459,409,229,180,0,0,22,12,10,28,26,2,0
2021,Rhondda Cynon Taf 028E,W01001278,435,304,154,150,0,0,60,28,32,71,65,6,0
2021,Rhondda Cynon Taf 028F,W01001279,504,246,149,97,0,0,199,113,86,56,48,8,3
2021,Rhondda Cynon Taf 017E,W01001280,763,372,230,142,1,1,194,81,113,195,179,16,1
2021,Rhondda Cynon Taf 017F,W01001281,740,570,329,241,0,0,12,7,5,158,133,25,0
2021,Rhondda Cynon Taf 015C,W01001282,890,565,329,236,1,1,110,41,69,213,194,19,1
2021,Rhondda Cynon Taf 015D,W01001283,630,465,286,179,3,3,86,35,51,76,56,20,0
2021,Rhondda Cynon Taf 015E,W01001284,436,396,186,210,0,0,2,0,2,38,33,5,0
2021,Rhondda Cynon Taf 014D,W01001285,598,429,261,168,1,1,31,9,22,137,123,14,0
2021,Rhondda Cynon Taf 014E,W01001286,622,457,245,212,3,3,19,4,15,143,124,19,0
2021,Rhondda Cynon Taf 014F,W01001287,647,438,279,159,2,2,71,29,42,136,113,23,0
2021,Rhondda Cynon Taf 014G,W01001288,670,349,212,137,2,2,196,76,120,122,88,34,1
2021,Merthyr Tydfil 006A,W01001289,617,433,291,142,2,2,56,14,42,126,92,34,0
2021,Merthyr Tydfil 007A,W01001290,979,704,303,401,1,1,150,59,91,124,99,25,0
2021,Merthyr Tydfil 003A,W01001291,797,590,264,326,2,2,110,21,89,95,82,13,0
2021,Merthyr Tydfil 004A,W01001292,759,314,165,149,0,0,337,152,185,104,83,21,4
2021,Merthyr Tydfil 004B,W01001293,793,482,270,212,0,0,203,83,120,106,93,13,2
2021,Merthyr Tydfil 003B,W01001294,698,616,347,269,0,0,11,4,7,71,52,19,0
2021,Merthyr Tydfil 002A,W01001295,708,348,198,150,0,0,245,105,140,112,98,14,3
2021,Merthyr Tydfil 002B,W01001296,651,505,299,206,0,0,73,30,43,72,56,16,1
2021,Merthyr Tydfil 002C,W01001297,830,521,295,226,0,0,120,38,82,188,155,33,1
2021,Merthyr Tydfil 002D,W01001298,845,332,176,156,4,4,329,59,270,179,155,24,1
2021,Merthyr Tydfil 008A,W01001299,695,266,160,106,3,3,339,207,132,85,70,15,2
2021,Merthyr Tydfil 008B,W01001300,692,255,176,79,0,0,371,240,131,63,52,11,3
2021,Merthyr Tydfil 008C,W01001301,771,320,194,126,0,0,361,217,144,83,69,14,7
2021,Merthyr Tydfil 006B,W01001302,622,391,192,199,3,3,125,18,107,103,88,15,0
2021,Merthyr Tydfil 003C,W01001305,509,367,228,139,1,1,58,9,49,83,74,9,0
2021,Merthyr Tydfil 003D,W01001306,652,517,308,209,0,0,46,8,38,89,80,9,0
2021,Merthyr Tydfil 004C,W01001307,813,310,187,123,1,1,382,72,310,118,102,16,2
2021,Merthyr Tydfil 008D,W01001308,482,214,124,90,0,0,231,163,68,35,27,8,2
2021,Merthyr Tydfil 008E,W01001309,517,258,143,115,0,0,199,111,88,56,48,8,4
2021,Merthyr Tydfil 002E,W01001310,669,485,278,207,0,0,108,27,81,73,60,13,3
2021,Merthyr Tydfil 002F,W01001311,515,310,155,155,0,0,81,21,60,124,104,20,0
2021,Merthyr Tydfil 006E,W01001312,657,370,221,149,2,2,219,53,166,65,53,12,1
2021,Merthyr Tydfil 006F,W01001313,692,480,300,180,0,0,44,9,35,168,140,28,0
2021,Merthyr Tydfil 005A,W01001314,933,672,389,283,3,3,105,35,70,150,129,21,3
2021,Merthyr Tydfil 004D,W01001315,897,340,211,129,2,2,224,57,167,330,287,43,1
2021,Merthyr Tydfil 005C,W01001317,754,500,285,215,1,1,172,67,105,81,68,13,0
2021,Merthyr Tydfil 005D,W01001318,671,526,314,212,2,2,32,5,27,111,91,20,0
2021,Merthyr Tydfil 007B,W01001319,676,610,352,258,0,0,18,6,12,48,35,13,0
2021,Merthyr Tydfil 007C,W01001320,667,487,296,191,1,1,93,12,81,86,79,7,0
2021,Merthyr Tydfil 007D,W01001321,652,424,213,211,1,1,111,41,70,116,100,16,0
2021,Merthyr Tydfil 007E,W01001322,733,478,270,208,2,2,96,17,79,157,130,27,0
2021,Merthyr Tydfil 003E,W01001324,870,618,396,222,1,1,123,46,77,126,104,22,2
2021,Caerphilly 003A,W01001325,658,408,184,224,3,3,195,181,14,52,44,8,0
2021,Caerphilly 003B,W01001326,965,518,259,259,2,2,284,144,140,160,136,24,1
2021,Caerphilly 014A,W01001327,1090,760,359,401,11,11,138,47,91,181,152,29,0
2021,Caerphilly 014B,W01001328,655,428,206,222,1,1,138,118,20,86,71,15,2
2021,Caerphilly 014C,W01001329,653,432,243,189,2,2,106,79,27,113,93,20,0
2021,Caerphilly 018A,W01001330,615,424,206,218,3,3,122,91,31,65,49,16,1
2021,Caerphilly 018B,W01001331,732,490,243,247,3,3,80,32,48,159,128,31,0
2021,Caerphilly 018C,W01001332,804,442,222,220,1,1,174,89,85,186,167,19,1
2021,Caerphilly 018D,W01001333,626,364,166,198,0,0,144,50,94,118,102,16,0
2021,Caerphilly 005A,W01001334,595,297,151,146,0,0,218,122,96,80,73,7,0
2021,Caerphilly 005B,W01001335,530,431,224,207,3,3,41,37,4,55,38,17,0
2021,Caerphilly 004A,W01001336,614,415,230,185,1,1,114,103,11,84,70,14,0
2021,Caerphilly 004B,W01001337,665,470,291,179,1,1,55,6,49,139,124,15,0
2021,Caerphilly 004C,W01001338,802,521,292,229,3,3,35,32,3,243,215,28,0
2021,Caerphilly 004D,W01001339,590,218,129,89,0,0,318,315,3,54,50,4,0
2021,Caerphilly 020A,W01001340,772,671,336,335,1,1,59,42,17,41,32,9,0
2021,Caerphilly 020B,W01001341,761,408,212,196,0,0,259,192,67,93,84,9,1
2021,Caerphilly 021A,W01001342,514,400,211,189,0,0,55,48,7,59,52,7,0
2021,Caerphilly 021B,W01001343,484,402,230,172,0,0,30,25,5,52,47,5,0
2021,Caerphilly 020C,W01001344,716,515,292,223,1,1,117,71,46,83,61,22,0
2021,Caerphilly 021C,W01001345,577,209,127,82,0,0,329,309,20,39,33,6,0
2021,Caerphilly 020D,W01001346,655,444,242,202,1,1,98,72,26,112,92,20,0
2021,Caerphilly 005C,W01001347,647,478,287,191,7,7,93,60,33,69,60,9,0
2021,Caerphilly 009A,W01001348,725,374,167,207,0,0,277,206,71,73,69,4,1
2021,Caerphilly 009B,W01001349,672,564,264,300,0,0,49,13,36,58,53,5,1
2021,Caerphilly 009C,W01001350,792,581,318,263,1,1,54,35,19,155,138,17,1
2021,Caerphilly 005D,W01001351,643,551,356,195,2,2,35,32,3,55,46,9,0
2021,Caerphilly 007A,W01001352,744,433,237,196,1,1,229,211,18,81,69,12,0
2021,Caerphilly 007B,W01001353,742,461,293,168,2,2,230,151,79,45,38,7,4
2021,Caerphilly 014D,W01001354,721,567,285,282,0,0,51,28,23,103,83,20,0
2021,Caerphilly 015A,W01001355,754,421,240,181,2,2,228,148,80,103,91,12,0
2021,Caerphilly 006A,W01001356,478,422,228,194,1,1,15,14,1,40,29,11,0
2021,Caerphilly 006B,W01001357,722,535,279,256,11,11,113,56,57,63,55,8,0
2021,Caerphilly 006C,W01001358,618,347,218,129,0,0,220,196,24,50,37,13,1
2021,Caerphilly 006D,W01001359,639,485,252,233,6,6,46,5,41,102,84,18,0
2021,Caerphilly 002A,W01001360,562,443,270,173,1,1,44,28,16,74,52,22,0
2021,Caerphilly 002B,W01001361,486,293,178,115,1,1,135,132,3,57,50,7,0
2021,Caerphilly 003C,W01001362,899,593,325,268,0,0,151,124,27,155,129,26,0
2021,Caerphilly 012A,W01001363,710,536,217,319,0,0,90,29,61,84,71,13,0
2021,Caerphilly 012B,W01001364,676,369,164,205,1,1,214,167,47,91,74,17,1
2021,Caerphilly 012C,W01001365,821,590,267,323,1,1,160,65,95,70,63,7,0
2021,Caerphilly 019A,W01001366,701,558,305,253,5,5,55,5,50,83,72,11,0
2021,Caerphilly 019B,W01001367,661,477,241,236,3,3,50,23,27,131,115,16,0
2021,Caerphilly 019C,W01001368,647,360,183,177,2,2,204,97,107,80,71,9,1
2021,Caerphilly 012D,W01001369,1056,817,418,399,1,1,139,112,27,99,72,27,0
2021,Caerphilly 023A,W01001370,836,569,299,270,0,0,154,98,56,112,86,26,1
2021,Caerphilly 022A,W01001371,822,471,173,298,8,8,263,183,80,78,67,11,2
2021,Caerphilly 022B,W01001372,816,614,358,256,23,23,86,7,79,93,77,16,0
2021,Caerphilly 022C,W01001373,823,602,270,332,5,5,78,28,50,138,111,27,0
2021,Caerphilly 001A,W01001374,594,408,249,159,1,1,94,75,19,91,75,16,0
2021,Caerphilly 001B,W01001375,724,405,235,170,3,3,201,138,63,115,92,23,0
2021,Caerphilly 001C,W01001376,650,283,173,110,1,1,317,283,34,49,41,8,0
2021,Caerphilly 013A,W01001377,672,533,328,205,1,1,61,9,52,77,59,18,0
2021,Caerphilly 013B,W01001378,678,432,267,165,0,0,179,161,18,65,53,12,2
2021,Caerphilly 013C,W01001379,640,497,277,220,1,1,87,47,40,55,42,13,0
2021,Caerphilly 010A,W01001380,768,584,312,272,1,1,72,64,8,111,92,19,0
2021,Caerphilly 010B,W01001381,614,304,191,113,0,0,256,210,46,53,43,10,1
2021,Caerphilly 010C,W01001382,684,495,294,201,1,1,77,57,20,109,99,10,2
2021,Caerphilly 010D,W01001383,658,424,233,191,1,1,99,70,29,132,115,17,2
2021,Caerphilly 002C,W01001384,697,473,283,190,0,0,38,19,19,186,166,20,0
2021,Caerphilly 002D,W01001385,676,416,229,187,1,1,99,92,7,158,142,16,2
2021,Caerphilly 002E,W01001386,692,333,207,126,0,0,257,188,69,102,88,14,0
2021,Caerphilly 007C,W01001387,531,294,157,137,0,0,124,109,15,113,96,17,0
2021,Caerphilly 007D,W01001388,759,441,228,213,7,7,225,58,167,84,74,10,2
2021,Caerphilly 007E,W01001389,462,356,196,160,1,1,48,28,20,57,44,13,0
2021,Caerphilly 006E,W01001390,801,680,303,377,2,2,41,4,37,78,67,11,0
2021,Caerphilly 006F,W01001391,673,458,249,209,2,2,126,63,63,87,78,9,0
2021,Caerphilly 009D,W01001392,831,712,384,328,5,5,32,22,10,82,58,24,0
2021,Caerphilly 019D,W01001393,537,335,172,163,1,1,147,118,29,54,47,7,0
2021,Caerphilly 023B,W01001394,502,469,239,230,1,1,7,4,3,25,20,5,0
2021,Caerphilly 023C,W01001395,590,376,224,152,1,1,162,152,10,51,40,11,0
2021,Caerphilly 023D,W01001396,643,322,161,161,1,1,263,142,121,55,45,10,2
2021,Caerphilly 019E,W01001397,683,550,281,269,1,1,53,39,14,79,70,9,0
2021,Caerphilly 024A,W01001398,1060,785,250,535,0,0,115,12,103,160,135,25,0
2021,Caerphilly 023E,W01001399,562,457,257,200,4,4,35,23,12,66,51,15,0
2021,Caerphilly 019F,W01001400,560,234,106,128,0,0,268,252,16,56,51,5,2
2021,Caerphilly 011A,W01001401,887,553,301,252,2,2,216,198,18,116,102,14,0
2021,Caerphilly 011B,W01001402,683,407,198,209,1,1,197,174,23,77,65,12,1
2021,Caerphilly 011C,W01001403,687,486,257,229,1,1,67,44,23,133,121,12,0
2021,Caerphilly 011D,W01001404,592,545,364,181,0,0,12,10,2,35,32,3,0
2021,Caerphilly 011E,W01001405,747,490,278,212,3,3,190,120,70,64,57,7,0
2021,Caerphilly 001D,W01001406,860,522,305,217,1,1,213,202,11,124,101,23,0
2021,Caerphilly 016A,W01001407,607,478,274,204,0,0,66,36,30,63,54,9,0
2021,Caerphilly 016B,W01001408,605,340,173,167,5,5,200,174,26,60,53,7,0
2021,Caerphilly 016C,W01001409,697,540,307,233,4,4,84,46,38,69,59,10,0
2021,Caerphilly 016D,W01001410,830,516,268,248,7,7,214,190,24,93,84,9,0
2021,Caerphilly 017A,W01001411,765,510,300,210,0,0,166,97,69,89,77,12,0
2021,Caerphilly 017B,W01001412,835,541,323,218,4,4,56,49,7,234,213,21,0
2021,Caerphilly 017C,W01001413,765,507,266,241,4,4,160,134,26,93,63,30,1
2021,Caerphilly 008A,W01001414,692,368,194,174,1,1,252,210,42,68,54,14,3
2021,Caerphilly 008B,W01001415,719,483,238,245,2,2,94,45,49,140,115,25,0
2021,Caerphilly 008C,W01001416,627,477,272,205,0,0,61,26,35,87,74,13,2
2021,Caerphilly 008D,W01001417,581,497,243,254,1,1,17,7,10,66,50,16,0
2021,Caerphilly 008E,W01001418,631,379,208,171,3,3,171,142,29,77,63,14,1
2021,Caerphilly 021D,W01001419,667,525,284,241,2,2,82,69,13,58,39,19,0
2021,Caerphilly 022D,W01001420,556,421,251,170,2,2,18,14,4,115,103,12,0
2021,Caerphilly 022E,W01001421,684,152,78,74,0,0,471,335,136,60,55,5,1
2021,Caerphilly 022F,W01001422,659,357,248,109,1,1,227,219,8,73,65,8,1
2021,Caerphilly 024B,W01001423,642,568,366,202,2,2,10,4,6,62,44,18,0
2021,Caerphilly 024C,W01001424,652,402,228,174,3,3,118,107,11,129,111,18,0
2021,Caerphilly 024D,W01001425,790,602,322,280,3,3,79,13,66,106,91,15,0
2021,Caerphilly 024E,W01001426,576,512,260,252,0,0,42,7,35,22,12,10,0
2021,Caerphilly 024F,W01001427,741,614,230,384,1,1,27,8,19,99,95,4,0
2021,Caerphilly 001E,W01001428,528,201,135,66,0,0,295,288,7,32,27,5,0
2021,Caerphilly 001F,W01001429,530,380,228,152,3,3,64,37,27,82,76,6,1
2021,Caerphilly 015B,W01001430,1016,651,325,326,9,9,169,87,82,187,155,32,0
2021,Caerphilly 015C,W01001431,654,516,265,251,1,1,33,8,25,104,86,18,0
2021,Caerphilly 013D,W01001432,1134,785,320,465,2,2,155,52,103,192,174,18,0
2021,Caerphilly 013E,W01001433,646,459,270,189,0,0,39,11,28,148,134,14,0
2021,Caerphilly 013F,W01001434,548,487,244,243,1,1,5,5,0,55,37,18,0
2021,Blaenau Gwent 008A,W01001435,618,388,220,168,1,1,33,3,30,196,166,30,0
2021,Blaenau Gwent 008B,W01001436,666,333,215,118,1,1,77,16,61,255,236,19,0
2021,Blaenau Gwent 008C,W01001437,643,497,311,186,1,1,33,6,27,111,94,17,1
2021,Blaenau Gwent 004A,W01001438,686,403,204,199,1,1,229,65,164,52,41,11,1
2021,Blaenau Gwent 004B,W01001439,679,523,299,224,0,0,91,39,52,65,48,17,0
2021,Blaenau Gwent 001A,W01001440,606,381,241,140,1,1,180,52,128,44,36,8,0
2021,Blaenau Gwent 001B,W01001441,488,209,107,102,0,0,229,118,111,48,43,5,2
2021,Blaenau Gwent 001C,W01001442,478,416,261,155,0,0,6,1,5,56,40,16,0
2021,Blaenau Gwent 005A,W01001443,625,344,195,149,1,1,158,37,121,122,103,19,0
2021,Blaenau Gwent 005B,W01001444,840,568,300,268,0,0,195,78,117,77,60,17,0
2021,Blaenau Gwent 005C,W01001445,607,405,241,164,1,1,92,30,62,109,96,13,0
2021,Blaenau Gwent 002A,W01001446,511,369,215,154,3,3,84,20,64,55,42,13,0
2021,Blaenau Gwent 002B,W01001447,614,302,159,143,1,1,234,99,135,75,67,8,2
2021,Blaenau Gwent 002C,W01001448,600,347,204,143,1,1,88,14,74,163,155,8,1
2021,Blaenau Gwent 002D,W01001449,698,382,212,170,0,0,193,50,143,123,110,13,0
2021,Blaenau Gwent 007A,W01001450,532,358,217,141,1,1,93,43,50,80,59,21,0
2021,Blaenau Gwent 007B,W01001451,642,379,258,121,1,1,73,8,65,189,163,26,0
2021,Blaenau Gwent 007C,W01001452,635,474,267,207,0,0,55,5,50,106,93,13,0
2021,Blaenau Gwent 008D,W01001453,630,324,186,138,1,1,258,118,140,46,41,5,1
2021,Blaenau Gwent 008E,W01001454,581,372,212,160,1,1,150,65,85,56,47,9,2
2021,Blaenau Gwent 008F,W01001455,770,439,271,168,1,1,160,36,124,169,153,16,1
2021,Blaenau Gwent 004C,W01001456,555,345,184,161,1,1,108,49,59,101,97,4,0
2021,Blaenau Gwent 004D,W01001457,799,246,150,96,0,0,448,214,234,99,91,8,6
2021,Blaenau Gwent 004E,W01001458,723,557,295,262,1,1,57,22,35,106,89,17,2
2021,Blaenau Gwent 007D,W01001459,479,230,139,91,0,0,183,79,104,64,56,8,2
2021,Blaenau Gwent 007E,W01001460,791,477,232,245,0,0,70,5,65,244,220,24,0
2021,Blaenau Gwent 007F,W01001461,624,354,199,155,0,0,114,18,96,155,140,15,1
2021,Blaenau Gwent 006A,W01001462,804,537,235,302,2,2,176,76,100,82,70,12,7
2021,Blaenau Gwent 006B,W01001463,860,651,357,294,0,0,41,11,30,168,136,32,0
2021,Blaenau Gwent 009A,W01001464,659,333,188,145,0,0,216,88,128,110,88,22,0
2021,Blaenau Gwent 009B,W01001465,695,380,233,147,1,1,224,85,139,90,76,14,0
2021,Blaenau Gwent 009C,W01001466,735,443,276,167,2,2,71,18,53,219,199,20,0
2021,Blaenau Gwent 005D,W01001467,801,431,216,215,1,1,291,135,156,74,58,16,4
2021,Blaenau Gwent 005E,W01001468,605,369,214,155,1,1,140,73,67,95,84,11,0
2021,Blaenau Gwent 005F,W01001469,554,271,178,93,0,0,241,89,152,40,33,7,2
2021,Blaenau Gwent 001D,W01001470,623,511,315,196,2,2,72,36,36,38,29,9,0
2021,Blaenau Gwent 001E,W01001471,737,297,175,122,1,1,364,182,182,72,63,9,3
2021,Blaenau Gwent 003A,W01001472,604,519,304,215,0,0,40,17,23,45,34,11,0
2021,Blaenau Gwent 003B,W01001473,570,197,146,51,0,0,322,147,175,51,42,9,0
2021,Blaenau Gwent 003C,W01001474,633,380,252,128,3,3,205,87,118,45,28,17,0
2021,Blaenau Gwent 003D,W01001475,487,371,193,178,0,0,49,12,37,66,55,11,1
2021,Blaenau Gwent 006C,W01001478,646,479,286,193,2,2,45,11,34,120,97,23,0
2021,Blaenau Gwent 006D,W01001479,676,230,153,77,0,0,381,180,201,63,54,9,2
2021,Blaenau Gwent 003E,W01001480,649,324,181,143,2,2,272,152,120,48,30,18,3
2021,Blaenau Gwent 006E,W01001481,828,379,241,138,0,0,263,67,196,186,166,20,0
2021,Torfaen 002A,W01001482,515,298,171,127,1,1,176,77,99,37,32,5,3
2021,Torfaen 002B,W01001483,583,268,140,128,0,0,259,101,158,56,43,13,0
2021,Torfaen 002C,W01001484,676,559,313,246,1,1,65,17,48,51,33,18,0
2021,Torfaen 002D,W01001485,553,269,152,117,1,1,249,66,183,34,26,8,0
2021,Torfaen 002E,W01001486,644,446,223,223,1,1,106,36,70,91,77,14,0
2021,Torfaen 001A,W01001487,716,470,257,213,1,1,160,57,103,85,72,13,0
2021,Torfaen 001B,W01001488,649,308,169,139,2,2,265,110,155,73,51,22,1
2021,Torfaen 001C,W01001489,676,363,230,133,0,0,192,36,156,119,100,19,2
2021,Torfaen 001D,W01001490,652,424,257,167,1,1,90,28,62,137,110,27,0
2021,Torfaen 004A,W01001491,797,479,252,227,2,2,198,90,108,117,95,22,1
2021,Torfaen 012A,W01001492,992,730,390,340,3,3,196,76,120,63,50,13,0
2021,Torfaen 008A,W01001493,880,515,281,234,0,0,206,71,135,159,135,24,0
2021,Torfaen 008B,W01001494,660,529,318,211,0,0,62,23,39,69,62,7,0
2021,Torfaen 008C,W01001495,827,610,378,232,0,0,137,29,108,80,66,14,0
2021,Torfaen 004B,W01001496,644,369,211,158,1,1,216,113,103,58,41,17,0
2021,Torfaen 011A,W01001497,588,342,163,179,3,3,183,71,112,59,51,8,1
2021,Torfaen 011B,W01001498,525,302,174,128,1,1,180,58,122,41,32,9,1
2021,Torfaen 011C,W01001499,510,329,148,181,18,18,99,42,57,64,55,9,0
2021,Torfaen 011D,W01001500,500,400,187,213,50,50,4,1,3,46,37,9,0
2021,Torfaen 009A,W01001501,512,261,126,135,0,0,185,68,117,66,54,12,0
2021,Torfaen 011E,W01001502,492,405,224,181,0,0,41,21,20,46,42,4,0
2021,Torfaen 009B,W01001503,485,234,107,127,2,2,165,64,101,84,68,16,0
2021,Torfaen 013A,W01001504,995,639,309,330,8,8,255,86,169,92,74,18,1
2021,Torfaen 013B,W01001505,1099,866,345,521,5,5,138,30,108,90,68,22,0
2021,Torfaen 010A,W01001506,780,358,201,157,5,5,309,94,215,108,94,14,0
2021,Torfaen 008D,W01001507,879,625,368,257,0,0,142,41,101,112,88,24,0
2021,Torfaen 013C,W01001508,513,417,269,148,3,3,44,23,21,48,37,11,1
2021,Torfaen 013D,W01001509,605,550,350,200,0,0,24,9,15,31,27,4,0
2021,Torfaen 005A,W01001510,740,501,297,204,5,5,155,46,109,79,68,11,0
2021,Torfaen 005B,W01001511,717,479,275,204,4,4,169,39,130,63,48,15,2
2021,Torfaen 005C,W01001512,608,565,387,178,1,1,12,2,10,30,25,5,0
2021,Torfaen 005D,W01001513,626,572,348,224,0,0,10,5,5,44,34,10,0
2021,Torfaen 006A,W01001514,490,406,244,162,3,3,25,9,16,56,40,16,0
2021,Torfaen 006B,W01001515,635,431,217,214,2,2,56,10,46,146,129,17,0
2021,Torfaen 006C,W01001516,625,338,197,141,1,1,232,94,138,52,41,11,2
2021,Torfaen 006D,W01001517,1023,812,339,473,10,10,84,31,53,117,107,10,0
2021,Torfaen 006E,W01001518,488,424,269,155,2,2,39,14,25,23,14,9,0
2021,Torfaen 007A,W01001519,592,191,104,87,3,3,299,93,206,97,85,12,2
2021,Torfaen 007B,W01001520,1065,781,305,476,4,4,165,35,130,115,96,19,0
2021,Torfaen 007C,W01001521,614,379,195,184,7,7,118,53,65,109,91,18,1
2021,Torfaen 007D,W01001522,749,376,188,188,2,2,306,102,204,63,53,10,2
2021,Torfaen 004C,W01001523,635,415,228,187,6,6,85,18,67,129,110,19,0
2021,Torfaen 004D,W01001524,894,518,290,228,13,13,196,48,148,167,153,14,0
2021,Torfaen 003A,W01001525,723,454,234,220,6,6,218,85,133,43,32,11,2
2021,Torfaen 010B,W01001526,600,291,161,130,7,7,243,117,126,58,51,7,1
2021,Torfaen 010C,W01001527,624,270,163,107,9,9,260,83,177,85,66,19,0
2021,Torfaen 010D,W01001528,730,505,188,317,1,1,173,50,123,50,38,12,1
2021,Torfaen 003B,W01001529,948,538,303,235,0,0,293,96,197,117,101,16,0
2021,Torfaen 003C,W01001530,672,211,100,111,3,3,398,177,221,55,42,13,5
2021,Torfaen 003D,W01001531,722,425,235,190,2,2,227,88,139,68,49,19,0
2021,Torfaen 010E,W01001532,751,380,183,197,1,1,289,120,169,80,60,20,1
2021,Torfaen 012B,W01001533,629,544,283,261,3,3,29,7,22,53,39,14,0
2021,Torfaen 012C,W01001534,630,434,235,199,3,3,138,43,95,55,44,11,0
2021,Torfaen 012D,W01001535,564,387,237,150,1,1,123,26,97,53,45,8,0
2021,Torfaen 009C,W01001536,474,159,81,78,0,0,276,84,192,39,39,0,0
2021,Torfaen 007E,W01001537,510,404,254,150,19,19,34,12,22,53,42,11,0
2021,Torfaen 009D,W01001538,589,269,132,137,0,0,254,98,156,65,54,11,1
2021,Torfaen 009E,W01001539,598,347,180,167,0,0,169,68,101,82,76,6,0
2021,Torfaen 004E,W01001540,554,402,195,207,1,1,63,8,55,88,74,14,0
2021,Torfaen 004F,W01001541,468,335,185,150,0,0,89,24,65,44,32,12,0
2021,Monmouthshire 009A,W01001542,886,672,354,318,6,6,102,26,76,106,90,16,0
2021,Monmouthshire 009B,W01001543,713,621,333,288,2,2,34,1,33,56,44,12,0
2021,Monmouthshire 001A,W01001545,671,574,429,145,4,4,26,10,16,67,54,13,0
2021,Monmouthshire 002A,W01001546,690,323,190,133,1,1,275,83,192,90,79,11,1
2021,Monmouthshire 001B,W01001548,900,739,516,223,0,0,52,15,37,109,78,31,0
2021,Monmouthshire 007A,W01001549,600,507,330,177,1,1,23,3,20,69,54,15,0
2021,Monmouthshire 010C,W01001551,463,290,146,144,0,0,126,63,63,46,40,6,1
2021,Monmouthshire 004A,W01001552,633,586,417,169,2,2,6,3,3,39,30,9,0
2021,Monmouthshire 004C,W01001554,765,461,353,108,3,3,62,8,54,237,199,38,2
2021,Monmouthshire 006A,W01001555,496,432,290,142,0,0,5,1,4,59,49,10,0
2021,Monmouthshire 006B,W01001556,593,439,255,184,5,5,100,25,75,49,42,7,0
2021,Monmouthshire 001C,W01001557,944,483,304,179,2,2,192,44,148,264,213,51,3
2021,Monmouthshire 002C,W01001558,738,411,254,157,4,4,248,98,150,74,56,18,1
2021,Monmouthshire 008A,W01001559,560,446,276,170,1,1,66,22,44,47,36,11,0
2021,Monmouthshire 006C,W01001560,545,456,277,179,1,1,8,4,4,80,63,17,0
2021,Monmouthshire 003A,W01001561,692,641,435,206,1,1,5,2,3,45,32,13,0
2021,Monmouthshire 003B,W01001562,597,467,246,221,1,1,65,21,44,64,50,14,0
2021,Monmouthshire 003C,W01001563,516,347,204,143,4,4,118,28,90,47,40,7,0
2021,Monmouthshire 006D,W01001565,753,617,399,218,3,3,39,6,33,94,72,22,0
2021,Monmouthshire 005C,W01001568,730,587,379,208,0,0,27,8,19,116,86,30,0
2021,Monmouthshire 003E,W01001569,603,467,328,139,2,2,74,37,37,60,44,16,0
2021,Monmouthshire 001D,W01001571,642,525,333,192,2,2,40,7,33,75,57,18,0
2021,Monmouthshire 011A,W01001572,709,516,273,243,2,2,112,23,89,79,66,13,0
2021,Monmouthshire 011B,W01001573,569,502,279,223,2,2,20,4,16,45,39,6,0
2021,Monmouthshire 011C,W01001574,604,471,244,227,6,6,20,5,15,107,98,9,0
2021,Monmouthshire 005D,W01001575,516,402,276,126,0,0,34,5,29,80,60,20,0
2021,Monmouthshire 004D,W01001576,499,315,195,120,3,3,63,11,52,118,106,12,0
2021,Monmouthshire 004E,W01001577,618,255,185,70,3,3,282,55,227,78,68,10,0
2021,Monmouthshire 009C,W01001578,1086,890,451,439,3,3,94,32,62,99,80,19,0
2021,Monmouthshire 001E,W01001579,846,600,430,170,1,1,64,12,52,181,158,23,0
2021,Monmouthshire 002E,W01001580,829,563,368,195,1,1,154,33,121,111,94,17,0
2021,Monmouthshire 005E,W01001581,859,647,457,190,5,5,103,28,75,104,91,13,0
2021,Monmouthshire 011D,W01001582,741,524,220,304,2,2,151,36,115,64,56,8,0
2021,Monmouthshire 007B,W01001583,664,539,317,222,0,0,43,9,34,82,71,11,0
2021,Monmouthshire 008B,W01001584,789,533,267,266,2,2,86,29,57,168,146,22,0
2021,Monmouthshire 007C,W01001585,539,474,266,208,0,0,8,3,5,57,54,3,0
2021,Monmouthshire 007D,W01001586,1008,843,447,396,5,5,62,5,57,98,87,11,0
2021,Monmouthshire 008C,W01001587,1053,514,288,226,2,2,191,41,150,343,312,31,3
2021,Monmouthshire 010D,W01001588,742,656,428,228,2,2,11,0,11,73,62,11,0
2021,Monmouthshire 010E,W01001589,661,396,251,145,3,3,183,56,127,79,65,14,0
2021,Monmouthshire 009D,W01001590,884,777,477,300,0,0,35,15,20,72,53,19,0
2021,Monmouthshire 011E,W01001591,629,535,218,317,2,2,30,9,21,62,53,9,0
2021,Monmouthshire 008D,W01001592,681,252,106,146,2,2,322,84,238,102,93,9,3
2021,Monmouthshire 008E,W01001593,754,470,227,243,1,1,137,31,106,146,131,15,0
2021,Monmouthshire 007E,W01001594,566,448,278,170,5,5,55,12,43,58,46,12,0
2021,Monmouthshire 007F,W01001595,544,506,314,192,1,1,10,2,8,27,21,6,0
2021,Monmouthshire 006E,W01001596,488,320,240,80,1,1,87,10,77,79,65,14,1
2021,Monmouthshire 006F,W01001597,678,518,320,198,5,5,44,7,37,111,96,15,0
2021,Monmouthshire 010F,W01001598,714,407,196,211,7,7,224,66,158,76,63,13,0
2021,Monmouthshire 004F,W01001599,999,671,431,240,5,5,201,39,162,122,102,20,0
2021,Newport 012A,W01001600,767,695,367,328,0,0,8,2,6,63,51,12,1
2021,Newport 006A,W01001601,653,234,135,99,4,4,323,46,277,92,82,10,0
2021,Newport 012B,W01001602,686,538,277,261,3,3,86,9,77,59,43,16,0
2021,Newport 012C,W01001603,608,382,181,201,2,2,39,14,25,184,168,16,1
2021,Newport 012D,W01001604,614,554,301,253,1,1,15,2,13,44,38,6,0
2021,Newport 014A,W01001605,660,390,217,173,18,18,83,15,68,168,158,10,1
2021,Newport 008A,W01001606,518,445,242,203,3,3,27,16,11,43,28,15,0
2021,Newport 015A,W01001607,501,157,55,102,0,0,249,134,115,94,84,10,1
2021,Newport 008B,W01001608,637,505,261,244,0,0,59,15,44,72,61,11,1
2021,Newport 015B,W01001609,711,285,111,174,1,1,360,176,184,63,54,9,2
2021,Newport 015C,W01001610,513,317,160,157,9,9,123,72,51,64,59,5,0
2021,Newport 011A,W01001611,519,337,165,172,0,0,30,9,21,152,139,13,0
2021,Newport 011B,W01001612,673,421,219,202,2,2,100,30,70,148,131,17,2
2021,Newport 011C,W01001613,595,451,216,235,1,1,20,4,16,122,105,17,1
2021,Newport 005A,W01001614,767,315,142,173,7,7,361,170,191,79,68,11,5
2021,Newport 005B,W01001615,607,459,194,265,0,0,95,53,42,52,42,10,1
2021,Newport 005C,W01001616,632,481,281,200,4,4,71,32,39,73,67,6,3
2021,Newport 003A,W01001617,582,192,112,80,4,4,336,157,179,46,33,13,4
2021,Newport 003B,W01001618,490,234,138,96,2,2,186,109,77,61,49,12,7
2021,Newport 003C,W01001619,583,226,130,96,0,0,271,178,93,82,78,4,4
2021,Newport 003D,W01001620,690,375,152,223,12,12,218,103,115,83,71,12,2
2021,Newport 003E,W01001621,598,278,151,127,4,4,235,120,115,81,73,8,0
2021,Newport 003F,W01001622,515,341,170,171,17,17,92,45,47,65,56,9,0
2021,Newport 001A,W01001623,647,490,296,194,2,2,27,7,20,128,106,22,0
2021,Newport 001B,W01001624,505,442,237,205,4,4,12,4,8,47,35,12,0
2021,Newport 001C,W01001625,567,458,272,186,4,4,43,21,22,60,44,16,2
2021,Newport 001D,W01001626,606,496,286,210,3,3,63,29,34,40,37,3,4
2021,Newport 001E,W01001627,683,607,350,257,0,0,14,8,6,62,55,7,0
2021,Newport 001F,W01001628,517,243,117,126,0,0,215,132,83,57,52,5,2
2021,Newport 017A,W01001629,622,480,276,204,1,1,74,28,46,66,56,10,1
2021,Newport 017B,W01001630,815,341,199,142,17,17,382,159,223,70,47,23,5
2021,Newport 017C,W01001631,599,483,252,231,5,5,48,22,26,63,51,12,0
2021,Newport 017D,W01001632,571,356,171,185,10,10,129,65,64,72,60,12,4
2021,Newport 019A,W01001633,696,292,140,152,6,6,334,156,178,63,55,8,1
2021,Newport 019B,W01001634,629,363,191,172,7,7,142,86,56,117,98,19,0
2021,Newport 016A,W01001635,593,457,233,224,3,3,68,19,49,65,57,8,0
2021,Newport 020A,W01001636,739,639,266,373,7,7,14,4,10,79,67,12,0
2021,Newport 016B,W01001637,903,674,315,359,8,8,135,45,90,85,67,18,1
2021,Newport 016C,W01001638,472,424,217,207,1,1,8,2,6,39,31,8,0
2021,Newport 004A,W01001639,855,756,332,424,4,4,33,12,21,62,51,11,0
2021,Newport 004B,W01001640,485,427,278,149,1,1,15,8,7,42,33,9,0
2021,Newport 004C,W01001641,540,490,294,196,1,1,4,4,0,45,32,13,0
2021,Newport 013A,W01001642,789,395,208,187,3,3,154,86,68,235,213,22,2
2021,Newport 013B,W01001643,734,295,90,205,27,27,248,94,154,158,151,7,6
2021,Newport 015D,W01001645,509,367,172,195,3,3,86,45,41,52,45,7,1
2021,Newport 015E,W01001646,603,308,212,96,1,1,261,145,116,32,26,6,1
2021,Newport 015G,W01001648,650,486,253,233,1,1,72,32,40,90,77,13,1
2021,Newport 004E,W01001650,651,392,167,225,1,1,172,79,93,85,78,7,1
2021,Newport 002A,W01001651,621,549,332,217,1,1,14,2,12,57,46,11,0
2021,Newport 002B,W01001652,724,243,109,134,2,2,396,236,160,80,72,8,3
2021,Newport 002C,W01001653,603,527,316,211,3,3,29,15,14,43,33,10,1
2021,Newport 002D,W01001654,689,573,302,271,1,1,21,10,11,93,75,18,1
2021,Newport 002E,W01001655,646,563,322,241,2,2,20,6,14,61,50,11,0
2021,Newport 020C,W01001657,535,492,227,265,0,0,4,1,3,39,27,12,0
2021,Newport 020D,W01001658,776,650,295,355,0,0,70,35,35,55,40,15,1
2021,Newport 018A,W01001659,677,209,77,132,4,4,247,95,152,214,178,36,3
2021,Newport 018B,W01001660,1011,732,261,471,7,7,111,43,68,160,138,22,1
2021,Newport 018C,W01001661,1106,290,119,171,14,14,359,90,269,438,391,47,5
2021,Newport 018D,W01001662,627,166,76,90,4,4,305,175,130,144,110,34,8
2021,Newport 008C,W01001663,680,347,211,136,3,3,274,119,155,55,46,9,1
2021,Newport 010A,W01001664,548,255,136,119,1,1,243,148,95,45,39,6,4
2021,Newport 008D,W01001665,743,401,227,174,1,1,226,38,188,112,96,16,3
2021,Newport 010B,W01001666,594,292,142,150,0,0,243,154,89,58,49,9,1
2021,Newport 010C,W01001667,497,209,112,97,1,1,237,135,102,50,46,4,0
2021,Newport 010D,W01001668,481,249,145,104,0,0,184,119,65,47,41,6,1
2021,Newport 009A,W01001669,528,487,317,170,1,1,9,5,4,31,28,3,0
2021,Newport 009B,W01001670,859,745,362,383,0,0,8,5,3,106,97,9,0
2021,Newport 016D,W01001671,1051,646,236,410,15,15,235,132,103,155,141,14,0
2021,Newport 009D,W01001673,642,564,370,194,2,2,36,23,13,40,37,3,0
2021,Newport 009E,W01001674,600,440,222,218,1,1,106,60,46,53,41,12,0
2021,Newport 007A,W01001675,660,422,194,228,2,2,83,11,72,153,125,28,0
2021,Newport 007B,W01001676,835,431,170,261,35,35,81,18,63,287,264,23,1
2021,Newport 007C,W01001677,644,488,256,232,2,2,26,8,18,128,116,12,0
2021,Newport 005D,W01001678,691,418,220,198,1,1,191,83,108,80,69,11,1
2021,Newport 007D,W01001679,450,377,205,172,0,0,33,16,17,39,35,4,1
2021,Newport 007E,W01001680,510,356,153,203,3,3,18,8,10,132,113,19,1
2021,Newport 006B,W01001681,633,257,109,148,4,4,211,100,111,155,141,14,6
2021,Newport 006C,W01001682,580,309,155,154,2,2,193,94,99,72,54,18,4
2021,Newport 006D,W01001683,467,354,173,181,1,1,52,17,35,59,50,9,1
2021,Newport 006E,W01001684,635,449,216,233,6,6,18,5,13,160,136,24,2
2021,Newport 014B,W01001685,858,276,126,150,2,2,203,43,160,376,353,23,1
2021,Newport 014C,W01001686,536,341,149,192,1,1,77,18,59,117,102,15,0
2021,Newport 014D,W01001687,1087,281,156,125,3,3,314,44,270,487,451,36,2
2021,Newport 019D,W01001689,783,143,61,82,5,5,583,345,238,48,44,4,4
2021,Newport 013D,W01001690,846,433,179,254,13,13,56,10,46,340,286,54,4
2021,Newport 011D,W01001691,707,352,180,172,4,4,92,21,71,258,243,15,1
2021,Newport 011E,W01001692,833,421,208,213,5,5,87,19,68,317,291,26,3
2021,Newport 013E,W01001693,949,404,182,222,6,6,107,12,95,432,401,31,0
2021,Cardiff 036A,W01001694,886,302,119,183,3,3,212,57,155,366,338,28,3
2021,Cardiff 036B,W01001695,745,104,48,56,1,1,295,41,254,337,325,12,8
2021,Cardiff 036C,W01001696,667,199,92,107,0,0,264,70,194,198,180,18,6
2021,Cardiff 036D,W01001697,866,384,168,216,3,3,131,30,101,345,319,26,3
2021,Cardiff 036E,W01001698,947,248,101,147,3,3,118,13,105,572,542,30,6
2021,Cardiff 049A,W01001699,1031,202,89,113,2,2,476,392,84,333,311,22,18
2021,Cardiff 045A,W01001702,737,452,181,271,2,2,170,78,92,112,98,14,1
2021,Cardiff 045B,W01001703,486,220,114,106,2,2,208,104,104,55,47,8,1
2021,Cardiff 041A,W01001704,624,195,86,109,0,0,358,273,85,68,53,15,3
2021,Cardiff 045C,W01001705,784,405,190,215,0,0,198,117,81,173,150,23,8
2021,Cardiff 041B,W01001706,587,389,216,173,4,4,113,11,102,80,67,13,1
2021,Cardiff 041C,W01001707,808,351,170,181,7,7,347,184,163,98,87,11,5
2021,Cardiff 045D,W01001708,727,290,141,149,0,0,292,203,89,139,110,29,6
2021,Cardiff 040B,W01001710,802,464,204,260,4,4,70,8,62,264,238,26,0
2021,Cardiff 040C,W01001711,876,452,222,230,0,0,267,124,143,152,120,32,5
2021,Cardiff 040D,W01001712,713,445,189,256,0,0,54,7,47,214,189,25,0
2021,Cardiff 040E,W01001713,772,498,224,274,1,1,101,7,94,172,159,13,0
2021,Cardiff 035A,W01001714,608,541,268,273,1,1,15,0,15,51,40,11,0
2021,Cardiff 035B,W01001715,794,489,230,259,4,4,106,8,98,195,185,10,0
2021,Cardiff 035C,W01001716,541,446,209,237,0,0,7,3,4,87,79,8,1
2021,Cardiff 035D,W01001717,746,453,190,263,1,1,146,21,125,146,137,9,0
2021,Cardiff 028A,W01001718,621,184,73,111,4,4,20,6,14,411,391,20,2
2021,Cardiff 028B,W01001719,565,271,150,121,0,0,10,0,10,284,271,13,0
2021,Cardiff 028C,W01001720,646,87,48,39,0,0,44,5,39,514,504,10,1
2021,Cardiff 032A,W01001721,569,97,61,36,4,4,99,44,55,368,347,21,1
2021,Cardiff 028D,W01001722,530,103,62,41,4,4,27,7,20,395,386,9,1
2021,Cardiff 032C,W01001724,607,77,57,20,1,1,29,5,24,499,490,9,1
2021,Cardiff 032D,W01001725,520,42,23,19,0,0,41,8,33,436,427,9,1
2021,Cardiff 028E,W01001726,550,166,80,86,4,4,32,10,22,345,331,14,3
2021,Cardiff 014A,W01001727,513,426,232,194,0,0,34,16,18,53,43,10,0
2021,Cardiff 014B,W01001728,595,552,339,213,1,1,2,2,0,40,34,6,0
2021,Cardiff 014C,W01001729,1169,979,396,583,2,2,65,4,61,123,106,17,0
2021,Cardiff 008A,W01001730,627,577,371,206,0,0,9,4,5,41,33,8,0
2021,Cardiff 008B,W01001731,539,479,242,237,0,0,7,5,2,53,42,11,0
2021,Cardiff 019A,W01001732,670,557,324,233,0,0,5,1,4,108,93,15,0
2021,Cardiff 019B,W01001733,564,423,227,196,0,0,63,6,57,78,73,5,0
2021,Cardiff 019C,W01001734,588,522,298,224,0,0,9,5,4,57,49,8,0
2021,Cardiff 019D,W01001735,610,470,278,192,3,3,12,4,8,125,112,13,0
2021,Cardiff 008C,W01001736,593,538,296,242,0,0,4,1,3,51,44,7,0
2021,Cardiff 039A,W01001737,631,254,110,144,0,0,300,281,19,72,65,7,5
2021,Cardiff 039B,W01001738,518,151,64,87,0,0,291,280,11,74,67,7,2
2021,Cardiff 039C,W01001739,547,161,64,97,1,1,312,262,50,66,60,6,7
2021,Cardiff 039D,W01001740,679,278,132,146,2,2,329,302,27,67,60,7,3
2021,Cardiff 039E,W01001741,610,156,70,86,1,1,369,349,20,81,78,3,3
2021,Cardiff 043A,W01001742,643,212,100,112,0,0,300,280,20,125,120,5,6
2021,Cardiff 043B,W01001743,641,517,299,218,1,1,59,17,42,63,48,15,1
2021,Cardiff 043C,W01001744,758,244,122,122,0,0,412,324,88,87,71,16,15
2021,Cardiff 043D,W01001745,549,472,256,216,2,2,7,1,6,68,55,13,0
2021,Cardiff 041D,W01001746,656,277,128,149,2,2,240,218,22,132,117,15,5
2021,Cardiff 027A,W01001747,828,616,316,300,2,2,34,25,9,176,159,17,0
2021,Cardiff 027B,W01001748,646,395,189,206,6,6,181,160,21,63,45,18,1
2021,Cardiff 027C,W01001749,671,414,201,213,2,2,138,91,47,114,89,25,3
2021,Cardiff 031A,W01001750,827,377,182,195,0,0,357,276,81,85,73,12,8
2021,Cardiff 027D,W01001751,819,291,130,161,1,1,381,323,58,142,125,17,4
2021,Cardiff 031B,W01001752,660,586,294,292,0,0,35,27,8,39,35,4,0
2021,Cardiff 031C,W01001753,634,267,130,137,0,0,274,93,181,93,86,7,0
2021,Cardiff 031D,W01001754,794,630,342,288,4,4,62,11,51,98,84,14,0
2021,Cardiff 025A,W01001755,635,291,116,175,3,3,10,2,8,331,311,20,0
2021,Cardiff 025B,W01001756,624,297,117,180,0,0,215,122,93,108,92,16,4
2021,Cardiff 025C,W01001757,597,289,160,129,3,3,18,2,16,284,269,15,3
2021,Cardiff 025D,W01001758,656,310,138,172,2,2,23,7,16,321,299,22,0
2021,Cardiff 046A,W01001759,695,449,219,230,4,4,78,10,68,164,149,15,0
2021,Cardiff 046B,W01001760,679,409,210,199,1,1,131,68,63,137,114,23,1
2021,Cardiff 046C,W01001761,686,344,132,212,1,1,138,55,83,200,179,21,3
2021,Cardiff 046D,W01001762,711,270,101,169,3,3,224,99,125,210,185,25,4
2021,Cardiff 044A,W01001764,595,270,147,123,1,1,138,18,120,184,165,19,2
2021,Cardiff 044B,W01001765,519,295,149,146,1,1,45,3,42,177,168,9,1
2021,Cardiff 044C,W01001766,697,347,165,182,3,3,94,34,60,251,232,19,2
2021,Cardiff 044D,W01001767,740,337,140,197,1,1,96,33,63,304,292,12,2
2021,Cardiff 044E,W01001768,521,272,124,148,0,0,44,6,38,204,192,12,1
2021,Cardiff 018A,W01001769,615,574,325,249,2,2,5,2,3,34,27,7,0
2021,Cardiff 018B,W01001770,488,316,172,144,10,10,60,24,36,102,81,21,0
2021,Cardiff 018C,W01001771,675,541,282,259,1,1,30,8,22,102,84,18,1
2021,Cardiff 021A,W01001772,589,541,325,216,1,1,6,3,3,41,34,7,0
2021,Cardiff 012A,W01001773,1046,722,357,365,3,3,92,22,70,228,211,17,1
2021,Cardiff 018D,W01001774,529,490,260,230,0,0,2,1,1,37,33,4,0
2021,Cardiff 021B,W01001775,707,519,265,254,1,1,26,14,12,161,144,17,0
2021,Cardiff 021C,W01001776,518,442,239,203,3,3,3,2,1,70,65,5,0
2021,Cardiff 001A,W01001777,709,625,353,272,1,1,31,13,18,52,40,12,0
2021,Cardiff 001B,W01001778,687,644,387,257,1,1,5,4,1,37,35,2,0
2021,Cardiff 026A,W01001779,664,531,307,224,4,4,12,1,11,117,102,15,0
2021,Cardiff 026B,W01001780,606,492,301,191,6,6,31,3,28,75,69,6,2
2021,Cardiff 026C,W01001781,825,580,355,225,0,0,73,3,70,171,146,25,1
2021,Cardiff 026D,W01001782,586,541,267,274,0,0,6,2,4,39,28,11,0
2021,Cardiff 026E,W01001783,502,439,237,202,2,2,4,0,4,57,43,14,0
2021,Cardiff 026F,W01001784,575,484,290,194,4,4,6,0,6,80,66,14,1
2021,Cardiff 023A,W01001785,483,217,93,124,1,1,224,102,122,37,35,2,4
2021,Cardiff 023B,W01001786,624,469,203,266,1,1,68,49,19,85,67,18,1
2021,Cardiff 023C,W01001787,539,321,162,159,1,1,156,108,48,57,52,5,4
2021,Cardiff 023D,W01001788,627,291,122,169,2,2,261,217,44,68,61,7,5
2021,Cardiff 023E,W01001789,724,531,262,269,1,1,33,15,18,159,148,11,0
2021,Cardiff 023F,W01001790,483,315,146,169,4,4,111,74,37,53,41,12,0
2021,Cardiff 005A,W01001791,854,659,403,256,6,6,52,25,27,137,112,25,0
2021,Cardiff 005B,W01001792,686,399,201,198,3,3,220,203,17,56,44,12,8
2021,Cardiff 002A,W01001793,568,431,206,225,12,12,15,3,12,110,107,3,0
2021,Cardiff 001C,W01001794,612,450,233,217,2,2,6,2,4,154,136,18,0
2021,Cardiff 002B,W01001795,656,501,254,247,12,12,23,9,14,119,110,9,1
2021,Cardiff 002C,W01001796,644,468,259,209,8,8,62,13,49,106,100,6,0
2021,Cardiff 005C,W01001797,603,510,286,224,1,1,30,21,9,62,50,12,0
2021,Cardiff 002D,W01001798,652,514,284,230,4,4,8,7,1,126,112,14,0
2021,Cardiff 001D,W01001799,519,450,293,157,4,4,13,5,8,52,41,11,0
2021,Cardiff 005D,W01001800,640,364,165,199,7,7,205,178,27,63,51,12,1
2021,Cardiff 007A,W01001802,742,466,238,228,1,1,182,127,55,90,69,21,3
2021,Cardiff 015A,W01001803,700,372,166,206,1,1,221,198,23,100,87,13,6
2021,Cardiff 015B,W01001804,627,345,147,198,0,0,169,143,26,110,96,14,3
2021,Cardiff 015C,W01001805,669,424,157,267,0,0,190,161,29,53,44,9,2
2021,Cardiff 015D,W01001806,811,557,344,213,0,0,48,8,40,206,179,27,0
2021,Cardiff 007B,W01001807,620,253,101,152,0,0,295,241,54,65,51,14,7
2021,Cardiff 007C,W01001808,638,219,90,129,0,0,329,297,32,84,73,11,6
2021,Cardiff 017A,W01001809,532,417,219,198,0,0,68,26,42,47,42,5,0
2021,Cardiff 017B,W01001810,634,312,143,169,0,0,220,185,35,96,79,17,6
2021,Cardiff 009A,W01001811,548,225,102,123,2,2,251,221,30,68,60,8,2
2021,Cardiff 017C,W01001812,481,334,168,166,3,3,66,54,12,73,67,6,5
2021,Cardiff 017D,W01001813,785,340,166,174,2,2,337,248,89,99,93,6,7
2021,Cardiff 017E,W01001814,687,432,225,207,0,0,66,41,25,188,176,12,1
2021,Cardiff 008D,W01001815,542,429,217,212,2,2,45,14,31,66,44,22,0
2021,Cardiff 009B,W01001816,1100,524,163,361,1,1,356,213,143,213,195,18,6
2021,Cardiff 009C,W01001817,583,388,179,209,2,2,122,19,103,70,57,13,1
2021,Cardiff 009D,W01001818,622,398,152,246,2,2,76,7,69,146,131,15,0
2021,Cardiff 014D,W01001819,965,798,499,299,2,2,90,65,25,70,55,15,5
2021,Cardiff 006A,W01001820,518,389,203,186,2,2,63,27,36,64,58,6,0
2021,Cardiff 024A,W01001821,552,376,234,142,0,0,68,3,65,107,95,12,1
2021,Cardiff 029A,W01001822,808,548,291,257,2,2,138,9,129,119,107,12,1
2021,Cardiff 029B,W01001823,514,445,224,221,2,2,6,1,5,60,56,4,1
2021,Cardiff 029C,W01001824,724,326,161,165,1,1,30,3,27,366,357,9,1
2021,Cardiff 029D,W01001825,870,493,219,274,3,3,122,10,112,251,229,22,1
2021,Cardiff 024B,W01001826,546,468,271,197,0,0,13,3,10,65,51,14,0
2021,Cardiff 024C,W01001827,632,559,347,212,1,1,19,4,15,53,47,6,0
2021,Cardiff 024D,W01001828,632,572,366,206,1,1,9,4,5,49,44,5,1
2021,Cardiff 033A,W01001829,720,205,106,99,3,3,55,4,51,456,432,24,1
2021,Cardiff 033B,W01001830,886,146,61,85,0,0,112,14,98,627,602,25,1
2021,Cardiff 030A,W01001831,656,324,131,193,5,5,15,7,8,310,289,21,2
2021,Cardiff 033C,W01001832,806,60,36,24,4,4,96,9,87,644,628,16,2
2021,Cardiff 033D,W01001833,698,346,162,184,3,3,79,8,71,270,259,11,0
2021,Cardiff 033E,W01001834,714,301,133,168,2,2,82,35,47,327,303,24,2
2021,Cardiff 033F,W01001835,979,217,116,101,5,5,338,57,281,414,399,15,5
2021,Cardiff 030B,W01001836,525,247,110,137,0,0,15,4,11,263,250,13,0
2021,Cardiff 030C,W01001837,513,172,81,91,3,3,76,43,33,260,244,16,2
2021,Cardiff 030D,W01001838,623,337,144,193,0,0,18,10,8,268,248,20,0
2021,Cardiff 030E,W01001839,604,283,138,145,2,2,15,2,13,303,289,14,1
2021,Cardiff 007D,W01001840,883,517,260,257,1,1,264,36,228,101,90,11,0
2021,Cardiff 003A,W01001841,747,578,250,328,7,7,70,3,67,92,80,12,0
2021,Cardiff 003B,W01001842,728,496,166,330,2,2,6,4,2,224,213,11,0
2021,Cardiff 003D,W01001844,850,539,213,326,15,15,98,6,92,198,180,18,0
2021,Cardiff 006C,W01001846,653,556,243,313,0,0,34,14,20,63,55,8,0
2021,Cardiff 006D,W01001847,638,599,379,220,0,0,8,2,6,31,24,7,0
2021,Cardiff 012B,W01001848,604,559,310,249,1,1,7,3,4,37,32,5,0
2021,Cardiff 004A,W01001849,644,583,342,241,0,0,6,2,4,55,49,6,0
2021,Cardiff 012C,W01001850,786,705,417,288,1,1,14,7,7,65,51,14,1
2021,Cardiff 012D,W01001851,710,542,327,215,1,1,50,23,27,117,105,12,0
2021,Cardiff 004B,W01001852,738,684,364,320,1,1,10,3,7,43,29,14,0
2021,Cardiff 004C,W01001853,757,669,450,219,0,0,15,6,9,73,62,11,0
2021,Cardiff 004D,W01001854,796,715,497,218,3,3,19,7,12,59,51,8,0
2021,Cardiff 042A,W01001855,669,279,111,168,2,2,173,43,130,212,198,14,3
2021,Cardiff 042B,W01001856,683,239,135,104,0,0,131,33,98,313,297,16,0
2021,Cardiff 042C,W01001857,905,300,128,172,4,4,336,131,205,256,229,27,9
2021,Cardiff 034A,W01001858,854,447,244,203,1,1,77,6,71,328,302,26,1
2021,Cardiff 034B,W01001859,775,422,193,229,3,3,66,15,51,284,266,18,0
2021,Cardiff 034C,W01001860,777,474,230,244,2,2,50,29,21,251,232,19,0
2021,Cardiff 034D,W01001861,750,363,164,199,1,1,31,5,26,355,327,28,0
2021,Cardiff 042D,W01001862,757,248,148,100,2,2,61,11,50,445,431,14,1
2021,Cardiff 022A,W01001863,643,485,253,232,2,2,73,34,39,78,63,15,5
2021,Cardiff 022B,W01001864,630,540,320,220,3,3,9,1,8,78,61,17,0
2021,Cardiff 022C,W01001865,520,454,233,221,1,1,30,2,28,35,30,5,0
2021,Cardiff 016A,W01001866,662,385,176,209,1,1,193,95,98,82,73,9,1
2021,Cardiff 016B,W01001867,547,256,112,144,2,2,217,164,53,69,65,4,3
2021,Cardiff 022D,W01001868,599,351,184,167,1,1,189,135,54,55,49,6,3
2021,Cardiff 038A,W01001869,619,367,137,230,0,0,94,10,84,155,139,16,3
2021,Cardiff 037A,W01001870,634,398,152,246,1,1,93,69,24,142,134,8,0
2021,Cardiff 037B,W01001871,687,273,103,170,1,1,306,196,110,106,93,13,1
2021,Cardiff 038B,W01001872,697,362,162,200,1,1,147,8,139,185,164,21,2
2021,Cardiff 038C,W01001873,799,341,141,200,2,2,232,52,180,212,196,16,12
2021,Cardiff 038D,W01001874,746,158,62,96,1,1,431,35,396,145,130,15,11
2021,Cardiff 037D,W01001876,652,285,100,185,2,2,263,231,32,92,80,12,10
2021,Cardiff 011A,W01001877,816,594,261,333,4,4,52,6,46,166,147,19,0
2021,Cardiff 011B,W01001878,623,413,189,224,1,1,103,92,11,106,94,12,0
2021,Cardiff 013A,W01001879,798,325,114,211,10,10,325,164,161,138,130,8,0
2021,Cardiff 013B,W01001880,611,188,63,125,1,1,357,107,250,62,59,3,3
2021,Cardiff 013C,W01001881,656,296,165,131,1,1,263,206,57,91,84,7,5
2021,Cardiff 011C,W01001882,756,536,208,328,9,9,38,8,30,172,160,12,1
2021,Cardiff 016C,W01001883,698,286,149,137,2,2,327,182,145,81,71,10,2
2021,Cardiff 013D,W01001884,524,54,21,33,0,0,430,23,407,38,35,3,2
2021,Cardiff 011D,W01001885,998,632,224,408,7,7,241,162,79,114,91,23,4
2021,Cardiff 016D,W01001886,532,213,99,114,0,0,225,101,124,88,81,7,6
2021,Cardiff 020A,W01001887,616,559,326,233,0,0,8,2,6,48,42,6,1
2021,Cardiff 010A,W01001888,687,537,260,277,2,2,74,48,26,74,66,8,0
2021,Cardiff 020B,W01001889,700,522,336,186,3,3,76,33,43,99,85,14,0
2021,Cardiff 021D,W01001890,604,492,282,210,2,2,4,1,3,106,96,10,0
2021,Cardiff 020C,W01001891,733,499,281,218,1,1,107,72,35,123,102,21,3
2021,Cardiff 020D,W01001892,600,565,332,233,0,0,4,4,0,31,20,11,0
2021,Cardiff 010B,W01001893,803,561,282,279,2,2,160,72,88,74,63,11,6
2021,Cardiff 010C,W01001894,645,567,319,248,1,1,8,2,6,69,56,13,0
2021,Cardiff 010D,W01001895,837,395,232,163,0,0,345,221,124,93,73,20,4
2021,Cardiff 020E,W01001896,606,521,295,226,2,2,17,5,12,66,53,13,0
2021,Powys 020D,W01001897,828,647,438,209,3,3,69,62,7,109,82,27,0
2021,Merthyr Tydfil 008F,W01001898,644,449,239,210,1,1,147,80,67,45,30,15,2
2021,Powys 021F,W01001899,933,618,394,224,2,2,178,129,49,130,107,23,5
2021,Neath Port Talbot 020G,W01001900,670,450,283,167,2,2,110,64,46,108,87,21,0
2021,Powys 017F,W01001901,858,623,450,173,1,1,99,77,22,135,86,49,0
2021,Powys 017G,W01001902,586,197,125,72,0,0,341,180,161,45,36,9,3
2021,Powys 018F,W01001903,967,674,489,185,0,0,187,94,93,106,75,31,0
2021,Powys 018G,W01001904,741,575,411,164,4,4,56,45,11,106,70,36,0
2021,Powys 018H,W01001905,917,703,480,223,2,2,50,41,9,162,124,38,0
2021,Powys 001F,W01001906,882,662,478,184,1,1,80,68,12,134,102,32,5
2021,Powys 001G,W01001907,575,428,310,118,1,1,43,30,13,103,78,25,0
2021,Monmouthshire 010G,W01001908,928,546,329,217,2,2,291,76,215,87,76,11,2
2021,Vale of Glamorgan 012G,W01001910,809,369,131,238,2,2,165,23,142,273,245,28,0
2021,Vale of Glamorgan 012H,W01001911,505,323,150,173,2,2,44,24,20,136,130,6,0
2021,Newport 020E,W01001912,667,563,308,255,4,4,11,7,4,89,74,15,0
2021,Newport 020F,W01001913,614,406,129,277,4,4,51,15,36,153,140,13,0
2021,Rhondda Cynon Taf 023F,W01001914,669,629,233,396,10,10,6,1,5,24,21,3,0
2021,Rhondda Cynon Taf 027F,W01001915,602,541,212,329,0,0,7,4,3,54,41,13,0
2021,Rhondda Cynon Taf 027G,W01001916,558,484,173,311,2,2,5,2,3,67,56,11,0
2021,Rhondda Cynon Taf 023G,W01001917,622,484,276,208,0,0,54,23,31,83,68,15,1
2021,Bridgend 017E,W01001918,660,564,161,403,1,1,22,2,20,73,62,11,0
2021,Bridgend 017F,W01001919,552,436,156,280,3,3,29,3,26,84,74,10,0
2021,Bridgend 017G,W01001920,457,379,166,213,2,2,7,1,6,69,60,9,0
2021,Bridgend 017H,W01001921,574,365,135,230,0,0,132,2,130,77,68,9,0
2021,Cardiff 032E,W01001922,407,36,19,17,1,1,41,5,36,329,324,5,0
2021,Carmarthenshire 026G,W01001923,818,456,185,271,7,7,162,119,43,192,173,19,1
2021,Carmarthenshire 026H,W01001924,597,229,148,81,1,1,227,178,49,135,120,15,5
2021,Carmarthenshire 023F,W01001925,971,728,482,246,2,2,135,128,7,106,83,23,0
2021,Conwy 011F,W01001926,1001,773,483,290,7,7,47,22,25,174,145,29,0
2021,Conwy 010G,W01001927,591,453,289,164,6,6,50,16,34,82,70,12,0
2021,Conwy 010H,W01001928,639,317,233,84,1,1,77,18,59,244,233,11,0
2021,Wrexham 012F,W01001929,587,193,134,59,3,3,140,121,19,247,235,12,4
2021,Wrexham 019F,W01001930,902,647,417,230,0,0,106,70,36,146,123,23,3
2021,Wrexham 012G,W01001931,689,192,104,88,5,5,273,184,89,217,206,11,2
2021,Gwynedd 014E,W01001932,1130,770,590,180,2,2,96,28,68,261,195,66,1
2021,Gwynedd 017F,W01001933,968,731,557,174,4,4,94,32,62,137,97,40,2
2021,Ceredigion 003E,W01001935,487,246,145,101,2,2,33,4,29,206,181,25,0
2021,Ceredigion 003F,W01001936,416,304,193,111,1,1,47,15,32,64,57,7,0
2021,Ceredigion 001F,W01001937,919,673,463,210,5,5,54,16,38,187,165,22,0
2021,Cardiff 048A,W01001940,670,168,80,88,13,13,99,9,90,390,375,15,0
2021,Cardiff 049B,W01001942,775,287,115,172,3,3,221,77,144,262,231,31,2
2021,Cardiff 048B,W01001943,647,216,76,140,6,6,66,5,61,359,329,30,0
2021,Cardiff 048C,W01001944,626,244,61,183,1,1,44,9,35,337,320,17,0
2021,Cardiff 049C,W01001946,667,191,65,126,1,1,277,146,131,194,183,11,4
2021,Cardiff 048E,W01001947,948,360,98,262,3,3,58,4,54,526,505,21,1
2021,Cardiff 006E,W01001948,890,677,208,469,2,2,67,10,57,144,129,15,0
2021,Cardiff 005F,W01001949,682,294,80,214,7,7,174,16,158,207,193,14,0
2021,Cardiff 049D,W01001950,595,258,126,132,1,1,28,1,27,307,287,20,1
2021,Cardiff 049E,W01001951,500,194,61,133,0,0,46,8,38,259,236,23,1
2021,Cardiff 049F,W01001952,644,187,44,143,0,0,64,39,25,393,370,23,0
2021,Cardiff 005G,W01001953,634,415,166,249,4,4,137,99,38,74,58,16,4
2021,Cardiff 006F,W01001954,640,566,339,227,0,0,13,4,9,61,52,9,0
2021,Swansea 025F,W01001955,1253,45,27,18,2,2,830,190,640,373,350,23,3
2021,Swansea 032C,W01001956,815,621,349,272,0,0,67,4,63,124,103,21,3
2021,Swansea 025H,W01001958,797,297,152,145,0,0,216,65,151,283,255,28,1
2021,Merthyr Tydfil 005E,W01001959,610,495,227,268,2,2,17,5,12,96,82,14,0
2021,Merthyr Tydfil 005F,W01001960,688,466,238,228,0,0,66,9,57,156,130,26,0
2021,Merthyr Tydfil 006G,W01001961,1013,655,398,257,0,0,217,65,152,140,125,15,1
2021,Rhondda Cynon Taf 011E,W01001962,1182,697,401,296,0,0,169,25,144,316,283,33,0
2021,Rhondda Cynon Taf 014H,W01001963,972,655,395,260,1,1,132,64,68,182,160,22,2
2021,Rhondda Cynon Taf 021H,W01001964,1072,600,303,297,2,2,147,43,104,320,289,31,3
2021,Rhondda Cynon Taf 029E,W01001965,702,469,231,238,1,1,167,38,129,65,54,11,0
2021,Rhondda Cynon Taf 029F,W01001966,649,512,123,389,0,0,54,11,43,83,70,13,0
2021,Rhondda Cynon Taf 031G,W01001967,634,496,213,283,3,3,32,8,24,103,91,12,0
2021,Rhondda Cynon Taf 031H,W01001968,604,479,146,333,2,2,25,17,8,97,89,8,1
2021,Wrexham 010F,W01001969,931,393,211,182,1,1,434,417,17,97,77,20,6
2021,Wrexham 021C,W01001970,926,847,527,320,3,3,18,14,4,58,49,9,0
2021,Wrexham 022D,W01001971,459,341,181,160,0,0,49,42,7,66,52,14,3
2021,Wrexham 022E,W01001972,511,413,154,259,0,0,11,5,6,87,80,7,0
2021,Blaenau Gwent 009F,W01001973,1060,705,429,276,0,0,90,17,73,265,235,30,0
2021,Monmouthshire 002G,W01001974,635,312,171,141,0,0,254,76,178,68,55,13,1
2021,Monmouthshire 002H,W01001975,626,379,240,139,3,3,177,60,117,67,57,10,0
2021,Monmouthshire 003F,W01001976,697,539,369,170,1,1,69,29,40,88,67,21,0
2021,Monmouthshire 003G,W01001977,608,406,229,177,10,10,114,15,99,78,68,10,0
2021,Monmouthshire 004G,W01001978,687,447,282,165,5,5,162,31,131,72,55,17,1
2021,Monmouthshire 004H,W01001979,810,611,248,363,7,7,92,20,72,100,84,16,0
2021,Monmouthshire 005F,W01001980,927,555,374,181,0,0,68,10,58,302,260,42,2
2021,Bridgend 011D,W01001981,506,425,59,366,0,0,24,3,21,57,51,6,0
2021,Bridgend 011E,W01001982,543,457,134,323,1,1,15,2,13,70,60,10,0
2021,Bridgend 011F,W01001983,584,525,106,419,1,1,6,1,5,52,44,8,0
2021,Bridgend 011G,W01001984,487,330,77,253,1,1,95,4,91,61,58,3,0
2021,Neath Port Talbot 006F,W01001985,915,828,570,258,0,0,18,7,11,69,49,20,0
2021,Neath Port Talbot 007E,W01001986,1130,947,631,316,3,3,85,28,57,95,64,31,0
2021,Neath Port Talbot 010G,W01001987,600,450,186,264,1,1,67,8,59,82,66,16,0
2021,Neath Port Talbot 010H,W01001988,593,485,105,380,1,1,42,16,26,65,60,5,0
2021,Neath Port Talbot 010I,W01001989,587,484,255,229,1,1,44,6,38,57,46,11,1
2021,Neath Port Talbot 021E,W01001990,920,661,441,220,0,0,129,49,80,130,101,29,0
2021,Swansea 005G,W01001991,650,285,132,153,1,1,229,33,196,135,124,11,0
2021,Swansea 005H,W01001992,660,384,132,252,0,0,140,61,79,135,121,14,1
2021,Swansea 006E,W01001993,588,459,95,364,0,0,36,6,30,93,84,9,0
2021,Swansea 006F,W01001994,626,513,221,292,3,3,55,46,9,54,39,15,1
2021,Swansea 021E,W01001995,636,305,187,118,0,0,137,78,59,194,165,29,0
2021,Swansea 021F,W01001996,820,298,172,126,49,49,184,36,148,288,270,18,1
2021,Swansea 025I,W01001997,1100,340,224,116,3,3,208,45,163,544,501,43,5
2021,Vale of Glamorgan 015G,W01001998,960,616,276,340,6,6,123,49,74,215,189,26,0
2021,Carmarthenshire 019F,W01001999,1100,991,680,311,2,2,27,23,4,80,65,15,0
2021,Ceredigion 002G,W01002000,528,321,241,80,2,2,70,26,44,134,117,17,1
2021,Ceredigion 002H,W01002001,422,118,85,33,1,1,67,5,62,236,226,10,0
2021,Ceredigion 007E,W01002002,1979,1556,1122,434,6,6,130,30,100,286,216,70,1
2021,Gwynedd 013E,W01002003,1157,882,678,204,5,5,112,32,80,157,101,56,1
2021,Gwynedd 016F,W01002004,1016,577,416,161,2,2,183,83,100,252,199,53,2
2021,Isle of Anglesey 002E,W01002005,1029,790,594,196,1,1,83,77,6,154,114,40,1
2021,Isle of Anglesey 004G,W01002007,993,722,485,237,1,1,146,127,19,121,92,29,3
2021,Isle of Anglesey 007F,W01002008,971,635,454,181,1,1,141,119,22,190,145,45,4
2021,Pembrokeshire 005E,W01002009,619,286,199,87,4,4,128,50,78,201,180,21,0
2021,Pembrokeshire 005F,W01002010,603,207,111,96,1,1,184,87,97,210,191,19,1
2021,Pembrokeshire 010D,W01002011,711,453,270,183,1,1,192,26,166,65,47,18,0
2021,Pembrokeshire 010E,W01002012,611,318,208,110,0,0,221,111,110,72,59,13,0
2021,Pembrokeshire 011G,W01002013,1156,812,626,186,2,2,96,76,20,246,198,48,0
2021,Pembrokeshire 016E,W01002014,1079,525,361,164,3,3,264,153,111,287,241,46,0
2021,Cardiff 003E,W01002016,537,473,88,385,3,3,27,6,21,34,29,5,0
2021,Cardiff 003F,W01002017,597,414,66,348,2,2,84,8,76,97,87,10,0
2021,Cardiff 003G,W01002018,565,451,156,295,0,0,3,2,1,111,103,8,0
2021,Cardiff 032H,W01002019,1149,250,131,119,4,4,51,6,45,844,789,55,0
2021,Cardiff 037E,W01002020,622,270,100,170,0,0,195,114,81,155,145,10,2
2021,Cardiff 037F,W01002021,651,287,67,220,2,2,133,48,85,229,208,21,0
2021,Cardiff 040F,W01002022,555,361,47,314,2,2,131,6,125,61,59,2,0
2021,Cardiff 040G,W01002023,686,479,204,275,3,3,86,8,78,118,103,15,0
2021,Cardiff 048F,W01002024,701,196,77,119,1,1,23,0,23,481,453,28,0
2021,Cardiff 048G,W01002025,626,241,87,154,2,2,75,7,68,308,299,9,0
2021,Newport 004F,W01002026,753,602,79,523,13,13,78,19,59,60,55,5,0
2021,Newport 004G,W01002027,740,588,286,302,0,0,103,47,56,49,38,11,0
2021,Newport 009F,W01002028,776,584,281,303,20,20,101,50,51,71,63,8,0
2021,Newport 009G,W01002029,611,519,55,464,0,0,48,11,37,42,38,4,2
2021,Newport 013F,W01002030,595,363,136,227,26,26,34,10,24,171,155,16,1
2021,Newport 013G,W01002031,704,338,88,250,8,8,69,12,57,289,272,17,0
2021,Newport 015H,W01002032,571,458,284,174,0,0,62,11,51,50,40,10,1
2021,Newport 015I,W01002033,651,412,84,328,2,2,93,17,76,144,132,12,0
2021,Newport 019E,W01002034,741,543,188,355,14,14,18,2,16,166,153,13,0
2021,Newport 019F,W01002035,605,277,47,230,6,6,260,125,135,62,55,7,0
2021,Vale of Glamorgan 005G,W01002036,773,454,193,261,1,1,111,13,98,207,192,15,0
2021,Vale of Glamorgan 005H,W01002037,565,338,174,164,2,2,38,28,10,187,172,15,0
2021,Vale of Glamorgan 014G,W01002038,580,410,247,163,0,0,82,66,16,87,72,15,1
2021,Vale of Glamorgan 014H,W01002039,666,527,148,379,6,6,80,8,72,53,44,9,0
2021,Vale of Glamorgan 015F,W01002040,900,643,84,559,5,5,118,12,106,134,118,16,0
